date,hAbv,hScore,hW,hL,vAbv,vScore,vW,vL,tW,tL
1946-11-01,HUS,66,0,0,NYK,68,0,0,0,0
1946-11-02,PRO,59,0,0,BOS,53,0,0,0,0
1946-11-02,BOM,56,0,0,PIT,51,0,0,0,0
1946-11-02,CHS,63,0,0,NYK,47,1,0,1,0
1946-11-02,DEF,33,0,0,WAS,50,0,0,0,0
1946-11-03,CLR,71,0,0,HUS,60,0,1,0,1
1946-11-04,PIT,56,0,1,WAS,71,1,0,1,1
1946-11-05,BOS,55,0,1,CHS,57,1,0,1,1
1946-11-05,DEF,49,0,1,BOM,53,1,0,1,1
1946-11-07,PHW,81,0,0,PIT,75,0,2,0,2
1946-11-07,PRO,73,1,0,CHS,65,2,0,3,0
1946-11-07,BOM,63,2,0,NYK,68,1,1,3,1
1946-11-08,HUS,73,0,2,DEF,71,0,2,0,4
1946-11-09,BOM,70,2,1,WAS,69,2,0,4,1
1946-11-09,PRO,76,2,0,PIT,66,0,3,2,3
1946-11-09,CHS,64,2,1,HUS,54,1,2,3,3
1946-11-09,DEF,69,0,3,BOS,46,0,2,0,5
1946-11-10,CLR,92,1,0,WAS,68,2,1,3,1
1946-11-11,PIT,84,0,4,PRO,71,3,0,3,4
1946-11-11,NYK,68,2,1,CHS,78,3,1,5,2
1946-11-13,DEF,68,1,3,PRO,70,3,1,4,4
1946-11-13,CHS,71,4,1,BOS,61,0,3,4,4
1946-11-14,PHW,68,1,0,WAS,65,2,2,3,2
1946-11-14,BOM,64,3,1,BOS,62,0,4,3,5
1946-11-15,HUS,85,1,3,PRO,68,4,1,5,4
1946-11-16,BOM,83,4,1,CLR,74,2,0,6,1
1946-11-16,CHS,65,5,1,WAS,73,2,3,7,4
1946-11-16,NYK,64,2,2,PIT,62,1,4,3,6
1946-11-16,PRO,59,4,2,DEF,70,1,4,5,6
1946-11-16,BOS,53,0,5,HUS,49,2,3,2,8
1946-11-17,CLR,76,2,1,CHS,78,5,2,7,3
1946-11-18,NYK,61,3,2,DEF,57,2,4,5,6
1946-11-18,PIT,54,1,5,HUS,48,2,4,3,9
1946-11-19,HUS,72,2,5,CLR,74,2,2,4,7
1946-11-19,PHW,63,2,0,BOM,66,5,1,7,1
1946-11-20,NYK,72,4,2,CHS,69,6,2,10,4
1946-11-20,DEF,53,2,5,PIT,54,2,5,4,10
1946-11-20,WAS,54,3,3,BOM,51,6,1,9,4
1946-11-21,PHW,63,2,1,CHS,65,6,3,8,4
1946-11-21,PRO,58,4,3,WAS,66,4,3,8,6
1946-11-21,BOS,53,1,5,BOM,65,6,2,7,7
1946-11-22,HUS,83,2,6,BOS,82,1,6,3,12
1946-11-23,NYK,82,5,2,CLR,76,3,2,8,4
1946-11-23,PRO,59,4,4,BOM,65,7,2,11,6
1946-11-23,WAS,74,5,3,HUS,50,3,6,8,9
1946-11-23,DEF,54,2,6,BOS,46,1,7,3,13
1946-11-24,CLR,62,3,3,PIT,60,3,5,6,8
1946-11-24,CHS,55,7,3,DEF,68,3,6,10,9
1946-11-25,BOS,59,1,8,PRO,71,4,5,5,13
1946-11-25,PIT,46,3,6,NYK,62,6,2,9,8
1946-11-26,HUS,68,3,7,WAS,78,6,3,9,10
1946-11-26,PHW,66,2,2,BOS,54,1,9,3,11
1946-11-26,DEF,66,4,6,CLR,46,4,3,8,9
1946-11-27,WAS,75,7,3,CHS,67,7,4,14,7
1946-11-27,PIT,62,3,7,CLR,60,4,4,7,11
1946-11-27,NYK,67,7,2,BOM,60,8,2,15,4
1946-11-28,CHS,72,7,5,BOM,75,8,3,15,8
1946-11-28,PRO,58,5,5,NYK,60,8,2,13,7
1946-11-28,BOS,59,1,10,PIT,55,4,7,5,17
1946-11-28,PHW,55,3,2,DEF,68,5,6,8,8
1946-11-29,HUS,72,3,8,CLR,87,4,5,7,13
1946-11-30,PRO,79,5,6,HUS,65,3,9,8,15
1946-11-30,NYK,64,9,2,PHW,60,3,3,12,5
1946-11-30,BOM,60,9,3,DEF,57,6,6,15,9
1946-11-30,WAS,49,8,3,PIT,40,4,8,12,11
1946-12-01,CHS,66,7,6,BOS,56,2,10,9,16
1946-12-01,CLR,49,5,5,DEF,47,6,7,11,12
1946-12-02,PIT,44,4,9,BOS,46,2,11,6,20
1946-12-03,PHW,76,3,4,PRO,68,6,6,9,10
1946-12-04,WAS,80,9,3,PRO,62,6,7,15,10
1946-12-04,NYK,70,10,2,DEF,57,6,8,16,10
1946-12-04,PIT,46,4,10,CHS,57,8,6,12,16
1946-12-05,CHS,61,9,6,HUS,65,3,10,12,16
1946-12-05,BOS,61,3,11,DEF,65,6,9,9,20
1946-12-05,BOM,66,10,3,PIT,55,4,11,14,14
1946-12-05,PHW,62,4,4,NYK,51,11,2,15,6
1946-12-07,CHS,86,9,7,CLR,78,6,5,15,12
1946-12-07,BOS,65,3,12,NYK,90,11,3,14,15
1946-12-07,WAS,75,10,3,DEF,64,7,9,17,12
1946-12-07,PRO,59,6,8,HUS,68,4,10,10,18
1946-12-07,BOM,47,11,3,PHW,57,5,4,16,7
1946-12-08,CLR,72,6,6,PHW,66,6,4,12,10
1946-12-08,NYK,62,12,3,BOS,44,3,13,15,16
1946-12-09,PIT,58,4,12,DEF,66,7,10,11,22
1946-12-10,HUS,73,5,10,PHW,85,6,5,11,15
1946-12-10,CLR,61,7,6,BOM,62,11,4,18,10
1946-12-11,CHS,88,10,7,CLR,79,7,7,17,14
1946-12-11,NYK,83,13,3,PRO,68,6,9,19,12
1946-12-11,WAS,81,11,3,DEF,66,8,10,19,13
1946-12-12,BOM,68,12,4,CHS,88,11,7,23,11
1946-12-12,BOS,73,3,14,DEF,66,8,11,11,25
1946-12-12,PHW,49,7,5,WAS,64,12,3,19,8
1946-12-13,HUS,52,5,11,PIT,62,4,13,9,24
1946-12-14,PRO,81,6,10,DEF,66,8,12,14,22
1946-12-14,BOS,77,4,14,PHW,65,7,6,11,20
1946-12-14,WAS,72,13,3,CLR,52,7,8,20,11
1946-12-15,CHS,84,12,7,PIT,75,5,13,17,20
1946-12-15,CLR,70,7,9,NYK,52,14,3,21,12
1946-12-15,BOM,46,12,5,HUS,50,5,12,17,17
1946-12-16,PIT,55,5,14,BOM,66,12,6,17,20
1946-12-17,CLR,78,8,9,HUS,62,6,12,14,21
1946-12-17,PHW,57,7,7,DEF,49,8,13,15,20
1946-12-18,NYK,53,14,4,CLR,56,9,9,23,13
1946-12-18,WAS,68,14,3,BOM,47,13,6,27,9
1946-12-19,PRO,81,7,10,CHS,77,13,7,20,17
1946-12-19,BOS,74,5,14,BOM,76,13,7,18,21
1946-12-19,PHW,58,8,7,CLR,44,10,9,18,16
1946-12-20,HUS,74,6,13,NYK,70,14,5,20,18
1946-12-21,PRO,63,8,10,NYK,61,14,6,22,16
1946-12-21,WAS,68,15,3,PHW,56,9,7,24,10
1946-12-22,CHS,95,13,8,DEF,92,8,14,21,22
1946-12-22,CLR,74,10,10,PIT,78,5,15,15,25
1946-12-22,BOM,65,14,7,BOS,53,5,15,19,22
1946-12-23,PIT,64,6,15,BOS,54,5,16,11,31
1946-12-26,PRO,66,9,10,WAS,78,16,3,25,13
1946-12-26,BOM,55,15,7,DEF,51,8,15,23,22
1946-12-26,PHW,53,9,8,PIT,46,7,15,16,23
1946-12-27,HUS,80,7,13,CHS,88,14,8,21,21
1946-12-27,BOS,60,5,17,PHW,63,10,8,15,25
1946-12-28,PRO,80,9,11,BOS,68,5,18,14,29
1946-12-28,WAS,70,17,3,NYK,49,14,7,31,10
1946-12-29,CLR,79,10,11,CHS,87,15,8,25,19
1946-12-29,BOM,75,16,7,PHW,68,11,8,27,15
1946-12-29,DEF,48,8,16,HUS,52,7,14,15,30
1946-12-30,PIT,60,7,16,PHW,62,11,9,18,25
1946-12-30,BOS,60,5,19,WAS,70,18,3,23,22
1946-12-31,HUS,87,8,14,CHS,76,16,8,24,22
1946-12-31,CLR,59,10,12,BOM,68,17,7,27,19
1947-01-01,CHS,90,16,9,BOM,103,18,7,34,16
1947-01-01,DEF,62,8,17,WAS,57,19,3,27,20
1947-01-01,PIT,48,7,17,CLR,61,10,13,17,30
1947-01-02,PHW,84,12,9,PRO,72,10,11,22,20
1947-01-02,BOM,66,19,7,WAS,57,19,4,38,11
1947-01-03,HUS,53,9,14,BOS,58,5,20,14,34
1947-01-04,PRO,78,10,12,PHW,74,13,9,23,21
1947-01-04,WAS,78,19,5,CLR,64,11,13,30,18
1947-01-04,DEF,50,9,17,NYK,62,14,8,23,25
1947-01-05,BOM,57,20,7,NYK,59,15,8,35,15
1947-01-06,HUS,76,9,15,DEF,61,9,18,18,33
1947-01-06,BOS,53,6,20,CLR,64,11,14,17,34
1947-01-06,PIT,49,7,18,WAS,63,20,5,27,23
1947-01-08,DEF,80,9,19,CHS,83,16,10,25,29
1947-01-08,WAS,77,21,5,PRO,69,11,12,32,17
1947-01-08,PIT,67,7,19,PHW,63,13,10,20,29
1947-01-08,NYK,63,16,8,HUS,76,10,15,26,23
1947-01-09,BOM,84,20,8,CHS,81,17,10,37,18
1947-01-09,PRO,91,11,13,CLR,68,12,14,23,27
1947-01-09,PHW,74,13,11,HUS,55,11,15,24,26
1947-01-10,BOS,66,6,21,NYK,62,16,9,22,30
1947-01-11,PRO,72,12,13,BOS,73,7,21,19,34
1947-01-11,WAS,81,22,5,HUS,66,11,16,33,21
1947-01-11,DEF,58,9,20,PHW,56,14,11,23,31
1947-01-12,CHS,75,17,11,PHW,72,14,12,31,23
1947-01-12,BOM,72,21,8,PIT,59,8,19,29,27
1947-01-13,PIT,50,8,20,NYK,53,16,10,24,30
1947-01-14,CLR,74,12,15,PRO,78,12,14,24,29
1947-01-14,HUS,74,11,17,PHW,104,14,13,25,30
1947-01-15,NYK,63,17,10,WAS,65,23,5,40,15
1947-01-15,DEF,68,10,20,CHS,59,18,11,28,31
1947-01-15,PIT,65,8,21,PRO,53,13,14,21,35
1947-01-16,PHW,78,15,13,CHS,84,18,12,33,25
1947-01-16,BOM,59,22,8,CLR,63,12,16,34,24
1947-01-16,BOS,47,8,21,WAS,38,24,5,32,26
1947-01-17,HUS,64,11,18,DEF,74,11,20,22,38
1947-01-18,WAS,87,24,6,CHS,72,19,12,43,18
1947-01-18,NYK,45,17,11,BOS,58,9,21,26,32
1947-01-19,CLR,79,13,16,NYK,72,17,12,30,28
1947-01-19,BOM,69,22,9,PRO,53,13,15,35,24
1947-01-20,PIT,62,9,21,DEF,57,12,20,21,41
1947-01-20,BOS,54,10,21,CHS,81,19,13,29,34
1947-01-21,HUS,72,11,19,BOM,71,23,9,34,28
1947-01-21,PHW,59,15,14,BOS,43,10,22,25,36
1947-01-22,NYK,74,17,13,CHS,64,20,13,37,26
1947-01-22,WAS,57,25,6,PHW,55,16,14,41,20
1947-01-22,DEF,47,12,21,CLR,61,14,16,26,37
1947-01-23,PHW,83,16,15,CLR,78,15,16,31,31
1947-01-23,CHS,97,20,14,PRO,76,13,16,33,30
1947-01-23,BOS,48,10,23,PIT,43,10,21,20,44
1947-01-24,HUS,93,12,19,PRO,96,13,17,25,36
1947-01-25,WAS,84,26,6,PIT,71,10,22,36,28
1947-01-25,DEF,55,12,22,PHW,61,17,15,29,37
1947-01-25,NYK,46,18,13,BOS,52,11,23,29,36
1947-01-26,BOM,71,23,10,DEF,66,12,23,35,33
1947-01-26,CHS,63,21,14,PHW,57,18,15,39,29
1947-01-27,HUS,82,12,20,CLR,88,15,17,27,37
1947-01-27,PIT,71,10,23,PRO,63,14,17,24,40
1947-01-27,BOS,57,12,23,WAS,80,27,6,39,29
1947-01-28,CLR,80,16,17,HUS,70,12,21,28,38
1947-01-29,DEF,73,12,24,PRO,83,14,18,26,42
1947-01-29,NYK,64,18,14,PIT,60,11,23,29,37
1947-01-29,WAS,69,28,6,BOS,57,12,24,40,30
1947-01-30,BOM,70,24,10,PRO,82,15,18,39,28
1947-01-30,PHW,65,18,16,NYK,58,19,14,37,30
1947-01-30,BOS,66,12,25,PIT,51,11,24,23,49
1947-01-31,HUS,83,12,22,WAS,74,29,6,41,28
1947-02-01,PRO,89,16,18,PIT,73,11,25,27,43
1947-02-01,NYK,63,19,15,PHW,71,19,16,38,31
1947-02-01,BOM,70,24,11,CLR,48,17,17,41,28
1947-02-02,CLR,81,17,18,WAS,107,29,7,46,25
1947-02-02,CHS,90,22,14,HUS,75,13,22,35,36
1947-02-02,DEF,65,12,25,NYK,63,19,16,31,41
1947-02-03,PIT,68,11,26,BOM,63,25,11,36,37
1947-02-03,PHW,61,20,16,BOS,55,13,25,33,41
1947-02-04,PHW,75,21,16,PRO,68,17,18,38,34
1947-02-05,PIT,55,12,26,HUS,58,13,23,25,49
1947-02-05,DEF,46,13,25,WAS,67,30,7,43,32
1947-02-05,NYK,46,19,17,BOM,71,25,12,44,29
1947-02-06,CHS,109,23,14,PIT,85,12,27,35,41
1947-02-06,PRO,65,17,19,BOM,73,26,12,43,31
1947-02-06,PHW,79,22,16,HUS,61,14,23,36,39
1947-02-06,BOS,49,13,26,NYK,48,19,18,32,44
1947-02-08,BOM,65,27,12,WAS,68,31,7,58,19
1947-02-08,DEF,64,13,26,PIT,58,12,28,25,54
1947-02-08,PRO,67,17,20,PHW,58,23,16,40,36
1947-02-08,NYK,69,19,19,HUS,46,14,24,33,43
1947-02-09,CLR,69,17,19,DEF,74,14,26,31,45
1947-02-09,CHS,85,24,14,WAS,67,32,7,56,21
1947-02-10,PIT,75,12,29,WAS,69,32,8,44,37
1947-02-11,CLR,85,17,20,PRO,76,18,20,35,40
1947-02-11,PHW,75,23,17,BOM,59,27,13,50,30
1947-02-12,PIT,82,13,29,CHS,101,25,14,38,43
1947-02-12,NYK,78,20,19,WAS,72,32,9,52,28
1947-02-12,DEF,84,15,26,PRO,64,18,21,33,47
1947-02-13,CHS,81,26,14,PRO,79,18,22,44,36
1947-02-13,BOS,64,14,26,BOM,54,27,14,41,40
1947-02-13,PHW,61,24,17,CLR,48,18,20,42,37
1947-02-14,HUS,84,14,25,PIT,73,13,30,27,55
1947-02-15,NYK,84,21,19,CLR,90,18,21,39,40
1947-02-15,PRO,82,18,23,PIT,72,13,31,31,54
1947-02-15,WAS,70,32,10,PHW,60,25,17,57,27
1947-02-16,CHS,84,27,14,BOS,77,15,26,42,40
1947-02-16,CLR,75,19,21,PHW,71,25,18,44,39
1947-02-16,BOM,80,27,15,HUS,64,15,25,42,40
1947-02-16,DEF,58,16,26,NYK,66,21,20,37,46
1947-02-17,PIT,63,13,32,DEF,59,16,27,29,59
1947-02-18,CLR,84,20,21,BOS,73,15,27,35,48
1947-02-18,HUS,65,15,26,BOM,57,28,15,43,41
1947-02-19,NYK,62,22,20,PRO,69,19,23,41,43
1947-02-19,WAS,69,33,10,HUS,59,16,26,49,36
1947-02-19,DEF,51,16,28,BOS,57,15,28,31,56
1947-02-20,CHS,74,28,14,DEF,76,16,29,44,43
1947-02-20,PRO,74,20,23,WAS,82,34,10,54,33
1947-02-20,PHW,78,25,19,PIT,66,14,32,39,51
1947-02-21,HUS,67,16,27,BOS,61,16,28,32,55
1947-02-21,BOM,65,28,16,CHS,60,28,15,56,31
1947-02-21,NYK,77,22,21,PIT,49,14,33,36,54
1947-02-22,PRO,85,20,24,CLR,77,21,21,41,45
1947-02-22,WAS,93,35,10,PIT,61,14,34,49,44
1947-02-23,CLR,83,21,22,WAS,91,36,10,57,32
1947-02-23,CHS,82,28,16,NYK,68,23,21,51,37
1947-02-23,BOM,71,29,16,PHW,66,26,19,55,35
1947-02-23,BOS,55,16,29,PRO,67,21,24,37,53
1947-02-23,DEF,61,17,29,HUS,52,17,27,34,56
1947-02-24,PIT,67,14,35,PHW,69,26,20,40,55
1947-02-24,WAS,83,37,10,BOS,59,16,30,53,40
1947-02-25,CLR,76,21,23,BOM,96,30,16,51,39
1947-02-25,HUS,83,17,28,PRO,60,22,24,39,52
1947-02-26,DEF,68,18,29,CHS,72,29,16,47,45
1947-02-26,PHW,75,27,20,BOM,65,31,16,58,36
1947-02-26,NYK,60,23,22,WAS,84,38,10,61,32
1947-02-26,PIT,53,14,36,CLR,74,21,24,35,60
1947-02-27,PRO,65,22,25,NYK,73,23,23,45,48
1947-02-28,HUS,77,18,28,PHW,69,28,20,46,48
1947-02-28,BOS,69,16,31,CLR,62,22,24,38,55
1947-03-01,PRO,80,22,26,DEF,74,18,30,40,56
1947-03-01,WAS,75,39,10,BOS,52,17,31,56,41
1947-03-01,NYK,63,24,23,HUS,48,19,28,43,51
1947-03-02,CHS,98,30,16,BOM,86,31,17,61,33
1947-03-02,CLR,72,22,25,PHW,69,28,21,50,46
1947-03-03,BOM,71,31,18,PRO,70,23,26,54,44
1947-03-03,PIT,66,14,37,CHS,69,31,16,45,53
1947-03-03,PHW,76,28,22,HUS,66,19,29,47,51
1947-03-04,CLR,82,23,25,PRO,76,23,27,46,52
1947-03-05,WAS,99,40,10,DEF,67,18,31,58,41
1947-03-05,PIT,60,14,38,HUS,63,19,30,33,68
1947-03-06,CHS,72,32,16,PIT,71,14,39,46,55
1947-03-06,BOS,74,17,32,DEF,65,18,32,35,64
1947-03-06,PHW,59,29,22,NYK,61,25,23,54,45
1947-03-07,HUS,70,20,30,WAS,86,41,10,61,40
1947-03-08,CHS,107,33,16,PRO,81,23,28,56,44
1947-03-08,WAS,74,42,10,BOM,73,32,18,74,28
1947-03-08,BOS,67,18,32,HUS,65,20,31,38,63
1947-03-08,NYK,64,26,23,DEF,61,18,33,44,56
1947-03-09,CLR,77,24,25,CHS,107,34,16,58,41
1947-03-10,BOS,70,19,32,PRO,87,23,29,42,61
1947-03-11,PHW,77,29,23,WAS,80,43,10,72,33
1947-03-11,CLR,78,24,26,PIT,72,14,40,38,66
1947-03-11,HUS,79,20,32,BOM,71,32,19,52,51
1947-03-12,DEF,81,18,34,CLR,89,25,26,43,60
1947-03-12,BOS,69,19,33,HUS,57,21,32,40,65
1947-03-13,NYK,78,27,23,BOM,74,32,20,59,43
1947-03-13,CHS,69,35,16,WAS,86,44,10,79,26
1947-03-13,PRO,71,24,29,HUS,64,21,33,45,62
1947-03-13,PHW,81,29,24,BOS,57,20,33,49,57
1947-03-14,CHS,70,35,17,PHW,67,30,24,65,41
1947-03-14,WAS,78,45,10,NYK,63,28,23,73,33
1947-03-14,PRO,60,25,29,BOM,56,32,21,57,50
1947-03-16,CLR,69,26,26,NYK,81,28,24,54,50
1947-03-16,DEF,61,18,35,PHW,67,30,25,48,60
1947-03-18,HUS,64,21,34,PIT,70,14,41,35,75
1947-03-18,DEF,59,18,36,BOM,68,32,22,50,58
1947-03-18,BOS,58,20,34,CLR,67,26,27,46,61
1947-03-19,WAS,96,46,10,PRO,95,26,29,72,39
1947-03-19,CHS,57,36,17,NYK,65,29,24,65,41
1947-03-19,PIT,54,15,41,BOM,79,33,22,48,63
1947-03-20,PHW,77,31,25,DEF,75,18,37,49,62
1947-03-20,PRO,76,26,30,CLR,73,27,27,53,57
1947-03-20,BOM,51,34,22,NYK,49,30,24,64,46
1947-03-21,HUS,83,21,35,CHS,99,36,18,57,53
1947-03-22,PRO,82,27,30,PHW,103,32,25,59,55
1947-03-22,DEF,85,18,38,PIT,65,15,42,33,80
1947-03-22,WAS,63,47,10,NYK,68,30,25,77,35
1947-03-22,CHS,58,37,18,CLR,67,27,28,64,46
1947-03-23,CLR,69,28,28,DEF,63,19,38,47,66
1947-03-23,BOM,60,35,22,HUS,40,21,36,56,58
1947-03-24,BOS,69,20,35,CHS,80,37,19,57,54
1947-03-24,PIT,51,15,43,NYK,65,31,25,46,68
1947-03-25,CLR,72,29,28,BOS,64,20,36,49,64
1947-03-26,NYK,91,32,25,PRO,84,27,31,59,56
1947-03-26,WAS,105,47,11,CHS,77,38,19,85,30
1947-03-26,DEF,63,19,39,BOM,67,36,22,55,61
1947-03-26,PIT,61,15,44,BOS,74,20,37,35,81
1947-03-27,PHW,80,33,25,CHS,73,38,20,71,45
1947-03-28,HUS,71,21,37,NYK,61,33,25,54,62
1947-03-29,PRO,83,27,32,CHS,79,38,21,65,53
1947-03-29,WAS,79,48,11,CLR,69,30,28,78,39
1947-03-29,DEF,66,19,40,HUS,63,22,37,41,77
1947-03-29,BOM,59,37,22,BOS,55,21,37,58,59
1947-03-30,PHW,76,34,25,NYK,72,33,26,67,51
1947-03-30,CLR,66,30,29,BOS,71,21,38,51,67
1947-03-31,CHS,73,38,22,BOM,66,38,22,76,44
1947-11-12,WAS,63,0,0,BAL,55,0,0,0,0
1947-11-13,BAL,85,0,1,BOS,74,0,0,0,1
1947-11-13,CHS,80,0,0,BOM,70,0,0,0,0
1947-11-13,NYK,80,0,0,WAS,65,1,0,1,0
1947-11-13,PHW,79,0,0,PRO,64,0,0,0,0
1947-11-14,BOS,74,0,1,PHW,79,1,0,1,1
1947-11-15,PRO,78,0,1,PHW,80,2,0,2,1
1947-11-15,BOS,73,0,2,WAS,69,1,1,1,3
1947-11-15,NYK,73,1,0,BOM,67,0,1,1,1
1947-11-15,CHS,63,1,0,BAL,67,1,1,2,1
1947-11-18,PRO,69,0,2,NYK,87,2,0,2,2
1947-11-18,BOS,50,1,2,BOM,65,0,2,1,4
1947-11-19,WAS,74,1,2,PHW,67,3,0,4,2
1947-11-19,NYK,63,3,0,CHS,81,1,1,4,1
1947-11-20,CHS,81,2,1,WAS,77,2,2,4,3
1947-11-20,BOM,73,1,2,PRO,67,0,3,1,5
1947-11-20,PHW,57,3,1,BOS,67,1,3,4,4
1947-11-20,BAL,68,2,1,NYK,56,3,1,5,2
1947-11-21,BOS,73,2,3,BAL,89,3,1,5,4
1947-11-22,NYK,78,3,2,PHW,83,3,2,6,4
1947-11-22,BAL,75,4,1,CHS,72,3,1,7,2
1947-11-22,BOS,65,2,4,PRO,62,0,4,2,8
1947-11-22,BOM,70,2,2,WAS,62,2,3,4,5
1947-11-25,BOS,75,3,4,NYK,91,3,3,6,7
1947-11-26,WAS,83,2,4,BOM,64,3,2,5,6
1947-11-26,NYK,63,4,3,BOS,65,3,5,7,8
1947-11-27,PRO,61,0,5,BAL,76,5,1,5,6
1947-11-27,PHW,59,4,2,NYK,81,4,4,8,6
1947-11-28,BOS,92,4,5,WAS,83,3,4,7,9
1947-11-28,CHS,75,3,2,PHW,71,4,3,7,5
1947-11-29,WAS,78,3,5,PRO,85,0,6,3,11
1947-11-29,BOM,67,3,3,BAL,71,6,1,9,4
1947-12-01,NYK,62,5,4,WAS,70,3,6,8,10
1947-12-02,BOS,69,5,5,BAL,77,7,1,12,6
1947-12-02,PRO,66,1,6,BOM,86,3,4,4,10
1947-12-03,CHS,81,4,2,WAS,73,4,6,8,8
1947-12-03,PHW,58,4,4,BAL,73,8,1,12,5
1947-12-04,BAL,51,9,1,BOM,65,4,4,13,5
1947-12-05,BOS,73,5,6,PRO,69,1,7,6,13
1947-12-06,PRO,85,1,8,NYK,114,5,5,6,13
1947-12-06,CHS,73,5,2,BAL,65,9,2,14,4
1947-12-08,NYK,71,6,5,BOM,56,5,4,11,9
1947-12-09,PHW,78,4,5,PRO,74,1,9,5,14
1947-12-10,BOS,75,6,6,NYK,79,7,5,13,11
1947-12-11,BAL,69,9,3,WAS,71,4,7,13,10
1947-12-11,PHW,69,5,5,BOM,74,5,5,10,10
1947-12-12,CHS,75,6,2,BOM,85,6,5,12,7
1947-12-12,BOS,69,6,7,PHW,67,5,6,11,13
1947-12-13,WAS,88,5,7,PRO,72,1,10,6,17
1947-12-13,BAL,66,9,4,NYK,80,8,5,17,9
1947-12-15,NYK,71,9,5,PHW,74,5,7,14,12
1947-12-17,BOS,67,7,7,PRO,66,1,11,8,18
1947-12-17,WAS,66,6,7,BAL,64,9,5,15,12
1947-12-18,PHW,71,6,7,NYK,99,9,6,15,13
1947-12-18,BAL,74,9,6,BOM,67,7,5,16,11
1947-12-18,CHS,64,6,3,WAS,70,7,7,13,10
1947-12-19,BOS,78,8,7,BOM,70,7,6,15,13
1947-12-20,PRO,74,1,12,PHW,80,6,8,7,20
1947-12-20,NYK,70,10,6,BOS,58,9,7,19,13
1947-12-20,WAS,52,8,7,BOM,55,7,7,15,14
1947-12-21,CHS,93,6,4,BAL,83,10,6,16,10
1947-12-23,BOS,75,9,8,CHS,83,7,4,16,12
1947-12-23,PRO,66,1,13,NYK,58,11,6,12,19
1947-12-25,NYK,89,11,7,PRO,75,2,13,13,20
1947-12-25,BAL,87,10,7,CHS,70,8,4,18,11
1947-12-25,BOM,56,8,7,WAS,73,8,8,16,15
1947-12-26,PHW,89,7,8,PRO,61,2,14,9,22
1947-12-27,WAS,72,9,8,PHW,70,8,8,17,16
1947-12-27,NYK,70,12,7,CHS,79,8,5,20,12
1947-12-27,BOS,74,9,9,PRO,63,2,15,11,24
1947-12-28,BOM,67,8,8,BAL,63,11,7,19,15
1947-12-30,PRO,73,2,16,CHS,85,9,5,11,21
1947-12-30,BOS,70,10,9,PHW,64,8,9,18,18
1948-01-01,BAL,60,11,8,PHW,72,8,10,19,18
1948-01-01,BOM,58,9,8,BOS,48,11,9,20,17
1948-01-02,PHW,69,9,10,WAS,60,10,8,19,18
1948-01-03,PRO,76,2,17,CHS,79,10,5,12,22
1948-01-03,NYK,70,12,8,BAL,79,11,9,23,17
1948-01-03,WAS,95,10,9,BOS,60,11,10,21,19
1948-01-04,BOM,80,10,8,PHW,66,10,10,20,18
1948-01-06,BAL,82,12,9,PRO,64,2,18,14,27
1948-01-07,NYK,74,12,9,CHS,79,11,5,23,14
1948-01-08,BAL,78,13,9,CHS,75,12,5,25,14
1948-01-08,BOM,76,11,8,WAS,73,11,9,22,17
1948-01-09,PHW,60,10,11,CHS,77,12,6,22,17
1948-01-10,WAS,106,11,10,PHW,99,10,12,21,22
1948-01-10,PRO,70,2,19,BOS,57,11,11,13,30
1948-01-11,CHS,99,13,6,NYK,86,12,10,25,16
1948-01-11,BOS,84,11,12,WAS,56,12,10,23,22
1948-01-11,BOM,69,12,8,BAL,54,14,9,26,17
1948-01-14,WAS,75,12,11,CHS,67,14,6,26,17
1948-01-15,PRO,78,3,19,BAL,98,14,10,17,29
1948-01-15,BOM,55,13,8,NYK,59,12,11,25,19
1948-01-16,PHW,72,10,13,BAL,63,15,10,25,23
1948-01-16,BOS,75,12,12,CHS,61,14,7,26,19
1948-01-17,BAL,77,15,11,PHW,79,11,13,26,24
1948-01-17,WAS,78,13,11,NYK,62,13,11,26,22
1948-01-18,BOM,70,13,9,PRO,61,3,20,16,29
1948-01-18,CHS,72,14,8,BOS,48,13,12,27,20
1948-01-19,NYK,57,13,12,PHW,63,12,13,25,25
1948-01-20,PHW,82,13,13,BOM,59,14,9,27,22
1948-01-21,WAS,81,14,11,BOM,74,14,10,28,21
1948-01-22,BAL,68,15,12,BOM,71,14,11,29,23
1948-01-22,PHW,54,14,13,BOS,61,13,13,27,26
1948-01-22,CHS,50,15,8,PRO,56,3,21,18,29
1948-01-23,BOS,58,14,13,NYK,74,13,13,27,26
1948-01-24,WAS,69,15,11,PRO,60,4,21,19,32
1948-01-24,NYK,58,14,13,BAL,72,15,13,29,26
1948-01-25,BOM,72,15,11,BOS,54,14,14,29,25
1948-01-27,CHS,78,15,9,BAL,74,16,13,31,22
1948-01-27,BOS,68,14,15,PHW,77,14,14,28,29
1948-01-27,PRO,61,4,22,BOM,94,16,11,20,33
1948-01-28,NYK,75,14,14,PRO,73,4,23,18,37
1948-01-29,BOM,62,17,11,CHS,60,16,9,33,20
1948-01-29,PHW,60,15,14,NYK,66,15,14,30,28
1948-01-30,BAL,95,16,14,WAS,71,16,11,32,25
1948-01-30,BOS,69,14,16,PRO,79,4,24,18,40
1948-01-31,NYK,66,16,14,BOS,64,14,17,30,31
1948-01-31,PRO,62,5,24,BAL,68,17,14,22,38
1948-01-31,BOM,60,18,11,PHW,66,15,15,33,26
1948-01-31,WAS,54,16,12,CHS,48,16,10,32,22
1948-02-01,CHS,78,16,11,PHW,85,16,15,32,26
1948-02-03,PRO,62,5,25,NYK,78,17,14,22,39
1948-02-04,WAS,77,17,12,BAL,72,18,14,35,26
1948-02-04,NYK,108,18,14,PRO,69,5,26,23,40
1948-02-05,BAL,100,18,15,PRO,74,5,27,23,42
1948-02-05,BOM,71,18,12,CHS,77,16,12,34,24
1948-02-05,PHW,60,17,15,WAS,72,18,12,35,27
1948-02-06,BOS,57,14,18,NYK,68,19,14,33,32
1948-02-07,PRO,64,5,28,WAS,86,19,12,24,40
1948-02-07,BOM,67,18,13,PHW,54,17,16,35,29
1948-02-08,CHS,80,17,12,PHW,74,17,17,34,29
1948-02-08,NYK,80,20,14,BOS,68,14,19,34,33
1948-02-10,WAS,79,20,12,PRO,60,5,29,25,41
1948-02-11,CHS,78,18,12,BOM,80,19,13,37,25
1948-02-11,NYK,86,21,14,PRO,63,5,30,26,44
1948-02-12,BAL,96,19,15,NYK,86,22,14,41,29
1948-02-12,BOM,74,20,13,CHS,80,18,13,38,26
1948-02-12,PHW,69,17,18,BOS,60,14,20,31,38
1948-02-13,BOS,79,14,21,PRO,73,5,31,19,52
1948-02-14,WAS,72,21,12,BOS,58,15,21,36,33
1948-02-14,NYK,78,22,15,PHW,47,18,18,40,33
1948-02-15,CHS,79,19,13,PRO,85,5,32,24,45
1948-02-15,BOM,69,20,14,BAL,63,20,15,40,29
1948-02-18,WAS,75,22,12,NYK,79,23,15,45,27
1948-02-19,BOS,76,15,22,BAL,79,20,16,35,38
1948-02-19,PHW,84,18,19,WAS,76,22,13,40,32
1948-02-19,CHS,82,19,14,NYK,74,24,15,43,29
1948-02-19,BOM,78,21,14,PRO,69,6,32,27,46
1948-02-21,PRO,73,6,33,CHS,92,20,14,26,47
1948-02-21,WAS,85,22,14,BAL,72,21,16,43,30
1948-02-22,BOS,77,15,23,CHS,97,21,14,36,37
1948-02-22,BOM,80,22,14,NYK,71,24,16,46,30
1948-02-24,PHW,83,19,19,BAL,71,21,17,40,36
1948-02-25,WAS,66,23,14,CHS,73,22,14,45,28
1948-02-26,BOM,94,23,14,BOS,92,15,24,38,38
1948-02-26,PHW,89,20,19,CHS,80,23,14,43,33
1948-02-26,BAL,97,21,18,WAS,70,23,15,44,33
1948-02-27,CHS,69,23,15,BOS,83,15,25,38,40
1948-02-28,PRO,82,6,34,PHW,83,21,19,27,53
1948-02-28,BOM,82,24,14,WAS,61,23,16,47,30
1948-02-28,NYK,56,24,17,BAL,78,22,18,46,35
1948-02-29,CHS,76,23,16,WAS,75,23,17,46,33
1948-02-29,BOS,65,16,25,BAL,62,23,18,39,43
1948-03-02,PHW,76,22,19,NYK,66,24,18,46,37
1948-03-04,BAL,84,23,19,BOM,75,25,14,48,33
1948-03-04,PHW,82,23,19,BOS,62,17,25,40,44
1948-03-05,BOS,71,17,26,BOM,68,25,15,42,41
1948-03-06,BAL,81,24,19,BOS,68,18,26,42,45
1948-03-06,NYK,69,24,19,WAS,64,23,18,47,37
1948-03-07,CHS,89,24,16,PRO,81,6,35,30,51
1948-03-09,PHW,79,24,19,CHS,93,25,16,49,35
1948-03-09,PRO,69,6,36,BOM,75,25,16,31,52
1948-03-10,NYK,73,25,19,BOM,82,26,16,51,35
1948-03-10,WAS,54,23,19,CHS,71,26,16,49,35
1948-03-11,BAL,86,25,19,CHS,83,27,16,52,35
1948-03-11,PHW,92,24,20,BOM,74,27,16,51,36
1948-03-13,WAS,86,23,20,BOM,69,27,17,50,37
1948-03-13,PRO,64,6,37,BOS,86,18,27,24,64
1948-03-13,BAL,64,26,19,PHW,62,25,20,51,39
1948-03-13,CHS,58,27,17,NYK,51,25,20,52,37
1948-03-16,PRO,78,6,38,PHW,100,25,21,31,59
1948-03-16,BOS,62,19,27,WAS,76,24,20,43,47
1948-03-17,WAS,82,25,20,PRO,67,6,39,31,59
1948-03-18,BOM,80,27,18,NYK,91,25,21,52,39
1948-03-18,CHS,72,28,17,BOS,77,19,28,47,45
1948-03-18,BAL,64,27,19,WAS,71,26,20,53,39
1948-03-18,PHW,88,26,21,PRO,57,6,40,32,61
1948-03-20,WAS,103,27,20,NYK,82,26,21,53,41
1948-03-20,BOM,75,27,19,CHS,63,28,18,55,37
1948-03-20,BAL,75,27,20,PRO,58,6,41,33,61
1948-03-21,CHS,70,28,19,BOM,82,28,19,56,38
1948-03-23,CHS,75,28,20,WAS,72,28,20,56,40
1948-03-25,CHS,74,29,20,BAL,70,28,20,57,40
1948-11-01,JET,84,0,0,BOM,80,0,0,0,0
1948-11-03,FTW,76,0,0,NYK,80,0,0,0,0
1948-11-03,WAS,77,0,0,PHW,70,0,0,0,0
1948-11-04,PRO,95,0,0,WAS,99,1,0,1,0
1948-11-04,PHW,94,0,1,BOS,73,0,0,0,1
1948-11-04,BAL,72,0,0,MNL,84,0,0,0,0
1948-11-05,JET,71,1,0,NYK,87,1,0,2,0
1948-11-06,CHS,82,0,0,BAL,69,0,1,0,1
1948-11-06,WAS,67,2,0,MNL,62,1,0,3,0
1948-11-06,ROC,69,0,0,JET,58,1,1,1,1
1948-11-06,PRO,56,0,1,PHW,69,1,2,1,3
1948-11-06,BOM,65,0,1,FTW,55,0,1,0,2
1948-11-07,FTW,77,0,2,BAL,78,0,2,0,4
1948-11-07,BOS,85,0,1,PHW,77,2,2,2,3
1948-11-09,PHW,92,2,3,PRO,84,0,2,2,5
1948-11-09,JET,64,1,2,BAL,65,1,2,2,4
1948-11-09,BOM,60,1,1,NYK,56,3,0,4,1
1948-11-09,BOS,77,1,1,MNL,55,2,1,3,2
1948-11-10,WAS,73,3,0,ROC,66,1,0,4,0
1948-11-11,NYK,68,3,1,MNL,77,1,1,4,2
1948-11-11,PRO,90,0,3,FTW,87,0,3,0,6
1948-11-11,PHW,75,3,3,ROC,83,1,1,4,4
1948-11-11,BAL,68,2,2,WAS,70,4,0,6,2
1948-11-12,BOS,84,2,1,FTW,75,0,4,2,5
1948-11-13,NYK,91,3,2,BAL,87,2,3,5,5
1948-11-13,BOM,76,2,1,PHW,75,3,4,5,5
1948-11-13,CHS,79,1,0,JET,72,1,3,2,3
1948-11-13,WAS,80,5,0,FTW,71,0,5,5,5
1948-11-13,PRO,67,1,3,MNL,90,2,2,3,5
1948-11-13,ROC,95,2,1,BOS,63,3,1,5,2
1948-11-14,ROC,92,3,1,MNL,75,3,2,6,3
1948-11-14,FTW,79,0,6,JET,73,1,4,1,10
1948-11-16,JET,82,1,5,PHW,90,3,5,4,10
1948-11-16,BOM,79,3,1,BOS,74,3,2,6,3
1948-11-16,ROC,75,4,1,NYK,63,4,2,8,3
1948-11-17,MNL,72,3,3,BOS,74,3,3,6,6
1948-11-17,FTW,80,1,6,PHW,72,4,5,5,11
1948-11-17,NYK,62,4,3,WAS,73,6,0,10,3
1948-11-18,PRO,74,1,4,ROC,103,5,1,6,5
1948-11-18,PHW,83,4,6,JET,71,1,6,5,12
1948-11-18,BAL,55,2,4,NYK,67,4,4,6,8
1948-11-19,CHS,81,2,0,MNL,85,3,4,5,4
1948-11-19,BOM,82,4,1,BAL,72,2,5,6,6
1948-11-19,BOS,75,4,3,JET,70,1,7,5,10
1948-11-20,NYK,91,2,0,PHW,86,1,1,3,1
1948-11-20,PRO,107,1,5,JET,110,1,8,2,13
1948-11-20,WAS,90,7,0,BOS,75,5,3,12,3
1948-11-20,BOM,64,5,1,BAL,85,2,6,7,7
1948-11-21,MNL,94,4,4,BAL,81,3,6,7,10
1948-11-21,ROC,77,6,1,WAS,80,8,0,14,1
1948-11-21,FTW,69,2,6,CHS,70,2,1,4,7
1948-11-23,ROC,108,6,2,BAL,90,3,7,9,9
1948-11-23,JET,82,2,8,MNL,88,5,4,7,12
1948-11-23,PHW,80,5,6,FTW,90,2,7,7,13
1948-11-23,BOS,68,5,4,WAS,71,9,0,14,4
1948-11-24,MNL,117,6,4,PRO,89,1,6,7,10
1948-11-25,BOM,84,5,2,PRO,82,1,7,6,9
1948-11-25,PHW,73,5,7,WAS,81,10,0,15,7
1948-11-25,JET,81,2,9,BOS,66,5,5,7,14
1948-11-25,BAL,69,3,8,FTW,64,3,7,6,15
1948-11-27,ROC,105,7,2,CHS,103,3,1,10,3
1948-11-27,WAS,94,11,0,JET,76,3,9,14,9
1948-11-27,BOM,71,6,2,MNL,87,7,4,13,6
1948-11-27,PRO,71,1,8,BAL,91,4,8,5,16
1948-11-27,NYK,80,5,4,FTW,70,3,8,8,12
1948-11-28,FTW,80,3,9,BOS,74,5,6,8,15
1948-11-28,MNL,88,8,4,PHW,67,5,8,13,12
1948-11-30,MNL,94,9,4,BOS,84,5,7,14,11
1948-11-30,CHS,74,3,2,PHW,68,5,9,8,11
1948-11-30,JET,62,3,10,FTW,77,4,9,7,19
1948-11-30,PRO,61,1,9,NYK,88,6,4,7,13
1948-12-01,FTW,84,5,9,MNL,74,10,4,15,13
1948-12-01,NYK,72,7,4,ROC,73,8,2,15,6
1948-12-01,WAS,75,12,0,PRO,63,1,10,13,10
1948-12-01,BOM,72,6,3,CHS,61,4,2,10,5
1948-12-02,PHW,87,5,10,BOS,88,5,8,10,18
1948-12-02,BAL,90,5,8,JET,78,3,11,8,19
1948-12-02,PRO,61,1,11,WAS,66,13,0,14,11
1948-12-04,ROC,105,9,2,PHW,101,5,11,14,13
1948-12-04,CHS,104,4,3,MNL,100,10,5,14,8
1948-12-04,WAS,83,14,0,BAL,82,6,8,20,8
1948-12-04,NYK,66,7,5,JET,63,3,12,10,17
1948-12-04,PRO,63,1,12,BOS,70,6,8,7,20
1948-12-04,BOM,76,7,3,FTW,62,6,9,13,12
1948-12-05,FTW,79,6,10,CHS,88,5,3,11,13
1948-12-05,MNL,78,10,6,BOM,68,8,3,18,9
1948-12-06,BOS,79,7,8,ROC,87,10,2,17,10
1948-12-07,ROC,89,11,2,PRO,90,1,13,12,15
1948-12-07,JET,94,3,13,WAS,78,15,0,18,13
1948-12-08,MNL,83,11,6,WAS,94,15,1,26,7
1948-12-08,PHW,78,5,12,BAL,83,6,9,11,21
1948-12-08,NYK,83,8,5,PRO,74,2,13,10,18
1948-12-08,FTW,70,6,11,BOM,60,8,4,14,15
1948-12-09,BAL,92,7,9,PHW,91,5,13,12,22
1948-12-09,PRO,63,2,14,NYK,74,9,5,11,19
1948-12-10,BOM,88,8,5,WAS,83,16,1,24,6
1948-12-10,ROC,75,11,3,MNL,96,11,7,22,10
1948-12-10,CHS,78,6,3,FTW,70,7,11,13,14
1948-12-11,NYK,72,10,5,BAL,71,8,9,18,14
1948-12-11,WAS,87,16,2,BOM,63,9,5,25,7
1948-12-12,FTW,78,7,12,NYK,89,11,5,18,17
1948-12-12,MNL,67,12,7,ROC,58,11,4,23,11
1948-12-13,BOS,83,7,9,BOM,79,9,6,16,15
1948-12-13,JET,74,4,13,NYK,80,12,5,16,18
1948-12-13,CHS,75,7,3,BAL,70,8,10,15,13
1948-12-14,CHS,78,8,3,ROC,85,11,5,19,8
1948-12-14,BAL,88,8,11,JET,75,4,14,12,25
1948-12-14,PHW,74,5,14,BOM,61,9,7,14,21
1948-12-15,WAS,92,17,2,PHW,81,6,14,23,16
1948-12-15,MNL,79,13,7,JET,61,4,15,17,22
1948-12-16,BAL,82,9,11,BOM,85,9,8,18,19
1948-12-16,PRO,61,2,15,FTW,76,7,13,9,28
1948-12-17,PHW,87,6,15,NYK,78,13,5,19,20
1948-12-17,JET,67,4,16,CHS,71,8,4,12,20
1948-12-17,BOS,63,8,9,BAL,74,9,12,17,21
1948-12-18,PRO,90,2,16,PHW,94,7,15,9,31
1948-12-18,NYK,88,13,6,BOM,79,10,8,23,14
1948-12-18,ROC,84,12,5,FTW,64,8,13,20,18
1948-12-18,WAS,69,18,2,BOS,60,8,10,26,12
1948-12-19,MNL,94,14,7,CHS,84,9,4,23,11
1948-12-19,FTW,78,8,14,ROC,83,13,5,21,19
1948-12-19,BOS,77,8,11,NYK,75,14,6,22,17
1948-12-21,JET,71,4,17,ROC,84,14,5,18,22
1948-12-21,PHW,72,8,15,MNL,64,15,7,23,22
1948-12-22,NYK,97,14,7,MNL,79,15,8,29,15
1948-12-22,WAS,102,19,2,PRO,77,2,17,21,19
1948-12-23,PRO,99,2,18,BOM,109,10,9,12,27
1948-12-23,BAL,96,10,12,CHS,89,9,5,19,17
1948-12-23,JET,71,4,18,FTW,60,8,15,12,33
1948-12-25,PRO,83,2,19,BAL,88,11,12,13,31
1948-12-25,ROC,90,15,5,BOM,82,11,9,26,14
1948-12-25,PHW,80,9,15,BOS,77,9,11,18,26
1948-12-25,WAS,88,20,2,FTW,74,8,16,28,18
1948-12-25,NYK,64,15,7,CHS,70,9,6,24,13
1948-12-26,MNL,99,15,9,ROC,90,16,5,31,14
1948-12-26,CHS,84,10,6,BOS,73,9,12,19,18
1948-12-26,FTW,91,8,17,WAS,73,21,2,29,19
1948-12-26,BOM,75,11,10,JET,65,5,18,16,28
1948-12-28,BOS,74,9,13,CHS,76,11,6,20,19
1948-12-29,BAL,88,12,12,PRO,98,2,20,14,32
1948-12-29,NYK,77,15,8,ROC,74,16,6,31,14
1948-12-29,MNL,91,16,9,WAS,68,21,3,37,12
1948-12-30,PHW,94,10,15,JET,91,5,19,15,34
1948-12-30,BAL,100,12,13,ROC,89,16,7,28,20
1948-12-30,PRO,89,3,20,CHS,101,12,6,15,26
1948-12-30,BOM,68,12,10,WAS,81,21,4,33,14
1948-12-31,BOS,69,9,14,PRO,67,3,21,12,35
1949-01-01,WAS,92,22,4,CHS,90,13,6,35,10
1949-01-01,ROC,106,16,8,BOM,83,12,11,28,19
1949-01-01,NYK,88,16,8,PHW,80,11,15,27,23
1949-01-01,PRO,77,3,22,JET,78,5,20,8,42
1949-01-01,MNL,92,17,9,FTW,72,9,17,26,26
1949-01-01,BAL,72,13,13,BOS,67,10,14,23,27
1949-01-02,CHS,81,13,7,NYK,79,17,8,30,15
1949-01-02,FTW,69,9,18,BOS,90,10,15,19,33
1949-01-02,BOM,64,12,12,ROC,89,17,8,29,20
1949-01-04,CHS,115,14,7,PRO,104,3,23,17,30
1949-01-04,PHW,78,11,16,WAS,84,23,4,34,20
1949-01-04,BOS,75,11,15,BAL,69,14,13,25,28
1949-01-04,JET,63,6,20,NYK,58,17,9,23,29
1949-01-05,MNL,101,18,9,BOM,76,12,13,30,22
1949-01-05,WAS,68,24,4,BAL,88,14,14,38,18
1949-01-06,BAL,93,15,14,PHW,88,11,17,26,31
1949-01-06,PRO,78,3,24,CHS,89,15,7,18,31
1949-01-06,JET,73,7,20,ROC,62,18,8,25,28
1949-01-07,BOS,67,12,15,NYK,69,17,10,29,25
1949-01-08,ROC,88,18,9,CHS,91,16,7,34,16
1949-01-08,NYK,81,18,10,BAL,83,16,14,34,24
1949-01-08,WAS,89,24,5,JET,81,8,20,32,25
1949-01-08,PRO,87,3,25,BOS,69,12,16,15,41
1949-01-08,PHW,67,11,18,FTW,73,9,19,20,37
1949-01-08,BOM,64,12,14,MNL,59,19,9,31,23
1949-01-09,FTW,80,10,19,JET,78,8,21,18,40
1949-01-09,CHS,75,17,7,ROC,90,18,10,35,17
1949-01-09,MNL,74,19,10,BOM,58,13,14,32,24
1949-01-10,BOS,83,12,17,WAS,94,25,5,37,22
1949-01-11,ROC,83,19,10,PHW,71,11,19,30,29
1949-01-11,JET,90,8,22,PRO,67,4,25,12,47
1949-01-12,BAL,106,17,14,WAS,92,26,5,43,19
1949-01-12,BOM,66,13,15,CHS,75,17,8,30,23
1949-01-12,NYK,81,18,11,BOS,64,12,18,30,29
1949-01-12,MNL,98,20,10,PRO,64,4,26,24,36
1949-01-13,BAL,85,18,14,ROC,102,20,10,38,24
1949-01-14,BOS,79,12,19,PHW,104,11,20,23,39
1949-01-14,JET,61,9,22,CHS,88,18,8,27,30
1949-01-15,PHW,94,12,20,BAL,87,18,15,30,35
1949-01-15,CHS,94,19,8,BOS,86,12,20,31,28
1949-01-15,BOM,79,13,16,PRO,76,4,27,17,43
1949-01-15,WAS,75,26,6,NYK,73,19,11,45,17
1949-01-15,ROC,73,21,10,FTW,62,11,19,32,29
1949-01-16,CHS,92,20,8,WAS,70,27,6,47,14
1949-01-16,MNL,75,21,10,JET,66,9,23,30,33
1949-01-16,FTW,76,11,20,PRO,56,4,28,15,48
1949-01-17,NYK,71,19,12,BOM,79,14,16,33,28
1949-01-18,BOS,83,12,21,BOM,89,15,16,27,37
1949-01-18,PHW,86,13,20,PRO,74,4,29,17,49
1949-01-18,JET,56,9,24,MNL,81,22,10,31,34
1949-01-19,CHS,96,21,8,FTW,104,12,20,33,28
1949-01-19,ROC,70,22,10,JET,66,9,25,31,35
1949-01-20,PRO,81,4,30,WAS,88,27,7,31,37
1949-01-20,BOM,74,16,16,ROC,84,23,10,39,26
1949-01-20,PHW,92,14,20,CHS,72,21,9,35,29
1949-01-20,BAL,82,18,16,NYK,68,19,13,37,29
1949-01-20,MNL,83,23,10,FTW,65,13,20,36,30
1949-01-21,BOS,76,12,22,CHS,86,21,10,33,32
1949-01-22,ROC,103,24,10,NYK,98,19,14,43,24
1949-01-22,PRO,89,4,31,BAL,86,19,16,23,47
1949-01-22,WAS,95,28,7,BOS,64,12,23,40,30
1949-01-23,NYK,93,19,15,WAS,97,29,7,48,22
1949-01-23,FTW,80,13,21,ROC,81,25,10,38,31
1949-01-23,BOM,73,16,17,JET,91,9,26,25,43
1949-01-23,MNL,89,24,10,PHW,71,15,20,39,30
1949-01-25,CHS,77,22,10,PHW,86,15,21,37,31
1949-01-25,BOS,54,12,24,PRO,69,5,31,17,55
1949-01-25,JET,65,10,26,BOM,53,16,18,26,44
1949-01-26,BAL,96,19,17,WAS,86,30,7,49,24
1949-01-26,FTW,88,13,22,PHW,80,16,21,29,43
1949-01-26,NYK,89,19,16,PRO,77,6,31,25,47
1949-01-26,MNL,84,25,10,CHS,49,22,11,47,21
1949-01-27,PHW,102,16,22,NYK,96,20,16,36,38
1949-01-27,BAL,89,20,17,PRO,95,6,32,26,49
1949-01-28,BOS,91,12,25,WAS,90,30,8,42,33
1949-01-28,CHS,83,22,12,BOM,65,16,19,38,31
1949-01-28,JET,77,11,26,FTW,63,14,22,25,48
1949-01-29,ROC,90,26,10,BAL,86,20,18,46,28
1949-01-29,PRO,91,7,32,BOS,85,13,25,20,57
1949-01-29,CHS,87,23,12,JET,81,12,26,35,38
1949-01-29,NYK,73,20,17,PHW,78,17,22,37,39
1949-01-29,BOM,86,16,20,FTW,73,14,23,30,43
1949-01-31,MNL,84,26,10,WAS,79,30,9,56,19
1949-01-31,FTW,78,14,24,BAL,93,20,19,34,43
1949-02-01,PHW,93,18,22,PRO,86,8,32,26,54
1949-02-01,JET,83,12,27,WAS,69,30,10,42,37
1949-02-01,BOS,68,13,26,ROC,76,27,10,40,36
1949-02-02,FTW,79,14,25,MNL,82,27,10,41,35
1949-02-02,CHS,77,24,12,BAL,67,21,19,45,31
1949-02-02,WAS,83,30,11,JET,57,13,27,43,38
1949-02-03,PRO,88,8,33,ROC,80,28,10,36,43
1949-02-03,PHW,76,19,22,MNL,78,28,10,47,32
1949-02-03,BAL,84,21,20,BOS,76,13,27,34,47
1949-02-03,BOM,65,17,20,WAS,74,31,11,48,31
1949-02-04,BOS,75,13,28,JET,64,13,28,26,56
1949-02-05,BAL,87,22,20,JET,75,13,29,35,49
1949-02-05,PRO,75,9,33,CHS,91,25,12,34,45
1949-02-05,WAS,73,32,11,NYK,83,20,18,52,29
1949-02-05,ROC,80,28,11,FTW,61,14,26,42,37
1949-02-06,NYK,75,21,18,CHS,87,26,12,47,30
1949-02-06,BOM,74,17,21,PHW,77,19,23,36,44
1949-02-06,MNL,74,29,10,ROC,85,29,11,58,21
1949-02-06,FTW,82,14,27,WAS,72,32,12,46,39
1949-02-07,BOS,95,14,28,BAL,83,23,20,37,48
1949-02-07,JET,90,13,30,PHW,73,20,23,33,53
1949-02-08,FTW,89,15,27,PHW,87,20,24,35,51
1949-02-08,CHS,73,27,12,BOM,75,17,22,44,34
1949-02-08,ROC,97,30,11,PRO,65,9,34,39,45
1949-02-09,WAS,99,32,13,ROC,94,31,11,63,24
1949-02-09,BOM,83,18,22,NYK,95,21,19,39,41
1949-02-09,FTW,67,16,27,JET,70,14,30,30,57
1949-02-10,PHW,108,20,25,JET,87,15,30,35,55
1949-02-10,BAL,76,23,21,ROC,90,31,12,54,33
1949-02-10,MNL,95,29,11,NYK,75,22,19,51,30
1949-02-11,CHS,105,27,13,MNL,97,30,11,57,24
1949-02-11,BOS,94,15,28,PRO,77,9,35,24,63
1949-02-12,WAS,88,33,13,PHW,91,21,25,54,38
1949-02-12,PRO,91,9,36,JET,78,15,31,24,67
1949-02-12,BOM,74,18,23,BAL,73,23,22,41,45
1949-02-12,ROC,87,32,12,CHS,73,28,13,60,25
1949-02-12,NYK,85,22,20,FTW,58,16,28,38,48
1949-02-13,MNL,91,30,12,BAL,74,23,23,53,35
1949-02-13,FTW,82,16,29,NYK,73,23,20,39,49
1949-02-15,ROC,91,33,12,WAS,79,33,14,66,26
1949-02-15,NYK,79,23,21,BOM,75,19,23,42,44
1949-02-15,JET,69,15,32,BAL,82,23,24,38,56
1949-02-15,CHS,83,28,14,FTW,69,17,29,45,43
1949-02-16,MNL,90,31,12,CHS,71,29,14,60,26
1949-02-16,FTW,84,17,30,BAL,68,24,24,41,54
1949-02-17,BAL,100,24,25,PRO,102,10,36,34,61
1949-02-17,PHW,86,22,25,NYK,82,24,21,46,46
1949-02-17,BOM,63,19,24,ROC,68,34,12,53,36
1949-02-18,BOS,71,16,28,MNL,85,32,12,48,40
1949-02-18,JET,53,15,33,ROC,65,35,12,50,45
1949-02-19,WAS,92,33,15,BAL,88,24,26,57,41
1949-02-19,PRO,80,11,36,MNL,94,33,12,44,48
1949-02-19,NYK,77,24,22,BOS,87,16,29,40,51
1949-02-19,ROC,87,36,12,JET,73,15,34,51,46
1949-02-19,BOM,63,19,25,CHS,59,29,15,48,40
1949-02-20,CHS,95,29,16,JET,72,15,35,44,51
1949-02-20,FTW,64,18,30,BOM,70,20,25,38,55
1949-02-22,ROC,92,37,12,PHW,86,23,25,60,37
1949-02-22,NYK,74,24,23,MNL,101,34,12,58,35
1949-02-22,JET,74,15,36,BOS,68,17,29,32,65
1949-02-23,WAS,100,34,15,PRO,88,11,37,45,52
1949-02-23,PHW,85,23,26,CHS,102,30,16,53,42
1949-02-23,BOM,77,21,25,BOS,83,17,30,38,55
1949-02-24,PRO,89,11,38,NYK,84,24,24,35,62
1949-02-24,MNL,77,35,12,FTW,73,18,31,53,43
1949-02-24,BAL,68,24,27,CHS,87,31,16,55,43
1949-02-25,BOS,102,18,30,BOM,83,21,26,39,56
1949-02-26,BAL,114,24,28,MNL,115,36,12,60,40
1949-02-26,PRO,90,12,38,BOM,93,21,27,33,65
1949-02-26,WAS,90,35,15,CHS,103,32,16,67,31
1949-02-26,NYK,81,24,25,JET,76,16,36,40,61
1949-02-26,ROC,64,38,12,BOS,59,19,30,57,42
1949-02-27,FTW,74,18,32,MNL,50,37,12,55,44
1949-02-28,CHS,57,33,16,WAS,67,35,16,68,32
1949-03-01,PHW,89,23,27,BOM,83,22,27,45,54
1949-03-01,JET,79,16,37,CHS,69,33,17,49,54
1949-03-01,ROC,67,39,12,WAS,64,36,16,75,28
1949-03-02,NYK,81,25,25,CHS,79,33,18,58,43
1949-03-02,WAS,75,36,17,BOM,82,22,28,58,45
1949-03-03,JET,79,17,37,MNL,82,37,13,54,50
1949-03-03,PHW,90,24,27,CHS,75,33,19,57,46
1949-03-03,BAL,94,24,29,BOM,66,23,28,47,57
1949-03-03,NYK,86,26,25,PRO,65,12,39,38,64
1949-03-04,BOS,76,19,31,FTW,70,19,32,38,63
1949-03-05,WAS,95,36,18,CHS,106,33,20,69,38
1949-03-05,BAL,99,25,29,PHW,85,25,27,50,56
1949-03-05,ROC,81,40,12,PRO,64,12,40,52,52
1949-03-05,NYK,66,27,25,BOS,61,20,31,47,56
1949-03-06,FTW,66,19,33,ROC,78,41,12,60,45
1949-03-06,MNL,68,38,13,PRO,59,12,41,50,54
1949-03-07,JET,86,17,38,BOS,107,20,32,37,70
1949-03-08,CHS,110,34,20,PRO,82,12,42,46,62
1949-03-08,BOS,63,21,32,FTW,60,19,34,40,66
1949-03-09,JET,80,17,39,BOM,81,23,29,40,68
1949-03-09,FTW,84,19,35,PRO,80,12,43,31,78
1949-03-09,NYK,90,28,25,WAS,74,36,19,64,44
1949-03-09,MNL,74,39,13,BOS,67,22,32,61,45
1949-03-10,BAL,94,26,29,NYK,99,29,25,55,54
1949-03-10,PHW,71,25,28,ROC,73,42,12,67,40
1949-03-10,BOM,88,24,29,MNL,71,40,13,64,42
1949-03-11,BOS,108,22,33,PHW,100,25,29,47,62
1949-03-12,CHS,80,35,20,NYK,85,30,25,65,45
1949-03-12,BAL,89,26,30,BOS,77,23,33,49,63
1949-03-12,ROC,104,43,12,BOM,74,25,29,68,41
1949-03-12,PRO,70,12,44,PHW,92,25,30,37,74
1949-03-12,MNL,97,40,14,JET,69,17,40,57,54
1949-03-12,WAS,87,36,20,FTW,60,20,35,56,55
1949-03-13,MNL,100,41,14,NYK,90,31,25,72,39
1949-03-13,BOM,87,25,30,JET,86,17,41,42,71
1949-03-13,FTW,81,20,36,CHS,78,35,21,55,57
1949-03-15,JET,90,17,42,PRO,84,12,45,29,87
1949-03-15,BOS,86,23,34,ROC,83,44,12,67,46
1949-03-15,PHW,84,26,30,BAL,76,27,30,53,60
1949-03-16,NYK,89,31,26,ROC,94,44,13,75,39
1949-03-16,CHS,107,35,22,BOS,82,24,34,59,56
1949-03-16,WAS,85,37,20,MNL,72,42,14,79,34
1949-03-16,BOM,81,26,30,PRO,59,12,46,38,76
1949-03-17,PHW,84,27,30,WAS,81,38,20,65,50
1949-03-17,CHS,85,36,22,BOM,79,27,30,63,52
1949-03-17,FTW,74,21,36,PRO,72,12,47,33,83
1949-03-17,BAL,101,27,31,MNL,67,42,15,69,46
1949-03-18,BOS,70,24,35,NYK,56,31,27,55,62
1949-03-19,BOM,109,27,31,PHW,100,28,30,55,61
1949-03-19,ROC,85,45,13,MNL,99,42,16,87,29
1949-03-19,BAL,99,28,31,FTW,79,22,36,50,67
1949-03-19,WAS,70,38,21,NYK,82,31,28,69,49
1949-03-20,FTW,82,22,37,BOM,87,28,31,50,68
1949-03-20,MNL,91,43,16,PHW,78,28,31,71,47
1949-03-20,CHS,98,37,22,ROC,61,45,14,82,36
1949-10-29,TCB,93,0,0,DN,85,0,0,0,0
1949-11-01,CHS,87,0,0,NYK,89,0,1,0,1
1949-11-01,ROC,108,2,0,SHE,75,0,0,2,0
1949-11-01,INO,71,0,0,DN,64,0,1,0,1
1949-11-01,BOM,72,0,0,TCB,51,1,0,1,0
1949-11-02,PHW,69,0,0,MNL,81,0,1,0,1
1949-11-02,WAS,66,0,0,BAL,61,0,0,0,0
1949-11-02,WAT,60,0,0,NYK,68,1,1,1,1
1949-11-03,AND,110,0,0,TCB,87,1,1,1,1
1949-11-03,SHE,98,0,1,BOS,83,0,0,0,1
1949-11-03,FTW,87,0,0,NYK,72,2,1,2,1
1949-11-03,BAL,65,0,1,BOM,81,1,0,1,1
1949-11-03,SYR,78,0,0,DN,58,0,2,0,2
1949-11-04,PHW,79,0,1,BOM,58,2,0,2,1
1949-11-05,BAL,77,0,2,MNL,92,1,1,1,3
1949-11-05,TCB,72,1,2,NYK,76,2,2,3,4
1949-11-05,CHS,86,0,1,BOS,70,0,1,0,2
1949-11-05,WAS,81,1,0,BOM,69,2,1,3,1
1949-11-05,ROC,83,3,0,PHW,53,1,1,4,1
1949-11-05,SYR,84,1,0,DN,51,0,3,1,3
1949-11-06,SHE,99,1,1,NYK,93,3,2,4,3
1949-11-06,SYR,82,2,0,PHW,72,1,2,3,2
1949-11-06,FTW,87,1,0,CHS,70,1,1,2,1
1949-11-06,WAT,80,0,1,BOS,66,0,2,0,3
1949-11-08,WAS,66,2,0,MNL,68,2,1,4,1
1949-11-08,INO,64,1,0,NYK,79,3,3,4,3
1949-11-08,AND,70,1,0,BOM,62,2,2,3,2
1949-11-09,AND,102,2,0,TCB,99,1,3,3,3
1949-11-09,SYR,103,3,0,INO,73,1,1,4,1
1949-11-09,CHS,75,1,2,ROC,72,4,0,5,2
1949-11-09,PHW,69,1,3,WAS,84,2,1,3,4
1949-11-09,WAT,80,1,1,DN,65,0,4,1,5
1949-11-10,SHE,97,2,1,ROC,87,4,1,6,2
1949-11-10,BOS,84,0,3,MNL,98,3,1,3,4
1949-11-10,NYK,79,4,3,INO,83,1,2,5,5
1949-11-10,BAL,72,0,3,WAS,88,3,1,3,4
1949-11-10,BOM,73,2,3,SYR,67,4,0,6,3
1949-11-10,FTW,89,2,0,WAT,59,2,1,4,1
1949-11-10,CHS,64,2,2,DN,53,0,5,2,7
1949-11-11,PHW,84,1,4,INO,91,2,2,3,6
1949-11-12,TCB,99,1,4,WAT,89,2,2,3,6
1949-11-12,CHS,86,3,2,MNL,79,4,1,7,3
1949-11-12,BAL,82,0,4,FTW,75,3,0,3,4
1949-11-12,ROC,94,4,2,NYK,73,4,4,8,6
1949-11-12,INO,94,3,2,BOM,71,3,3,6,5
1949-11-12,AND,69,3,0,SYR,84,4,1,7,1
1949-11-12,WAS,68,4,1,BOS,76,0,4,4,5
1949-11-12,PHW,81,1,5,DN,63,0,6,1,11
1949-11-13,SHE,104,3,1,INO,101,4,2,7,3
1949-11-13,FTW,90,3,1,DN,71,0,7,3,8
1949-11-13,WAT,69,2,3,AND,81,3,1,5,4
1949-11-13,SYR,80,5,1,NYK,66,4,5,9,6
1949-11-13,BOM,65,3,4,CHS,91,4,2,7,6
1949-11-15,ROC,93,5,2,TCB,81,2,4,7,6
1949-11-15,BOS,76,1,4,BAL,81,1,4,2,8
1949-11-15,NYK,74,4,6,SYR,77,6,1,10,7
1949-11-15,INO,72,4,3,AND,83,4,1,8,4
1949-11-15,CHS,77,5,2,WAS,63,4,2,9,4
1949-11-16,WAS,99,4,3,DN,90,0,8,4,11
1949-11-16,PHW,93,2,5,BOS,80,1,5,3,10
1949-11-16,WAT,73,2,4,SHE,76,4,1,6,5
1949-11-16,CHS,85,6,2,FTW,72,4,1,10,3
1949-11-16,MNL,94,4,2,BOM,71,3,5,7,7
1949-11-17,SHE,97,5,1,WAT,95,2,5,7,6
1949-11-17,SYR,79,7,1,TCB,76,2,5,9,6
1949-11-17,BAL,86,2,4,DN,71,0,9,2,13
1949-11-17,BOS,90,1,6,INO,68,4,4,5,10
1949-11-17,BOM,78,3,6,MNL,65,5,2,8,8
1949-11-18,PHW,103,3,5,CHS,88,7,2,10,7
1949-11-18,NYK,85,4,7,DN,78,0,10,4,17
1949-11-19,TCB,85,2,6,FTW,88,4,2,6,8
1949-11-19,BAL,82,3,4,BOS,91,2,6,5,10
1949-11-19,AND,83,5,1,MNL,80,5,3,10,4
1949-11-19,INO,106,4,5,WAT,74,2,6,6,11
1949-11-19,NYK,85,5,7,PHW,69,4,5,9,12
1949-11-19,WAS,85,5,3,CHS,69,7,3,12,6
1949-11-19,ROC,96,6,2,DN,64,0,11,6,13
1949-11-20,MNL,121,5,4,INO,95,5,5,10,9
1949-11-20,SHE,92,6,1,BAL,97,3,5,9,6
1949-11-20,FTW,99,5,2,BOS,89,3,6,8,8
1949-11-20,SYR,102,8,1,DN,76,0,12,8,13
1949-11-20,BOM,95,4,6,ROC,74,7,2,11,8
1949-11-20,WAT,75,2,7,TCB,62,2,7,4,14
1949-11-21,AND,85,6,1,BOS,99,3,7,9,8
1949-11-21,SYR,77,9,1,DN,67,0,13,9,14
1949-11-22,INO,80,5,6,ROC,74,7,3,12,9
1949-11-22,WAS,74,6,3,NYK,89,6,7,12,10
1949-11-22,TCB,80,2,8,BOS,72,4,7,6,15
1949-11-23,CHS,92,7,4,INO,72,6,6,13,10
1949-11-23,MNL,84,6,4,BAL,71,4,5,10,9
1949-11-23,WAT,71,3,7,ROC,90,7,4,10,11
1949-11-23,NYK,87,7,7,WAS,67,6,4,13,11
1949-11-24,SYR,125,10,1,AND,123,6,2,16,3
1949-11-24,SHE,120,6,2,TCB,113,3,8,9,10
1949-11-24,BOS,85,4,8,FTW,99,6,2,10,10
1949-11-24,PHW,70,4,6,NYK,75,8,7,12,13
1949-11-24,BOM,63,5,6,BAL,65,4,6,9,12
1949-11-25,DN,81,0,14,MNL,101,7,4,7,18
1949-11-26,ROC,120,8,4,WAT,95,3,8,11,12
1949-11-26,NYK,96,9,7,BOS,84,4,9,13,16
1949-11-26,WAS,93,6,5,FTW,76,7,2,13,7
1949-11-26,AND,73,6,3,BOM,63,5,7,11,10
1949-11-26,INO,85,6,7,SHE,59,7,2,13,9
1949-11-26,CHS,90,8,4,PHW,54,4,7,12,11
1949-11-27,SHE,91,7,3,AND,111,7,3,14,6
1949-11-27,TCB,104,3,9,INO,88,7,7,10,16
1949-11-27,MNL,82,8,4,CHS,96,9,4,17,8
1949-11-27,FTW,72,7,3,NYK,77,10,7,17,10
1949-11-27,BOM,80,5,8,PHW,67,4,8,9,16
1949-11-27,SYR,80,11,1,WAT,62,3,9,14,10
1949-11-27,DN,68,0,15,BAL,61,5,6,5,21
1949-11-28,AND,101,8,3,WAT,87,3,10,11,13
1949-11-29,INO,92,7,8,TCB,76,4,9,11,17
1949-11-29,DN,56,1,15,PHW,57,4,9,5,24
1949-11-30,MNL,102,8,5,NYK,92,11,7,19,12
1949-11-30,WAS,84,7,5,ROC,86,9,4,16,9
1949-11-30,TCB,82,4,10,BOM,89,6,8,10,18
1949-11-30,BOS,71,4,10,SYR,87,12,1,16,11
1949-11-30,WAT,95,3,11,FTW,71,7,4,10,15
1949-11-30,CHS,57,10,4,BAL,50,5,7,15,11
1949-12-01,SHE,78,7,4,CHS,80,11,4,18,8
1949-12-01,AND,81,9,3,TCB,72,4,11,13,14
1949-12-01,FTW,74,7,5,PHW,70,5,9,12,14
1949-12-01,BOM,68,7,8,NYK,85,11,8,18,16
1949-12-01,INO,86,8,8,MNL,68,9,5,17,13
1949-12-01,BAL,70,5,8,ROC,64,10,4,15,12
1949-12-02,PHW,79,5,10,ROC,82,10,5,15,15
1949-12-02,DN,74,1,16,WAT,63,4,11,5,27
1949-12-03,TCB,87,4,12,BOS,82,4,11,8,23
1949-12-03,CHS,80,12,4,MNL,91,9,6,21,10
1949-12-03,ROC,99,11,5,INO,77,9,8,20,13
1949-12-03,SHE,72,7,5,BOM,75,7,9,14,14
1949-12-03,WAS,79,7,6,PHW,63,5,11,12,17
1949-12-03,NYK,85,12,8,BAL,55,6,8,18,16
1949-12-04,MNL,95,10,6,ROC,80,12,5,22,11
1949-12-04,BOM,85,8,9,BOS,76,4,12,12,21
1949-12-04,DN,86,2,16,WAT,76,4,12,6,28
1949-12-04,FTW,72,8,5,WAS,68,8,6,16,11
1949-12-04,SYR,67,13,1,INO,61,9,9,22,10
1949-12-05,AND,88,10,3,SHE,81,7,6,17,9
1949-12-06,INO,93,9,10,BOS,82,4,13,13,23
1949-12-06,CHS,75,12,5,WAS,55,8,7,20,12
1949-12-07,MNL,93,11,6,WAS,76,8,8,19,14
1949-12-07,DN,72,3,16,BOM,76,9,9,12,25
1949-12-07,BAL,72,6,9,CHS,84,13,5,19,14
1949-12-07,TCB,69,5,12,SYR,77,14,1,19,13
1949-12-07,WAT,77,4,13,SHE,67,7,7,11,20
1949-12-08,BOS,91,4,14,PHW,87,5,12,9,26
1949-12-08,SHE,72,7,8,SYR,86,15,1,22,9
1949-12-08,AND,69,11,3,INO,72,10,10,21,13
1949-12-08,FTW,87,9,5,MNL,66,12,6,21,11
1949-12-08,BAL,60,6,10,NYK,82,14,8,20,18
1949-12-09,PHW,80,5,13,CHS,77,14,6,19,19
1949-12-09,INO,78,11,10,DN,75,3,17,14,27
1949-12-10,NYK,93,13,8,CHS,91,14,5,27,13
1949-12-10,BOS,83,5,14,SHE,78,7,9,12,23
1949-12-10,MNL,89,12,7,DN,76,3,18,15,25
1949-12-10,WAS,75,8,9,FTW,69,10,5,18,14
1949-12-10,BAL,69,6,11,BOM,66,10,9,16,20
1949-12-10,ROC,69,12,6,SYR,63,16,1,28,7
1949-12-11,WAT,83,5,13,AND,87,11,4,16,17
1949-12-11,MNL,90,13,7,PHW,81,6,13,19,20
1949-12-11,FTW,90,10,6,INO,74,12,10,22,16
1949-12-11,SYR,89,16,2,SHE,72,7,10,23,12
1949-12-11,TCB,98,5,13,DN,66,3,19,8,32
1949-12-12,AND,105,12,4,FTW,97,11,6,23,10
1949-12-13,CHS,75,14,7,PHW,65,6,14,20,21
1949-12-13,DN,65,3,20,ROC,81,13,6,16,26
1949-12-13,INO,84,12,11,TCB,63,6,13,18,24
1949-12-14,NYK,94,15,8,MNL,84,14,7,29,15
1949-12-14,SYR,96,17,2,FTW,83,11,7,28,9
1949-12-14,WAT,70,5,14,PHW,73,6,15,11,29
1949-12-14,TCB,73,6,14,CHS,68,15,7,21,21
1949-12-14,WAS,79,9,9,BOM,61,10,10,19,19
1949-12-15,AND,100,13,4,SYR,88,18,2,31,6
1949-12-15,BOS,83,6,14,BOM,81,10,11,16,25
1949-12-15,SHE,89,7,11,TCB,74,7,14,14,25
1949-12-15,BAL,87,7,11,MNL,68,14,8,21,19
1949-12-15,FTW,69,11,8,ROC,66,14,6,25,14
1949-12-16,DN,79,3,21,INO,81,13,11,16,32
1949-12-16,WAT,77,5,15,BAL,75,8,11,13,26
1949-12-16,CHS,80,15,8,ROC,71,14,7,29,15
1949-12-16,PHW,54,7,15,BOM,68,10,12,17,27
1949-12-17,SHE,110,8,11,AND,91,14,4,22,15
1949-12-17,NYK,81,16,8,BOM,76,11,12,27,20
1949-12-17,PHW,81,7,16,WAT,72,6,15,13,31
1949-12-17,WAS,72,10,9,BAL,89,8,12,18,21
1949-12-17,ROC,85,14,8,CHS,63,16,8,30,16
1949-12-18,FTW,106,12,8,BAL,95,9,12,21,20
1949-12-18,DN,79,3,22,INO,83,14,11,17,33
1949-12-18,SYR,86,18,3,CHS,73,16,9,34,12
1949-12-18,MNL,77,14,9,BOS,72,7,14,21,23
1949-12-18,TCB,69,7,15,AND,78,14,5,21,20
1949-12-19,AND,83,15,5,NYK,86,17,8,32,13
1949-12-20,INO,79,15,11,BAL,88,9,13,24,24
1949-12-20,CHS,79,16,10,NYK,77,18,8,34,18
1949-12-20,WAT,70,6,16,SYR,95,19,3,25,19
1949-12-20,ROC,87,15,8,MNL,62,15,9,30,17
1949-12-21,TCB,84,7,16,SYR,96,20,3,27,19
1949-12-21,CHS,78,17,10,WAT,70,6,17,23,27
1949-12-21,WAS,61,10,10,MNL,75,15,10,25,20
1949-12-21,PHW,70,8,16,BAL,60,10,13,18,29
1949-12-21,BOM,75,11,13,NYK,52,18,9,29,22
1949-12-22,INO,104,15,12,CHS,92,18,10,33,22
1949-12-22,AND,101,15,6,WAT,84,6,18,21,24
1949-12-22,BAL,86,10,14,WAS,82,10,11,20,25
1949-12-22,FTW,87,13,8,BOM,75,12,13,25,21
1949-12-22,SHE,74,9,11,SYR,83,21,3,30,14
1949-12-22,BOS,87,7,15,MNL,69,16,10,23,25
1949-12-23,WAS,86,10,12,BOS,73,8,15,18,27
1949-12-23,DN,72,3,23,NYK,83,18,10,21,33
1949-12-25,WAT,97,6,19,INO,93,16,12,22,31
1949-12-25,SYR,94,22,3,AND,88,16,6,38,9
1949-12-25,ROC,88,16,8,BOS,79,8,16,24,24
1949-12-25,DN,72,3,24,SHE,76,9,12,12,36
1949-12-25,BOM,68,12,14,WAS,81,11,12,23,26
1949-12-25,BAL,63,11,14,PHW,64,9,16,20,30
1949-12-25,MNL,72,16,11,FTW,58,14,8,30,19
1949-12-26,NYK,80,0,0,ROC,83,1,0,1,0
1949-12-26,TCB,76,7,17,MNL,78,17,11,24,28
1949-12-26,FTW,76,14,9,CHS,74,18,11,32,20
1949-12-26,AND,80,16,7,WAS,73,12,12,28,19
1949-12-26,BOS,82,8,17,BAL,57,11,15,19,32
1949-12-27,INO,89,16,13,AND,82,17,7,33,20
1949-12-27,BOS,97,9,17,NYK,78,19,10,28,27
1949-12-27,ROC,96,17,8,WAS,72,12,13,29,21
1949-12-28,WAS,87,12,14,SYR,85,23,3,35,17
1949-12-28,WAT,80,7,19,CHS,87,18,12,25,31
1949-12-28,MNL,88,18,11,BAL,77,11,16,29,27
1949-12-28,FTW,81,15,9,TCB,75,7,18,22,27
1949-12-28,PHW,72,10,16,NYK,79,19,11,29,27
1949-12-29,SHE,94,10,12,WAT,92,7,20,17,32
1949-12-29,AND,80,17,8,CHS,81,19,12,36,20
1949-12-29,ROC,97,18,8,FTW,79,16,9,34,17
1949-12-29,BOM,90,12,15,BAL,63,11,17,23,32
1949-12-29,SYR,64,23,4,PHW,62,10,17,33,21
1949-12-30,DN,83,3,25,TCB,85,7,19,10,44
1949-12-30,BOS,92,10,17,FTW,73,16,10,26,27
1949-12-31,WAT,68,7,21,MNL,86,19,11,26,32
1949-12-31,ROC,87,19,8,BOM,68,13,15,32,23
1949-12-31,WAS,70,13,14,NYK,64,20,11,33,25
1949-12-31,PHW,62,10,18,FTW,65,16,11,26,29
1950-01-01,BOM,91,13,16,WAT,79,7,22,20,38
1950-01-01,DN,78,3,26,CHS,92,20,12,23,38
1950-01-01,MNL,87,20,11,AND,75,17,9,37,20
1950-01-01,SHE,75,11,12,INO,89,17,13,28,25
1950-01-01,SYR,79,24,4,WAS,73,14,14,38,18
1950-01-01,FTW,80,17,11,BOS,72,11,17,28,28
1950-01-01,TCB,79,8,19,BAL,66,11,18,19,37
1950-01-01,NYK,81,20,12,PHW,59,10,19,30,31
1950-01-02,AND,92,17,10,BAL,75,11,19,28,29
1950-01-03,ROC,83,20,8,WAS,79,14,15,34,23
1950-01-03,INO,78,18,13,TCB,76,9,19,27,32
1950-01-03,WAT,69,7,23,SHE,73,11,13,18,36
1950-01-04,DN,86,3,27,AND,82,18,10,21,37
1950-01-04,MNL,91,21,11,FTW,75,18,11,39,22
1950-01-04,BOM,72,14,16,BOS,68,11,18,25,34
1950-01-04,WAS,63,14,16,ROC,72,21,8,35,24
1950-01-05,FTW,87,18,12,BOM,83,15,16,33,28
1950-01-05,SHE,85,12,13,MNL,82,22,11,34,24
1950-01-05,SYR,82,25,4,TCB,73,9,20,34,24
1950-01-05,BAL,74,11,20,ROC,71,22,8,33,28
1950-01-05,NYK,82,21,12,WAT,70,7,24,28,36
1950-01-05,DN,76,4,27,AND,69,18,11,22,38
1950-01-06,PHW,91,10,20,ROC,73,22,9,32,29
1950-01-06,BOS,74,11,19,BAL,53,12,20,23,39
1950-01-07,TCB,98,9,21,SHE,86,13,13,22,34
1950-01-07,WAS,101,14,17,WAT,83,7,25,21,42
1950-01-07,NYK,80,22,12,FTW,88,19,12,41,24
1950-01-07,ROC,85,22,10,PHW,68,11,20,33,30
1950-01-07,BAL,61,12,21,INO,85,19,13,31,34
1950-01-08,MNL,85,22,12,BOS,80,12,19,34,31
1950-01-08,BOM,73,15,17,ROC,75,23,10,38,27
1950-01-08,FTW,83,20,12,SHE,69,13,14,33,26
1950-01-08,SYR,84,26,4,WAT,68,7,26,33,30
1950-01-09,AND,112,18,12,SHE,89,13,15,31,27
1950-01-10,WAT,86,7,27,SYR,84,27,4,34,31
1950-01-10,DN,84,5,27,BOS,97,12,20,17,47
1950-01-10,INO,107,20,13,SHE,77,13,16,33,29
1950-01-10,WAS,86,15,17,CHS,71,21,12,36,29
1950-01-10,ROC,85,24,10,BAL,67,12,22,36,32
1950-01-11,MNL,98,23,12,SYR,88,27,5,50,17
1950-01-11,TCB,88,10,21,AND,81,19,12,29,33
1950-01-11,NYK,73,22,13,WAS,72,16,17,38,30
1950-01-12,SHE,115,13,17,DN,92,5,28,18,45
1950-01-12,BOM,73,15,18,MNL,89,24,12,39,30
1950-01-12,AND,80,19,13,WAT,69,8,27,27,40
1950-01-12,FTW,62,21,12,SYR,64,27,6,48,18
1950-01-13,BOS,76,13,20,CHS,77,21,13,34,33
1950-01-13,PHW,67,11,21,WAS,77,16,18,27,39
1950-01-13,INO,80,21,13,WAT,64,8,28,29,41
1950-01-14,ROC,83,0,0,MNL,77,0,0,0,0
1950-01-14,NYK,82,23,13,BOS,80,13,21,36,34
1950-01-14,SHE,80,14,17,DN,94,5,29,19,46
1950-01-14,BAL,78,12,23,CHS,83,22,13,34,36
1950-01-14,WAS,78,17,18,PHW,70,11,22,28,40
1950-01-15,BOM,89,15,19,DN,83,6,29,21,48
1950-01-15,TCB,84,11,21,WAT,80,8,29,19,50
1950-01-15,SHE,81,14,18,AND,76,20,13,34,31
1950-01-15,MNL,85,25,12,ROC,73,25,10,50,22
1950-01-15,SYR,82,28,6,INO,69,22,13,50,19
1950-01-15,FTW,81,21,13,PHW,67,11,23,32,36
1950-01-16,AND,95,20,14,DN,83,6,30,26,44
1950-01-16,PHW,89,11,24,SHE,72,15,18,26,42
1950-01-16,CHS,78,23,13,BOM,69,16,19,39,32
1950-01-17,INO,101,22,14,DN,81,6,31,28,45
1950-01-17,BOS,79,13,22,MNL,105,26,12,39,34
1950-01-18,PHW,94,12,24,BOS,86,13,23,25,47
1950-01-18,SHE,72,15,19,FTW,73,22,13,37,32
1950-01-18,WAT,80,8,30,BOM,69,16,20,24,50
1950-01-18,WAS,68,18,18,MNL,76,27,12,45,30
1950-01-18,TCB,65,12,21,ROC,70,25,11,37,32
1950-01-19,INO,104,23,14,WAT,87,9,30,32,44
1950-01-19,SYR,107,29,6,DN,86,6,32,35,38
1950-01-19,NYK,83,24,13,MNL,94,28,12,52,25
1950-01-19,AND,78,21,14,ROC,81,26,11,47,25
1950-01-19,BAL,68,12,24,WAS,81,18,19,30,43
1950-01-19,CHS,83,24,13,TCB,68,12,22,36,35
1950-01-19,BOM,74,16,21,FTW,64,23,13,39,34
1950-01-19,BOS,86,13,24,PHW,63,13,24,26,48
1950-01-20,PHW,90,13,25,MNL,89,29,12,42,37
1950-01-21,INO,112,24,14,FTW,94,23,14,47,28
1950-01-21,WAT,88,9,31,DN,84,6,33,15,64
1950-01-21,WAS,82,19,19,SHE,88,15,20,34,39
1950-01-21,ROC,95,27,11,AND,79,21,15,48,26
1950-01-21,BAL,68,12,25,PHW,58,14,25,26,50
1950-01-22,TCB,111,12,23,DN,97,6,34,18,57
1950-01-22,SYR,75,30,6,AND,77,21,16,51,22
1950-01-22,MNL,103,29,13,CHS,75,25,13,54,26
1950-01-22,NYK,81,24,14,ROC,71,28,11,52,25
1950-01-22,FTW,82,23,15,WAS,70,19,20,42,35
1950-01-22,BAL,76,13,25,SHE,69,16,20,29,45
1950-01-22,BOM,71,17,21,BOS,47,14,24,31,45
1950-01-23,AND,96,22,16,TCB,99,13,23,35,39
1950-01-24,PHW,87,14,26,FTW,74,24,15,38,41
1950-01-24,INO,107,25,14,WAT,69,10,31,35,45
1950-01-24,CHS,68,25,14,MNL,80,30,13,55,27
1950-01-24,NYK,101,25,14,SHE,68,16,21,41,35
1950-01-24,WAS,75,19,21,BOM,67,18,21,37,42
1950-01-24,ROC,70,28,12,BAL,56,14,25,42,37
1950-01-25,WAT,104,10,32,DN,83,6,35,16,67
1950-01-25,MNL,85,31,13,BOM,78,18,22,49,35
1950-01-25,NYK,96,26,14,FTW,66,24,16,50,30
1950-01-25,TCB,62,14,23,WAS,65,20,21,34,44
1950-01-26,BAL,77,14,26,NYK,79,27,14,41,40
1950-01-26,AND,109,22,17,DN,75,6,36,28,53
1950-01-26,SYR,76,30,7,ROC,72,29,12,59,19
1950-01-26,BOM,71,18,23,WAS,82,21,21,39,44
1950-01-26,BOS,89,14,25,FTW,68,24,17,38,42
1950-01-27,AND,78,23,17,INO,91,26,14,49,31
1950-01-27,PHW,71,15,26,BAL,74,14,27,29,53
1950-01-28,TCB,97,14,24,INO,81,27,14,41,38
1950-01-28,ROC,82,29,13,BOS,75,15,25,44,38
1950-01-28,BAL,77,15,27,FTW,64,24,18,39,45
1950-01-28,NYK,55,28,14,PHW,58,15,27,43,41
1950-01-29,WAT,79,11,32,TCB,85,15,24,26,56
1950-01-29,SYR,85,31,7,SHE,70,16,22,47,29
1950-01-29,FTW,92,24,19,NYK,70,28,15,52,34
1950-01-29,MNL,88,32,13,WAS,60,22,21,54,34
1950-01-29,BOM,51,18,24,CHS,66,25,15,43,39
1950-01-30,SYR,91,32,7,INO,75,27,15,59,22
1950-01-30,AND,91,23,18,SHE,74,16,23,39,41
1950-01-31,CHS,89,26,15,FTW,93,25,19,51,34
1950-01-31,DN,78,6,37,WAS,88,22,22,28,59
1950-01-31,TCB,83,16,24,NYK,77,28,16,44,40
1950-01-31,BOS,72,15,26,ROC,85,30,13,45,39
1950-02-01,TCB,91,17,24,SYR,83,33,7,50,31
1950-02-01,MNL,96,33,13,NYK,81,28,17,61,30
1950-02-01,CHS,78,26,16,BOS,76,15,27,41,43
1950-02-01,WAT,73,11,33,AND,86,24,18,35,51
1950-02-01,PHW,68,16,27,ROC,82,31,13,47,40
1950-02-02,FTW,78,26,19,MNL,79,34,13,60,32
1950-02-02,BOM,73,18,25,NYK,87,28,18,46,43
1950-02-02,BAL,79,16,27,ROC,69,32,13,48,40
1950-02-02,INO,67,27,16,SYR,73,33,8,60,24
1950-02-02,SHE,68,16,24,WAS,65,23,22,39,46
1950-02-03,BOS,106,15,28,AND,98,25,18,40,46
1950-02-03,CHS,98,27,16,BAL,81,17,27,44,43
1950-02-03,SYR,103,34,8,WAT,79,11,34,45,42
1950-02-03,PHW,83,16,28,TCB,72,18,24,34,52
1950-02-04,BOS,100,16,28,WAT,82,11,35,27,63
1950-02-04,ROC,82,32,14,CHS,78,28,16,60,30
1950-02-04,WAS,71,23,23,NYK,76,29,18,52,41
1950-02-04,BAL,90,17,28,AND,70,25,19,42,47
1950-02-05,SYR,96,35,8,BAL,87,18,28,53,36
1950-02-05,FTW,95,26,20,AND,85,25,20,51,40
1950-02-05,TCB,86,18,25,SHE,71,17,24,35,49
1950-02-05,CHS,77,28,17,BOS,70,17,28,45,45
1950-02-05,MNL,100,35,13,PHW,67,17,28,52,41
1950-02-05,NYK,65,30,18,ROC,73,33,14,63,32
1950-02-05,BOM,76,18,26,INO,64,27,17,45,43
1950-02-06,AND,77,25,21,PHW,75,17,29,42,50
1950-02-07,BOS,86,17,29,CHS,91,29,17,46,46
1950-02-07,ROC,90,34,14,BOM,84,19,26,53,40
1950-02-07,INO,88,27,18,WAS,81,23,24,50,42
1950-02-07,DN,67,6,38,FTW,83,27,20,33,58
1950-02-08,TCB,99,19,25,PHW,94,17,30,36,55
1950-02-08,NYK,82,30,19,BOM,84,19,27,49,46
1950-02-08,SYR,106,36,8,SHE,81,17,25,53,33
1950-02-08,WAT,77,11,36,WAS,70,23,25,34,61
1950-02-09,SHE,104,17,26,TCB,82,20,25,37,51
1950-02-09,BAL,79,18,29,BOM,67,20,27,38,56
1950-02-09,FTW,61,28,20,PHW,64,17,31,45,51
1950-02-09,MNL,71,36,13,WAS,59,23,26,59,39
1950-02-10,BOS,89,17,30,BOM,79,20,28,37,58
1950-02-10,PHW,76,18,31,CHS,83,30,17,48,48
1950-02-10,INO,76,28,18,AND,107,26,21,54,39
1950-02-11,ROC,84,35,14,FTW,92,28,21,63,35
1950-02-11,DN,108,6,39,SHE,78,18,26,24,65
1950-02-11,BAL,76,19,29,SYR,77,37,8,56,37
1950-02-11,NYK,85,30,20,CHS,75,31,17,61,37
1950-02-11,WAS,81,23,27,AND,69,27,21,50,48
1950-02-12,SYR,102,38,8,WAT,98,12,36,50,44
1950-02-12,TCB,89,20,26,INO,95,28,19,48,45
1950-02-12,FTW,76,29,21,ROC,74,35,15,64,36
1950-02-12,BOM,86,20,29,PHW,70,18,32,38,61
1950-02-12,MNL,88,37,13,BOS,70,18,30,55,43
1950-02-13,AND,93,27,22,WAT,80,12,37,39,59
1950-02-13,DN,79,7,39,SHE,67,18,27,25,66
1950-02-14,DN,84,8,39,BOS,78,18,31,26,70
1950-02-14,CHS,74,31,18,ROC,83,35,16,66,34
1950-02-14,INO,86,29,19,PHW,67,18,33,47,52
1950-02-15,WAS,81,24,27,TCB,85,20,27,44,54
1950-02-15,FTW,84,30,21,BOS,78,18,32,48,53
1950-02-15,WAT,76,12,38,INO,74,30,19,42,57
1950-02-15,MNL,92,38,13,ROC,70,36,16,74,29
1950-02-15,NYK,80,31,20,BAL,67,19,30,50,50
1950-02-15,SHE,61,18,28,PHW,66,18,34,36,62
1950-02-16,DN,86,9,39,AND,95,28,22,37,61
1950-02-16,BAL,83,19,31,FTW,77,31,21,50,52
1950-02-16,SYR,105,39,8,TCB,74,21,27,60,35
1950-02-16,BOM,71,21,29,MNL,72,39,13,60,42
1950-02-17,MNL,80,40,13,WAT,74,13,38,53,51
1950-02-17,BOS,73,18,33,ROC,81,36,17,54,50
1950-02-17,PHW,67,19,34,FTW,68,31,22,50,56
1950-02-18,WAT,93,13,39,TCB,116,21,28,34,67
1950-02-18,NYK,80,32,20,FTW,84,32,22,64,42
1950-02-18,WAS,81,24,28,INO,79,30,20,54,48
1950-02-18,ROC,94,37,17,BOS,73,18,34,55,51
1950-02-18,BAL,73,20,31,PHW,100,19,35,39,66
1950-02-19,ROC,105,38,17,NYK,92,32,21,70,38
1950-02-19,DN,86,9,40,AND,85,29,22,38,62
1950-02-19,MNL,96,41,13,CHS,83,31,19,72,32
1950-02-19,SYR,82,40,8,INO,78,30,21,70,29
1950-02-19,FTW,79,33,22,BAL,71,20,32,53,54
1950-02-19,BOM,72,21,30,SHE,65,18,29,39,59
1950-02-19,WAT,84,13,40,TCB,63,22,28,35,68
1950-02-21,INO,78,30,22,SHE,83,18,30,48,52
1950-02-21,DN,89,10,40,SYR,78,41,8,51,48
1950-02-21,ROC,84,39,17,WAS,76,25,28,64,45
1950-02-21,PHW,73,20,35,NYK,84,32,22,52,57
1950-02-21,CHS,72,31,20,BAL,64,20,33,51,53
1950-02-22,NYK,89,33,22,WAS,81,25,29,58,51
1950-02-22,TCB,81,22,29,AND,90,29,23,51,52
1950-02-22,WAT,77,14,40,BAL,84,20,34,34,74
1950-02-22,MNL,100,42,13,BOM,57,22,30,64,43
1950-02-23,SHE,81,19,30,WAT,86,14,41,33,71
1950-02-23,DN,80,11,40,SYR,108,41,9,52,49
1950-02-23,BOS,82,18,35,PHW,77,20,36,38,71
1950-02-23,TCB,82,22,30,BAL,73,21,34,43,64
1950-02-23,BOM,72,22,31,FTW,74,34,22,56,53
1950-02-24,BOS,89,19,35,WAS,74,25,30,44,65
1950-02-24,PHW,69,20,37,BAL,77,21,35,41,72
1950-02-24,SYR,72,42,9,INO,67,30,23,72,32
1950-02-24,CHS,77,32,20,BOM,62,22,32,54,52
1950-02-25,WAS,80,25,31,PHW,92,20,38,45,69
1950-02-25,NYK,86,34,22,CHS,79,33,20,67,42
1950-02-25,TCB,74,23,30,SHE,66,19,31,42,61
1950-02-25,BAL,66,22,35,BOS,82,20,35,42,70
1950-02-25,ROC,66,40,17,MNL,64,43,13,83,30
1950-02-26,SHE,86,19,32,INO,107,30,24,49,56
1950-02-26,BOM,79,22,33,ROC,81,41,17,63,50
1950-02-26,FTW,78,35,22,WAS,81,25,32,60,54
1950-02-26,DN,76,11,41,WAT,100,15,41,26,82
1950-02-26,MNL,80,43,14,TCB,66,24,30,67,44
1950-02-26,SYR,73,43,9,CHS,64,33,21,76,30
1950-02-27,BOS,77,21,35,CHS,79,33,22,54,57
1950-02-27,TCB,110,24,31,DN,75,11,42,35,73
1950-02-27,AND,97,30,23,SYR,73,44,9,74,32
1950-02-28,INO,110,31,24,SYR,72,44,10,75,34
1950-02-28,ROC,74,42,17,CHS,69,34,22,76,39
1950-02-28,MNL,71,44,14,FTW,65,35,23,79,37
1950-03-01,TCB,97,25,31,DN,80,11,43,36,74
1950-03-01,NYK,82,35,22,BAL,76,22,36,57,58
1950-03-01,CHS,76,34,23,WAS,75,26,32,60,55
1950-03-01,WAT,72,16,41,SYR,93,44,11,60,52
1950-03-01,BOM,70,22,34,FTW,75,35,24,57,58
1950-03-01,PHW,77,21,38,BOS,64,21,36,42,74
1950-03-02,WAS,91,26,33,CHS,88,35,23,61,56
1950-03-02,SHE,95,19,33,SYR,85,45,11,64,44
1950-03-02,BOS,72,21,37,NYK,81,36,22,57,59
1950-03-02,AND,85,31,23,DN,72,11,44,42,67
1950-03-02,BAL,68,22,37,MNL,88,45,14,67,51
1950-03-02,FTW,91,36,24,BOM,61,22,35,58,59
1950-03-03,INO,83,32,24,TCB,96,26,31,58,55
1950-03-03,PHW,66,22,38,MNL,61,46,14,68,52
1950-03-04,NYK,75,37,22,MNL,84,46,15,83,37
1950-03-04,WAS,95,27,33,BOS,75,21,38,48,71
1950-03-04,BAL,77,22,38,CHS,72,35,24,57,62
1950-03-04,ROC,73,43,17,FTW,70,37,24,80,41
1950-03-05,SHE,87,20,33,INO,92,32,25,52,58
1950-03-05,TCB,91,27,31,DN,80,11,45,38,76
1950-03-05,SYR,84,45,12,MNL,75,47,15,92,27
1950-03-05,CHS,73,35,25,AND,89,32,23,67,48
1950-03-05,BOM,71,22,36,PHW,67,23,38,45,74
1950-03-05,FTW,60,37,25,ROC,65,44,17,81,42
1950-03-06,AND,88,33,23,TCB,77,28,31,61,54
1950-03-07,INO,107,33,25,AND,93,34,23,67,48
1950-03-07,MNL,90,47,16,SHE,73,20,34,67,50
1950-03-07,BOS,75,21,39,WAS,64,28,33,49,72
1950-03-08,WAS,88,28,34,BAL,80,23,38,51,72
1950-03-08,NYK,80,37,23,BOM,78,23,36,60,59
1950-03-08,WAT,97,16,42,DN,68,11,46,27,88
1950-03-08,TCB,67,28,32,AND,82,34,24,62,56
1950-03-08,MNL,68,48,16,PHW,65,23,39,71,55
1950-03-09,SHE,115,20,35,DN,92,11,47,31,82
1950-03-09,AND,90,35,24,INO,97,34,25,69,49
1950-03-09,BAL,91,23,39,NYK,79,38,23,61,62
1950-03-09,SYR,85,46,12,BOM,74,23,37,69,49
1950-03-09,FTW,84,37,26,CHS,71,35,26,72,52
1950-03-09,ROC,78,45,17,BOS,59,22,39,67,56
1950-03-10,SHE,141,21,35,DN,104,11,48,32,83
1950-03-10,PHW,78,23,40,BOM,73,23,38,46,78
1950-03-10,BOS,66,22,40,WAS,76,29,34,51,74
1950-03-11,WAS,92,30,34,BOM,90,23,39,53,73
1950-03-11,AND,91,35,25,NYK,89,38,24,73,49
1950-03-11,CHS,90,35,27,FTW,88,38,26,73,53
1950-03-11,TCB,97,28,33,SHE,79,22,35,50,68
1950-03-11,BAL,79,24,39,BOS,75,22,41,46,80
1950-03-11,ROC,90,46,17,PHW,72,24,40,70,57
1950-03-12,INO,90,35,25,WAT,89,17,42,52,67
1950-03-12,FTW,86,38,27,BAL,75,25,39,63,66
1950-03-12,SYR,96,47,12,BOS,72,22,42,69,54
1950-03-12,ROC,99,47,17,BOM,72,23,40,70,57
1950-03-12,CHS,73,36,27,PHW,67,24,41,60,68
1950-03-12,MNL,87,49,16,NYK,66,38,25,87,41
1950-03-13,AND,98,36,25,SHE,86,22,36,58,61
1950-03-14,BOS,76,22,43,BOM,86,23,41,45,84
1950-03-14,CHS,85,37,27,NYK,75,38,26,75,53
1950-03-14,INO,68,36,25,SYR,65,48,12,84,37
1950-03-15,NYK,88,38,27,BOS,84,22,44,60,71
1950-03-15,PHW,83,24,42,AND,80,37,25,61,67
1950-03-15,WAT,87,17,43,SHE,69,22,37,39,80
1950-03-15,WAS,64,31,34,ROC,93,48,17,79,51
1950-03-15,MNL,96,50,16,BAL,62,25,40,75,56
1950-03-16,INO,111,37,25,DN,99,11,49,48,74
1950-03-16,SHE,75,22,38,SYR,88,48,13,70,51
1950-03-16,BOM,71,24,41,BAL,63,25,41,49,82
1950-03-17,BOS,96,22,45,NYK,98,39,27,61,72
1950-03-17,BOM,85,25,41,CHS,69,38,27,63,68
1950-03-17,PHW,85,25,42,WAS,59,31,35,56,77
1950-03-18,TCB,88,29,33,SYR,89,49,13,78,46
1950-03-18,WAS,82,31,36,FTW,76,39,27,70,63
1950-03-18,ROC,77,49,17,NYK,74,40,27,89,44
1950-03-18,INO,110,38,25,DN,73,11,50,49,75
1950-03-18,CHS,66,38,28,SHE,63,22,39,60,67
1950-03-19,WAT,79,18,43,TCB,77,29,34,47,77
1950-03-19,FTW,69,39,28,MNL,67,51,16,90,44
1950-03-19,SYR,72,50,13,AND,67,37,26,87,39
1950-03-19,ROC,97,50,17,BAL,66,25,42,75,59
1950-03-19,BOM,64,26,41,CHS,80,39,28,65,69
1950-03-20,FTW,86,40,28,CHS,69,40,28,80,56
1950-03-21,ROC,76,51,17,MNL,78,51,17,102,34
1950-10-31,ROC,78,1,0,WAS,70,0,0,1,0
1950-11-01,WAS,100,0,1,INO,84,0,0,0,1
1950-11-01,FTW,107,0,0,BOS,84,0,0,0,0
1950-11-01,BAL,81,0,0,MNL,71,0,1,0,1
1950-11-02,SYR,92,0,0,FTW,77,1,0,1,0
1950-11-02,TCB,79,0,0,BOS,65,0,1,0,1
1950-11-04,BAL,102,1,0,INO,86,0,1,1,1
1950-11-04,WAS,85,1,1,MNL,91,0,2,1,3
1950-11-04,TCB,87,1,0,NYK,76,0,0,1,0
1950-11-04,ROC,95,2,0,FTW,71,1,1,3,1
1950-11-04,PHW,77,0,0,BOS,68,0,2,0,2
1950-11-05,TCB,98,2,0,NYK,95,0,1,2,1
1950-11-05,SYR,90,1,0,MNL,87,1,2,2,2
1950-11-05,FTW,68,1,2,INO,63,0,2,1,4
1950-11-07,INO,86,0,3,NYK,73,0,2,0,5
1950-11-07,BOS,83,0,3,BAL,64,2,0,2,3
1950-11-08,WAS,86,1,2,BAL,81,2,1,3,3
1950-11-08,FTW,87,2,2,TCB,79,3,0,5,2
1950-11-09,NYK,73,0,3,INO,85,1,3,1,6
1950-11-09,PHW,87,1,0,FTW,72,3,2,4,2
1950-11-09,BOS,76,1,3,MNL,71,1,3,2,6
1950-11-09,SYR,89,2,0,TCB,70,3,1,5,1
1950-11-11,WAS,77,2,2,BOS,78,2,3,4,5
1950-11-11,BAL,85,2,2,FTW,77,3,3,5,5
1950-11-11,ROC,86,3,0,TCB,77,3,2,6,2
1950-11-11,NYK,74,0,4,SYR,72,3,0,3,4
1950-11-12,TCB,82,3,3,ROC,79,4,0,7,3
1950-11-12,BOS,78,3,3,INO,75,2,3,5,6
1950-11-12,FTW,87,3,4,WAS,73,2,3,5,7
1950-11-12,MNL,83,1,4,PHW,70,2,0,3,4
1950-11-12,SYR,83,3,1,BAL,57,3,2,6,3
1950-11-14,WAS,87,2,4,NYK,92,1,4,3,8
1950-11-14,INO,108,2,4,SYR,78,4,1,6,5
1950-11-14,PHW,84,2,1,BAL,72,3,3,5,4
1950-11-15,FTW,89,4,4,ROC,85,4,1,8,5
1950-11-15,BOS,79,4,3,WAS,74,2,5,6,8
1950-11-15,BAL,80,3,4,PHW,72,3,1,6,5
1950-11-15,MNL,72,2,4,SYR,71,4,2,6,6
1950-11-16,TCB,79,4,3,SYR,75,4,3,8,6
1950-11-16,BOS,82,5,3,BAL,73,4,4,9,7
1950-11-16,NYK,71,2,4,MNL,69,3,4,5,8
1950-11-16,PHW,84,3,2,INO,67,3,4,6,6
1950-11-18,NYK,93,3,4,PHW,87,4,2,7,6
1950-11-18,ROC,77,4,2,MNL,86,3,5,7,7
1950-11-18,BAL,76,4,5,BOS,80,6,3,10,8
1950-11-18,WAS,118,2,6,FTW,75,5,4,7,10
1950-11-18,INO,74,3,5,TCB,67,5,3,8,8
1950-11-19,SYR,96,4,4,NYK,83,4,4,8,8
1950-11-19,TCB,104,5,4,INO,81,4,5,9,9
1950-11-19,FTW,84,5,5,BAL,80,4,6,9,11
1950-11-19,MNL,90,4,5,ROC,77,4,3,8,8
1950-11-19,BOS,75,7,3,WAS,81,3,6,10,9
1950-11-21,NYK,83,4,5,BOS,89,7,4,11,9
1950-11-21,INO,91,4,6,ROC,79,4,4,8,10
1950-11-21,PHW,83,4,3,WAS,78,4,6,8,9
1950-11-21,TCB,76,6,4,BAL,65,4,7,10,11
1950-11-22,BAL,73,4,8,NYK,87,4,6,8,14
1950-11-22,WAS,65,4,7,TCB,60,7,4,11,11
1950-11-22,MNL,18,5,5,FTW,19,6,5,11,10
1950-11-23,SYR,85,5,4,INO,92,5,6,10,10
1950-11-23,BOS,94,8,4,TCB,78,7,5,15,9
1950-11-23,NYK,109,5,6,WAS,78,5,7,10,13
1950-11-23,PHW,89,5,3,ROC,71,4,5,9,8
1950-11-23,FTW,73,7,5,MNL,63,5,6,12,11
1950-11-25,ROC,90,4,6,BOS,82,9,4,13,10
1950-11-25,INO,92,6,6,BAL,81,4,9,10,15
1950-11-25,TCB,85,7,6,FTW,71,8,5,15,11
1950-11-25,WAS,67,5,8,SYR,77,5,5,10,13
1950-11-26,BOS,93,9,5,NYK,90,6,6,15,11
1950-11-26,SYR,90,6,5,WAS,76,5,9,11,14
1950-11-26,MNL,85,5,7,BAL,71,4,10,9,17
1950-11-26,FTW,79,8,6,INO,70,7,6,15,12
1950-11-28,NYK,108,6,7,SYR,84,7,5,13,12
1950-11-28,PHW,76,6,3,BOS,74,10,5,16,8
1950-11-28,ROC,87,5,6,WAS,71,5,10,10,16
1950-11-28,INO,90,7,7,FTW,66,9,6,16,13
1950-11-28,TCB,65,8,6,BAL,73,4,11,12,17
1950-11-29,WAS,71,5,11,ROC,72,6,6,11,17
1950-11-29,MNL,85,6,7,TCB,66,8,7,14,14
1950-11-30,BOS,81,10,6,WAS,85,5,12,15,18
1950-11-30,PHW,81,7,3,SYR,78,7,6,14,9
1950-11-30,NYK,79,7,7,ROC,74,7,6,14,13
1950-12-01,INO,66,8,7,MNL,65,7,7,15,14
1950-12-02,BAL,96,5,11,SYR,99,7,7,12,18
1950-12-02,WAS,75,6,12,BOS,83,10,7,16,19
1950-12-02,ROC,94,7,7,INO,72,9,7,16,14
1950-12-03,TCB,92,8,8,NYK,100,8,7,16,15
1950-12-03,BOS,97,11,7,BAL,85,5,12,16,19
1950-12-03,MNL,95,7,8,PHW,83,8,3,15,11
1950-12-03,SYR,84,8,7,INO,81,9,8,17,15
1950-12-03,FTW,80,9,7,ROC,79,8,7,17,14
1950-12-05,INO,95,9,9,NYK,89,9,7,18,16
1950-12-06,WAS,79,6,13,INO,101,10,9,16,22
1950-12-06,FTW,92,10,7,PHW,73,8,4,18,11
1950-12-06,BAL,70,5,13,ROC,74,8,8,13,21
1950-12-06,MNL,84,8,8,NYK,62,9,8,17,16
1950-12-07,TCB,76,8,9,FTW,77,11,7,19,16
1950-12-07,PHW,102,8,5,INO,73,11,9,19,14
1950-12-07,SYR,69,9,7,ROC,76,9,8,18,15
1950-12-09,BOS,85,12,7,SYR,86,9,8,21,15
1950-12-09,WAS,91,6,14,NYK,84,9,9,15,23
1950-12-09,TCB,79,8,10,MNL,88,9,8,17,18
1950-12-09,BAL,76,5,14,PHW,75,9,5,14,19
1950-12-10,MNL,114,10,8,TCB,101,8,11,18,19
1950-12-10,ROC,99,10,8,PHW,84,9,6,19,14
1950-12-10,NYK,106,9,10,INO,84,11,10,20,20
1950-12-10,FTW,97,12,7,WAS,81,7,14,19,21
1950-12-10,SYR,76,10,8,BAL,86,6,14,16,22
1950-12-12,PHW,101,9,7,NYK,91,10,10,19,17
1950-12-12,ROC,102,11,8,BAL,87,7,14,18,22
1950-12-12,BOS,87,12,8,FTW,81,13,7,25,15
1950-12-12,INO,75,11,11,TCB,74,8,12,19,23
1950-12-13,WAS,110,7,15,BOS,79,13,8,20,23
1950-12-13,MNL,72,11,8,ROC,82,12,8,23,16
1950-12-13,BAL,83,7,15,TCB,55,8,13,15,28
1950-12-14,PHW,94,10,7,FTW,82,13,8,23,15
1950-12-14,SYR,69,10,9,TCB,78,8,14,18,23
1950-12-15,INO,71,12,11,MNL,82,11,9,23,20
1950-12-16,WAS,88,8,15,PHW,96,11,7,19,22
1950-12-16,BAL,119,8,15,BOS,88,13,9,21,24
1950-12-16,NYK,86,10,11,FTW,77,13,9,23,20
1950-12-16,ROC,75,13,8,SYR,79,10,10,23,18
1950-12-16,TCB,71,9,14,MNL,86,12,9,21,23
1950-12-17,FTW,99,13,10,TCB,103,9,15,22,25
1950-12-17,SYR,95,11,10,NYK,86,11,11,22,21
1950-12-17,BOS,88,13,10,ROC,75,13,9,26,19
1950-12-17,MNL,79,13,9,INO,60,12,12,25,21
1950-12-19,INO,92,12,13,FTW,93,13,11,25,24
1950-12-19,NYK,86,11,12,BOS,80,14,10,25,22
1950-12-19,PHW,71,12,7,MNL,67,14,9,26,16
1950-12-20,BAL,91,9,15,MNL,84,14,10,23,25
1950-12-20,TCB,86,10,15,SYR,83,12,10,22,25
1950-12-20,WAS,76,8,16,ROC,94,13,10,21,26
1950-12-21,FTW,97,14,11,SYR,72,12,11,26,22
1950-12-23,BOS,87,14,11,MNL,81,14,11,28,22
1950-12-23,NYK,83,12,12,PHW,79,13,7,25,19
1950-12-23,WAS,79,8,17,INO,87,12,14,20,31
1950-12-23,ROC,77,14,10,FTW,65,15,11,29,21
1950-12-25,PHW,84,13,8,NYK,86,13,12,26,20
1950-12-25,MNL,93,14,12,WAS,79,8,18,22,30
1950-12-25,ROC,90,15,10,BOS,77,15,11,30,21
1950-12-25,TCB,87,11,15,BAL,72,10,15,21,30
1950-12-25,SYR,81,12,12,FTW,69,15,12,27,24
1950-12-26,BOS,102,15,12,SYR,100,13,12,28,24
1950-12-26,INO,81,13,14,WAS,88,8,19,21,33
1950-12-27,PHW,74,13,9,NYK,79,14,12,27,21
1950-12-27,FTW,68,15,13,ROC,74,16,10,31,23
1950-12-27,MNL,81,15,12,BAL,63,10,16,25,28
1950-12-28,PHW,91,13,10,SYR,88,13,13,26,23
1950-12-28,TCB,97,12,15,WAS,80,9,19,21,34
1950-12-28,ROC,75,17,10,MNL,67,16,12,33,22
1950-12-29,INO,112,13,15,TCB,81,13,15,26,30
1950-12-30,BAL,80,10,17,SYR,90,13,14,23,31
1950-12-30,ROC,91,18,10,WAS,77,9,20,27,30
1950-12-30,NYK,77,15,12,BOS,60,16,12,31,24
1950-12-31,TCB,110,13,16,FTW,100,15,14,28,30
1950-12-31,BOS,100,16,13,NYK,90,16,12,32,25
1950-12-31,MNL,83,16,13,PHW,73,14,10,30,23
1951-01-01,TCB,109,14,16,PHW,92,14,11,28,27
1951-01-01,SYR,106,14,14,BOS,89,17,13,31,27
1951-01-01,ROC,91,19,10,NYK,88,16,13,35,23
1951-01-01,BAL,83,10,18,WAS,71,9,21,19,39
1951-01-01,FTW,83,15,15,MNL,70,17,13,32,28
1951-01-02,INO,86,14,15,PHW,87,14,12,28,27
1951-01-03,TCB,82,15,16,BOS,84,17,14,32,30
1951-01-03,WAS,92,9,22,BAL,82,11,18,20,40
1951-01-03,MNL,86,17,14,FTW,64,16,15,33,29
1951-01-04,FTW,83,16,16,INO,94,14,16,30,32
1951-01-04,SYR,77,15,14,MNL,80,18,14,33,28
1951-01-04,PHW,92,15,12,BAL,69,11,19,26,31
1951-01-05,MNL,69,19,14,BOS,54,18,14,37,28
1951-01-06,NYK,85,16,14,SYR,87,15,15,31,29
1951-01-06,WAS,76,10,22,FTW,91,16,17,26,39
1951-01-06,ROC,73,20,10,INO,75,15,16,35,26
1951-01-06,BAL,64,11,20,PHW,57,16,12,27,32
1951-01-07,BOS,91,18,15,WAS,86,10,23,28,38
1951-01-07,TCB,83,15,17,INO,79,16,16,31,33
1951-01-07,FTW,76,17,17,NYK,79,16,15,33,32
1951-01-07,SYR,73,16,15,BAL,65,12,20,28,35
1951-01-07,MNL,69,20,14,ROC,57,20,11,40,25
1951-01-09,WAS,74,10,24,PHW,102,16,13,26,37
1951-01-09,NYK,75,17,15,FTW,70,17,18,34,33
1951-01-09,INO,59,16,17,ROC,77,20,12,36,29
1951-01-10,TCB,96,16,17,SYR,97,17,15,33,32
1951-01-10,BAL,78,12,21,ROC,80,21,12,33,33
1951-01-10,MNL,70,21,14,NYK,65,18,15,39,29
1951-01-11,TCB,109,16,18,MNL,113,22,14,38,32
1951-01-11,PHW,82,17,13,ROC,79,22,12,39,25
1951-01-11,FTW,84,17,19,SYR,76,18,15,35,34
1951-01-12,INO,81,16,18,FTW,89,18,19,34,37
1951-01-13,PHW,87,18,13,BOS,97,19,15,37,28
1951-01-13,NYK,92,18,16,BAL,79,12,22,30,38
1951-01-13,ROC,99,22,13,FTW,78,19,19,41,32
1951-01-14,BAL,93,12,23,NYK,91,19,16,31,39
1951-01-14,FTW,94,19,20,TCB,85,16,19,35,39
1951-01-14,MNL,86,23,14,INO,84,16,19,39,33
1951-01-14,BOS,98,20,15,PHW,73,18,14,38,29
1951-01-14,SYR,92,18,16,ROC,63,23,13,41,29
1951-01-16,ROC,97,23,14,TCB,89,16,20,39,34
1951-01-16,INO,82,16,20,MNL,68,24,14,40,34
1951-01-17,BAL,81,13,23,TCB,70,16,21,29,44
1951-01-18,SYR,87,19,16,ROC,96,24,14,43,30
1951-01-18,BOS,105,21,15,TCB,85,16,22,37,37
1951-01-18,PHW,114,18,15,INO,80,17,20,35,35
1951-01-18,NYK,95,19,17,MNL,78,24,15,43,32
1951-01-20,ROC,87,25,14,PHW,101,19,15,44,29
1951-01-20,TCB,91,16,23,BOS,85,22,15,38,38
1951-01-20,MNL,89,24,16,FTW,70,20,20,44,36
1951-01-20,BAL,102,14,23,INO,63,17,21,31,44
1951-01-21,FTW,106,20,21,BOS,112,22,16,42,37
1951-01-21,SYR,86,19,17,PHW,96,20,15,39,32
1951-01-21,NYK,88,20,17,ROC,83,25,15,45,32
1951-01-21,MNL,89,25,16,TCB,82,17,23,42,39
1951-01-23,ROC,102,25,16,NYK,92,21,17,46,33
1951-01-23,INO,79,17,22,BOS,83,23,16,40,38
1951-01-23,MNL,89,26,16,BAL,79,15,23,41,39
1951-01-23,PHW,88,21,15,TCB,77,17,24,38,39
1951-01-24,NYK,95,21,18,TCB,85,17,25,38,43
1951-01-24,BAL,87,15,24,SYR,82,19,18,34,42
1951-01-25,BOS,99,24,16,FTW,97,20,22,44,38
1951-01-25,SYR,113,19,19,TCB,87,17,26,36,45
1951-01-25,PHW,71,22,15,MNL,90,27,16,49,31
1951-01-26,INO,78,17,23,PHW,75,22,16,39,39
1951-01-27,BAL,97,16,24,FTW,91,20,23,36,47
1951-01-27,TCB,86,17,27,PHW,96,22,17,39,44
1951-01-27,ROC,85,26,16,SYR,83,20,19,46,35
1951-01-27,NYK,76,22,18,BOS,75,25,16,47,34
1951-01-28,FTW,93,20,24,ROC,88,27,16,47,40
1951-01-28,SYR,104,20,20,BOS,83,25,17,45,37
1951-01-28,MNL,101,28,16,INO,75,18,23,46,39
1951-01-29,INO,87,18,24,TCB,85,17,28,35,52
1951-01-30,ROC,95,27,17,BAL,90,17,24,44,41
1951-01-30,BOS,96,25,18,SYR,87,21,20,46,38
1951-01-31,FTW,91,21,24,PHW,84,23,17,44,41
1951-01-31,MNL,106,29,16,TCB,78,17,29,46,45
1951-01-31,NYK,89,23,18,BAL,77,17,25,40,43
1951-01-31,INO,68,19,24,ROC,63,28,17,47,41
1951-02-01,TCB,109,17,30,FTW,102,22,24,39,54
1951-02-01,SYR,90,21,21,NYK,93,24,18,45,39
1951-02-01,PHW,82,23,18,BOS,80,26,18,49,36
1951-02-02,BOS,96,26,19,SYR,90,21,22,47,41
1951-02-03,INO,84,20,24,MNL,89,30,16,50,40
1951-02-03,BAL,72,17,26,NYK,83,25,18,42,44
1951-02-03,ROC,65,28,18,PHW,61,24,18,52,36
1951-02-04,FTW,95,22,25,BAL,108,17,27,39,52
1951-02-04,MNL,98,31,16,BOS,84,27,19,58,35
1951-02-04,NYK,83,26,18,INO,105,20,25,46,43
1951-02-04,TCB,84,18,30,ROC,81,29,18,47,48
1951-02-04,SYR,78,21,23,PHW,75,24,19,45,42
1951-02-05,BOS,70,27,20,INO,57,21,25,48,45
1951-02-06,NYK,91,26,19,BAL,82,18,27,44,46
1951-02-06,PHW,97,24,20,TCB,77,19,30,43,50
1951-02-06,INO,78,21,26,ROC,76,29,19,50,45
1951-02-07,FTW,96,22,26,MNL,86,32,16,54,42
1951-02-07,SYR,82,22,23,BAL,102,18,28,40,51
1951-02-08,SYR,96,22,24,NYK,83,27,19,49,43
1951-02-08,PHW,86,25,20,BAL,75,19,28,44,48
1951-02-08,BOS,85,28,20,TCB,70,19,31,47,51
1951-02-08,MNL,69,32,17,ROC,58,29,20,61,37
1951-02-10,ROC,98,29,21,TCB,90,19,32,48,53
1951-02-10,INO,78,22,26,PHW,88,26,20,48,46
1951-02-10,BAL,81,19,29,BOS,76,29,20,48,49
1951-02-10,NYK,73,27,20,FTW,62,23,26,50,46
1951-02-11,FTW,120,23,27,NYK,96,28,20,51,47
1951-02-11,MNL,91,33,17,INO,78,22,27,55,44
1951-02-11,BOS,93,29,21,ROC,77,30,21,59,42
1951-02-11,TCB,76,19,33,PHW,72,27,20,46,53
1951-02-11,BAL,72,20,29,SYR,80,23,24,43,53
1951-02-13,PHW,104,27,21,BOS,98,30,21,57,42
1951-02-13,INO,80,22,28,FTW,78,24,27,46,55
1951-02-14,TCB,98,20,33,INO,91,23,28,43,61
1951-02-14,FTW,77,24,28,SYR,75,24,24,48,52
1951-02-14,MNL,99,34,17,BAL,71,20,30,54,47
1951-02-14,NYK,81,28,21,ROC,65,30,22,58,43
1951-02-15,PHW,93,28,21,NYK,98,29,21,57,42
1951-02-15,SYR,94,24,25,BOS,80,30,22,54,47
1951-02-15,INO,69,23,29,BAL,60,20,31,43,60
1951-02-16,BOS,81,30,23,PHW,76,28,22,58,45
1951-02-16,INO,71,24,29,MNL,76,35,17,59,46
1951-02-17,ROC,87,0,0,MNL,82,0,0,0,0
1951-02-17,BAL,112,20,32,FTW,91,25,28,45,60
1951-02-17,NYK,88,30,21,SYR,75,25,25,55,46
1951-02-18,TCB,89,21,33,ROC,83,30,23,51,56
1951-02-18,SYR,91,25,26,MNL,80,36,17,61,43
1951-02-18,BOS,78,31,23,INO,75,24,30,55,53
1951-02-18,FTW,75,25,29,PHW,70,28,23,53,52
1951-02-20,ROC,105,30,24,BAL,89,21,32,51,56
1951-02-20,INO,79,24,31,SYR,81,26,26,50,57
1951-02-20,PHW,99,28,24,TCB,69,22,33,50,57
1951-02-21,BOS,87,32,23,NYK,85,31,21,63,44
1951-02-21,BAL,81,21,33,PHW,83,29,24,50,57
1951-02-21,MNL,82,36,18,SYR,76,27,26,63,44
1951-02-22,NYK,94,31,22,TCB,90,22,34,53,56
1951-02-22,PHW,98,30,24,ROC,90,31,24,61,48
1951-02-22,BOS,72,33,23,BAL,69,21,34,54,57
1951-02-24,ROC,99,31,25,TCB,89,22,35,53,60
1951-02-24,MNL,95,37,18,FTW,78,26,29,63,47
1951-02-24,BAL,84,21,35,BOS,75,34,23,55,58
1951-02-24,NYK,64,32,22,PHW,70,31,24,63,46
1951-02-25,SYR,98,27,27,NYK,93,32,23,59,50
1951-02-25,FTW,102,26,30,BAL,92,22,35,48,65
1951-02-25,BOS,93,34,24,PHW,83,32,24,66,48
1951-02-25,TCB,78,22,36,ROC,82,32,25,54,61
1951-02-25,MNL,73,38,18,INO,75,24,32,62,50
1951-02-27,ROC,100,33,25,NYK,90,32,24,65,49
1951-02-27,MNL,83,38,19,TCB,77,22,37,60,56
1951-02-27,INO,96,25,32,BAL,74,22,36,47,68
1951-02-27,PHW,86,32,25,SYR,72,28,27,60,52
1951-02-28,TCB,100,22,38,BAL,85,22,37,44,75
1951-02-28,FTW,77,27,30,MNL,73,39,19,66,49
1951-03-01,SYR,108,28,28,FTW,86,28,30,56,58
1951-03-01,BOS,78,35,24,NYK,84,32,25,67,49
1951-03-01,PHW,97,33,25,MNL,77,39,20,72,45
1951-03-03,TCB,88,23,38,MNL,99,39,21,62,59
1951-03-03,BAL,87,22,38,BOS,95,35,25,57,63
1951-03-03,ROC,89,34,25,FTW,79,28,31,62,56
1951-03-03,NYK,97,33,25,SYR,78,29,28,62,53
1951-03-04,FTW,105,28,32,NYK,98,34,25,62,57
1951-03-04,BOS,92,36,25,MNL,86,40,21,76,46
1951-03-04,SYR,85,29,29,PHW,79,34,25,63,54
1951-03-04,TCB,87,23,39,INO,72,26,32,49,71
1951-03-06,TCB,88,24,39,FTW,86,29,32,53,71
1951-03-06,ROC,90,35,25,MNL,79,40,22,75,47
1951-03-06,PHW,96,34,26,NYK,76,34,26,68,52
1951-03-06,INO,75,26,33,BOS,73,37,25,63,58
1951-03-07,FTW,95,29,33,BOS,99,37,26,66,59
1951-03-07,ROC,107,36,25,SYR,86,30,29,66,54
1951-03-07,BAL,84,22,39,PHW,95,35,26,57,65
1951-03-08,SYR,121,30,30,INO,97,27,33,57,63
1951-03-08,NYK,97,34,27,MNL,94,40,23,74,50
1951-03-08,PHW,94,36,26,BAL,90,22,40,58,66
1951-03-09,INO,84,27,34,ROC,91,37,25,64,59
1951-03-11,MNL,98,40,24,BOS,96,38,26,78,50
1951-03-11,SYR,91,31,30,PHW,95,37,26,68,56
1951-03-11,BAL,112,22,41,NYK,89,35,27,57,68
1951-03-11,ROC,88,38,25,INO,95,27,35,65,60
1951-03-11,FTW,102,29,34,TCB,87,25,39,54,73
1951-03-13,BOS,107,38,27,ROC,111,38,26,76,53
1951-03-13,INO,98,28,35,SYR,93,31,31,59,66
1951-03-14,FTW,115,30,34,INO,109,29,35,59,69
1951-03-14,TCB,91,25,40,NYK,92,35,28,60,68
1951-03-14,MNL,100,41,24,SYR,76,31,32,72,56
1951-03-15,BAL,93,23,41,ROC,87,39,26,62,67
1951-03-15,PHW,88,38,26,FTW,78,31,34,69,60
1951-03-15,INO,74,29,36,NYK,70,36,28,65,64
1951-03-16,BOS,90,38,28,FTW,88,31,35,69,63
1951-03-17,TCB,91,25,41,MNL,92,42,24,67,65
1951-03-17,BAL,91,24,41,INO,92,30,36,54,77
1951-03-17,ROC,114,39,27,BOS,89,39,28,78,55
1951-03-17,PHW,100,39,26,SYR,86,31,33,70,59
1951-03-18,SYR,97,31,34,BOS,89,39,29,70,63
1951-03-18,FTW,95,31,36,TCB,82,25,42,56,78
1951-03-18,ROC,91,40,27,INO,79,31,36,71,63
1951-03-18,MNL,86,43,24,NYK,68,36,29,79,53
1951-11-01,ROC,101,1,1,BAL,97,0,0,1,1
1951-11-01,SYR,90,1,1,FTW,75,0,0,1,1
1951-11-03,BAL,86,0,1,INO,90,0,0,0,1
1951-11-03,ROC,74,2,1,MNL,93,2,3,4,4
1951-11-03,PHW,70,1,0,FTW,69,0,1,1,1
1951-11-03,MIH,66,0,0,NYK,68,2,1,2,1
1951-11-04,FTW,84,0,2,NYK,75,3,1,3,3
1951-11-04,SYR,98,2,1,MNL,67,3,3,5,4
1951-11-04,BOS,97,0,1,INO,65,1,0,1,1
1951-11-05,BAL,96,0,2,PHW,90,2,0,2,2
1951-11-06,INO,73,1,1,NYK,83,3,2,4,3
1951-11-06,MIH,65,0,1,FTW,62,1,2,1,3
1951-11-09,PHW,98,2,1,MNL,86,3,4,5,5
1951-11-09,INO,92,1,2,FTW,77,1,3,2,5
1951-11-10,ROC,100,2,2,INO,89,2,2,4,4
1951-11-10,BAL,91,1,2,SYR,82,3,1,4,3
1951-11-10,NYK,73,4,2,MNL,89,3,5,7,7
1951-11-10,BOS,83,1,1,PHW,69,3,1,4,2
1951-11-11,SYR,93,3,2,INO,79,2,3,5,5
1951-11-11,ROC,80,3,2,NYK,78,4,3,7,5
1951-11-11,BOS,77,2,1,MNL,72,4,5,6,6
1951-11-11,FTW,74,1,4,MIH,59,1,1,2,5
1951-11-12,BAL,80,2,2,MNL,90,4,6,6,8
1951-11-13,PHW,82,3,2,NYK,85,4,4,7,6
1951-11-13,MIH,75,1,2,ROC,91,4,2,5,4
1951-11-13,INO,71,2,4,MNL,77,5,6,7,10
1951-11-14,BOS,98,3,1,FTW,91,2,4,5,5
1951-11-15,SYR,97,4,2,BOS,95,4,1,8,3
1951-11-16,PHW,90,3,3,SYR,97,5,2,8,5
1951-11-16,INO,68,2,5,MIH,78,1,3,3,8
1951-11-17,BAL,75,2,3,BOS,88,4,2,6,5
1951-11-17,NYK,72,5,4,SYR,79,6,2,11,6
1951-11-17,ROC,86,5,2,PHW,72,3,4,8,6
1951-11-17,MNL,68,6,6,FTW,64,2,5,8,11
1951-11-17,INO,68,2,6,MIH,58,2,3,4,9
1951-11-18,BOS,92,5,2,NYK,93,5,5,10,7
1951-11-18,FTW,71,2,6,ROC,76,6,2,8,8
1951-11-18,SYR,71,7,2,BAL,68,2,4,9,6
1951-11-19,BAL,71,2,5,MIH,70,2,4,4,9
1951-11-20,NYK,88,6,5,BAL,86,3,5,9,10
1951-11-20,INO,69,3,6,ROC,65,7,2,10,8
1951-11-20,PHW,80,3,5,MIH,64,2,5,5,10
1951-11-22,NYK,102,7,5,PHW,88,4,5,11,10
1951-11-22,FTW,72,2,7,SYR,96,8,2,10,9
1951-11-22,BOS,103,5,3,MIH,72,2,6,7,9
1951-11-22,MNL,70,7,6,ROC,65,7,3,14,9
1951-11-23,PHW,100,4,6,BOS,102,6,3,10,9
1951-11-23,INO,82,4,6,SYR,68,9,2,13,8
1951-11-24,BAL,81,3,6,PHW,74,4,7,7,13
1951-11-24,NYK,68,8,5,BOS,70,7,3,15,8
1951-11-24,ROC,74,7,4,FTW,63,2,8,9,12
1951-11-24,MIH,59,2,7,MNL,72,8,6,10,13
1951-11-25,SYR,100,0,0,NYK,73,0,0,0,0
1951-11-25,BOS,103,8,3,PHW,85,4,8,12,11
1951-11-25,MIH,75,2,8,ROC,73,8,4,10,12
1951-11-25,MNL,82,9,6,INO,73,5,6,14,12
1951-11-25,FTW,83,2,9,BAL,66,4,6,6,15
1951-11-27,PHW,83,4,9,NYK,81,8,6,12,15
1951-11-27,ROC,77,8,5,MIH,73,3,8,11,13
1951-11-28,MNL,90,10,6,BOS,76,9,3,19,9
1951-11-29,SYR,82,9,3,FTW,78,3,9,12,12
1951-11-29,NYK,74,8,7,ROC,78,9,5,17,12
1951-11-29,BAL,77,4,7,MIH,64,3,9,7,16
1951-11-30,INO,92,5,7,BOS,87,9,4,14,11
1951-11-30,PHW,82,5,9,SYR,75,10,3,15,12
1951-12-01,BAL,84,5,7,NYK,82,8,8,13,15
1951-12-01,MNL,89,11,6,FTW,69,3,10,14,16
1951-12-01,ROC,71,10,5,MIH,66,3,10,13,15
1951-12-02,BOS,103,9,5,BAL,82,6,7,15,12
1951-12-02,SYR,79,10,4,ROC,81,11,5,21,9
1951-12-02,NYK,86,8,9,PHW,72,6,9,14,18
1951-12-02,MIH,71,3,11,INO,80,6,7,9,18
1951-12-02,FTW,63,3,11,MNL,61,12,6,15,17
1951-12-03,BAL,70,6,8,ROC,77,12,5,18,13
1951-12-04,PHW,96,6,10,ROC,80,13,5,19,15
1951-12-04,INO,83,7,7,SYR,77,10,5,17,12
1951-12-05,BOS,88,10,5,FTW,91,4,11,14,16
1951-12-05,MNL,81,12,7,SYR,83,10,6,22,13
1951-12-06,MIH,73,3,12,SYR,70,11,6,14,18
1951-12-07,PHW,93,7,10,NYK,91,9,9,16,19
1951-12-07,INO,88,8,7,BAL,80,6,9,14,16
1951-12-08,ROC,75,13,6,SYR,95,11,7,24,13
1951-12-08,MIH,82,4,12,FTW,71,5,11,9,23
1951-12-08,MNL,85,12,8,BAL,64,6,10,18,18
1951-12-09,BOS,103,10,6,NYK,94,9,10,19,16
1951-12-09,FTW,86,5,12,ROC,84,13,7,18,19
1951-12-09,MNL,78,13,8,INO,85,9,7,22,15
1951-12-09,SYR,93,12,7,PHW,74,8,10,20,17
1951-12-09,MIH,71,5,12,BAL,73,6,11,11,23
1951-12-11,NYK,88,9,11,MIH,83,5,13,14,24
1951-12-11,PHW,79,8,11,BOS,78,11,6,19,17
1951-12-11,INO,85,10,7,MNL,69,13,9,23,16
1951-12-11,SYR,80,13,7,FTW,62,6,12,19,19
1951-12-12,BOS,89,11,7,MIH,84,5,14,16,21
1951-12-12,MNL,99,13,10,BAL,79,7,11,20,21
1951-12-13,SYR,89,14,7,MIH,82,5,15,19,22
1951-12-14,INO,83,11,7,NYK,79,10,11,21,18
1951-12-14,PHW,72,9,11,FTW,62,6,13,15,24
1951-12-15,BAL,90,7,12,FTW,80,6,14,13,26
1951-12-15,ROC,75,13,8,INO,66,12,7,25,15
1951-12-16,ROC,99,14,8,BAL,95,8,12,22,20
1951-12-16,SYR,92,15,7,INO,96,12,8,27,15
1951-12-16,BOS,92,12,7,PHW,90,10,11,22,18
1951-12-16,FTW,71,6,15,NYK,80,10,12,16,27
1951-12-16,MNL,99,14,10,MIH,52,5,16,19,26
1951-12-17,BAL,92,8,13,BOS,80,13,7,21,20
1951-12-18,NYK,69,1,1,MNL,67,2,2,3,3
1951-12-18,PHW,82,10,12,BAL,78,9,13,19,25
1951-12-18,MIH,68,5,17,ROC,94,15,8,20,25
1951-12-19,BOS,103,13,8,SYR,97,15,8,28,16
1951-12-20,FTW,54,6,16,ROC,69,16,8,22,24
1951-12-21,PHW,105,0,0,MNL,103,2,0,2,0
1951-12-21,BOS,106,14,8,BAL,89,9,14,23,22
1951-12-21,INO,69,13,8,MIH,64,5,18,18,26
1951-12-22,BAL,90,9,15,MNL,96,15,10,24,25
1951-12-22,ROC,105,17,8,PHW,89,11,12,28,20
1951-12-22,NYK,92,11,12,SYR,73,15,9,26,21
1951-12-23,BOS,91,15,8,INO,88,14,8,29,16
1951-12-23,FTW,81,6,17,MNL,79,16,10,22,27
1951-12-23,SYR,72,15,10,NYK,75,12,12,27,22
1951-12-25,MNL,100,16,11,BOS,93,16,8,32,19
1951-12-25,ROC,87,18,8,INO,78,14,9,32,17
1951-12-25,SYR,70,15,11,MIH,65,5,19,20,30
1951-12-25,NYK,72,13,12,FTW,65,7,17,20,29
1951-12-26,BAL,103,9,16,PHW,99,11,13,20,29
1951-12-26,FTW,94,7,18,BOS,86,16,9,23,27
1951-12-26,MIH,78,5,20,NYK,76,14,12,19,32
1951-12-27,ROC,98,19,8,NYK,85,14,13,33,21
1951-12-27,SYR,68,16,11,MIH,69,6,20,22,31
1951-12-29,BAL,75,10,16,INO,65,14,10,24,26
1951-12-29,MIH,61,7,20,PHW,68,11,14,18,34
1951-12-29,ROC,75,20,8,FTW,61,8,18,28,26
1951-12-30,SYR,108,16,12,BAL,91,11,16,27,28
1951-12-30,BOS,100,16,10,NYK,90,14,14,30,24
1951-12-30,MNL,93,17,11,PHW,64,12,14,29,25
1951-12-30,FTW,77,8,19,MIH,60,7,21,15,40
1951-12-31,NYK,87,14,15,BOS,86,17,10,31,25
1951-12-31,BAL,86,11,17,FTW,95,9,19,20,36
1951-12-31,INO,77,14,11,ROC,73,21,8,35,19
1952-01-01,ROC,106,21,9,BOS,91,17,11,38,20
1952-01-01,MNL,82,18,11,SYR,80,17,12,35,23
1952-01-01,FTW,89,10,19,PHW,74,12,15,22,34
1952-01-01,MIH,65,7,22,NYK,68,15,15,22,37
1952-01-02,NYK,89,16,15,MIH,67,7,23,23,38
1952-01-03,SYR,107,17,13,BOS,81,17,12,34,25
1952-01-04,PHW,92,12,16,BAL,79,11,18,23,34
1952-01-04,INO,83,15,11,NYK,73,17,15,32,26
1952-01-04,MNL,79,19,11,FTW,64,11,19,30,30
1952-01-05,ROC,103,22,9,PHW,94,13,16,35,25
1952-01-05,BAL,73,11,19,BOS,94,17,13,28,32
1952-01-05,MNL,86,20,11,INO,65,16,11,36,22
1952-01-06,SYR,98,18,13,PHW,93,13,17,31,30
1952-01-06,MNL,107,21,11,NYK,92,17,16,38,27
1952-01-06,BOS,91,18,13,ROC,80,23,9,41,22
1952-01-06,FTW,79,11,20,INO,75,16,12,27,32
1952-01-08,MIH,76,7,24,BOS,83,19,13,26,37
1952-01-08,INO,82,16,13,MNL,75,22,11,38,24
1952-01-08,NYK,107,17,17,ROC,74,23,10,40,27
1952-01-09,MNL,91,22,12,INO,74,17,13,39,25
1952-01-10,SYR,110,19,13,NYK,96,18,17,37,30
1952-01-10,FTW,85,12,20,BOS,94,20,13,32,33
1952-01-11,PHW,85,13,18,ROC,83,23,11,36,29
1952-01-11,INO,100,17,14,BOS,79,21,13,38,27
1952-01-11,MIH,63,7,25,MNL,75,23,12,30,37
1952-01-12,BAL,88,11,20,SYR,92,20,13,31,33
1952-01-12,MNL,96,24,12,MIH,84,7,26,31,38
1952-01-12,NYK,86,18,18,INO,77,18,14,36,32
1952-01-12,ROC,76,23,12,FTW,88,12,21,35,33
1952-01-13,SYR,103,21,13,INO,85,18,15,39,28
1952-01-13,MNL,81,25,12,PHW,88,14,18,39,30
1952-01-13,FTW,81,13,21,BAL,71,11,21,24,42
1952-01-13,ROC,97,23,13,NYK,70,19,18,42,31
1952-01-15,INO,101,18,16,PHW,68,15,18,33,34
1952-01-15,MIH,76,7,27,FTW,63,14,21,21,48
1952-01-16,BOS,94,0,0,MNL,108,0,0,0,0
1952-01-16,MIH,77,8,27,BAL,71,11,22,19,49
1952-01-17,SYR,110,22,13,MNL,105,25,13,47,26
1952-01-17,FTW,82,14,22,PHW,78,15,19,29,41
1952-01-17,MIH,87,9,27,BAL,76,11,23,20,50
1952-01-18,PHW,98,15,20,INO,83,19,16,34,36
1952-01-19,NYK,94,19,19,PHW,88,16,20,35,39
1952-01-19,ROC,96,24,13,MNL,85,25,14,49,27
1952-01-19,BAL,81,11,24,INO,78,19,17,30,41
1952-01-20,MNL,91,1,0,ROC,81,0,0,1,0
1952-01-20,BOS,117,21,14,INO,98,19,18,40,32
1952-01-20,SYR,99,23,13,BAL,80,12,24,35,37
1952-01-20,FTW,83,15,22,MIH,76,10,27,25,49
1952-01-21,BAL,83,12,25,NYK,99,20,19,32,44
1952-01-21,ROC,78,25,13,MIH,76,10,28,35,41
1952-01-22,MIH,82,10,29,SYR,93,24,13,34,42
1952-01-22,PHW,78,16,21,NYK,82,21,19,37,40
1952-01-22,INO,68,19,19,ROC,65,26,13,45,32
1952-01-23,MNL,97,25,15,SYR,99,25,13,50,28
1952-01-23,BOS,117,22,14,BAL,75,12,26,34,40
1952-01-24,FTW,94,16,22,ROC,90,26,14,42,36
1952-01-25,PHW,95,16,22,SYR,94,26,13,42,35
1952-01-25,INO,83,20,19,FTW,79,17,22,37,41
1952-01-26,NYK,99,22,19,INO,93,21,19,43,38
1952-01-26,BOS,85,23,14,PHW,89,17,22,40,36
1952-01-26,BAL,73,12,27,SYR,78,26,14,38,41
1952-01-26,ROC,104,26,15,FTW,71,17,23,43,38
1952-01-26,MIH,56,10,30,MNL,57,25,16,35,46
1952-01-27,ROC,102,27,15,INO,95,21,20,48,35
1952-01-27,FTW,100,17,24,NYK,92,23,19,40,43
1952-01-27,SYR,91,27,14,BOS,86,23,15,50,29
1952-01-27,MNL,91,26,16,MIH,62,10,31,36,47
1952-01-29,PHW,97,18,22,BOS,96,23,16,41,38
1952-01-29,INO,100,21,21,NYK,72,23,20,44,41
1952-01-30,INO,77,22,21,FTW,81,18,24,40,45
1952-01-30,MNL,77,27,16,NYK,65,23,21,50,37
1952-01-31,SYR,88,28,14,MIH,79,10,32,38,46
1952-01-31,FTW,78,19,24,MNL,85,28,16,47,40
1952-02-01,PHW,81,19,22,BAL,79,12,28,31,50
1952-02-01,INO,85,22,22,MNL,77,29,16,51,38
1952-02-01,BOS,100,23,17,MIH,77,10,33,33,50
1952-02-02,NYK,91,23,22,BOS,83,24,17,47,39
1952-02-02,ROC,100,28,15,MIH,79,10,34,38,49
1952-02-02,BAL,63,12,29,FTW,76,19,25,31,54
1952-02-03,BOS,100,24,18,NYK,95,24,22,48,40
1952-02-03,MNL,77,29,17,ROC,75,29,15,58,32
1952-02-03,MIH,83,10,35,PHW,73,20,22,30,57
1952-02-03,SYR,95,29,14,BAL,73,12,30,41,44
1952-02-03,FTW,85,20,25,INO,70,23,22,43,47
1952-02-04,BAL,82,12,31,NYK,81,24,23,36,54
1952-02-05,INO,94,23,23,PHW,85,20,23,43,46
1952-02-05,FTW,64,21,25,MIH,75,11,35,32,60
1952-02-06,BOS,99,25,18,SYR,88,30,14,55,32
1952-02-06,NYK,73,24,24,BAL,70,13,31,37,55
1952-02-07,FTW,91,21,26,PHW,105,20,24,41,50
1952-02-07,MNL,86,30,17,ROC,75,29,16,59,33
1952-02-08,PHW,87,21,24,SYR,96,30,15,51,39
1952-02-08,NYK,103,25,24,BAL,83,13,32,38,56
1952-02-08,INO,80,24,23,MIH,76,12,35,36,58
1952-02-09,ROC,104,29,17,BOS,100,26,18,55,35
1952-02-09,NYK,96,26,24,PHW,86,21,25,47,49
1952-02-09,MIH,90,12,36,INO,83,25,23,37,59
1952-02-09,BAL,84,13,33,SYR,76,31,15,44,48
1952-02-09,MNL,67,31,17,FTW,70,21,27,52,44
1952-02-10,BOS,97,26,19,ROC,111,30,17,56,36
1952-02-10,SYR,91,31,16,PHW,84,21,26,52,42
1952-02-10,FTW,77,22,27,BAL,82,14,33,36,60
1952-02-10,MIH,70,13,36,MNL,69,31,18,44,54
1952-02-12,INO,80,25,24,FTW,78,22,28,47,52
1952-02-12,PHW,75,21,27,ROC,86,31,17,52,44
1952-02-12,NYK,78,27,24,SYR,69,32,16,59,40
1952-02-13,BAL,96,15,33,ROC,91,32,17,47,50
1952-02-14,SYR,76,1,0,ROC,78,0,1,1,1
1952-02-14,FTW,94,22,29,BOS,90,26,20,48,49
1952-02-14,MNL,109,31,19,MIH,74,14,36,45,55
1952-02-14,INO,89,26,24,BAL,66,16,33,42,57
1952-02-15,PHW,112,21,28,INO,91,27,24,48,52
1952-02-16,ROC,92,32,18,SYR,84,32,17,64,35
1952-02-16,NYK,102,28,24,BAL,82,16,34,44,58
1952-02-16,MNL,75,32,19,BOS,77,26,21,58,40
1952-02-17,MIH,97,14,37,BOS,95,27,21,41,58
1952-02-17,ROC,100,33,18,INO,92,27,25,60,43
1952-02-17,FTW,99,23,29,MNL,87,32,20,55,49
1952-02-17,BAL,83,16,35,PHW,90,22,28,38,63
1952-02-17,SYR,66,32,18,NYK,61,29,24,61,42
1952-02-18,BOS,106,27,22,MIH,84,15,37,42,59
1952-02-19,NYK,98,0,1,MNL,96,2,1,2,2
1952-02-19,INO,82,27,26,BOS,81,28,22,55,48
1952-02-19,PHW,98,23,28,FTW,80,24,29,47,57
1952-02-20,INO,95,28,26,MIH,80,15,38,43,64
1952-02-20,BAL,78,16,36,MNL,93,32,21,48,57
1952-02-21,SYR,88,33,18,MNL,80,33,21,66,39
1952-02-21,BOS,88,28,23,FTW,67,24,30,52,53
1952-02-22,PHW,118,24,28,NYK,95,29,25,53,53
1952-02-22,INO,82,29,26,MIH,73,15,39,44,65
1952-02-23,BAL,81,16,37,SYR,80,34,18,50,55
1952-02-23,NYK,82,29,26,FTW,77,24,31,53,57
1952-02-23,ROC,73,34,18,MNL,83,33,22,67,40
1952-02-23,INO,86,30,26,MIH,59,15,40,45,66
1952-02-24,ROC,124,34,19,BAL,100,17,37,51,56
1952-02-24,SYR,75,34,19,BOS,77,29,23,63,42
1952-02-24,PHW,76,25,28,MIH,71,15,41,40,69
1952-02-24,FTW,83,24,32,MNL,70,34,22,58,54
1952-02-25,MNL,108,34,23,PHW,95,26,28,60,51
1952-02-25,BAL,84,17,38,NYK,89,30,26,47,64
1952-02-26,INO,86,31,26,PHW,88,26,29,57,55
1952-02-26,ROC,99,35,19,MIH,67,15,42,50,61
1952-02-27,PHW,97,27,29,INO,89,31,27,58,56
1952-02-27,BOS,88,30,23,SYR,81,34,20,64,43
1952-02-28,SYR,88,34,21,FTW,83,25,32,59,53
1952-02-28,BOS,91,31,23,ROC,72,36,19,67,42
1952-02-29,PHW,103,28,29,BAL,86,17,39,45,68
1952-03-01,MNL,98,35,23,INO,88,31,28,66,51
1952-03-01,NYK,105,31,26,BOS,86,32,23,63,49
1952-03-01,ROC,98,36,20,SYR,83,35,21,71,41
1952-03-01,BAL,90,17,40,PHW,77,29,29,46,69
1952-03-01,FTW,66,25,33,MIH,58,15,43,40,76
1952-03-02,FTW,101,26,33,INO,88,31,29,57,62
1952-03-02,BOS,87,32,24,NYK,89,32,26,64,50
1952-03-02,MIH,85,15,44,MNL,96,36,23,51,67
1952-03-02,SYR,76,35,22,ROC,72,37,20,72,42
1952-03-03,BAL,99,18,40,ROC,96,37,21,55,61
1952-03-04,NYK,92,33,26,ROC,90,37,22,70,48
1952-03-04,PHW,83,29,30,MNL,81,37,23,66,53
1952-03-04,BOS,91,32,25,BAL,80,19,40,51,65
1952-03-04,INO,86,31,30,FTW,68,27,33,58,63
1952-03-05,NYK,88,34,26,BAL,82,19,41,53,67
1952-03-05,BOS,82,33,25,MNL,74,37,24,70,49
1952-03-06,FTW,81,27,34,SYR,83,36,22,63,56
1952-03-06,ROC,77,37,23,MIH,74,15,45,52,68
1952-03-07,INO,81,32,30,SYR,76,37,22,69,52
1952-03-07,MIH,75,15,46,FTW,74,27,35,42,81
1952-03-08,MIH,103,16,46,NYK,99,35,26,51,72
1952-03-08,ROC,94,38,23,MNL,92,37,25,75,48
1952-03-08,BAL,77,19,42,BOS,100,34,25,53,67
1952-03-09,MNL,96,37,26,ROC,90,39,23,76,49
1952-03-09,PHW,92,30,30,SYR,83,37,23,67,53
1952-03-09,FTW,80,27,36,NYK,79,35,27,62,63
1952-03-09,BOS,89,35,25,BAL,72,19,43,54,68
1952-03-10,PHW,84,31,30,BOS,88,36,25,67,55
1952-03-10,BAL,91,19,44,MIH,80,17,46,36,90
1952-03-11,SYR,99,37,24,PHW,82,31,31,68,55
1952-03-11,INO,81,33,30,ROC,82,39,24,72,54
1952-03-12,MNL,85,38,26,NYK,83,35,28,73,54
1952-03-12,BOS,71,37,25,SYR,89,38,24,75,49
1952-03-13,FTW,84,28,36,ROC,86,40,24,68,60
1952-03-13,SYR,89,39,24,BOS,70,37,26,76,50
1952-03-14,INO,103,33,31,BAL,87,20,44,53,75
1952-03-14,PHW,85,31,32,MIH,82,17,47,48,79
1952-03-15,ROC,106,41,24,BOS,118,37,27,78,51
1952-03-15,NYK,97,35,29,SYR,90,40,24,75,53
1952-03-15,PHW,105,32,32,MIH,86,17,48,49,80
1952-03-16,FTW,111,28,37,INO,92,34,31,62,68
1952-03-16,BOS,96,38,27,PHW,89,33,32,71,59
1952-03-16,SYR,84,40,25,NYK,90,36,29,76,54
1952-03-16,MNL,126,39,26,BAL,82,20,45,59,71
1952-10-31,INO,68,0,0,BOS,83,1,0,1,0
1952-11-01,MNL,94,2,2,BOS,91,2,0,4,2
1952-11-01,PHW,86,0,1,SYR,84,1,0,1,1
1952-11-01,ROC,94,1,1,FTW,82,0,1,1,2
1952-11-01,MIH,73,0,0,INO,71,0,1,0,1
1952-11-01,NYK,69,1,1,BAL,53,0,0,1,1
1952-11-02,SYR,117,1,1,PHW,91,1,1,2,2
1952-11-02,FTW,69,0,2,MNL,81,3,2,3,4
1952-11-05,BAL,75,0,1,MNL,97,4,2,4,3
1952-11-06,FTW,64,0,3,ROC,84,2,1,2,4
1952-11-07,INO,63,0,2,ROC,65,3,1,3,3
1952-11-08,PHW,71,0,0,MNL,93,1,1,1,1
1952-11-08,ROC,99,4,1,INO,96,0,3,4,4
1952-11-08,BOS,106,2,1,SYR,83,2,1,4,2
1952-11-08,BAL,62,0,2,NYK,92,2,1,2,3
1952-11-09,SYR,96,2,2,MNL,89,5,2,7,4
1952-11-09,MIH,78,1,0,ROC,75,5,1,6,1
1952-11-09,FTW,74,0,4,INO,71,0,4,0,8
1952-11-11,ROC,104,5,2,NYK,94,3,1,8,3
1952-11-11,BOS,92,3,1,MNL,101,5,3,8,4
1952-11-11,INO,78,0,5,FTW,63,1,4,1,9
1952-11-12,BAL,107,0,3,MIH,90,2,0,2,3
1952-11-13,NYK,100,3,2,MNL,91,6,3,9,5
1952-11-13,SYR,96,3,2,BOS,81,3,2,6,4
1952-11-13,ROC,97,6,2,MIH,79,2,1,8,3
1952-11-14,PHW,71,1,2,INO,77,1,5,2,7
1952-11-15,BAL,97,1,3,SYR,91,4,2,5,5
1952-11-15,ROC,97,7,2,MNL,89,6,4,13,6
1952-11-15,INO,79,2,5,PHW,76,1,3,3,8
1952-11-15,MIH,71,2,2,FTW,68,1,5,3,7
1952-11-15,NYK,79,4,2,BOS,68,3,3,7,5
1952-11-16,BOS,96,0,0,ROC,87,1,0,1,0
1952-11-16,FTW,112,1,6,NYK,83,5,2,6,8
1952-11-16,PHW,81,1,4,BAL,79,2,3,3,7
1952-11-16,SYR,84,4,3,INO,78,3,5,7,8
1952-11-16,MNL,87,6,5,MIH,51,3,2,9,7
1952-11-18,INO,100,3,6,NYK,90,5,3,8,9
1952-11-18,PHW,83,2,4,MIH,82,3,3,5,7
1952-11-19,BAL,106,2,4,PHW,89,3,4,5,8
1952-11-19,BOS,91,3,4,MIH,77,3,4,6,8
1952-11-20,PHW,106,3,5,BAL,99,3,4,6,9
1952-11-20,FTW,81,2,6,MNL,89,7,5,9,11
1952-11-20,SYR,92,5,3,MIH,73,3,5,8,8
1952-11-20,NYK,72,5,4,INO,67,4,6,9,10
1952-11-22,BAL,96,3,5,PHW,95,4,5,7,10
1952-11-22,BOS,96,4,4,INO,91,4,7,8,11
1952-11-22,MNL,96,8,5,FTW,89,2,7,10,12
1952-11-22,NYK,98,6,4,SYR,68,6,3,12,7
1952-11-22,ROC,69,8,2,MIH,65,3,6,11,8
1952-11-23,ROC,100,9,2,BOS,102,5,4,14,6
1952-11-23,BAL,90,4,5,INO,100,4,8,8,13
1952-11-23,FTW,92,2,8,PHW,80,4,6,6,14
1952-11-23,SYR,76,6,4,NYK,73,7,4,13,8
1952-11-23,MIH,46,3,7,MNL,62,9,5,12,12
1952-11-25,ROC,106,9,3,BAL,89,4,6,13,9
1952-11-25,INO,66,5,8,MIH,78,3,8,8,16
1952-11-26,BOS,93,6,4,PHW,92,4,7,10,11
1952-11-26,BAL,92,4,7,NYK,94,7,5,11,12
1952-11-26,MIH,72,4,8,FTW,80,3,8,7,16
1952-11-27,NYK,104,8,5,BAL,92,4,8,12,13
1952-11-27,FTW,95,4,8,MIH,87,4,9,8,17
1952-11-27,SYR,86,7,4,ROC,79,10,3,17,7
1952-11-27,PHW,70,4,8,BOS,83,7,4,11,12
1952-11-27,MNL,90,10,5,INO,69,5,9,15,14
1952-11-28,INO,82,5,10,MNL,97,11,5,16,15
1952-11-28,MIH,78,4,10,PHW,77,4,9,8,19
1952-11-29,BAL,74,4,9,SYR,87,8,4,12,13
1952-11-29,NYK,94,9,5,INO,72,5,11,14,16
1952-11-29,BOS,78,8,4,FTW,71,5,8,13,12
1952-11-29,ROC,83,10,4,MNL,71,12,5,22,9
1952-11-30,FTW,100,5,9,BAL,95,4,10,9,19
1952-11-30,MIH,88,5,10,ROC,91,11,4,16,14
1952-11-30,SYR,78,9,4,BOS,66,9,4,18,8
1952-11-30,MNL,91,12,6,PHW,66,4,10,16,16
1952-12-01,MNL,89,13,6,BAL,67,4,11,17,17
1952-12-02,PHW,82,4,11,NYK,89,10,5,14,16
1952-12-02,INO,85,5,12,ROC,76,12,4,17,16
1952-12-03,BOS,102,9,5,MNL,106,14,6,23,11
1952-12-03,BAL,98,4,12,MIH,87,5,11,9,23
1952-12-03,NYK,100,11,5,PHW,75,4,12,15,17
1952-12-04,NYK,71,0,0,MNL,81,0,1,0,1
1952-12-04,MIH,90,5,12,BOS,73,9,6,14,18
1952-12-04,FTW,70,6,9,SYR,78,10,4,16,13
1952-12-05,INO,84,6,12,FTW,74,6,10,12,22
1952-12-06,BAL,91,5,12,FTW,103,6,11,11,23
1952-12-06,BOS,88,9,7,MIH,83,6,12,15,19
1952-12-06,ROC,82,12,5,INO,79,7,12,19,17
1952-12-06,MNL,85,15,6,NYK,78,12,5,27,11
1952-12-06,PHW,74,4,13,SYR,82,11,4,15,17
1952-12-07,ROC,94,13,5,PHW,92,4,14,17,19
1952-12-07,FTW,102,7,11,NYK,91,12,6,19,17
1952-12-07,SYR,71,12,4,MIH,67,6,13,18,17
1952-12-08,MIH,101,6,14,SYR,89,13,4,19,18
1952-12-08,INO,81,7,13,MNL,76,16,6,23,19
1952-12-09,NYK,75,12,7,ROC,77,14,5,26,12
1952-12-09,BOS,86,10,7,PHW,72,4,15,14,22
1952-12-09,INO,70,8,13,SYR,87,13,5,21,18
1952-12-10,BAL,97,5,13,ROC,99,15,5,20,18
1952-12-10,BOS,103,11,7,PHW,97,4,16,15,23
1952-12-11,BOS,94,12,7,BAL,88,5,14,17,21
1952-12-11,PHW,98,4,17,ROC,86,16,5,20,22
1952-12-11,MNL,82,16,7,SYR,79,14,5,30,12
1952-12-11,FTW,71,8,11,MIH,70,7,14,15,25
1952-12-12,INO,63,8,14,MIH,49,7,15,15,29
1952-12-13,ROC,97,16,6,NYK,99,12,8,28,14
1952-12-13,BOS,82,13,7,PHW,78,5,17,18,24
1952-12-14,SYR,102,14,6,PHW,83,5,18,19,24
1952-12-14,MNL,95,17,7,ROC,77,16,7,33,14
1952-12-14,BAL,73,5,15,BOS,83,14,7,19,22
1952-12-14,FTW,86,9,11,INO,71,9,14,18,25
1952-12-14,MIH,69,7,16,NYK,74,13,8,20,24
1952-12-16,NYK,98,14,8,SYR,93,15,6,29,14
1952-12-16,INO,71,9,15,ROC,84,16,8,25,23
1952-12-16,FTW,95,10,11,PHW,64,5,19,15,30
1952-12-18,BOS,88,15,7,SYR,83,15,7,30,14
1952-12-18,PHW,79,5,20,FTW,86,11,11,16,31
1952-12-19,INO,69,9,16,MNL,87,18,7,27,23
1952-12-20,BAL,99,5,16,NYK,102,15,8,20,24
1952-12-20,ROC,92,17,8,FTW,89,12,11,29,19
1952-12-20,BOS,91,16,7,SYR,77,15,8,31,15
1952-12-20,MIH,86,7,17,MNL,75,19,7,26,24
1952-12-21,SYR,90,15,9,BOS,86,17,7,32,16
1952-12-21,NYK,102,16,8,BAL,77,5,17,21,25
1952-12-21,FTW,74,12,12,PHW,71,5,21,17,33
1952-12-21,ROC,83,18,8,INO,65,9,17,27,25
1952-12-22,NYK,80,17,8,MIH,75,8,17,25,25
1952-12-23,INO,72,9,18,FTW,59,13,12,22,30
1952-12-25,SYR,102,16,9,BAL,92,5,18,21,27
1952-12-25,NYK,97,18,8,BOS,84,17,8,35,16
1952-12-25,PHW,78,5,22,ROC,93,19,8,24,30
1952-12-25,MNL,90,19,8,INO,73,10,18,29,26
1952-12-25,FTW,71,13,13,MIH,69,8,18,21,31
1952-12-26,INO,85,10,19,BOS,74,17,9,27,28
1952-12-27,FTW,92,14,13,NYK,91,19,8,33,21
1952-12-27,BAL,76,5,19,SYR,81,17,9,22,28
1952-12-27,ROC,94,20,8,INO,73,11,19,31,27
1952-12-27,MNL,94,20,8,BOS,71,17,10,37,18
1952-12-28,MNL,86,21,8,MIH,77,8,19,29,27
1952-12-28,SYR,84,18,9,INO,73,11,20,29,29
1952-12-28,FTW,66,15,13,BOS,89,17,11,32,24
1952-12-28,NYK,72,19,9,PHW,54,5,23,24,32
1952-12-30,ROC,106,21,8,SYR,93,19,9,40,17
1952-12-30,INO,74,11,21,MNL,69,22,8,33,29
1952-12-31,BOS,97,18,11,SYR,87,19,10,37,21
1952-12-31,FTW,91,15,14,INO,85,12,21,27,35
1952-12-31,ROC,82,22,8,MIH,74,8,20,30,28
1952-12-31,MNL,82,22,9,BAL,56,5,20,27,29
1953-01-01,SYR,92,0,0,FTW,78,0,0,0,0
1953-01-01,PHW,82,5,24,NYK,108,20,9,25,33
1953-01-01,ROC,81,23,8,BOS,83,19,11,42,19
1953-01-01,MIH,81,8,21,BAL,83,5,21,13,42
1953-01-02,INO,73,12,22,BAL,66,6,21,18,43
1953-01-02,MNL,74,23,9,MIH,66,8,22,31,31
1953-01-03,ROC,106,23,9,FTW,101,16,14,39,23
1953-01-03,BAL,81,6,22,PHW,77,5,25,11,47
1953-01-03,NYK,85,21,9,SYR,77,19,11,40,20
1953-01-03,MNL,79,24,9,MIH,75,8,23,32,32
1953-01-03,BOS,78,20,11,INO,63,13,22,33,33
1953-01-04,BOS,103,21,11,NYK,100,22,9,43,20
1953-01-04,MNL,83,25,9,ROC,80,24,9,49,18
1953-01-04,FTW,79,16,15,PHW,68,5,26,21,41
1953-01-04,SYR,93,19,12,BAL,68,7,22,26,34
1953-01-06,MIH,73,8,24,FTW,71,17,15,25,39
1953-01-06,INO,71,13,23,PHW,76,5,27,18,50
1953-01-06,ROC,85,24,10,MNL,69,26,9,50,19
1953-01-07,SYR,114,20,12,NYK,93,22,10,42,22
1953-01-07,PHW,82,6,27,BOS,84,22,11,28,38
1953-01-08,ROC,85,25,10,BOS,88,23,11,48,21
1953-01-08,NYK,81,22,11,MIH,68,9,24,31,35
1953-01-08,SYR,75,21,12,MNL,67,26,10,47,22
1953-01-09,BOS,90,24,11,BAL,94,7,23,31,34
1953-01-09,INO,54,13,24,NYK,58,23,11,36,35
1953-01-10,BAL,126,8,23,BOS,105,24,12,32,35
1953-01-10,ROC,89,25,11,MIH,81,9,25,34,36
1953-01-10,MNL,84,26,11,FTW,79,17,16,43,27
1953-01-10,SYR,87,22,12,PHW,77,6,28,28,40
1953-01-11,BOS,131,24,13,BAL,87,9,23,33,36
1953-01-11,MIH,83,9,26,ROC,79,26,11,35,37
1953-01-11,MNL,85,27,11,NYK,79,24,11,51,22
1953-01-11,SYR,76,23,12,PHW,72,6,29,29,41
1953-01-11,FTW,72,17,17,INO,68,13,25,30,42
1953-01-14,BAL,104,9,24,MNL,112,28,11,37,35
1953-01-15,FTW,91,18,17,BOS,85,25,13,43,30
1953-01-15,SYR,109,24,12,ROC,85,26,12,50,24
1953-01-15,MIH,68,10,26,INO,75,13,26,23,52
1953-01-16,MIH,90,10,27,BOS,100,25,14,35,41
1953-01-16,FTW,75,19,17,INO,68,14,26,33,43
1953-01-17,ROC,109,26,13,MNL,101,29,11,55,24
1953-01-17,NYK,84,24,12,PHW,76,6,30,30,42
1953-01-17,BAL,82,9,25,INO,66,14,27,23,52
1953-01-18,FTW,90,20,17,ROC,87,27,13,47,30
1953-01-18,SYR,103,25,12,BAL,84,10,25,35,37
1953-01-18,BOS,99,26,14,NYK,83,25,12,51,26
1953-01-18,INO,76,14,28,PHW,74,6,31,20,59
1953-01-18,MNL,70,29,12,MIH,83,10,28,39,40
1953-01-20,NYK,112,25,13,BOS,89,27,14,52,27
1953-01-20,INO,70,15,28,ROC,59,27,14,42,42
1953-01-21,BOS,94,27,15,FTW,84,21,17,48,32
1953-01-21,BAL,82,10,26,ROC,89,27,15,37,41
1953-01-21,MIH,72,11,28,NYK,70,26,13,37,41
1953-01-22,SYR,87,26,12,FTW,75,21,18,47,30
1953-01-23,INO,90,16,28,BOS,85,28,15,44,43
1953-01-23,MIH,67,12,28,MNL,65,29,13,41,41
1953-01-24,ROC,82,28,15,SYR,107,27,12,55,27
1953-01-24,NYK,82,26,14,FTW,76,21,19,47,33
1953-01-24,MIH,72,13,28,INO,64,17,28,30,56
1953-01-25,MNL,87,29,14,BOS,82,28,16,57,30
1953-01-25,BAL,82,10,27,PHW,68,6,32,16,59
1953-01-25,FTW,65,21,20,MIH,62,14,28,35,48
1953-01-25,SYR,62,28,12,NYK,97,27,14,55,26
1953-01-27,MNL,96,30,14,FTW,76,22,20,52,34
1953-01-27,ROC,72,28,16,NYK,74,28,14,56,30
1953-01-27,INO,76,17,29,SYR,72,28,13,45,42
1953-01-27,BOS,80,28,17,MIH,58,14,29,42,46
1953-01-28,BAL,83,11,27,MIH,84,14,30,25,57
1953-01-29,FTW,111,22,21,BOS,98,29,17,51,38
1953-01-29,MIH,70,15,30,BAL,67,11,28,26,58
1953-01-29,MNL,65,31,14,SYR,83,28,14,59,28
1953-01-29,PHW,61,6,33,NYK,72,29,14,35,47
1953-01-30,ROC,70,28,17,FTW,68,23,21,51,38
1953-01-30,MIH,84,16,30,SYR,68,29,14,45,44
1953-01-31,BAL,97,11,29,INO,90,18,29,29,58
1953-01-31,ROC,103,29,17,PHW,83,6,34,35,51
1953-01-31,MNL,87,31,15,FTW,80,23,22,54,37
1953-01-31,NYK,76,30,14,BOS,69,29,18,59,32
1953-02-01,BOS,86,29,19,ROC,109,30,17,59,36
1953-02-01,NYK,90,31,14,PHW,85,6,35,37,49
1953-02-01,SYR,94,29,15,BAL,79,12,29,41,44
1953-02-01,FTW,76,23,23,MNL,92,32,15,55,38
1953-02-02,ROC,80,31,17,MIH,78,17,30,48,47
1953-02-02,SYR,98,30,15,BAL,77,12,30,42,45
1953-02-03,INO,96,18,30,MNL,93,33,15,51,45
1953-02-03,ROC,109,32,17,BAL,82,12,31,44,48
1953-02-03,NYK,76,32,14,MIH,69,17,31,49,45
1953-02-04,BOS,105,29,20,SYR,92,31,15,60,35
1953-02-04,PHW,96,6,36,BAL,88,12,32,18,68
1953-02-05,SYR,83,31,16,ROC,79,33,17,64,33
1953-02-05,MNL,81,33,16,NYK,73,33,14,66,30
1953-02-05,FTW,68,23,24,INO,63,19,30,42,54
1953-02-06,INO,73,19,31,NYK,84,33,15,52,46
1953-02-07,ROC,87,0,0,MNL,72,0,0,0,0
1953-02-07,BAL,98,12,33,BOS,101,30,20,42,53
1953-02-07,NYK,86,34,15,PHW,63,7,36,41,51
1953-02-08,SYR,98,32,16,PHW,89,7,37,39,53
1953-02-08,MIH,85,17,32,ROC,82,33,18,50,50
1953-02-08,BOS,87,31,20,NYK,79,35,15,66,35
1953-02-08,FTW,89,24,24,BAL,78,12,34,36,58
1953-02-08,MNL,71,34,16,INO,67,19,32,53,48
1953-02-10,ROC,101,33,19,PHW,85,7,38,40,57
1953-02-10,INO,88,19,33,BAL,83,12,35,31,68
1953-02-11,BAL,80,12,36,NYK,86,35,16,47,52
1953-02-11,FTW,96,25,24,SYR,78,33,16,58,40
1953-02-11,INO,65,20,33,MIH,67,18,32,38,65
1953-02-12,PHW,92,7,39,BOS,91,32,20,39,59
1953-02-12,MIH,92,19,32,BAL,85,12,37,31,69
1953-02-12,MNL,91,35,16,SYR,81,33,17,68,33
1953-02-13,NYK,106,36,16,BAL,96,12,38,48,54
1953-02-13,INO,86,20,34,SYR,89,33,18,53,52
1953-02-13,BOS,77,32,21,MIH,74,20,32,52,53
1953-02-14,BAL,88,12,39,FTW,102,26,24,38,63
1953-02-14,MNL,92,36,16,PHW,84,8,39,44,55
1953-02-14,NYK,91,37,16,INO,79,20,35,57,51
1953-02-14,ROC,81,34,19,MIH,72,20,33,54,52
1953-02-15,SYR,81,34,18,NYK,85,38,16,72,34
1953-02-15,BOS,89,33,21,INO,76,20,36,53,57
1953-02-15,PHW,95,8,40,BAL,75,12,40,20,80
1953-02-15,FTW,72,27,24,ROC,84,35,19,62,43
1953-02-15,MIH,71,20,34,MNL,80,37,16,57,50
1953-02-17,ROC,78,36,19,FTW,88,27,25,63,44
1953-02-17,INO,80,20,37,PHW,77,9,40,29,77
1953-02-17,MNL,70,38,16,BAL,74,12,41,50,57
1953-02-17,NYK,86,39,16,MIH,67,20,35,59,51
1953-02-17,SYR,84,34,19,BOS,65,34,21,68,40
1953-02-18,BOS,69,34,22,NYK,66,40,16,74,38
1953-02-19,MNL,107,38,17,ROC,87,36,20,74,37
1953-02-19,FTW,83,28,25,BAL,79,13,41,41,66
1953-02-19,SYR,82,35,19,MIH,72,20,36,55,55
1953-02-20,INO,59,21,37,BAL,58,13,42,34,79
1953-02-21,BAL,86,13,43,BOS,90,35,22,48,65
1953-02-21,MNL,85,39,17,FTW,75,29,25,68,42
1953-02-21,ROC,84,36,21,SYR,73,36,19,72,40
1953-02-21,NYK,85,40,17,PHW,69,9,41,49,58
1953-02-21,MIH,61,20,37,INO,60,22,37,42,74
1953-02-22,BOS,87,36,22,NYK,83,41,17,77,39
1953-02-22,FTW,90,29,26,MNL,78,40,17,69,43
1953-02-22,SYR,86,36,20,PHW,73,9,42,45,62
1953-02-22,MIH,71,21,37,INO,64,22,38,43,75
1953-02-23,MIH,78,22,37,PHW,64,9,43,31,80
1953-02-24,NYK,79,0,1,MNL,63,2,1,2,2
1953-02-24,ROC,80,37,21,FTW,91,30,26,67,47
1953-02-24,INO,71,22,39,MIH,69,23,37,45,76
1953-02-24,SYR,74,37,20,PHW,63,9,44,46,64
1953-02-25,BOS,87,37,22,PHW,80,9,45,46,67
1953-02-25,BAL,72,13,44,MNL,85,40,18,53,62
1953-02-25,ROC,79,37,22,NYK,71,41,18,78,40
1953-02-26,BOS,82,38,22,BAL,81,13,45,51,67
1953-02-26,SYR,89,38,20,FTW,77,31,26,69,46
1953-02-26,PHW,73,9,46,MNL,85,41,18,50,64
1953-02-27,MNL,98,42,18,PHW,75,9,47,51,65
1953-02-28,ROC,92,38,22,BOS,85,39,22,77,44
1953-02-28,BAL,77,13,46,SYR,74,39,20,52,66
1953-02-28,NYK,85,41,19,FTW,74,31,27,72,46
1953-02-28,MIH,87,23,38,PHW,73,9,48,32,86
1953-03-01,MNL,102,43,18,PHW,80,9,49,52,67
1953-03-01,FTW,76,31,28,MIH,74,24,38,55,66
1953-03-01,SYR,79,39,21,NYK,64,42,19,81,40
1953-03-03,BOS,95,39,23,BAL,94,14,46,53,69
1953-03-03,NYK,109,42,20,ROC,88,39,22,81,42
1953-03-03,INO,90,23,39,PHW,73,9,50,32,89
1953-03-03,MIH,75,24,39,SYR,70,40,21,64,60
1953-03-03,MNL,86,44,18,FTW,68,32,28,76,46
1953-03-04,BAL,77,14,47,ROC,81,39,23,53,70
1953-03-04,BOS,82,40,23,PHW,75,9,51,49,74
1953-03-04,FTW,73,32,29,SYR,75,40,22,72,51
1953-03-05,SYR,94,41,22,MNL,91,45,18,86,40
1953-03-05,PHW,78,9,52,ROC,69,40,23,49,75
1953-03-05,NYK,80,43,20,BAL,69,14,48,57,68
1953-03-06,BOS,100,41,23,MNL,85,45,19,86,42
1953-03-06,NYK,75,44,20,SYR,66,42,22,86,42
1953-03-06,INO,64,24,39,FTW,73,32,30,56,69
1953-03-07,PHW,88,10,52,SYR,87,42,23,52,75
1953-03-07,ROC,84,40,24,MNL,82,45,20,85,44
1953-03-07,BAL,81,14,49,FTW,83,33,30,47,79
1953-03-08,SYR,98,42,24,BAL,91,14,50,56,74
1953-03-08,NYK,78,45,20,BOS,89,42,23,87,43
1953-03-08,MNL,100,45,21,MIH,73,25,39,70,60
1953-03-08,FTW,69,34,30,ROC,71,41,24,75,54
1953-03-09,INO,95,24,40,MNL,83,46,21,70,61
1953-03-09,FTW,94,34,31,MIH,74,25,40,59,71
1953-03-10,MIH,77,25,41,PHW,76,11,52,36,93
1953-03-10,INO,59,25,40,ROC,61,42,24,67,64
1953-03-11,NYK,113,45,21,BAL,107,14,51,59,72
1953-03-11,BOS,98,43,23,FTW,92,35,31,78,54
1953-03-11,PHW,72,11,53,MIH,69,26,41,37,94
1953-03-12,PHW,85,12,53,NYK,90,46,21,58,74
1953-03-12,MNL,89,46,22,ROC,77,43,24,89,46
1953-03-12,SYR,84,43,24,BOS,70,44,23,87,47
1953-03-13,BAL,98,14,52,PHW,72,12,54,26,106
1953-03-13,INO,52,25,41,MIH,50,26,42,51,83
1953-03-14,BAL,87,15,52,PHW,85,12,55,27,107
1953-03-14,ROC,82,43,25,INO,90,26,41,69,66
1953-03-14,NYK,81,47,21,SYR,95,44,24,91,45
1953-03-15,BOS,103,44,24,PHW,87,12,56,56,80
1953-03-15,ROC,105,43,26,BAL,87,16,52,59,78
1953-03-15,FTW,81,35,32,NYK,69,47,22,82,54
1953-03-15,SYR,84,45,24,INO,68,27,41,72,65
1953-03-16,BOS,92,45,24,BAL,78,16,53,61,77
1953-03-17,INO,71,27,42,MNL,73,47,22,74,64
1953-03-17,SYR,72,46,24,BOS,68,46,24,92,48
1953-03-17,MIH,87,26,43,FTW,61,36,32,62,75
1953-03-18,MIH,69,27,43,INO,74,27,43,54,86
1953-10-30,MIH,69,0,0,MNL,59,1,0,1,0
1953-10-31,PHW,79,0,0,SYR,73,0,1,0,1
1953-10-31,ROC,72,0,0,BAL,68,0,0,0,0
1953-10-31,NYK,91,0,0,MNL,67,1,1,1,1
1953-11-01,BOS,79,0,0,MNL,84,1,2,1,2
1953-11-01,BAL,72,0,1,ROC,80,1,0,1,1
1953-11-01,FTW,77,0,0,MIH,67,1,0,1,0
1953-11-01,SYR,85,0,2,PHW,61,1,0,1,2
1953-11-04,BAL,75,0,2,MNL,77,2,2,2,4
1953-11-04,NYK,73,1,0,MIH,67,1,1,2,1
1953-11-05,SYR,65,0,0,MNL,77,0,0,0,0
1953-11-05,FTW,83,1,0,BOS,79,0,1,1,1
1953-11-06,MIH,68,1,2,NYK,80,2,0,3,2
1953-11-07,PHW,77,1,1,BOS,79,0,2,1,3
1953-11-07,SYR,88,1,2,BAL,77,0,3,1,5
1953-11-07,ROC,91,2,0,FTW,76,2,0,4,0
1953-11-07,MNL,70,3,2,NYK,62,3,0,6,2
1953-11-08,BAL,75,0,4,PHW,85,1,2,1,6
1953-11-08,FTW,70,2,1,NYK,75,3,1,5,2
1953-11-08,SYR,85,2,2,ROC,66,3,0,5,2
1953-11-10,ROC,64,3,1,PHW,66,2,2,5,3
1953-11-10,FTW,78,2,2,MNL,62,4,2,6,4
1953-11-10,MIH,59,1,3,SYR,74,3,2,4,5
1953-11-11,BOS,72,1,2,PHW,78,3,2,4,4
1953-11-12,FTW,78,3,2,SYR,74,4,2,7,4
1953-11-12,NYK,81,4,1,PHW,65,4,2,8,3
1953-11-13,MIH,84,1,4,MNL,92,4,3,5,7
1953-11-14,ROC,98,3,2,MNL,91,5,3,8,5
1953-11-14,BAL,88,0,5,NYK,83,5,1,5,6
1953-11-14,BOS,77,1,3,SYR,66,4,3,5,6
1953-11-14,PHW,63,4,3,FTW,58,4,2,8,5
1953-11-15,NYK,91,5,2,BAL,79,1,5,6,7
1953-11-15,MNL,89,5,4,BOS,74,2,3,7,7
1953-11-15,FTW,68,4,3,ROC,65,4,2,8,5
1953-11-15,SYR,69,4,4,MIH,61,1,5,5,9
1953-11-17,ROC,92,4,3,BOS,73,2,4,6,7
1953-11-17,MNL,83,6,4,FTW,66,5,3,11,7
1953-11-18,NYK,88,6,2,PHW,83,5,3,11,5
1953-11-18,BAL,104,1,6,MIH,74,1,6,2,12
1953-11-19,NYK,96,7,2,BAL,85,2,6,9,8
1953-11-19,PHW,79,5,4,MNL,107,7,4,12,8
1953-11-19,SYR,79,5,4,FTW,76,5,4,10,8
1953-11-19,ROC,79,5,3,MIH,69,1,7,6,10
1953-11-20,MIH,63,1,8,ROC,81,6,3,7,11
1953-11-21,PHW,103,5,5,BAL,83,2,7,7,12
1953-11-21,MNL,76,8,4,ROC,70,7,3,15,7
1953-11-21,BOS,90,2,5,FTW,68,5,5,7,10
1953-11-21,NYK,68,8,2,SYR,67,6,4,14,6
1953-11-22,FTW,83,5,6,ROC,82,7,4,12,10
1953-11-22,SYR,80,6,5,NYK,84,9,2,15,7
1953-11-22,MNL,57,9,4,MIH,55,1,9,10,13
1953-11-24,NYK,103,10,2,BOS,92,3,5,13,7
1953-11-24,PHW,83,6,5,BAL,80,2,8,8,13
1953-11-24,ROC,80,7,5,SYR,89,6,6,13,11
1953-11-25,BOS,96,3,6,NYK,84,11,2,14,8
1953-11-25,MIH,64,1,10,FTW,58,6,6,7,16
1953-11-25,BAL,66,2,9,SYR,58,7,6,9,15
1953-11-26,SYR,93,7,7,BOS,86,4,6,11,13
1953-11-26,MNL,88,10,4,PHW,80,7,5,17,9
1953-11-26,BAL,75,3,9,ROC,80,7,6,10,15
1953-11-26,FTW,78,6,7,MIH,64,2,10,8,17
1953-11-27,MIH,55,2,11,PHW,51,7,6,9,17
1953-11-28,NYK,95,11,3,ROC,90,8,6,19,9
1953-11-28,BAL,81,3,10,FTW,92,7,7,10,17
1953-11-28,SYR,80,8,7,BOS,91,4,7,12,14
1953-11-28,MIH,71,3,11,PHW,68,7,7,10,18
1953-11-29,MNL,95,11,4,BOS,82,5,7,16,11
1953-11-29,SYR,101,8,8,BAL,82,3,11,11,19
1953-11-29,FTW,83,8,7,PHW,69,7,8,15,15
1953-11-29,ROC,64,8,7,NYK,69,12,3,20,10
1953-12-01,BOS,89,5,8,PHW,86,7,9,12,17
1953-12-01,MIH,69,4,11,SYR,76,9,8,13,19
1953-12-01,ROC,92,8,8,FTW,69,9,7,17,15
1953-12-03,PHW,79,7,10,NYK,74,13,3,20,13
1953-12-03,MNL,87,12,4,SYR,74,10,8,22,12
1953-12-03,FTW,76,9,8,BOS,70,6,8,15,16
1953-12-05,MNL,90,13,4,SYR,80,10,9,23,13
1953-12-05,BOS,97,6,9,MIH,79,4,12,10,21
1953-12-05,NYK,73,13,4,FTW,92,10,8,23,12
1953-12-05,ROC,72,9,8,BAL,65,3,12,12,20
1953-12-06,BAL,95,3,13,BOS,102,7,9,10,22
1953-12-06,FTW,78,11,8,SYR,77,10,10,21,18
1953-12-08,ROC,97,10,8,BOS,79,8,9,18,17
1953-12-09,PHW,104,8,10,BOS,103,8,10,16,20
1953-12-09,BAL,92,3,14,SYR,77,10,11,13,25
1953-12-09,FTW,83,12,8,MIH,59,4,13,16,21
1953-12-10,NYK,108,13,5,BOS,113,8,11,21,16
1953-12-10,PHW,83,9,10,BAL,77,4,14,13,24
1953-12-10,SYR,96,10,12,MIH,76,4,14,14,26
1953-12-11,MIH,82,4,15,NYK,70,13,6,17,21
1953-12-12,ROC,90,11,8,SYR,85,11,12,22,20
1953-12-12,BOS,106,9,11,BAL,75,4,15,13,26
1953-12-12,MNL,71,14,4,NYK,67,13,7,27,11
1953-12-13,SYR,108,11,13,BOS,74,10,11,21,24
1953-12-13,BAL,70,4,16,MIH,73,5,15,9,31
1953-12-13,ROC,87,12,8,MNL,70,15,4,27,12
1953-12-13,FTW,68,13,8,NYK,69,13,8,26,16
1953-12-15,NYK,80,14,8,MNL,79,15,5,29,13
1953-12-15,BOS,82,10,12,FTW,75,13,9,23,21
1953-12-15,ROC,76,13,8,MIH,64,6,15,19,23
1953-12-16,BOS,91,11,12,FTW,74,13,10,24,22
1953-12-16,MNL,69,15,6,MIH,63,6,16,21,22
1953-12-17,ROC,91,14,8,PHW,79,10,10,24,18
1953-12-17,BAL,75,4,17,MNL,64,16,6,20,23
1953-12-19,BOS,83,12,12,SYR,90,12,13,24,25
1953-12-19,ROC,78,15,8,MNL,91,16,7,31,15
1953-12-19,BAL,63,5,17,NYK,65,15,8,20,25
1953-12-19,MIH,63,6,17,FTW,69,13,11,19,28
1953-12-20,BOS,101,12,13,PHW,89,10,11,22,24
1953-12-20,SYR,81,13,13,MNL,76,17,7,30,20
1953-12-20,NYK,75,16,8,BAL,67,5,18,21,26
1953-12-21,BOS,90,13,13,MIH,74,6,18,19,31
1953-12-23,BOS,80,14,13,MIH,74,6,19,20,32
1953-12-23,BAL,72,5,19,SYR,76,14,13,19,32
1953-12-25,NYK,89,17,8,SYR,80,15,13,32,21
1953-12-25,FTW,108,14,11,BOS,79,15,13,29,24
1953-12-25,MNL,78,17,8,BAL,88,5,20,22,28
1953-12-25,PHW,65,10,12,ROC,73,15,9,25,21
1953-12-26,ROC,77,16,9,NYK,78,18,8,34,17
1953-12-26,MNL,77,17,9,FTW,71,15,11,32,20
1953-12-26,MIH,74,6,20,BOS,67,15,14,21,34
1953-12-27,NYK,79,19,8,PHW,76,10,13,29,21
1953-12-27,FTW,75,15,12,MNL,79,18,9,33,21
1953-12-27,SYR,96,15,14,MIH,75,7,20,22,34
1953-12-27,BOS,98,15,15,ROC,72,16,10,31,25
1953-12-28,PHW,69,10,14,MIH,63,7,21,17,35
1953-12-29,ROC,96,16,11,BAL,77,6,20,22,31
1953-12-30,SYR,96,16,14,BOS,89,16,15,32,29
1953-12-30,MNL,80,19,9,FTW,97,15,13,34,22
1953-12-30,BAL,86,6,21,NYK,79,20,8,26,29
1953-12-31,SYR,86,17,14,ROC,81,17,11,34,25
1953-12-31,NYK,74,20,9,BOS,95,16,16,36,25
1953-12-31,FTW,83,16,13,PHW,56,11,14,27,27
1954-01-01,BOS,95,17,16,SYR,92,18,14,35,30
1954-01-01,ROC,79,17,12,PHW,76,11,15,28,27
1954-01-01,MIH,62,7,22,BAL,52,7,21,14,43
1954-01-02,BAL,77,7,22,BOS,92,18,16,25,38
1954-01-02,ROC,77,18,12,FTW,76,17,13,35,25
1954-01-02,MNL,78,19,10,NYK,74,20,10,39,20
1954-01-02,PHW,66,11,16,SYR,74,18,15,29,31
1954-01-03,SYR,77,19,15,PHW,90,11,17,30,32
1954-01-03,FTW,72,17,14,NYK,74,20,11,37,25
1954-01-03,BOS,90,19,16,BAL,72,7,23,26,39
1954-01-04,ROC,85,19,12,MNL,84,20,10,39,22
1954-01-04,BOS,77,20,16,BAL,73,7,24,27,40
1954-01-05,PHW,99,12,17,MIH,88,8,22,20,39
1954-01-05,FTW,60,17,15,SYR,72,19,16,36,31
1954-01-06,BAL,78,7,25,FTW,90,17,16,24,41
1954-01-06,PHW,77,13,17,MIH,72,8,23,21,40
1954-01-07,PHW,88,14,17,MIH,73,8,24,22,41
1954-01-07,MNL,89,20,11,ROC,71,20,12,40,23
1954-01-07,NYK,82,21,11,BAL,70,7,26,28,37
1954-01-07,SYR,79,20,16,FTW,67,18,16,38,32
1954-01-09,BAL,95,7,27,PHW,90,15,17,22,44
1954-01-09,ROC,87,20,13,NYK,88,22,11,42,24
1954-01-09,MIH,67,8,25,MNL,78,21,11,29,36
1954-01-10,MNL,99,22,11,BOS,85,21,16,43,27
1954-01-10,SYR,77,21,16,BAL,73,8,27,29,43
1954-01-10,FTW,81,18,17,MIH,73,8,26,26,43
1954-01-10,NYK,81,23,11,ROC,69,20,14,43,25
1954-01-12,ROC,78,20,15,MIH,73,8,27,28,42
1954-01-12,FTW,97,19,17,BAL,66,8,28,27,45
1954-01-13,BOS,88,21,17,MNL,84,23,11,44,28
1954-01-13,SYR,93,22,16,NYK,72,24,11,46,27
1954-01-14,FTW,81,20,17,BAL,74,8,29,28,46
1954-01-14,BOS,86,22,17,MIH,74,8,28,30,45
1954-01-14,PHW,71,15,18,NYK,83,24,12,39,30
1954-01-14,SYR,96,23,16,MNL,71,23,12,46,28
1954-01-16,ROC,93,21,15,SYR,95,24,16,45,31
1954-01-16,NYK,88,25,12,FTW,82,21,17,46,29
1954-01-16,BAL,82,8,30,PHW,72,15,19,23,49
1954-01-16,MNL,58,23,13,MIH,64,8,29,31,42
1954-01-17,BOS,84,23,17,NYK,87,26,12,49,29
1954-01-17,FTW,86,21,18,MNL,83,23,14,44,32
1954-01-17,SYR,84,25,16,ROC,81,21,16,46,32
1954-01-17,BAL,78,9,30,PHW,74,15,20,24,50
1954-01-18,MNL,91,23,15,MIH,72,9,29,32,44
1954-01-19,MIH,75,9,30,NYK,78,27,12,36,42
1954-01-19,PHW,89,15,21,BOS,73,23,18,38,39
1954-01-19,ROC,73,21,17,FTW,67,22,18,43,35
1954-01-22,NYK,84,28,12,PHW,82,16,21,44,33
1954-01-23,BAL,98,10,30,SYR,91,26,16,36,46
1954-01-23,MNL,75,24,15,FTW,72,22,19,46,34
1954-01-23,NYK,75,29,12,MIH,63,9,31,38,43
1954-01-23,ROC,71,22,17,PHW,61,16,22,38,39
1954-01-24,BOS,85,23,19,ROC,93,23,17,46,36
1954-01-24,SYR,78,26,17,PHW,80,16,23,42,40
1954-01-24,FTW,79,22,20,BAL,70,11,30,33,50
1954-01-24,MIH,68,9,32,NYK,66,30,12,39,44
1954-01-26,SYR,79,26,18,PHW,75,17,23,43,41
1954-01-26,NYK,74,30,13,ROC,71,24,17,54,30
1954-01-26,MIH,69,10,32,MNL,84,25,15,35,47
1954-01-26,BOS,94,23,20,BAL,69,11,31,34,51
1954-01-27,MNL,76,26,15,BAL,73,11,32,37,47
1954-01-27,FTW,77,23,20,MIH,68,10,33,33,53
1954-01-28,MNL,104,27,15,BAL,82,11,33,38,48
1954-01-28,PHW,79,17,24,ROC,82,24,18,41,42
1954-01-28,FTW,80,24,20,BOS,68,24,20,48,40
1954-01-28,SYR,79,27,18,NYK,66,31,13,58,31
1954-01-29,MIH,82,10,34,BOS,70,24,21,34,55
1954-01-30,BAL,80,11,34,PHW,74,17,25,28,59
1954-01-30,ROC,95,25,18,FTW,70,25,20,50,38
1954-01-30,NYK,66,31,14,SYR,65,28,18,59,32
1954-01-30,MNL,80,28,15,MIH,64,11,34,39,49
1954-01-31,SYR,114,28,19,NYK,70,32,14,60,33
1954-01-31,FTW,83,25,21,ROC,69,26,18,51,39
1954-01-31,MNL,82,29,15,BOS,67,24,22,53,37
1954-02-02,ROC,78,26,19,MNL,87,30,15,56,34
1954-02-03,BOS,88,24,23,ROC,81,26,20,50,43
1954-02-03,PHW,82,17,26,SYR,79,29,19,46,45
1954-02-03,MNL,91,31,15,NYK,79,32,15,63,30
1954-02-03,MIH,78,11,35,BAL,72,12,34,23,69
1954-02-04,SYR,90,29,20,NYK,82,32,16,61,36
1954-02-04,PHW,80,18,26,BOS,78,25,23,43,49
1954-02-04,BAL,70,12,35,MNL,82,32,15,44,50
1954-02-05,ROC,89,26,21,FTW,70,26,21,52,42
1954-02-05,MIH,69,12,35,PHW,66,19,26,31,61
1954-02-06,MNL,97,33,15,PHW,94,19,27,52,42
1954-02-06,SYR,93,30,20,FTW,87,26,22,56,42
1954-02-06,NYK,98,32,17,BAL,83,12,36,44,53
1954-02-06,ROC,81,27,21,BOS,104,25,24,52,45
1954-02-07,FTW,90,26,23,MNL,83,34,15,60,38
1954-02-07,BOS,78,26,24,NYK,87,33,17,59,41
1954-02-07,BAL,75,12,37,ROC,73,27,22,39,59
1954-02-07,SYR,88,31,20,MIH,73,13,35,44,55
1954-02-08,MNL,106,34,16,PHW,91,19,28,53,44
1954-02-08,BOS,87,26,25,BAL,75,13,37,39,62
1954-02-09,ROC,81,27,23,MIH,70,13,36,40,59
1954-02-09,MNL,70,35,16,PHW,67,19,29,54,45
1954-02-10,BOS,94,27,25,SYR,79,32,20,59,45
1954-02-10,PHW,97,19,30,BAL,79,13,38,32,68
1954-02-10,NYK,73,34,17,FTW,69,27,23,61,40
1954-02-10,MIH,61,13,37,ROC,62,28,23,41,60
1954-02-11,MNL,110,36,16,BAL,82,13,39,49,55
1954-02-11,BOS,84,28,25,NYK,81,35,17,63,42
1954-02-11,PHW,76,20,30,SYR,74,32,21,52,51
1954-02-11,ROC,79,29,23,MIH,68,13,38,42,61
1954-02-12,PHW,75,21,30,BAL,72,13,40,34,70
1954-02-12,MIH,71,13,39,MNL,62,37,16,50,55
1954-02-13,BAL,96,13,41,BOS,93,29,25,42,66
1954-02-13,ROC,81,30,23,SYR,78,32,22,62,45
1954-02-13,MNL,86,37,17,PHW,77,22,30,59,47
1954-02-13,NYK,73,35,18,FTW,79,27,24,62,42
1954-02-14,SYR,111,32,23,BAL,91,14,41,46,64
1954-02-14,BOS,103,29,26,NYK,89,35,19,64,45
1954-02-14,MNL,105,38,17,ROC,77,31,23,69,40
1954-02-14,FTW,94,28,24,PHW,76,22,31,50,55
1954-02-16,NYK,87,35,20,BOS,85,30,26,65,46
1954-02-16,MNL,85,39,17,ROC,79,31,24,70,41
1954-02-16,SYR,77,33,23,PHW,95,22,32,55,55
1954-02-16,MIH,65,14,39,FTW,69,29,24,43,63
1954-02-17,BAL,84,14,42,NYK,80,36,20,50,62
1954-02-18,MNL,92,40,17,BOS,105,30,27,70,44
1954-02-18,SYR,91,33,24,FTW,77,30,24,63,48
1954-02-18,PHW,60,23,32,NYK,69,36,21,59,53
1954-02-19,MIH,73,14,40,BOS,78,31,27,45,67
1954-02-20,BAL,85,15,42,FTW,87,30,25,45,67
1954-02-20,NYK,75,37,21,PHW,89,23,33,60,54
1954-02-20,MNL,83,40,18,SYR,68,34,24,74,42
1954-02-20,ROC,66,31,25,MIH,64,14,41,45,66
1954-02-21,BOS,95,32,27,PHW,85,24,33,56,60
1954-02-21,NYK,85,37,22,BAL,76,15,43,52,65
1954-02-21,SYR,100,34,25,MNL,73,41,18,75,43
1954-02-21,FTW,62,31,25,MIH,64,14,42,45,67
1954-02-22,BOS,111,33,27,BAL,110,15,44,48,71
1954-02-22,FTW,95,31,26,MIH,82,15,42,46,68
1954-02-22,PHW,79,24,34,MNL,72,41,19,65,53
1954-02-23,NYK,82,38,22,MNL,100,41,20,79,42
1954-02-23,ROC,93,32,25,BOS,77,34,27,66,52
1954-02-23,MIH,70,15,43,SYR,68,35,25,50,68
1954-02-24,BAL,64,15,45,ROC,79,33,25,48,70
1954-02-25,SYR,96,35,26,BOS,101,34,28,69,54
1954-02-25,ROC,102,34,25,BAL,86,15,46,49,71
1954-02-25,PHW,81,25,34,MNL,72,42,20,67,54
1954-02-25,FTW,82,32,26,NYK,62,38,23,70,49
1954-02-26,MIH,62,16,43,SYR,68,35,27,51,70
1954-02-27,BAL,85,15,47,MNL,95,42,21,57,68
1954-02-27,ROC,74,35,25,BOS,75,35,28,70,53
1954-02-27,PHW,72,26,34,FTW,79,33,26,59,60
1954-02-27,NYK,57,38,24,MIH,58,16,44,54,68
1954-02-28,SYR,85,36,27,ROC,91,35,26,71,53
1954-02-28,PHW,83,26,35,NYK,78,38,25,64,60
1954-02-28,FTW,94,34,26,MNL,77,43,21,77,47
1954-02-28,BOS,93,36,28,MIH,74,17,44,53,72
1954-03-01,MIH,71,17,45,FTW,72,35,26,52,71
1954-03-01,NYK,86,38,26,BOS,71,37,28,75,54
1954-03-02,MNL,91,43,22,SYR,87,36,28,79,50
1954-03-02,PHW,78,27,35,MIH,73,17,46,44,81
1954-03-02,ROC,71,36,26,FTW,64,36,26,72,52
1954-03-03,BAL,100,15,48,MIH,103,17,47,32,95
1954-03-03,NYK,88,39,26,PHW,79,28,35,67,61
1954-03-04,BAL,95,15,49,MIH,87,18,47,33,96
1954-03-04,PHW,78,28,36,ROC,85,37,26,65,62
1954-03-04,FTW,63,36,27,SYR,86,36,29,72,56
1954-03-05,BOS,128,37,29,MNL,106,44,22,81,51
1954-03-05,FTW,76,36,28,PHW,70,28,37,64,65
1954-03-05,NYK,70,40,26,ROC,66,38,26,78,52
1954-03-06,SYR,88,37,29,PHW,77,28,38,65,67
1954-03-06,BAL,71,16,49,FTW,76,37,28,53,77
1954-03-06,ROC,74,38,27,MNL,59,44,23,82,50
1954-03-07,NYK,88,41,26,ROC,91,39,27,80,53
1954-03-07,BOS,86,38,29,FTW,80,38,28,76,57
1954-03-07,SYR,103,38,29,BAL,77,16,50,54,79
1954-03-07,MNL,65,44,24,MIH,63,18,48,62,72
1954-03-08,MIH,65,18,49,BAL,54,16,51,34,100
1954-03-09,PHW,75,28,39,FTW,73,38,29,66,68
1954-03-09,NYK,72,41,27,MIH,65,19,49,60,76
1954-03-09,ROC,70,40,27,MNL,61,45,24,85,51
1954-03-10,BAL,77,16,52,SYR,85,39,29,55,81
1954-03-10,MNL,76,45,25,NYK,85,42,27,87,52
1954-03-10,FTW,88,38,30,PHW,70,29,39,67,69
1954-03-10,ROC,84,41,27,MIH,69,19,50,60,77
1954-03-11,SYR,97,40,29,BOS,95,39,29,79,58
1954-03-11,FTW,80,39,30,ROC,95,42,27,81,57
1954-03-12,BOS,97,39,30,PHW,95,29,40,68,70
1954-03-13,BOS,97,40,30,BAL,85,16,53,56,83
1954-03-13,ROC,77,43,27,PHW,76,29,41,72,68
1954-03-13,MNL,93,45,26,FTW,66,39,31,84,57
1954-03-13,NYK,67,43,27,SYR,60,41,29,84,56
1954-03-14,BOS,97,41,30,PHW,92,29,42,70,72
1954-03-14,FTW,91,39,32,BAL,86,16,54,55,86
1954-03-14,SYR,113,41,30,NYK,83,44,27,85,57
1954-03-14,MIH,91,19,51,ROC,53,44,27,63,78
1954-10-30,ROC,98,0,0,BOS,95,0,0,0,0
1954-10-30,NYK,94,0,0,MNL,83,0,0,0,0
1954-10-30,MIH,72,0,0,FTW,91,0,0,0,0
1954-10-30,SYR,,43,29,BAL,,1,1,44,30
1954-10-31,SYR,94,0,0,MNL,97,0,1,0,1
1954-10-31,FTW,90,1,0,BOS,86,0,1,1,1
1954-10-31,PHW,,33,39,BAL,,2,2,35,41
1954-11-02,MIH,84,0,1,NYK,91,1,0,1,1
1954-11-03,BAL,,3,3,MNL,,40,32,43,35
1954-11-06,BOS,107,0,2,SYR,84,0,1,0,3
1954-11-06,FTW,90,2,0,NYK,83,2,0,4,0
1954-11-06,MNL,79,1,1,MIH,67,0,2,1,3
1954-11-06,ROC,,29,43,BAL,,3,3,32,46
1954-11-07,MNL,93,2,1,NYK,103,2,1,4,2
1954-11-07,FTW,109,3,0,ROC,84,1,0,4,0
1954-11-07,SYR,97,0,2,MIH,80,0,3,0,5
1954-11-07,BOS,,36,36,BAL,,4,4,40,40
1954-11-10,ROC,90,1,1,MIH,86,0,4,1,5
1954-11-11,FTW,86,4,0,SYR,88,1,2,5,2
1954-11-11,MIH,95,0,5,BOS,85,1,2,1,7
1954-11-11,NYK,79,3,1,ROC,78,2,1,5,2
1954-11-11,MNL,,41,33,BAL,,5,5,46,38
1954-11-12,MNL,,41,33,BAL,,6,6,47,39
1954-11-13,ROC,98,2,2,FTW,103,4,1,6,3
1954-11-13,PHW,87,0,0,NYK,86,4,1,4,1
1954-11-13,MIH,85,1,5,SYR,72,2,2,3,7
1954-11-13,BOS,,36,36,BAL,,7,7,43,43
1954-11-14,MNL,99,2,2,SYR,92,2,3,4,5
1954-11-14,FTW,93,5,1,MIH,91,2,5,7,6
1954-11-14,NYK,,38,34,BAL,,8,8,46,42
1954-11-16,BOS,99,1,3,ROC,98,2,3,3,6
1954-11-16,SYR,86,2,4,PHW,85,1,0,3,4
1954-11-16,BAL,,9,9,NYK,,38,34,47,43
1954-11-18,NYK,96,4,2,PHW,94,1,1,5,3
1954-11-18,SYR,91,3,4,FTW,82,6,1,9,5
1954-11-19,FTW,,43,29,BAL,,9,9,52,38
1954-11-20,NYK,98,5,2,BOS,117,2,3,7,5
1954-11-20,PHW,99,1,2,FTW,82,6,2,7,4
1954-11-20,ROC,79,2,4,SYR,80,4,4,6,8
1954-11-20,BAL,,10,10,MIH,,26,46,36,56
1954-11-21,SYR,110,5,4,BOS,104,3,3,8,7
1954-11-21,FTW,89,6,3,ROC,78,2,5,8,8
1954-11-21,MNL,,41,33,BAL,,10,10,51,43
1954-11-24,BOS,108,3,4,NYK,103,5,3,8,7
1954-11-24,MIH,87,2,6,ROC,90,2,6,4,12
1954-11-24,PHW,91,2,2,FTW,87,7,3,9,5
1954-11-25,PHW,103,3,2,BOS,98,4,4,7,6
1954-11-25,SYR,91,6,4,MIH,85,2,7,8,11
1954-11-25,MNL,95,3,2,ROC,84,3,6,6,8
1954-11-25,FTW,,43,29,BAL,,0,0,43,29
1954-11-27,ROC,107,3,7,BOS,101,4,5,7,12
1954-11-27,FTW,97,7,4,MNL,81,4,2,11,6
1954-11-27,NYK,74,5,4,SYR,80,7,4,12,8
1954-11-28,MNL,115,4,3,BOS,108,4,6,8,9
1954-11-28,FTW,96,8,4,MIH,81,2,8,10,12
1954-11-28,SYR,79,8,4,NYK,77,5,5,13,9
1954-11-30,MIH,99,2,9,BOS,118,4,7,6,16
1954-11-30,NYK,95,5,6,PHW,91,4,2,9,8
1954-11-30,FTW,92,9,4,MNL,90,5,3,14,7
1954-12-01,ROC,96,4,7,FTW,101,10,4,14,11
1954-12-01,BOS,101,5,7,MIH,90,2,10,7,17
1954-12-01,PHW,88,4,3,MNL,91,5,4,9,7
1954-12-01,NYK,88,6,6,SYR,86,9,4,15,10
1954-12-02,MIH,117,2,11,MNL,108,6,4,8,15
1954-12-02,FTW,116,11,4,BOS,98,6,7,17,11
1954-12-02,SYR,82,9,5,ROC,78,4,8,13,13
1954-12-03,PHW,110,4,4,MIH,91,3,11,7,15
1954-12-04,BOS,110,6,8,ROC,102,4,9,10,17
1954-12-04,NYK,88,7,6,FTW,90,12,4,19,10
1954-12-04,MIH,95,3,12,MNL,88,6,5,9,17
1954-12-04,PHW,79,5,4,SYR,73,10,5,15,9
1954-12-05,MNL,104,6,6,MIH,102,4,12,10,18
1954-12-05,FTW,96,13,4,ROC,97,4,10,17,14
1954-12-05,SYR,89,10,6,PHW,72,6,4,16,10
1954-12-07,ROC,93,5,10,BOS,95,7,8,12,18
1954-12-07,NYK,97,7,7,MNL,89,7,6,14,13
1954-12-07,FTW,101,13,5,MIH,85,4,13,17,18
1954-12-07,SYR,88,11,6,PHW,81,6,5,17,11
1954-12-08,BOS,99,8,8,MNL,101,7,7,15,15
1954-12-08,ROC,105,5,11,SYR,78,12,6,17,17
1954-12-08,PHW,86,6,6,NYK,77,8,7,14,13
1954-12-08,FTW,92,14,5,MIH,68,4,14,18,19
1954-12-09,SYR,120,12,7,BOS,107,8,9,20,16
1954-12-09,PHW,96,7,6,NYK,98,8,8,15,14
1954-12-11,BOS,94,8,10,SYR,90,13,7,21,17
1954-12-11,MIH,87,4,15,NYK,97,9,8,13,23
1954-12-11,ROC,83,6,11,MNL,91,8,7,14,18
1954-12-12,FTW,100,15,5,BOS,99,9,10,24,15
1954-12-12,SYR,87,13,8,PHW,96,7,7,20,15
1954-12-12,ROC,74,6,12,MIH,86,4,16,10,28
1954-12-12,MNL,80,9,7,NYK,73,10,8,19,15
1954-12-14,BOS,115,9,11,MNL,108,10,7,19,18
1954-12-14,NYK,82,10,9,SYR,91,13,9,23,18
1954-12-15,ROC,99,6,13,MNL,97,10,8,16,21
1954-12-15,PHW,99,8,7,FTW,90,16,5,24,12
1954-12-15,NYK,88,10,10,SYR,81,14,9,24,19
1954-12-17,BOS,117,10,11,MIH,106,5,16,15,27
1954-12-18,BOS,107,11,11,PHW,103,9,7,20,18
1954-12-18,ROC,86,7,13,FTW,87,16,6,23,19
1954-12-18,MIH,85,5,17,NYK,91,11,10,16,27
1954-12-18,MNL,86,10,9,SYR,83,14,10,24,19
1954-12-19,SYR,108,14,11,MNL,93,11,9,25,20
1954-12-19,FTW,87,17,6,MIH,82,5,18,22,24
1954-12-19,NYK,93,12,10,BOS,81,12,11,24,21
1954-12-19,ROC,92,7,14,PHW,79,9,8,16,22
1954-12-23,PHW,82,9,9,FTW,92,18,6,27,15
1954-12-25,NYK,109,13,10,SYR,101,15,11,28,21
1954-12-25,MIH,99,5,19,BOS,108,12,12,17,31
1954-12-25,MNL,99,11,10,PHW,91,9,10,20,20
1954-12-25,ROC,80,8,14,FTW,73,19,6,27,20
1954-12-26,FTW,109,19,7,PHW,96,9,11,28,18
1954-12-26,SYR,97,15,12,NYK,92,14,10,29,22
1954-12-26,MNL,87,12,10,BOS,82,13,12,25,22
1954-12-28,SYR,84,16,12,ROC,82,9,14,25,26
1954-12-28,NYK,78,14,11,PHW,84,9,12,23,23
1954-12-29,BOS,118,13,13,MNL,129,13,10,26,23
1954-12-29,ROC,93,9,15,NYK,89,14,12,23,27
1954-12-29,PHW,72,10,12,SYR,70,17,12,27,24
1954-12-30,FTW,93,20,7,MNL,76,14,10,34,17
1954-12-31,BOS,119,13,14,PHW,113,11,12,24,26
1954-12-31,FTW,91,21,7,MNL,103,14,11,35,18
1954-12-31,MIH,89,5,20,NYK,64,14,13,19,33
1955-01-01,SYR,108,17,13,BOS,102,14,14,31,27
1955-01-01,ROC,96,10,15,PHW,92,11,13,21,28
1955-01-01,NYK,100,14,14,MIH,91,6,20,20,34
1955-01-02,MNL,100,15,11,ROC,102,11,15,26,26
1955-01-02,BOS,113,14,15,NYK,96,15,14,29,29
1955-01-02,SYR,79,18,13,MIH,91,6,21,24,34
1955-01-02,FTW,89,21,8,PHW,66,11,14,32,22
1955-01-03,MNL,76,15,12,PHW,74,11,15,26,27
1955-01-04,FTW,93,22,8,MNL,92,16,12,38,20
1955-01-04,MIH,92,7,21,ROC,80,12,15,19,36
1955-01-05,MIH,97,8,21,FTW,92,23,8,31,29
1955-01-05,ROC,103,12,16,NYK,85,15,15,27,31
1955-01-05,PHW,106,11,16,MNL,85,16,13,27,29
1955-01-06,SYR,106,18,14,MNL,117,16,14,34,28
1955-01-06,NYK,88,15,16,BOS,83,15,15,30,31
1955-01-06,ROC,83,13,16,FTW,90,23,9,36,25
1955-01-06,PHW,92,12,16,MIH,79,9,21,21,37
1955-01-07,MIH,85,9,22,NYK,75,16,16,25,38
1955-01-08,BOS,117,15,16,PHW,105,13,16,28,32
1955-01-08,MNL,97,17,14,SYR,100,18,15,35,29
1955-01-08,ROC,91,13,17,MIH,88,10,22,23,39
1955-01-09,BOS,98,16,16,ROC,92,14,17,30,33
1955-01-09,FTW,89,24,9,MNL,86,17,15,41,24
1955-01-09,NYK,86,16,17,PHW,84,13,17,29,34
1955-01-09,MIH,77,10,23,SYR,72,19,15,29,38
1955-01-11,FTW,110,25,9,BOS,119,17,16,42,25
1955-01-11,MIH,93,11,23,ROC,90,14,18,25,41
1955-01-11,MNL,93,17,16,SYR,82,19,16,36,32
1955-01-12,ROC,88,14,19,MNL,102,18,16,32,35
1955-01-13,BOS,116,18,16,NYK,100,17,17,35,33
1955-01-13,PHW,102,13,18,MNL,96,19,16,32,34
1955-01-13,SYR,100,19,17,FTW,83,25,10,44,27
1955-01-14,BOS,100,19,16,MNL,95,19,17,38,33
1955-01-14,MIH,86,12,23,PHW,84,14,18,26,41
1955-01-14,NYK,97,17,18,FTW,83,25,11,42,29
1955-01-15,ROC,93,14,20,MNL,90,19,18,33,38
1955-01-15,MIH,88,13,23,PHW,93,14,19,27,42
1955-01-15,NYK,106,18,18,FTW,87,25,12,43,30
1955-01-16,BOS,102,20,16,NYK,98,19,18,39,34
1955-01-16,MNL,106,19,19,PHW,98,15,19,34,38
1955-01-16,SYR,90,20,17,ROC,85,15,20,35,37
1955-01-16,FTW,89,25,13,MIH,78,13,24,38,37
1955-01-19,PHW,97,15,20,SYR,98,21,17,36,37
1955-01-19,FTW,105,26,13,BOS,84,21,16,47,29
1955-01-19,NYK,98,19,19,ROC,83,15,21,34,40
1955-01-19,MNL,95,20,19,MIH,81,13,25,33,44
1955-01-20,MNL,97,21,19,MIH,90,13,26,34,45
1955-01-20,SYR,92,22,17,BOS,87,21,17,43,34
1955-01-21,MNL,100,22,19,MIH,92,13,27,35,46
1955-01-21,BOS,90,21,18,PHW,89,15,21,36,39
1955-01-22,ROC,121,15,22,BOS,110,22,18,37,40
1955-01-22,NYK,99,20,19,PHW,102,15,22,35,41
1955-01-22,MIH,83,13,28,FTW,85,27,13,40,41
1955-01-23,BOS,94,22,19,PHW,91,16,22,38,41
1955-01-23,SYR,89,23,17,NYK,98,20,20,43,37
1955-01-23,FTW,105,28,13,ROC,84,16,22,44,35
1955-01-23,MNL,82,23,19,MIH,79,13,29,36,48
1955-01-24,ROC,97,16,23,MIH,86,13,30,29,53
1955-01-25,ROC,107,17,23,NYK,104,21,20,38,43
1955-01-25,SYR,66,23,18,FTW,69,29,13,52,31
1955-01-26,SYR,107,23,19,PHW,99,16,23,39,42
1955-01-26,ROC,96,18,23,NYK,94,21,21,39,44
1955-01-26,BOS,99,23,19,FTW,90,30,13,53,32
1955-01-27,ROC,98,19,23,BOS,92,24,19,43,42
1955-01-27,PHW,92,16,24,NYK,83,21,22,37,46
1955-01-27,MIH,85,13,31,MNL,79,24,19,37,50
1955-01-27,SYR,94,24,19,FTW,79,30,14,54,33
1955-01-28,BOS,101,24,20,SYR,90,25,19,49,39
1955-01-29,NYK,95,21,23,MIH,93,14,31,35,54
1955-01-29,MNL,100,24,20,FTW,91,30,15,54,35
1955-01-29,ROC,87,20,23,PHW,85,17,24,37,47
1955-01-30,FTW,99,30,16,MNL,92,25,20,55,36
1955-01-30,SYR,83,25,20,PHW,93,17,25,42,45
1955-01-30,BOS,79,25,20,MIH,88,14,32,39,52
1955-01-31,NYK,91,22,23,FTW,84,31,16,53,39
1955-01-31,MIH,100,15,32,ROC,80,21,23,36,55
1955-02-02,PHW,122,18,25,BOS,107,25,21,43,46
1955-02-02,MNL,96,25,21,NYK,81,23,23,48,44
1955-02-02,ROC,84,21,24,FTW,74,31,17,52,41
1955-02-03,ROC,88,22,24,MIH,87,16,32,38,56
1955-02-03,FTW,104,31,18,SYR,85,25,21,56,39
1955-02-03,MNL,90,26,21,NYK,83,23,24,49,45
1955-02-04,PHW,109,19,25,ROC,101,23,24,42,49
1955-02-04,BOS,114,25,22,SYR,88,25,22,50,44
1955-02-05,NYK,115,23,25,BOS,107,26,22,49,47
1955-02-05,ROC,88,23,25,SYR,94,25,23,48,48
1955-02-05,PHW,88,20,25,FTW,96,32,18,52,43
1955-02-05,MNL,103,27,21,MIH,87,16,33,43,54
1955-02-06,BOS,109,26,23,PHW,113,20,26,46,49
1955-02-06,MNL,99,28,21,MIH,101,16,34,44,55
1955-02-06,SYR,77,26,23,NYK,75,24,25,50,48
1955-02-06,FTW,92,33,18,ROC,75,23,26,56,44
1955-02-08,NYK,98,24,26,MNL,95,28,22,52,48
1955-02-08,MIH,102,17,34,PHW,95,21,26,38,60
1955-02-08,SYR,115,27,23,BOS,88,26,24,53,47
1955-02-09,NYK,118,25,26,MNL,112,28,23,53,49
1955-02-09,BOS,104,26,25,SYR,94,28,23,54,48
1955-02-09,ROC,74,23,27,MIH,75,18,34,41,61
1955-02-10,FTW,105,34,18,PHW,97,21,27,55,45
1955-02-10,SYR,85,28,24,MNL,81,28,24,56,48
1955-02-11,PHW,105,21,28,BOS,101,27,25,48,53
1955-02-11,ROC,91,23,28,FTW,83,35,18,58,46
1955-02-12,ROC,95,24,28,MNL,96,28,25,52,53
1955-02-12,NYK,88,26,26,FTW,82,35,19,61,45
1955-02-12,SYR,92,29,24,MIH,66,19,34,48,58
1955-02-13,BOS,103,27,26,NYK,105,27,26,54,52
1955-02-13,MNL,103,29,25,PHW,93,22,28,51,53
1955-02-13,SYR,88,30,24,ROC,87,24,29,54,53
1955-02-13,FTW,90,35,20,MIH,78,19,35,54,55
1955-02-14,NYK,92,28,26,FTW,88,36,20,64,46
1955-02-14,SYR,82,31,24,MIH,81,19,36,50,60
1955-02-14,PHW,79,22,29,ROC,72,24,30,46,59
1955-02-15,ROC,113,24,31,PHW,114,23,29,47,60
1955-02-15,BOS,106,27,27,MIH,103,19,37,46,64
1955-02-16,PHW,98,24,29,ROC,96,24,32,48,61
1955-02-17,SYR,107,32,24,BOS,93,28,27,60,51
1955-02-17,NYK,93,29,26,FTW,86,36,21,65,47
1955-02-17,PHW,78,25,29,ROC,73,24,33,49,62
1955-02-18,PHW,110,26,29,SYR,86,33,24,59,53
1955-02-19,MNL,98,30,25,FTW,92,36,22,66,47
1955-02-19,NYK,78,30,26,SYR,80,33,25,63,51
1955-02-19,ROC,78,24,34,MIH,84,19,38,43,72
1955-02-20,BOS,114,28,28,PHW,99,27,29,55,57
1955-02-20,MNL,105,31,25,ROC,92,24,35,55,60
1955-02-20,FTW,96,36,23,MIH,87,20,38,56,61
1955-02-20,SYR,104,34,25,NYK,84,30,27,64,52
1955-02-21,MNL,112,32,25,ROC,110,24,36,56,61
1955-02-22,NYK,103,30,28,PHW,102,27,30,57,58
1955-02-22,SYR,95,35,25,BOS,97,29,28,64,53
1955-02-22,MIH,71,20,39,ROC,87,24,37,44,76
1955-02-23,MIH,120,20,40,BOS,103,30,28,50,68
1955-02-23,FTW,120,37,23,MNL,97,33,25,70,48
1955-02-23,PHW,98,27,31,NYK,96,31,28,58,59
1955-02-24,MNL,112,33,26,BOS,98,30,29,63,55
1955-02-24,FTW,95,38,23,MIH,85,21,40,59,63
1955-02-24,SYR,97,35,26,ROC,83,25,37,60,63
1955-02-25,PHW,113,28,31,NYK,111,31,29,59,60
1955-02-25,BOS,107,30,30,MNL,104,34,26,64,56
1955-02-26,MNL,89,34,27,FTW,90,39,23,73,50
1955-02-26,ROC,88,25,38,PHW,80,29,31,54,69
1955-02-26,NYK,72,31,30,MIH,79,21,41,52,71
1955-02-27,MNL,93,34,28,ROC,84,26,38,60,66
1955-02-27,FTW,83,40,23,NYK,95,31,31,71,54
1955-02-27,SYR,105,36,26,PHW,77,29,32,65,58
1955-02-27,BOS,62,31,30,MIH,57,22,41,53,71
1955-02-28,MNL,88,35,28,FTW,90,40,24,75,52
1955-02-28,PHW,101,29,33,MIH,84,22,42,51,75
1955-03-01,NYK,102,32,31,SYR,105,37,26,69,57
1955-03-01,FTW,118,41,24,BOS,98,32,30,73,54
1955-03-01,PHW,88,30,33,MIH,91,22,43,52,76
1955-03-02,FTW,90,42,24,SYR,103,38,26,80,50
1955-03-02,PHW,78,30,34,MIH,75,23,43,53,77
1955-03-03,NYK,103,32,32,MIH,89,23,44,55,76
1955-03-03,FTW,81,42,25,SYR,83,39,26,81,51
1955-03-03,ROC,83,26,39,MNL,76,35,29,61,68
1955-03-04,BOS,106,32,31,MNL,121,35,30,67,61
1955-03-04,MIH,96,23,45,SYR,99,40,26,63,71
1955-03-04,NYK,95,33,32,ROC,92,27,39,60,71
1955-03-05,ROC,104,27,40,MNL,107,36,30,63,70
1955-03-05,PHW,95,31,34,BOS,89,32,32,63,66
1955-03-06,BOS,108,32,33,FTW,104,42,26,74,59
1955-03-06,SYR,107,41,26,PHW,101,32,34,73,60
1955-03-06,MNL,98,37,30,MIH,100,23,46,60,76
1955-03-06,NYK,101,34,32,ROC,96,27,41,61,73
1955-03-07,MNL,97,37,31,NYK,96,35,32,72,63
1955-03-07,BOS,110,33,33,FTW,91,42,27,75,60
1955-03-08,BOS,112,34,33,PHW,103,32,35,66,68
1955-03-08,NYK,99,35,33,ROC,96,27,42,62,75
1955-03-09,ROC,100,27,43,SYR,97,42,26,69,69
1955-03-09,PHW,102,32,36,MNL,89,38,31,70,67
1955-03-10,NYK,114,36,33,BOS,95,35,33,71,66
1955-03-10,SYR,93,42,27,MNL,96,38,32,80,59
1955-03-10,FTW,93,42,28,PHW,91,33,36,75,64
1955-03-11,NYK,97,37,33,BOS,95,35,34,72,67
1955-03-12,ROC,105,28,43,BOS,103,35,35,63,78
1955-03-12,SYR,112,42,28,FTW,92,43,28,85,56
1955-03-12,MNL,86,39,32,PHW,78,33,37,72,69
1955-03-13,BOS,112,35,36,NYK,101,38,33,73,69
1955-03-13,SYR,76,43,28,MIH,77,24,46,67,74
1955-03-14,MIH,99,25,46,PHW,84,33,38,58,84
1955-11-05,SYR,114,0,0,FTW,113,0,0,0,0
1955-11-05,ROC,98,0,0,NYK,100,0,0,0,0
1955-11-05,STL,101,0,0,MNL,89,0,0,0,0
1955-11-05,BOS,98,0,0,PHW,87,0,0,0,0
1955-11-06,FTW,95,0,1,MNL,96,0,1,0,2
1955-11-06,ROC,83,0,1,SYR,80,1,0,1,1
1955-11-09,PHW,117,0,1,MNL,106,1,1,1,2
1955-11-10,NYK,112,1,0,MNL,105,1,2,2,2
1955-11-10,ROC,84,1,1,PHW,89,1,1,2,2
1955-11-12,NYK,96,2,0,BOS,95,1,0,3,0
1955-11-12,PHW,100,2,1,MNL,89,1,3,3,4
1955-11-12,STL,81,1,0,SYR,91,1,1,2,1
1955-11-12,ROC,84,1,2,FTW,79,0,2,1,4
1955-11-12,BOS,119,1,1,MNL,75,1,4,2,5
1955-11-13,NYK,94,3,0,ROC,91,2,2,5,2
1955-11-13,FTW,93,0,3,SYR,79,2,1,2,4
1955-11-15,STL,121,1,1,NYK,95,4,0,5,1
1955-11-16,SYR,105,2,2,MNL,91,1,5,3,7
1955-11-17,PHW,106,3,1,BOS,92,2,1,5,2
1955-11-17,NYK,110,4,1,FTW,88,1,3,5,4
1955-11-19,BOS,104,2,2,FTW,102,1,4,3,6
1955-11-19,PHW,102,4,1,SYR,94,3,2,7,3
1955-11-19,NYK,91,5,1,STL,104,2,1,7,2
1955-11-19,ROC,90,2,3,MNL,91,1,6,3,9
1955-11-20,FTW,115,1,5,NYK,119,5,2,6,7
1955-11-20,MNL,96,2,6,ROC,104,2,4,4,10
1955-11-20,SYR,84,3,3,STL,80,3,1,6,4
1955-11-23,BOS,111,3,2,NYK,115,6,2,9,4
1955-11-23,PHW,104,5,1,SYR,101,4,3,9,4
1955-11-23,STL,90,3,2,ROC,88,3,4,6,6
1955-11-24,SYR,111,4,4,BOS,103,3,3,7,7
1955-11-24,MNL,107,2,7,STL,99,4,2,6,9
1955-11-24,PHW,118,6,1,NYK,97,7,2,13,3
1955-11-24,FTW,104,1,6,ROC,93,3,5,4,11
1955-11-26,ROC,103,3,6,BOS,104,3,4,6,10
1955-11-26,NYK,100,7,3,SYR,99,5,4,12,7
1955-11-26,STL,104,4,3,MNL,95,3,7,7,10
1955-11-26,PHW,87,7,1,FTW,82,2,6,9,7
1955-11-27,FTW,114,2,7,STL,106,5,3,7,10
1955-11-27,MNL,99,3,8,PHW,94,8,1,11,9
1955-11-27,SYR,85,5,5,NYK,74,8,3,13,8
1955-11-29,NYK,99,8,4,FTW,104,3,7,11,11
1955-11-29,SYR,97,6,5,BOS,105,4,4,10,9
1955-11-29,STL,108,5,4,PHW,95,8,2,13,6
1955-11-30,STL,99,6,4,MNL,97,4,8,10,12
1955-11-30,ROC,87,3,7,FTW,76,4,7,7,14
1955-12-01,PHW,115,8,3,STL,98,7,4,15,7
1955-12-01,MNL,97,4,9,NYK,90,8,5,12,14
1955-12-02,BOS,94,5,4,STL,81,7,5,12,9
1955-12-03,SYR,114,6,6,MNL,103,5,9,11,15
1955-12-03,NYK,102,8,6,PHW,109,9,3,17,9
1955-12-03,ROC,78,4,7,STL,89,7,6,11,13
1955-12-04,MNL,96,5,10,SYR,102,7,6,12,16
1955-12-04,FTW,111,4,8,BOS,90,6,4,10,12
1955-12-04,ROC,107,4,8,PHW,84,10,3,14,11
1955-12-06,NYK,116,8,7,ROC,105,5,8,13,15
1955-12-06,PHW,116,10,4,MNL,103,5,11,15,15
1955-12-06,STL,99,8,6,BOS,122,6,5,14,11
1955-12-06,FTW,90,5,8,SYR,88,8,6,13,14
1955-12-07,ROC,92,5,9,MNL,79,5,12,10,21
1955-12-08,FTW,105,6,8,SYR,94,8,7,14,15
1955-12-09,ROC,109,6,9,BOS,108,7,5,13,14
1955-12-09,PHW,101,11,4,SYR,92,8,8,19,12
1955-12-10,ROC,117,7,9,FTW,116,7,8,14,17
1955-12-10,BOS,118,7,6,MNL,102,5,13,12,19
1955-12-10,STL,80,8,7,NYK,99,9,7,17,14
1955-12-11,ROC,93,8,9,STL,91,8,8,16,17
1955-12-11,FTW,96,7,9,PHW,91,12,4,19,13
1955-12-11,SYR,101,8,9,BOS,89,8,6,16,15
1955-12-13,PHW,109,12,5,BOS,108,8,7,20,12
1955-12-13,NYK,98,10,7,MNL,91,5,14,15,21
1955-12-14,ROC,117,9,9,STL,109,8,9,17,18
1955-12-14,BOS,102,8,8,NYK,100,11,7,19,15
1955-12-14,MNL,98,5,15,FTW,85,8,9,13,24
1955-12-15,SYR,133,9,9,MNL,135,6,15,15,24
1955-12-15,PHW,80,13,5,FTW,73,8,10,21,15
1955-12-16,STL,100,8,10,ROC,97,10,9,18,19
1955-12-17,BOS,104,9,8,SYR,110,9,10,18,18
1955-12-17,FTW,95,8,11,NYK,100,11,8,19,19
1955-12-17,MNL,94,7,15,ROC,92,10,10,17,25
1955-12-18,NYK,92,12,8,BOS,95,9,9,21,17
1955-12-18,FTW,96,8,12,MNL,86,8,15,16,27
1955-12-18,STL,86,9,10,ROC,85,10,11,19,21
1955-12-18,SYR,99,10,10,PHW,79,14,5,24,15
1955-12-20,BOS,111,10,9,MNL,104,8,16,18,25
1955-12-20,NYK,91,12,9,SYR,98,11,10,23,19
1955-12-21,ROC,92,10,12,PHW,96,14,6,24,18
1955-12-25,MNL,112,8,17,BOS,115,11,9,19,26
1955-12-25,SYR,111,12,10,ROC,96,10,13,22,23
1955-12-25,FTW,92,9,12,NYK,87,12,10,21,22
1955-12-26,PHW,97,15,6,NYK,108,12,11,27,17
1955-12-26,ROC,93,10,14,SYR,91,13,10,23,24
1955-12-26,FTW,83,10,12,STL,67,10,10,20,22
1955-12-27,STL,102,10,11,BOS,105,12,9,22,20
1955-12-27,ROC,91,11,14,SYR,80,13,11,24,25
1955-12-27,NYK,80,13,11,PHW,79,15,7,28,18
1955-12-28,ROC,91,12,14,NYK,113,14,11,26,25
1955-12-28,MNL,90,8,18,STL,111,10,12,18,30
1955-12-29,PHW,112,15,8,SYR,83,13,12,28,20
1955-12-29,FTW,83,11,12,ROC,75,12,15,23,27
1955-12-29,MNL,74,8,19,STL,71,11,12,19,31
1955-12-30,BOS,110,13,9,SYR,103,13,13,26,22
1955-12-30,FTW,90,12,12,STL,89,11,13,23,25
1955-12-31,ROC,100,12,16,BOS,112,14,9,26,25
1955-12-31,SYR,101,13,14,NYK,92,15,11,28,25
1956-01-01,BOS,121,15,9,PHW,113,16,8,31,17
1956-01-01,NYK,92,15,12,ROC,101,12,17,27,29
1956-01-01,MNL,80,9,19,SYR,85,14,14,23,33
1956-01-01,FTW,85,13,12,STL,68,11,14,24,26
1956-01-02,PHW,130,16,9,ROC,100,13,17,29,26
1956-01-02,MNL,95,9,20,FTW,89,14,12,23,32
1956-01-02,STL,82,11,15,SYR,84,15,14,26,29
1956-01-03,NYK,107,15,13,BOS,97,16,9,31,22
1956-01-03,PHW,102,17,9,FTW,82,14,13,31,22
1956-01-04,SYR,87,16,14,PHW,88,18,9,34,23
1956-01-04,ROC,86,13,18,FTW,88,14,14,27,32
1956-01-04,NYK,103,16,13,BOS,86,16,10,32,23
1956-01-04,MNL,94,10,20,STL,76,11,16,21,36
1956-01-05,NYK,87,17,13,BOS,92,16,11,33,24
1956-01-05,FTW,92,15,14,PHW,81,19,9,34,23
1956-01-06,PHW,104,19,10,NYK,97,17,14,36,24
1956-01-07,SYR,99,16,15,BOS,105,17,11,33,26
1956-01-07,ROC,103,13,19,MNL,98,11,20,24,39
1956-01-07,STL,97,11,17,FTW,108,16,14,27,31
1956-01-08,BOS,109,18,11,ROC,111,14,19,32,30
1956-01-08,FTW,91,17,14,STL,96,11,18,28,32
1956-01-08,MNL,99,11,21,SYR,91,16,16,27,37
1956-01-08,NYK,83,17,15,PHW,95,20,10,37,25
1956-01-10,PHW,109,21,10,STL,107,12,18,33,28
1956-01-10,FTW,105,17,15,BOS,89,18,12,35,27
1956-01-10,MNL,90,12,21,SYR,79,16,17,28,38
1956-01-11,MNL,114,13,21,BOS,110,18,13,31,34
1956-01-11,ROC,94,15,19,PHW,97,22,10,37,29
1956-01-12,PHW,123,23,10,ROC,94,15,20,38,30
1956-01-12,SYR,93,16,18,STL,78,12,19,28,37
1956-01-13,BOS,119,18,14,SYR,104,17,18,35,32
1956-01-13,ROC,98,15,21,STL,90,12,20,27,41
1956-01-14,PHW,103,24,10,BOS,104,19,14,43,24
1956-01-14,NYK,101,17,16,STL,104,12,21,29,37
1956-01-14,MNL,117,14,21,FTW,94,18,15,32,36
1956-01-14,ROC,102,16,21,SYR,93,17,19,33,40
1956-01-15,BOS,104,20,14,NYK,109,17,17,37,31
1956-01-15,FTW,104,18,16,MNL,99,15,21,33,37
1956-01-15,STL,96,13,21,PHW,108,24,11,37,32
1956-01-15,SYR,99,17,20,ROC,88,17,21,34,41
1956-01-17,NYK,112,18,17,ROC,107,17,22,35,39
1956-01-17,MNL,97,15,22,STL,86,13,22,28,44
1956-01-17,BOS,91,20,15,FTW,85,19,16,39,31
1956-01-18,ROC,108,17,23,NYK,103,19,17,36,40
1956-01-18,MNL,105,16,22,PHW,94,25,11,41,33
1956-01-18,BOS,95,21,15,FTW,90,19,17,40,32
1956-01-19,SYR,122,18,20,MNL,100,17,22,35,42
1956-01-19,FTW,90,19,18,STL,83,13,23,32,41
1956-01-20,BOS,133,22,15,STL,112,13,24,35,39
1956-01-20,NYK,122,19,18,MNL,109,17,23,36,41
1956-01-21,BOS,100,23,15,SYR,96,19,20,42,35
1956-01-21,PHW,91,25,12,FTW,92,20,18,45,30
1956-01-21,ROC,97,18,23,STL,90,13,25,31,48
1956-01-21,NYK,89,20,18,MNL,109,17,24,37,42
1956-01-22,BOS,115,24,15,PHW,129,25,13,49,28
1956-01-22,SYR,105,19,21,STL,109,13,26,32,47
1956-01-22,MNL,95,18,24,NYK,100,20,19,38,43
1956-01-22,FTW,111,21,18,ROC,93,19,23,40,41
1956-01-23,PHW,120,26,13,BOS,104,24,16,50,29
1956-01-25,STL,114,14,26,ROC,106,19,24,33,50
1956-01-25,FTW,101,22,18,BOS,100,24,17,46,35
1956-01-25,PHW,112,27,13,SYR,100,19,22,46,35
1956-01-25,MNL,104,18,25,NYK,95,21,19,39,44
1956-01-26,SYR,100,19,23,PHW,89,28,13,47,36
1956-01-27,BOS,97,24,18,FTW,106,23,18,47,36
1956-01-27,ROC,111,19,25,NYK,93,21,20,40,45
1956-01-28,ROC,119,20,25,BOS,126,24,19,44,44
1956-01-28,NYK,91,21,21,FTW,92,24,18,45,39
1956-01-28,STL,93,15,26,SYR,85,20,23,35,49
1956-01-28,MNL,85,19,25,PHW,108,28,14,47,39
1956-01-29,MNL,107,19,26,STL,114,16,26,35,52
1956-01-29,BOS,112,25,19,ROC,103,20,26,45,45
1956-01-29,SYR,95,20,24,NYK,99,21,22,41,46
1956-01-29,FTW,99,25,18,PHW,85,29,14,54,32
1956-01-31,NYK,105,22,22,PHW,95,29,15,51,37
1956-01-31,STL,114,17,26,BOS,91,26,19,43,45
1956-01-31,MNL,92,19,27,ROC,86,20,27,39,54
1956-02-01,MNL,107,20,27,BOS,106,26,20,46,47
1956-02-01,PHW,104,29,16,NYK,105,23,22,52,38
1956-02-01,FTW,90,26,18,STL,98,18,26,44,44
1956-02-01,ROC,83,20,28,SYR,77,20,25,40,53
1956-02-02,BOS,102,26,21,MNL,101,21,27,47,48
1956-02-02,SYR,97,20,26,ROC,89,21,28,41,54
1956-02-02,NYK,87,24,22,PHW,88,29,17,53,39
1956-02-03,PHW,96,30,17,ROC,105,21,29,51,46
1956-02-04,FTW,94,26,19,STL,98,19,26,45,45
1956-02-04,NYK,94,24,23,SYR,103,21,26,45,49
1956-02-04,ROC,83,22,29,BOS,69,27,21,49,50
1956-02-05,MNL,109,21,28,ROC,121,23,29,44,57
1956-02-05,BOS,114,27,22,NYK,104,24,24,51,46
1956-02-05,STL,105,20,26,PHW,93,30,18,50,44
1956-02-05,SYR,90,22,26,FTW,85,26,20,48,46
1956-02-06,FTW,99,26,21,SYR,98,23,26,49,47
1956-02-07,NYK,113,24,25,BOS,102,28,22,52,47
1956-02-07,SYR,95,23,27,PHW,128,30,19,53,46
1956-02-08,STL,111,21,26,BOS,110,28,23,49,49
1956-02-08,ROC,97,24,29,NYK,102,25,25,49,54
1956-02-08,MNL,106,21,29,FTW,82,27,21,48,50
1956-02-09,SYR,97,23,28,BOS,98,28,24,51,52
1956-02-09,PHW,108,31,19,STL,97,22,26,53,45
1956-02-10,BOS,124,29,24,STL,100,22,27,51,51
1956-02-10,SYR,94,23,29,NYK,88,26,25,49,54
1956-02-11,MNL,102,22,29,PHW,117,32,19,54,48
1956-02-11,ROC,97,24,30,FTW,93,27,22,51,52
1956-02-11,NYK,107,26,26,STL,91,22,28,48,54
1956-02-12,BOS,116,30,24,NYK,108,27,26,57,50
1956-02-12,STL,79,22,29,PHW,87,33,19,55,48
1956-02-12,FTW,82,27,23,MNL,78,22,30,49,53
1956-02-12,SYR,101,24,29,ROC,74,25,30,49,59
1956-02-14,STL,99,22,30,NYK,103,27,27,49,57
1956-02-14,PHW,105,34,19,FTW,94,28,23,62,42
1956-02-14,MNL,110,22,31,ROC,79,25,31,47,62
1956-02-15,MNL,113,23,31,NYK,102,28,27,51,58
1956-02-15,PHW,101,35,19,FTW,78,28,24,63,43
1956-02-16,FTW,93,28,25,ROC,81,25,32,53,57
1956-02-17,PHW,134,36,19,MNL,111,24,31,60,50
1956-02-17,SYR,91,25,29,NYK,86,28,28,53,57
1956-02-18,PHW,115,37,19,BOS,101,31,24,68,43
1956-02-18,ROC,99,25,33,MNL,119,24,32,49,65
1956-02-18,SYR,85,26,29,FTW,84,29,25,55,54
1956-02-19,BOS,120,31,25,PHW,118,38,19,69,44
1956-02-19,SYR,118,27,29,NYK,98,28,29,55,58
1956-02-19,MNL,100,25,32,ROC,93,25,34,50,66
1956-02-19,STL,83,22,31,FTW,89,29,26,51,57
1956-02-20,STL,84,22,32,FTW,82,30,26,52,58
1956-02-21,NYK,107,28,30,SYR,108,28,29,56,59
1956-02-21,ROC,106,25,35,FTW,102,30,27,55,62
1956-02-21,STL,101,23,32,BOS,97,32,25,55,57
1956-02-22,ROC,110,26,35,STL,109,24,32,50,67
1956-02-22,PHW,108,38,20,NYK,117,28,31,66,51
1956-02-22,MNL,90,26,32,BOS,93,32,26,58,58
1956-02-23,SYR,94,29,29,FTW,92,30,28,59,57
1956-02-24,PHW,135,38,21,BOS,129,33,26,71,47
1956-02-24,STL,116,24,33,SYR,103,30,29,54,62
1956-02-25,NYK,89,29,31,STL,99,25,33,54,64
1956-02-25,ROC,72,27,35,FTW,97,30,29,57,64
1956-02-26,BOS,111,33,27,ROC,100,27,36,60,63
1956-02-26,MNL,90,26,33,FTW,95,31,29,57,62
1956-02-26,SYR,85,30,30,PHW,87,39,21,69,51
1956-02-26,STL,103,26,33,NYK,85,29,32,55,65
1956-02-27,NYK,113,29,33,STL,109,27,33,56,66
1956-02-27,FTW,95,32,29,SYR,98,30,31,62,60
1956-02-28,ROC,113,27,37,BOS,97,34,27,61,64
1956-02-28,NYK,95,30,33,FTW,99,32,30,62,63
1956-02-29,BOS,106,34,28,FTW,99,33,30,67,58
1956-02-29,MNL,98,26,34,SYR,94,31,31,57,65
1956-02-29,PHW,86,40,21,ROC,81,28,37,68,58
1956-03-01,PHW,100,41,21,MNL,102,27,34,68,55
1956-03-01,SYR,111,31,32,BOS,100,35,28,66,60
1956-03-01,STL,94,27,34,ROC,95,28,38,55,72
1956-03-02,BOS,119,35,29,MNL,113,28,34,63,63
1956-03-02,FTW,104,33,31,NYK,97,30,34,63,65
1956-03-03,PHW,102,41,22,SYR,96,32,32,73,54
1956-03-03,ROC,94,29,38,MNL,90,28,35,57,73
1956-03-03,STL,92,27,35,FTW,86,34,31,61,66
1956-03-04,BOS,128,36,29,PHW,114,42,22,78,51
1956-03-04,SYR,111,32,33,NYK,118,30,35,62,68
1956-03-04,FTW,103,34,32,ROC,88,30,38,64,70
1956-03-04,MNL,113,28,36,STL,84,28,35,56,71
1956-03-06,NYK,119,31,35,BOS,99,37,29,68,64
1956-03-06,STL,102,28,36,PHW,97,42,23,70,59
1956-03-07,BOS,111,37,30,SYR,98,32,34,69,64
1956-03-07,MNL,98,29,36,FTW,95,35,32,64,68
1956-03-07,ROC,89,30,39,STL,96,29,36,59,75
1956-03-07,PHW,108,42,24,NYK,87,32,35,74,59
1956-03-08,PHW,142,43,24,BOS,120,38,30,81,54
1956-03-08,SYR,92,32,35,STL,88,30,36,62,71
1956-03-08,FTW,100,35,33,MNL,82,30,36,65,69
1956-03-09,STL,103,30,37,MNL,102,30,37,60,74
1956-03-10,FTW,106,36,33,BOS,103,38,31,74,64
1956-03-10,STL,105,31,37,MNL,97,30,38,61,75
1956-03-10,ROC,111,30,40,PHW,96,44,24,74,64
1956-03-10,NYK,104,32,36,SYR,84,33,35,65,71
1956-03-11,BOS,121,38,32,STL,127,32,37,70,69
1956-03-11,MNL,126,30,39,ROC,98,31,40,61,79
1956-03-11,FTW,96,37,33,NYK,122,33,36,70,69
1956-03-11,SYR,99,33,36,PHW,88,44,25,77,61
1956-03-12,SYR,97,34,36,STL,92,33,37,67,73
1956-03-13,PHW,116,44,26,STL,113,33,38,77,64
1956-03-13,MNL,102,31,39,NYK,89,34,36,65,75
1956-03-14,NYK,115,34,37,PHW,108,45,26,79,63
1956-03-14,BOS,122,38,33,SYR,103,35,36,73,69
1956-03-14,MNL,100,32,39,FTW,96,37,34,69,73
1956-03-15,SYR,82,35,37,NYK,77,35,37,70,74
1956-03-16,STL,97,33,39,MNL,103,33,39,66,78
1956-10-27,NYK,112,0,0,BOS,115,0,0,0,0
1956-10-27,SYR,109,0,0,PHW,103,0,0,0,0
1956-10-27,ROC,88,0,0,FTW,85,0,0,0,0
1956-10-27,STL,97,0,0,MNL,75,0,0,0,0
1956-10-28,FTW,94,0,1,MNL,88,0,1,0,2
1956-10-28,SYR,91,1,0,ROC,75,1,0,2,0
1956-11-01,MNL,97,0,2,ROC,88,1,1,1,3
1956-11-03,BOS,107,1,0,NYK,113,0,1,1,1
1956-11-03,ROC,85,1,2,MNL,95,1,2,2,4
1956-11-03,PHW,116,0,1,FTW,81,1,1,1,2
1956-11-03,SYR,75,2,0,STL,73,1,0,3,0
1956-11-04,MNL,88,2,2,ROC,87,1,3,3,5
1956-11-04,FTW,83,1,2,NYK,96,1,1,2,3
1956-11-04,SYR,76,3,0,STL,78,1,1,4,1
1956-11-07,STL,107,2,1,NYK,101,2,1,4,2
1956-11-07,ROC,81,1,4,PHW,80,1,1,2,5
1956-11-09,PHW,93,1,2,ROC,95,2,4,3,6
1956-11-10,BOS,117,1,1,MNL,110,3,2,4,3
1956-11-10,PHW,83,1,3,NYK,81,2,2,3,5
1956-11-10,STL,86,3,1,FTW,79,1,3,4,4
1956-11-10,ROC,90,3,4,SYR,76,3,1,6,5
1956-11-11,NYK,106,2,3,PHW,95,2,3,4,6
1956-11-11,SYR,83,3,2,BOS,94,2,1,5,3
1956-11-11,ROC,94,4,4,MNL,82,3,3,7,7
1956-11-11,FTW,96,1,4,STL,81,4,1,5,5
1956-11-13,STL,118,4,2,ROC,105,5,4,9,6
1956-11-14,MNL,113,3,4,BOS,97,3,1,6,5
1956-11-14,ROC,90,5,5,NYK,87,3,3,8,8
1956-11-15,SYR,96,3,3,MNL,103,4,4,7,7
1956-11-15,FTW,98,2,4,BOS,95,3,2,5,6
1956-11-15,PHW,92,2,4,ROC,83,6,5,8,9
1956-11-16,PHW,123,3,4,MNL,97,5,4,8,8
1956-11-17,PHW,109,4,4,SYR,96,3,4,7,8
1956-11-17,STL,92,5,2,FTW,87,3,4,8,6
1956-11-17,BOS,108,3,3,ROC,86,6,6,9,9
1956-11-18,MNL,107,5,5,FTW,111,3,5,8,10
1956-11-18,SYR,99,3,5,PHW,97,5,4,8,9
1956-11-18,ROC,87,6,7,BOS,101,4,3,10,10
1956-11-18,NYK,102,3,4,STL,69,6,2,9,6
1956-11-20,STL,104,6,3,SYR,81,4,5,10,8
1956-11-21,FTW,104,4,5,NYK,103,4,4,8,9
1956-11-21,BOS,95,5,3,PHW,83,5,5,10,8
1956-11-21,ROC,85,6,8,STL,76,7,3,13,11
1956-11-22,FTW,104,5,5,ROC,102,7,8,12,13
1956-11-22,PHW,78,5,6,BOS,101,6,3,11,9
1956-11-22,MNL,111,5,6,SYR,78,4,6,9,12
1956-11-24,STL,102,7,4,MNL,104,6,6,13,10
1956-11-24,BOS,114,7,3,SYR,99,4,7,11,10
1956-11-24,PHW,98,5,7,FTW,88,6,5,11,12
1956-11-24,NYK,87,4,5,ROC,96,7,9,11,14
1956-11-25,MNL,94,7,6,STL,95,7,5,14,11
1956-11-25,ROC,95,8,9,NYK,93,4,6,12,15
1956-11-25,FTW,112,6,6,PHW,88,6,7,12,13
1956-11-27,NYK,105,4,7,FTW,98,7,6,11,13
1956-11-27,MNL,113,7,7,PHW,98,6,8,13,15
1956-11-27,STL,90,8,5,BOS,102,8,3,16,8
1956-11-27,ROC,90,9,9,SYR,82,4,8,13,17
1956-11-28,BOS,105,9,3,MNL,93,8,7,17,10
1956-11-29,SYR,87,4,9,FTW,92,7,7,11,16
1956-11-30,BOS,104,10,3,FTW,102,8,7,18,10
1956-11-30,PHW,110,6,9,NYK,99,5,7,11,16
1956-12-01,NYK,117,5,8,SYR,100,4,10,9,18
1956-12-01,STL,95,8,6,PHW,107,7,9,15,15
1956-12-01,BOS,108,11,3,FTW,93,8,8,19,11
1956-12-01,ROC,95,10,9,MNL,83,8,8,18,17
1956-12-02,SYR,110,4,11,NYK,100,6,8,10,19
1956-12-02,MNL,106,8,9,PHW,96,8,9,16,18
1956-12-04,BOS,108,12,3,STL,107,8,7,20,10
1956-12-04,SYR,97,5,11,FTW,96,8,9,13,20
1956-12-04,NYK,101,6,9,MNL,88,9,9,15,18
1956-12-06,PHW,113,8,10,BOS,111,13,3,21,13
1956-12-06,MNL,103,9,10,STL,96,8,8,17,18
1956-12-06,NYK,95,7,9,ROC,92,11,9,18,18
1956-12-06,FTW,104,8,10,SYR,92,6,11,14,21
1956-12-07,BOS,121,13,4,MNL,114,10,10,23,14
1956-12-07,STL,101,8,9,NYK,107,8,9,16,18
1956-12-07,FTW,105,9,10,SYR,97,6,12,15,22
1956-12-08,NYK,109,9,9,STL,104,8,10,17,19
1956-12-08,ROC,92,11,10,PHW,91,9,10,20,20
1956-12-09,SYR,116,6,13,BOS,110,14,4,20,17
1956-12-09,FTW,100,10,10,ROC,101,12,10,22,20
1956-12-09,MNL,91,10,11,NYK,100,10,9,20,20
1956-12-11,NYK,128,11,9,STL,137,8,11,19,20
1956-12-11,PHW,114,9,11,MNL,111,10,12,19,23
1956-12-11,BOS,113,14,5,FTW,97,10,11,24,16
1956-12-12,MNL,121,10,13,NYK,103,11,10,21,23
1956-12-12,PHW,115,10,11,STL,99,9,11,19,22
1956-12-12,BOS,93,15,5,ROC,103,13,10,28,15
1956-12-15,SYR,108,7,13,PHW,117,11,11,18,24
1956-12-15,BOS,102,15,6,STL,99,9,12,24,18
1956-12-15,ROC,76,14,10,NYK,91,11,11,25,21
1956-12-16,PHW,116,12,11,BOS,104,16,6,28,17
1956-12-16,MNL,101,11,13,ROC,97,14,11,25,24
1956-12-16,SYR,101,7,14,STL,91,9,13,16,27
1956-12-16,FTW,84,10,12,NYK,80,12,11,22,23
1956-12-18,NYK,110,12,12,BOS,99,16,7,28,19
1956-12-18,STL,95,9,14,FTW,84,11,12,20,26
1956-12-20,MNL,105,12,13,ROC,103,14,12,26,25
1956-12-22,ROC,115,14,13,MNL,101,13,13,27,26
1956-12-22,BOS,95,16,8,STL,93,10,14,26,22
1956-12-23,SYR,107,8,14,MNL,97,13,14,21,28
1956-12-23,NYK,90,13,12,PHW,95,13,11,26,23
1956-12-23,FTW,95,11,13,BOS,87,17,8,28,21
1956-12-25,NYK,105,13,13,STL,107,10,15,23,28
1956-12-25,ROC,98,15,13,SYR,93,9,14,24,27
1956-12-25,MNL,100,13,15,FTW,89,12,13,25,28
1956-12-25,PHW,89,14,11,BOS,82,17,9,31,20
1956-12-26,BOS,120,17,10,PHW,97,15,11,32,21
1956-12-26,FTW,99,12,14,ROC,93,16,13,28,27
1956-12-27,STL,102,11,15,SYR,95,9,15,20,30
1956-12-27,FTW,120,13,14,MNL,93,14,15,27,29
1956-12-27,BOS,97,18,10,ROC,92,16,14,34,24
1956-12-27,PHW,112,15,12,NYK,87,13,14,28,26
1956-12-29,PHW,103,16,12,SYR,104,9,16,25,28
1956-12-29,MNL,92,14,16,STL,95,12,15,26,31
1956-12-29,ROC,95,16,15,FTW,88,14,14,30,29
1956-12-30,FTW,104,14,15,PHW,99,16,13,30,28
1956-12-30,STL,100,13,15,MNL,93,14,17,27,32
1956-12-30,BOS,105,19,10,SYR,92,10,16,29,26
1956-12-30,NYK,96,13,15,ROC,88,17,15,30,30
1957-01-01,SYR,106,10,17,NYK,102,14,15,24,32
1957-01-01,ROC,102,17,16,STL,101,14,15,31,31
1957-01-01,BOS,100,20,10,PHW,87,16,14,36,24
1957-01-03,NYK,126,14,16,SYR,111,11,17,25,33
1957-01-03,FTW,104,15,15,MNL,102,14,18,29,33
1957-01-03,PHW,82,16,15,STL,81,14,16,30,31
1957-01-04,SYR,116,11,18,BOS,106,21,10,32,28
1957-01-04,PHW,96,17,15,STL,92,14,17,31,32
1957-01-05,FTW,109,16,15,NYK,96,15,16,31,31
1957-01-05,ROC,78,18,16,PHW,81,18,15,36,31
1957-01-06,SYR,128,12,18,PHW,123,19,15,31,33
1957-01-06,MNL,101,14,19,NYK,111,15,17,29,36
1957-01-06,BOS,118,21,11,FTW,92,17,15,38,26
1957-01-06,STL,86,14,18,ROC,93,18,17,32,35
1957-01-08,NYK,113,16,17,BOS,102,22,11,38,28
1957-01-08,ROC,95,19,17,PHW,94,19,16,38,33
1957-01-08,FTW,87,17,16,MNL,86,14,20,31,36
1957-01-09,MNL,93,14,21,SYR,86,13,18,27,39
1957-01-10,SYR,110,13,19,MNL,118,15,21,28,40
1957-01-10,PHW,112,19,17,ROC,93,20,17,39,34
1957-01-10,NYK,89,17,17,STL,84,14,19,31,36
1957-01-10,FTW,81,18,16,BOS,98,22,12,40,28
1957-01-12,STL,100,14,20,BOS,98,23,12,37,32
1957-01-12,ROC,88,20,18,SYR,97,13,20,33,38
1957-01-12,MNL,105,16,21,FTW,87,18,17,34,38
1957-01-12,PHW,116,20,17,NYK,82,18,17,38,34
1957-01-13,NYK,101,18,18,PHW,90,21,17,39,35
1957-01-13,FTW,91,18,18,STL,89,15,20,33,38
1957-01-13,MNL,104,17,21,BOS,87,23,13,40,34
1957-01-13,SYR,91,14,20,ROC,85,20,19,34,39
1957-01-16,ROC,106,20,20,STL,108,15,21,35,41
1957-01-17,PHW,103,21,18,SYR,108,15,20,36,38
1957-01-17,NYK,94,19,18,MNL,93,18,21,37,39
1957-01-17,STL,106,16,21,FTW,82,19,18,35,39
1957-01-18,BOS,126,23,14,STL,117,17,21,40,35
1957-01-18,PHW,96,21,19,SYR,94,16,20,37,39
1957-01-19,NYK,102,20,18,FTW,100,19,19,39,37
1957-01-19,SYR,96,16,21,STL,104,17,22,33,43
1957-01-19,ROC,83,20,21,BOS,97,24,14,44,35
1957-01-20,MNL,114,18,22,ROC,107,20,22,38,44
1957-01-20,STL,104,18,22,PHW,102,22,19,40,41
1957-01-20,SYR,101,16,22,FTW,98,19,20,35,42
1957-01-20,BOS,114,25,14,NYK,78,21,18,46,32
1957-01-22,NYK,90,21,19,SYR,88,17,22,38,41
1957-01-22,FTW,97,19,21,STL,87,19,22,38,43
1957-01-23,BOS,140,26,14,SYR,108,17,23,43,37
1957-01-23,MNL,107,19,22,ROC,99,20,23,39,45
1957-01-23,PHW,99,22,20,NYK,93,22,19,44,39
1957-01-23,STL,101,19,23,FTW,78,20,21,39,44
1957-01-24,SYR,115,17,24,NYK,97,22,20,39,44
1957-01-24,PHW,107,23,20,STL,96,20,23,43,43
1957-01-25,BOS,115,27,14,MNL,106,20,22,47,36
1957-01-25,STL,100,20,24,ROC,99,20,24,40,48
1957-01-26,NYK,122,22,21,MNL,107,20,23,42,44
1957-01-26,FTW,101,20,22,PHW,98,24,20,44,42
1957-01-26,ROC,95,20,25,SYR,99,18,24,38,49
1957-01-27,FTW,103,21,22,NYK,102,23,21,44,43
1957-01-27,SYR,94,19,24,MNL,93,20,24,39,48
1957-01-27,PHW,87,24,21,BOS,107,28,14,52,35
1957-01-27,STL,107,21,24,ROC,83,20,26,41,50
1957-01-28,SYR,112,20,24,MNL,96,20,25,40,49
1957-01-28,BOS,105,29,14,PHW,95,24,22,53,36
1957-01-29,NYK,114,23,22,PHW,110,24,23,47,45
1957-01-29,BOS,103,30,14,MNL,91,20,26,50,40
1957-01-29,STL,85,22,24,FTW,91,22,22,44,46
1957-01-30,BOS,116,31,14,SYR,119,21,24,52,38
1957-01-30,NYK,92,24,22,ROC,80,20,27,44,49
1957-01-31,MNL,107,20,27,FTW,111,23,22,43,49
1957-01-31,SYR,105,22,24,BOS,104,31,15,53,39
1957-01-31,NYK,102,25,22,PHW,106,24,24,49,46
1957-02-01,ROC,96,20,28,FTW,80,24,22,44,50
1957-02-02,NYK,111,25,23,BOS,114,31,16,56,39
1957-02-02,PHW,107,25,24,SYR,100,23,24,48,48
1957-02-02,MNL,97,20,28,STL,106,22,25,42,53
1957-02-02,ROC,93,21,28,FTW,79,24,23,45,51
1957-02-03,PHW,110,26,24,ROC,108,22,28,48,52
1957-02-03,BOS,116,32,16,NYK,98,25,24,57,40
1957-02-03,SYR,104,23,25,FTW,95,24,24,47,49
1957-02-03,STL,102,23,25,MNL,85,20,29,43,54
1957-02-04,FTW,103,24,25,PHW,91,27,24,51,49
1957-02-05,SYR,101,24,25,BOS,105,33,16,57,41
1957-02-05,NYK,88,25,25,ROC,91,22,29,47,54
1957-02-05,STL,87,24,25,PHW,101,27,25,51,50
1957-02-06,MNL,101,20,30,PHW,100,28,25,48,55
1957-02-06,ROC,103,23,29,STL,100,24,26,47,55
1957-02-06,NYK,119,25,26,SYR,100,24,26,49,52
1957-02-06,BOS,108,34,16,FTW,93,25,25,59,41
1957-02-07,SYR,112,24,27,STL,110,24,27,48,54
1957-02-08,NYK,92,26,26,BOS,90,35,16,61,42
1957-02-08,PHW,93,28,26,STL,90,24,28,52,54
1957-02-09,ROC,103,24,29,BOS,102,35,17,59,46
1957-02-09,MNL,99,21,30,FTW,92,25,26,46,56
1957-02-09,NYK,89,27,26,SYR,101,25,27,52,53
1957-02-10,SYR,102,26,27,NYK,100,27,27,53,54
1957-02-10,FTW,113,25,27,MNL,100,22,30,47,57
1957-02-10,BOS,103,35,18,PHW,98,29,26,64,44
1957-02-10,STL,117,24,29,ROC,93,25,29,49,58
1957-02-11,STL,107,25,29,SYR,101,27,27,52,56
1957-02-12,STL,105,26,29,MNL,110,22,31,48,60
1957-02-13,MNL,115,23,31,BOS,114,36,18,59,49
1957-02-13,PHW,99,29,27,FTW,89,26,27,55,54
1957-02-13,ROC,82,25,30,NYK,85,27,28,52,58
1957-02-14,FTW,112,26,28,BOS,106,36,19,62,47
1957-02-14,MNL,99,24,31,NYK,97,28,28,52,59
1957-02-14,SYR,95,27,28,ROC,104,25,31,52,59
1957-02-15,STL,116,26,30,BOS,123,36,20,62,50
1957-02-15,PHW,105,30,27,MNL,104,25,31,55,58
1957-02-16,NYK,120,28,29,MNL,112,25,32,53,61
1957-02-16,ROC,84,26,31,FTW,87,27,28,53,59
1957-02-17,MNL,115,25,33,STL,118,26,31,51,64
1957-02-17,PHW,123,31,27,NYK,115,29,29,60,56
1957-02-17,SYR,116,27,29,BOS,106,37,20,64,49
1957-02-17,FTW,104,28,28,ROC,85,26,32,54,60
1957-02-19,NYK,110,29,30,BOS,112,37,21,66,51
1957-02-19,STL,96,27,31,FTW,83,29,28,56,59
1957-02-20,MNL,111,25,34,ROC,103,26,33,51,67
1957-02-21,FTW,120,29,29,NYK,114,29,31,58,60
1957-02-21,BOS,125,38,21,STL,112,28,31,66,52
1957-02-21,SYR,92,28,29,PHW,86,32,27,60,56
1957-02-22,PHW,117,32,28,BOS,109,39,21,71,49
1957-02-22,FTW,110,30,29,ROC,105,26,34,56,63
1957-02-23,MNL,101,26,34,SYR,103,29,29,55,63
1957-02-23,NYK,102,29,32,FTW,94,31,29,60,61
1957-02-23,ROC,101,26,35,STL,86,28,32,54,67
1957-02-24,MNL,123,26,35,FTW,115,31,30,57,65
1957-02-24,STL,113,28,33,PHW,112,33,28,61,61
1957-02-24,SYR,109,30,29,ROC,93,27,35,57,64
1957-02-24,BOS,97,39,22,NYK,85,30,32,69,54
1957-02-25,FTW,108,31,31,SYR,102,31,29,62,60
1957-02-25,STL,110,29,33,MNL,94,27,35,56,68
1957-02-26,SYR,120,31,30,MNL,108,27,36,58,66
1957-02-26,ROC,77,27,36,BOS,92,40,22,67,58
1957-02-26,NYK,107,30,33,STL,76,30,33,60,66
1957-02-27,SYR,108,32,30,STL,93,30,34,62,64
1957-02-27,ROC,90,27,37,FTW,76,32,31,59,68
1957-02-28,NYK,122,31,33,BOS,121,41,22,72,55
1957-02-28,SYR,123,33,30,FTW,112,32,32,65,62
1957-02-28,PHW,129,33,29,MNL,112,27,37,60,66
1957-03-01,MNL,125,27,38,ROC,117,28,37,55,75
1957-03-01,BOS,90,41,23,PHW,80,34,29,75,52
1957-03-02,STL,94,30,35,NYK,97,32,33,62,68
1957-03-02,ROC,96,28,38,BOS,87,42,23,70,61
1957-03-02,PHW,98,34,30,SYR,85,34,30,68,60
1957-03-03,MNL,119,28,38,NYK,108,33,33,61,71
1957-03-03,BOS,111,42,24,ROC,102,29,38,71,62
1957-03-03,FTW,102,32,33,STL,112,30,36,62,69
1957-03-03,SYR,112,34,31,PHW,86,35,30,69,61
1957-03-05,STL,104,31,36,BOS,102,43,24,74,60
1957-03-05,NYK,92,33,34,SYR,99,35,31,68,65
1957-03-05,PHW,114,35,31,FTW,80,32,34,67,65
1957-03-06,SYR,93,36,31,NYK,100,33,35,69,66
1957-03-06,ROC,82,29,39,PHW,79,36,31,65,70
1957-03-07,MNL,109,29,38,BOS,104,43,25,72,63
1957-03-07,PHW,114,36,32,FTW,100,32,35,68,67
1957-03-07,NYK,99,34,35,SYR,94,36,32,70,67
1957-03-08,FTW,97,32,36,MNL,101,30,38,62,74
1957-03-08,STL,100,32,36,ROC,92,30,39,62,75
1957-03-09,SYR,104,36,33,BOS,102,43,26,79,59
1957-03-09,STL,97,33,36,FTW,96,32,37,65,73
1957-03-10,MNL,117,31,38,STL,104,34,36,65,74
1957-03-10,NYK,104,35,35,PHW,103,37,32,72,67
1957-03-10,FTW,100,32,38,ROC,96,30,40,62,78
1957-03-10,BOS,92,43,27,SYR,94,37,33,80,60
1957-03-12,MNL,100,32,38,PHW,94,37,33,69,71
1957-03-13,ROC,104,30,41,STL,99,34,37,64,78
1957-03-13,MNL,114,33,38,PHW,97,37,34,70,72
1957-03-13,BOS,122,43,28,NYK,91,36,35,79,63
1957-03-13,FTW,114,33,38,SYR,81,38,33,71,71
1957-03-14,STL,115,34,38,FTW,103,34,38,68,76
1957-03-16,STL,114,35,38,MNL,111,34,38,69,76
1957-10-22,STL,90,0,0,BOS,115,0,0,0,0
1957-10-23,NYK,112,0,0,STL,95,0,1,0,1
1957-10-23,DET,94,0,0,BOS,105,1,0,1,0
1957-10-25,SYR,103,0,0,PHW,85,0,0,0,0
1957-10-26,NYK,121,1,0,BOS,131,2,0,3,0
1957-10-26,CIN,110,0,0,SYR,100,1,0,1,0
1957-10-26,DET,100,0,1,PHW,112,0,1,0,2
1957-10-26,STL,112,0,2,MNL,84,0,0,0,2
1957-10-30,MNL,96,0,1,DET,115,0,2,0,3
1957-11-01,SYR,113,1,1,MNL,100,0,2,1,3
1957-11-01,CIN,99,1,0,STL,92,1,2,2,2
1957-11-02,PHW,118,1,1,MNL,108,0,3,1,4
1957-11-02,STL,102,1,3,CIN,93,2,0,3,3
1957-11-02,BOS,107,3,0,SYR,83,2,1,5,1
1957-11-03,NYK,123,1,1,PHW,105,2,1,3,2
1957-11-03,SYR,95,2,2,BOS,113,4,0,6,2
1957-11-03,CIN,88,2,1,DET,94,1,2,3,3
1957-11-05,BOS,111,5,0,DET,105,2,2,7,2
1957-11-05,STL,115,2,3,SYR,101,2,3,4,6
1957-11-06,MNL,94,0,4,BOS,103,6,0,6,4
1957-11-07,PHW,113,2,2,NYK,101,2,1,4,3
1957-11-08,CIN,110,2,2,BOS,122,7,0,9,2
1957-11-08,PHW,119,3,2,MNL,108,0,5,3,7
1957-11-08,SYR,99,2,4,NYK,104,2,2,4,6
1957-11-09,STL,105,3,3,PHW,100,4,2,7,5
1957-11-10,CIN,101,2,3,PHW,106,4,3,6,6
1957-11-11,BOS,92,8,0,STL,88,4,3,12,3
1957-11-12,DET,109,2,3,NYK,107,3,2,5,5
1957-11-12,BOS,107,9,0,MNL,104,0,6,9,6
1957-11-13,MNL,124,0,7,NYK,106,3,3,3,10
1957-11-14,PHW,94,5,3,SYR,97,2,5,7,8
1957-11-15,DET,104,3,3,MNL,112,1,7,4,10
1957-11-15,CIN,101,2,4,NYK,99,3,4,5,8
1957-11-15,SYR,91,3,5,STL,86,4,4,7,9
1957-11-16,NYK,105,3,5,DET,109,3,4,6,9
1957-11-16,STL,118,4,5,SYR,101,4,5,8,10
1957-11-16,BOS,111,10,0,PHW,89,5,4,15,4
1957-11-17,MNL,98,2,7,SYR,110,4,6,6,13
1957-11-17,CIN,97,3,4,STL,98,5,5,8,9
1957-11-17,PHW,91,5,5,DET,95,4,4,9,9
1957-11-19,STL,118,6,5,NYK,115,3,6,9,11
1957-11-19,CIN,92,3,5,DET,75,5,4,8,9
1957-11-20,MNL,101,2,8,NYK,105,3,7,5,15
1957-11-20,PHW,89,5,6,CIN,99,4,5,9,11
1957-11-21,NYK,124,4,7,MNL,123,2,9,6,16
1957-11-21,DET,90,5,5,BOS,112,11,0,16,5
1957-11-22,SYR,98,5,6,CIN,102,5,5,10,11
1957-11-23,NYK,115,5,7,SYR,119,5,7,10,14
1957-11-23,STL,115,7,5,DET,110,5,6,12,11
1957-11-23,BOS,131,12,0,MNL,107,2,10,14,10
1957-11-24,PHW,105,5,7,MNL,98,2,11,7,18
1957-11-26,NYK,110,5,8,STL,120,8,5,13,13
1957-11-26,DET,109,5,7,MNL,91,2,12,7,19
1957-11-27,DET,110,6,7,STL,121,9,5,15,12
1957-11-27,BOS,120,13,0,NYK,107,5,9,18,9
1957-11-27,CIN,107,6,5,MNL,106,2,13,8,18
1957-11-27,SYR,92,6,7,PHW,87,6,7,12,14
1957-11-28,PHW,102,6,8,SYR,98,7,7,13,15
1957-11-28,STL,112,10,5,CIN,96,7,5,17,10
1957-11-28,NYK,97,5,10,BOS,80,14,0,19,10
1957-11-29,CIN,99,7,6,DET,96,6,8,13,14
1957-11-30,MNL,118,2,14,STL,113,11,5,13,19
1957-11-30,BOS,118,14,1,SYR,112,7,8,21,9
1957-11-30,DET,100,6,9,CIN,96,8,6,14,15
1957-11-30,PHW,111,7,8,NYK,83,6,10,13,18
1957-12-01,SYR,118,7,9,BOS,109,15,1,22,10
1957-12-01,NYK,109,6,11,DET,102,7,9,13,20
1957-12-01,CIN,90,8,7,MNL,89,3,14,11,21
1957-12-03,DET,113,7,10,BOS,124,15,2,22,12
1957-12-03,STL,115,11,6,MNL,108,3,15,14,21
1957-12-03,NYK,110,7,11,CIN,104,9,7,16,18
1957-12-03,SYR,119,8,9,PHW,96,8,8,16,17
1957-12-04,MNL,98,3,16,BOS,108,16,2,19,18
1957-12-05,PHW,124,8,9,STL,109,12,6,20,15
1957-12-05,CIN,109,9,8,DET,99,7,11,16,19
1957-12-06,BOS,111,17,2,STL,97,12,7,29,9
1957-12-06,CIN,97,10,8,NYK,112,8,11,18,19
1957-12-06,SYR,118,9,9,DET,91,7,12,16,21
1957-12-07,MNL,121,3,17,SYR,113,10,9,13,26
1957-12-07,PHW,106,9,9,BOS,112,18,2,27,11
1957-12-07,DET,109,7,13,CIN,105,10,9,17,22
1957-12-08,STL,110,12,8,NYK,113,9,11,21,19
1957-12-08,CIN,99,10,10,PHW,88,9,10,19,20
1957-12-10,SYR,114,10,10,MNL,104,4,17,14,27
1957-12-10,NYK,106,10,11,BOS,103,19,2,29,13
1957-12-10,DET,97,8,13,PHW,100,9,11,17,24
1957-12-10,STL,102,12,9,CIN,90,11,10,23,19
1957-12-11,STL,135,13,9,NYK,126,11,11,24,20
1957-12-11,BOS,116,19,3,CIN,104,11,11,30,14
1957-12-11,MNL,110,4,18,SYR,95,11,10,15,28
1957-12-12,PHW,96,10,11,DET,101,8,14,18,25
1957-12-12,STL,97,14,9,BOS,94,20,3,34,12
1957-12-14,STL,136,15,9,NYK,124,11,12,26,21
1957-12-14,SYR,104,11,11,CIN,100,11,12,22,23
1957-12-14,BOS,112,20,4,PHW,94,10,12,30,16
1957-12-15,MNL,118,5,18,STL,138,16,9,21,27
1957-12-15,DET,109,9,14,NYK,116,11,13,20,27
1957-12-15,SYR,109,12,11,CIN,83,11,13,23,24
1957-12-17,NYK,123,12,13,SYR,117,13,11,25,24
1957-12-17,STL,106,17,9,DET,99,9,15,26,24
1957-12-18,MNL,108,5,19,PHW,102,10,13,15,32
1957-12-20,CIN,113,11,14,SYR,122,13,12,24,26
1957-12-21,STL,146,18,9,SYR,136,14,12,32,21
1957-12-21,BOS,140,21,4,MNL,119,6,19,27,23
1957-12-21,DET,112,9,16,CIN,101,11,15,20,31
1957-12-22,STL,123,19,9,MNL,115,6,20,25,29
1957-12-22,NYK,126,13,13,PHW,100,10,14,23,27
1957-12-22,CIN,98,11,16,BOS,116,22,4,33,20
1957-12-22,SYR,119,14,13,DET,93,10,16,24,29
1957-12-25,SYR,134,15,13,NYK,130,14,13,29,26
1957-12-25,PHW,115,10,15,BOS,105,23,4,33,19
1957-12-25,DET,104,10,17,MNL,106,6,21,16,38
1957-12-26,BOS,120,23,5,NYK,110,14,14,37,19
1957-12-26,STL,106,20,9,DET,110,10,18,30,27
1957-12-26,SYR,104,16,13,CIN,100,11,17,27,30
1957-12-27,NYK,125,14,15,DET,120,11,18,25,33
1957-12-27,PHW,110,11,15,BOS,106,24,5,35,20
1957-12-27,CIN,96,11,18,STL,97,20,10,31,28
1957-12-28,PHW,122,12,15,NYK,115,15,15,27,30
1957-12-28,DET,117,11,19,SYR,111,17,13,28,32
1957-12-28,STL,112,21,10,BOS,107,24,6,45,16
1957-12-28,MNL,101,7,21,CIN,112,11,19,18,40
1957-12-29,CIN,103,12,19,MNL,111,7,22,19,41
1957-12-29,SYR,105,17,14,PHW,97,13,15,30,29
1957-12-30,STL,105,22,10,MNL,98,8,22,30,32
1957-12-31,NYK,142,15,16,MNL,116,8,23,23,39
1957-12-31,CIN,130,12,20,DET,96,12,19,24,39
1958-01-01,SYR,120,18,14,MNL,109,8,24,26,38
1958-01-02,NYK,131,16,16,SYR,98,19,14,35,30
1958-01-02,PHW,95,13,16,STL,93,23,10,36,26
1958-01-03,CIN,106,13,20,PHW,94,14,16,27,36
1958-01-04,SYR,115,19,15,BOS,106,24,7,43,22
1958-01-04,DET,81,12,20,PHW,78,14,17,26,37
1958-01-05,NYK,100,17,16,CIN,101,14,20,31,36
1958-01-05,BOS,113,24,8,MNL,100,8,25,32,33
1958-01-05,PHW,96,14,18,SYR,111,20,15,34,33
1958-01-05,STL,95,23,11,DET,93,13,20,36,31
1958-01-07,NYK,112,17,17,STL,114,24,11,41,28
1958-01-07,CIN,114,15,20,DET,99,13,21,28,41
1958-01-08,DET,109,13,22,SYR,107,21,15,34,37
1958-01-08,NYK,123,17,18,CIN,105,16,20,33,38
1958-01-08,MNL,87,8,26,BOS,107,25,8,33,34
1958-01-09,NYK,136,18,18,BOS,123,26,8,44,26
1958-01-09,SYR,127,21,16,MNL,122,8,27,29,43
1958-01-10,MNL,124,8,28,DET,114,14,22,22,50
1958-01-10,CIN,107,16,21,NYK,104,19,18,35,39
1958-01-10,PHW,124,14,19,STL,93,25,11,39,30
1958-01-11,DET,129,14,23,MNL,102,9,28,23,51
1958-01-11,CIN,105,17,21,SYR,100,22,16,39,37
1958-01-11,STL,102,25,12,BOS,98,26,9,51,21
1958-01-12,NYK,110,19,19,PHW,115,15,19,34,38
1958-01-12,SYR,135,22,17,DET,109,15,23,37,40
1958-01-12,STL,111,26,12,MNL,105,9,29,35,41
1958-01-12,CIN,115,18,21,BOS,97,26,10,44,31
1958-01-14,CIN,117,19,21,NYK,111,19,20,38,41
1958-01-14,STL,109,27,12,PHW,110,16,19,43,31
1958-01-15,BOS,131,26,11,DET,113,15,24,41,35
1958-01-16,PHW,108,17,19,DET,113,15,25,32,44
1958-01-16,CIN,124,20,21,MNL,108,9,30,29,51
1958-01-16,SYR,112,23,17,STL,96,27,13,50,30
1958-01-17,PHW,117,17,20,NYK,116,19,21,36,41
1958-01-17,MNL,112,9,31,STL,110,27,14,36,45
1958-01-17,BOS,120,27,11,SYR,99,24,17,51,28
1958-01-17,DET,115,16,25,CIN,94,21,21,37,46
1958-01-18,NYK,123,19,22,SYR,120,24,18,43,40
1958-01-18,PHW,116,18,20,BOS,104,28,11,46,31
1958-01-18,STL,105,27,15,DET,103,17,25,44,40
1958-01-19,BOS,114,28,12,PHW,113,19,20,47,32
1958-01-19,MNL,118,10,31,DET,111,17,26,27,57
1958-01-19,SYR,112,24,19,NYK,108,20,22,44,41
1958-01-19,STL,108,28,15,CIN,90,21,22,49,37
1958-01-22,SYR,109,25,19,CIN,115,21,23,46,42
1958-01-22,DET,92,17,27,NYK,115,20,23,37,50
1958-01-22,MNL,87,11,31,BOS,97,29,12,40,43
1958-01-23,MNL,128,11,32,DET,125,17,28,28,60
1958-01-23,SYR,101,25,20,PHW,88,19,21,44,41
1958-01-24,BOS,125,30,12,NYK,104,21,23,51,35
1958-01-24,CIN,92,22,23,PHW,102,19,22,41,45
1958-01-25,NYK,128,21,24,MNL,116,12,32,33,56
1958-01-25,SYR,112,26,20,BOS,100,31,12,57,32
1958-01-25,DET,105,17,29,STL,98,29,15,46,44
1958-01-26,STL,112,29,16,PHW,125,20,22,49,38
1958-01-26,MNL,106,12,33,NYK,109,22,24,34,57
1958-01-26,CIN,107,22,24,DET,103,18,29,40,53
1958-01-26,BOS,118,31,13,SYR,95,27,20,58,33
1958-01-27,NYK,113,23,24,MNL,102,12,34,35,58
1958-01-27,DET,115,18,30,PHW,93,21,22,39,52
1958-01-28,STL,123,29,17,PHW,109,21,23,50,40
1958-01-28,NYK,102,24,24,SYR,110,27,21,51,45
1958-01-29,BOS,111,32,13,STL,101,30,17,62,30
1958-01-30,MNL,105,12,35,CIN,104,23,24,35,59
1958-01-30,PHW,116,21,24,BOS,96,33,13,54,37
1958-01-30,DET,87,19,30,SYR,83,28,21,47,51
1958-01-31,DET,119,20,30,NYK,105,24,25,44,55
1958-01-31,BOS,101,33,14,PHW,110,22,24,55,38
1958-01-31,CIN,100,23,25,STL,92,30,18,53,43
1958-02-01,NYK,114,24,26,BOS,121,33,15,57,41
1958-02-01,MNL,91,13,35,SYR,97,28,22,41,57
1958-02-01,STL,127,30,19,CIN,88,24,25,54,44
1958-02-01,PHW,106,23,24,DET,86,21,30,44,54
1958-02-02,PHW,131,24,24,NYK,120,24,27,48,51
1958-02-02,BOS,119,34,15,DET,115,21,31,55,46
1958-02-02,STL,100,31,19,SYR,102,29,22,60,41
1958-02-02,MNL,106,13,36,CIN,95,24,26,37,62
1958-02-04,NYK,120,24,28,STL,116,31,20,55,48
1958-02-04,DET,118,21,32,SYR,113,30,22,51,54
1958-02-04,PHW,107,25,24,MNL,103,14,36,39,60
1958-02-04,BOS,107,35,15,CIN,87,24,27,59,42
1958-02-05,MNL,102,14,37,PHW,112,26,24,40,61
1958-02-05,BOS,116,36,15,CIN,89,24,28,60,43
1958-02-07,DET,125,22,32,STL,107,31,21,53,53
1958-02-07,SYR,105,30,23,NYK,102,25,28,55,51
1958-02-07,PHW,100,27,24,CIN,103,24,29,51,53
1958-02-07,BOS,114,37,15,MNL,88,14,38,51,53
1958-02-08,SYR,102,31,23,STL,103,31,22,62,45
1958-02-08,NYK,94,25,29,MNL,93,14,39,39,68
1958-02-08,BOS,109,38,15,CIN,91,25,29,63,44
1958-02-09,CIN,121,25,30,MNL,104,14,40,39,70
1958-02-09,DET,98,23,32,NYK,100,26,29,49,61
1958-02-09,PHW,105,27,25,STL,98,32,22,59,47
1958-02-09,SYR,123,31,24,BOS,98,39,15,70,39
1958-02-11,STL,107,32,23,NYK,105,27,29,59,52
1958-02-11,CIN,106,26,30,MNL,103,14,41,40,71
1958-02-11,PHW,115,28,25,DET,98,23,33,51,58
1958-02-11,SYR,84,32,24,BOS,76,39,16,71,40
1958-02-12,DET,105,23,34,STL,122,33,23,56,57
1958-02-12,BOS,119,39,17,SYR,101,33,24,72,41
1958-02-12,MNL,97,14,42,NYK,106,27,30,41,72
1958-02-13,SYR,108,33,25,PHW,98,29,25,62,50
1958-02-14,BOS,109,40,17,DET,111,23,35,63,52
1958-02-14,MNL,100,14,43,STL,104,34,23,48,66
1958-02-14,CIN,92,27,30,NYK,103,28,30,55,60
1958-02-15,DET,110,24,35,MNL,111,14,44,38,79
1958-02-15,NYK,99,29,30,CIN,97,27,31,56,61
1958-02-15,PHW,96,29,26,BOS,110,40,18,69,44
1958-02-16,SYR,113,34,25,CIN,105,27,32,61,57
1958-02-16,MNL,106,15,44,PHW,99,29,27,44,71
1958-02-16,STL,98,35,23,DET,100,24,36,59,59
1958-02-18,NYK,111,30,30,BOS,113,41,18,71,48
1958-02-18,STL,118,35,24,MNL,98,16,44,51,68
1958-02-18,DET,120,25,36,SYR,98,35,25,60,61
1958-02-19,MNL,115,16,45,DET,117,26,36,42,81
1958-02-19,SYR,116,35,26,NYK,110,30,31,65,57
1958-02-19,PHW,123,29,28,BOS,103,42,18,71,46
1958-02-20,PHW,110,30,28,SYR,97,36,26,66,54
1958-02-20,BOS,94,42,19,CIN,92,27,33,69,52
1958-02-21,PHW,117,31,28,NYK,111,30,32,61,60
1958-02-21,CIN,107,27,34,DET,109,27,36,54,70
1958-02-21,STL,119,36,24,BOS,100,43,19,79,43
1958-02-22,NYK,115,30,33,SYR,112,36,27,66,60
1958-02-22,DET,98,28,36,STL,96,37,24,65,60
1958-02-22,MNL,100,16,46,CIN,81,27,35,43,81
1958-02-23,BOS,99,43,20,PHW,97,32,28,75,48
1958-02-23,CIN,111,27,36,MNL,93,17,46,44,82
1958-02-23,SYR,101,36,28,STL,92,37,25,73,53
1958-02-24,PHW,110,32,29,MNL,95,17,47,49,76
1958-02-25,DET,114,29,36,STL,113,37,26,66,62
1958-02-25,NYK,110,31,33,PHW,132,33,29,64,62
1958-02-26,STL,105,37,27,CIN,103,28,36,65,63
1958-02-26,DET,99,30,36,BOS,106,44,20,74,56
1958-02-26,NYK,112,31,34,PHW,96,34,29,65,63
1958-02-26,SYR,119,37,28,MNL,90,17,48,54,76
1958-02-27,DET,112,30,37,MNL,109,17,49,47,86
1958-02-27,PHW,97,34,30,SYR,91,38,28,72,58
1958-03-01,NYK,101,32,34,DET,103,31,37,63,71
1958-03-01,PHW,88,35,30,CIN,101,28,37,63,67
1958-03-02,SYR,100,38,29,BOS,107,45,20,83,49
1958-03-02,STL,103,38,27,CIN,93,29,37,67,64
1958-03-02,MNL,102,17,50,PHW,92,35,31,52,81
1958-03-04,NYK,104,32,35,BOS,99,46,20,78,55
1958-03-04,PHW,97,35,32,CIN,91,29,38,64,70
1958-03-05,BOS,109,46,21,STL,102,39,27,85,48
1958-03-05,SYR,102,38,30,NYK,91,33,35,71,65
1958-03-06,MNL,116,18,50,DET,132,32,37,50,87
1958-03-06,PHW,108,36,32,CIN,110,29,39,65,71
1958-03-07,STL,102,39,28,SYR,100,39,30,78,58
1958-03-08,STL,126,40,28,MNL,123,18,51,58,79
1958-03-08,BOS,108,47,21,DET,103,33,37,80,58
1958-03-09,BOS,107,48,21,CIN,121,30,39,78,60
1958-03-09,MNL,107,18,52,STL,99,41,28,59,80
1958-03-09,SYR,111,39,31,DET,90,33,38,72,69
1958-03-09,NYK,123,33,36,PHW,81,36,33,69,69
1958-03-10,CIN,122,31,39,STL,84,41,29,72,68
1958-03-11,BOS,126,48,22,NYK,119,34,36,82,58
1958-03-11,STL,101,41,30,PHW,106,36,34,77,64
1958-03-12,BOS,125,49,22,NYK,127,34,37,83,59
1958-03-12,SYR,110,40,31,PHW,99,37,34,77,65
1958-03-12,MNL,89,19,52,CIN,96,32,39,51,91
1958-10-19,SYR,103,0,0,DET,94,0,0,0,0
1958-10-22,MNL,99,0,0,CIN,79,0,0,0,0
1958-10-23,STL,104,0,0,DET,103,0,1,0,1
1958-10-25,NYK,127,0,0,BOS,125,0,0,0,0
1958-10-25,DET,117,0,2,STL,112,1,0,1,2
1958-10-25,SYR,109,1,0,PHW,110,0,0,1,0
1958-10-25,CIN,110,0,1,MNL,94,1,0,1,1
1958-10-26,MNL,108,1,1,DET,100,1,2,2,3
1958-10-26,PHW,94,1,0,NYK,100,1,0,2,0
1958-10-29,MNL,100,2,1,STL,112,1,1,3,2
1958-10-31,DET,120,1,3,CIN,113,1,1,2,4
1958-11-01,SYR,130,1,1,CIN,108,1,2,2,3
1958-11-01,STL,101,2,1,MNL,108,2,2,4,3
1958-11-01,BOS,112,0,1,DET,98,2,3,2,4
1958-11-01,NYK,92,2,0,PHW,111,1,1,3,1
1958-11-02,PHW,91,2,1,DET,107,2,4,4,5
1958-11-02,CIN,90,1,3,STL,97,2,2,3,5
1958-11-05,SYR,115,2,1,BOS,117,1,1,3,2
1958-11-05,CIN,97,1,4,NYK,108,2,1,3,5
1958-11-06,MNL,103,3,2,PHW,101,2,2,5,4
1958-11-07,DET,101,3,4,NYK,115,3,1,6,5
1958-11-08,MNL,100,4,2,NYK,108,4,1,8,3
1958-11-08,PHW,98,2,3,SYR,103,2,2,4,5
1958-11-08,STL,87,3,2,BOS,84,2,1,5,3
1958-11-09,DET,136,3,5,BOS,133,2,2,5,7
1958-11-09,SYR,101,3,2,MNL,97,4,3,7,5
1958-11-09,CIN,92,1,5,PHW,106,2,4,3,9
1958-11-11,BOS,116,2,3,MNL,113,4,4,6,7
1958-11-12,CIN,115,1,6,SYR,116,4,2,5,8
1958-11-13,DET,119,4,5,MNL,110,4,5,8,10
1958-11-13,NYK,119,5,1,STL,102,4,2,9,3
1958-11-14,DET,109,5,5,SYR,111,5,2,10,7
1958-11-14,STL,110,4,3,PHW,100,3,4,7,7
1958-11-15,BOS,130,3,3,CIN,105,1,7,4,10
1958-11-15,PHW,106,3,5,MNL,101,4,6,7,11
1958-11-15,SYR,92,6,2,NYK,96,6,1,12,3
1958-11-15,STL,102,5,3,DET,91,5,6,10,9
1958-11-16,NYK,98,7,1,MNL,90,4,7,11,8
1958-11-18,BOS,115,4,3,DET,102,5,7,9,10
1958-11-18,STL,94,6,3,SYR,120,6,3,12,6
1958-11-19,CIN,119,1,8,BOS,103,5,3,6,11
1958-11-20,MNL,121,4,8,SYR,102,7,3,11,11
1958-11-21,NYK,112,8,1,BOS,106,5,4,13,5
1958-11-21,PHW,108,4,5,CIN,90,2,8,6,13
1958-11-22,STL,114,6,4,MNL,109,5,8,11,12
1958-11-22,BOS,105,5,5,PHW,100,5,5,10,10
1958-11-22,NYK,114,9,1,SYR,99,7,4,16,5
1958-11-22,DET,103,5,8,CIN,86,2,9,7,17
1958-11-23,MNL,109,5,9,DET,124,6,8,11,17
1958-11-23,PHW,110,5,6,SYR,107,7,5,12,11
1958-11-23,CIN,89,2,10,STL,100,7,4,9,14
1958-11-24,BOS,123,6,5,MNL,104,5,10,11,15
1958-11-25,NYK,113,10,1,CIN,115,2,11,12,12
1958-11-25,PHW,106,6,6,STL,105,8,4,14,10
1958-11-25,DET,90,7,8,MNL,98,5,11,12,19
1958-11-26,BOS,121,7,5,NYK,109,10,2,17,7
1958-11-26,SYR,107,7,6,STL,112,8,5,15,11
1958-11-26,CIN,95,3,11,DET,112,7,9,10,20
1958-11-27,STL,107,9,5,SYR,98,7,7,16,12
1958-11-27,PHW,94,7,6,BOS,107,8,5,15,11
1958-11-28,DET,101,8,9,SYR,93,7,8,15,17
1958-11-28,MNL,114,6,11,CIN,93,3,12,9,23
1958-11-29,SYR,105,7,9,MNL,108,7,11,14,20
1958-11-29,NYK,115,10,3,PHW,103,7,7,17,10
1958-11-29,BOS,110,9,5,DET,96,9,9,18,14
1958-11-29,STL,98,10,5,CIN,86,3,13,13,18
1958-11-30,PHW,103,7,8,NYK,100,11,3,18,11
1958-11-30,CIN,77,3,14,MNL,84,8,11,11,25
1958-12-02,DET,95,9,10,PHW,91,8,8,17,18
1958-12-02,NYK,90,11,4,BOS,109,10,5,21,9
1958-12-02,STL,105,11,5,CIN,81,3,15,14,20
1958-12-03,BOS,110,11,5,STL,119,12,5,23,10
1958-12-03,CIN,110,3,16,NYK,108,11,5,14,21
1958-12-04,BOS,116,11,6,SYR,114,7,10,18,16
1958-12-04,PHW,92,8,9,STL,107,13,5,21,14
1958-12-05,DET,108,10,10,NYK,110,11,6,21,16
1958-12-06,CIN,132,4,16,MNL,128,9,11,13,27
1958-12-06,STL,107,14,5,PHW,97,8,10,22,15
1958-12-06,NYK,92,12,6,DET,99,10,11,22,17
1958-12-06,BOS,92,12,6,SYR,101,7,11,19,17
1958-12-07,SYR,108,8,11,BOS,104,12,7,20,18
1958-12-07,CIN,90,5,16,PHW,103,8,11,13,27
1958-12-09,NYK,110,12,7,MNL,97,9,12,21,19
1958-12-09,SYR,106,9,11,PHW,90,9,11,18,22
1958-12-10,BOS,100,12,8,PHW,97,9,12,21,20
1958-12-10,CIN,94,5,17,SYR,97,10,11,15,28
1958-12-10,DET,89,11,11,STL,82,15,5,26,16
1958-12-11,PHW,114,9,13,BOS,123,13,8,22,21
1958-12-11,DET,107,12,11,STL,101,15,6,27,17
1958-12-11,MNL,99,9,13,SYR,101,11,11,20,24
1958-12-12,BOS,125,14,8,CIN,115,5,18,19,26
1958-12-12,NYK,106,13,7,STL,104,15,7,28,14
1958-12-12,DET,97,13,11,PHW,95,9,14,22,25
1958-12-13,SYR,115,12,11,PHW,100,9,15,21,26
1958-12-13,STL,108,15,8,NYK,94,14,7,29,15
1958-12-14,MNL,99,9,14,NYK,100,14,8,23,22
1958-12-14,DET,95,14,11,SYR,101,13,11,27,22
1958-12-16,NYK,118,15,8,CIN,106,5,19,20,27
1958-12-16,SYR,104,14,11,BOS,108,15,8,29,19
1958-12-17,STL,136,16,8,NYK,122,16,8,32,16
1958-12-17,DET,95,14,12,BOS,102,16,8,30,20
1958-12-18,MNL,113,9,15,DET,104,14,13,23,28
1958-12-18,CIN,90,5,20,BOS,104,17,8,22,28
1958-12-20,SYR,120,14,12,CIN,121,5,21,19,33
1958-12-20,BOS,135,18,8,NYK,106,16,9,34,17
1958-12-20,DET,104,14,14,STL,111,17,8,31,22
1958-12-20,MNL,99,10,15,PHW,88,9,16,19,31
1958-12-21,NYK,108,16,10,SYR,94,14,13,30,23
1958-12-21,STL,98,18,8,PHW,86,9,17,27,25
1958-12-25,NYK,120,17,10,BOS,129,19,8,36,18
1958-12-25,DET,98,14,15,MNL,97,11,15,25,30
1958-12-25,CIN,92,6,21,STL,100,19,8,25,29
1958-12-26,BOS,107,20,8,MNL,99,11,16,31,24
1958-12-26,PHW,106,9,18,NYK,93,17,11,26,29
1958-12-26,DET,131,15,15,CIN,91,6,22,21,37
1958-12-27,PHW,114,10,18,STL,108,20,8,30,26
1958-12-27,SYR,102,14,14,NYK,106,17,12,31,26
1958-12-27,MNL,94,11,17,BOS,112,21,8,32,25
1958-12-28,CIN,120,6,23,MNL,116,11,18,17,41
1958-12-29,STL,124,20,9,CIN,112,7,23,27,32
1958-12-29,BOS,107,22,8,SYR,105,14,15,36,23
1958-12-29,PHW,95,11,18,MNL,93,11,19,22,37
1958-12-30,MNL,118,11,20,SYR,113,14,16,25,36
1958-12-30,PHW,112,12,18,BOS,105,23,8,35,26
1958-12-30,CIN,104,7,24,STL,119,21,9,28,33
1958-12-30,NYK,93,18,12,DET,90,16,15,34,27
1959-01-01,SYR,105,14,17,MNL,106,12,20,26,37
1959-01-02,PHW,107,13,18,SYR,117,14,18,27,36
1959-01-02,CIN,111,7,25,DET,104,16,16,23,41
1959-01-02,MNL,107,13,20,NYK,97,19,12,32,32
1959-01-03,STL,116,22,9,BOS,110,23,9,45,18
1959-01-03,DET,102,16,17,NYK,106,19,13,35,30
1959-01-04,STL,114,23,9,NYK,122,20,13,43,22
1959-01-04,CIN,108,8,25,BOS,111,23,10,31,35
1959-01-04,PHW,95,13,19,MNL,111,14,20,27,39
1959-01-04,SYR,118,15,18,DET,94,16,18,31,36
1959-01-05,BOS,118,24,10,MNL,106,15,20,39,30
1959-01-06,NYK,118,21,13,SYR,108,16,18,37,31
1959-01-06,PHW,105,13,20,DET,107,16,19,29,39
1959-01-06,BOS,109,25,10,CIN,95,8,26,33,36
1959-01-06,STL,112,23,10,MNL,95,15,21,38,31
1959-01-07,SYR,111,16,19,PHW,99,13,21,29,40
1959-01-07,STL,89,24,10,MNL,78,15,22,39,32
1959-01-07,NYK,78,22,13,BOS,109,26,10,48,23
1959-01-08,CIN,138,8,27,SYR,145,17,19,25,46
1959-01-08,MNL,95,15,23,STL,93,25,10,40,33
1959-01-09,STL,112,25,11,CIN,101,8,28,33,39
1959-01-09,DET,90,17,19,BOS,103,27,10,44,29
1959-01-10,PHW,103,13,22,NYK,97,22,14,35,36
1959-01-10,CIN,69,8,29,DET,101,17,20,25,49
1959-01-11,SYR,127,18,19,CIN,110,8,30,26,49
1959-01-11,BOS,109,28,10,MNL,106,16,23,44,33
1959-01-11,NYK,111,22,15,PHW,105,14,22,36,37
1959-01-11,STL,111,26,11,DET,100,18,20,44,31
1959-01-12,BOS,117,29,10,MNL,108,16,24,45,34
1959-01-13,STL,110,27,11,MNL,95,16,25,43,36
1959-01-13,DET,112,18,21,CIN,92,8,31,26,52
1959-01-14,BOS,123,30,10,NYK,112,23,15,53,25
1959-01-14,DET,108,19,21,STL,114,28,11,47,32
1959-01-14,SYR,119,19,19,PHW,104,14,23,33,42
1959-01-15,SYR,111,20,19,MNL,105,16,26,36,45
1959-01-15,NYK,91,23,16,PHW,95,14,24,37,40
1959-01-16,PHW,105,15,24,BOS,98,31,10,46,34
1959-01-16,CIN,95,8,32,MNL,91,16,27,24,59
1959-01-16,STL,102,29,11,SYR,89,21,19,50,30
1959-01-17,NYK,117,23,17,CIN,105,9,32,32,49
1959-01-17,DET,104,19,22,PHW,106,16,24,35,46
1959-01-18,SYR,118,21,20,NYK,120,24,17,45,37
1959-01-18,BOS,139,31,11,STL,117,30,11,61,22
1959-01-18,MNL,119,16,28,PHW,98,17,24,33,52
1959-01-18,CIN,107,9,33,DET,88,19,23,28,56
1959-01-20,STL,119,30,12,BOS,114,32,11,62,23
1959-01-20,CIN,114,10,33,NYK,108,25,17,35,50
1959-01-21,SYR,134,21,21,BOS,112,32,12,53,33
1959-01-21,CIN,109,11,33,NYK,130,25,18,36,51
1959-01-21,PHW,112,17,25,DET,105,19,24,36,49
1959-01-24,NYK,122,26,18,DET,118,19,25,45,43
1959-01-24,BOS,132,32,13,PHW,104,18,25,50,38
1959-01-24,SYR,123,22,21,CIN,102,11,34,33,55
1959-01-25,BOS,119,33,13,DET,118,19,26,52,39
1959-01-25,STL,115,31,12,NYK,111,27,18,58,30
1959-01-25,PHW,125,18,26,MNL,111,17,28,35,54
1959-01-25,CIN,109,11,35,SYR,104,23,21,34,56
1959-01-26,PHW,102,19,26,DET,98,19,27,38,53
1959-01-27,NYK,111,27,19,STL,112,32,12,59,31
1959-01-27,DET,107,19,28,SYR,121,23,22,42,50
1959-01-27,CIN,100,12,35,PHW,92,20,26,32,61
1959-01-28,BOS,120,34,13,STL,111,33,12,67,25
1959-01-28,MNL,112,17,29,SYR,109,24,22,41,51
1959-01-28,PHW,99,20,27,CIN,84,13,35,33,62
1959-01-29,SYR,117,24,23,MNL,91,18,29,42,52
1959-01-30,STL,118,33,13,CIN,87,13,36,46,49
1959-01-30,MNL,88,18,30,DET,86,19,29,37,59
1959-01-31,NYK,119,27,20,SYR,117,25,23,52,43
1959-01-31,BOS,137,35,13,PHW,102,21,27,56,40
1959-01-31,STL,120,34,13,MNL,96,19,30,53,43
1959-01-31,DET,103,19,30,CIN,88,13,37,32,67
1959-02-01,BOS,139,36,13,SYR,137,25,24,61,37
1959-02-01,NYK,105,28,20,PHW,113,21,28,49,48
1959-02-01,STL,130,35,13,DET,96,20,30,55,43
1959-02-03,NYK,115,28,21,SYR,114,25,25,53,46
1959-02-03,CIN,120,13,38,PHW,103,22,28,35,66
1959-02-03,BOS,104,37,13,STL,97,36,13,73,26
1959-02-04,BOS,126,38,13,NYK,129,29,21,67,34
1959-02-04,DET,119,20,31,PHW,117,22,29,42,60
1959-02-04,SYR,111,25,26,STL,113,36,14,61,40
1959-02-05,NYK,111,30,21,SYR,98,25,27,55,48
1959-02-05,PHW,106,22,30,STL,95,37,14,59,44
1959-02-06,SYR,122,25,28,DET,103,21,31,46,59
1959-02-06,BOS,122,38,14,STL,95,37,15,75,29
1959-02-07,NYK,116,31,21,BOS,124,39,14,70,35
1959-02-07,MNL,109,19,31,PHW,97,23,30,42,61
1959-02-08,BOS,136,40,14,CIN,117,14,38,54,52
1959-02-08,SYR,113,26,28,NYK,104,31,22,57,50
1959-02-08,DET,103,21,32,MNL,115,20,31,41,63
1959-02-08,STL,100,37,16,PHW,93,23,31,60,47
1959-02-09,MNL,128,21,31,NYK,122,31,23,52,54
1959-02-09,PHW,121,23,32,BOS,113,41,14,64,46
1959-02-09,DET,122,21,33,CIN,97,14,39,35,72
1959-02-09,STL,99,38,16,SYR,94,27,28,65,44
1959-02-10,MNL,118,22,31,CIN,100,14,40,36,71
1959-02-11,BOS,120,41,15,PHW,118,24,32,65,47
1959-02-11,SYR,114,27,29,DET,118,22,33,49,62
1959-02-11,MNL,106,23,31,CIN,105,14,41,37,72
1959-02-12,CIN,119,14,42,MNL,114,24,31,38,73
1959-02-12,STL,106,39,16,NYK,105,31,24,70,40
1959-02-13,DET,96,23,33,NYK,90,31,25,54,58
1959-02-14,BOS,124,42,15,SYR,121,27,30,69,45
1959-02-14,STL,139,40,16,MNL,96,24,32,64,48
1959-02-14,PHW,106,24,33,CIN,94,15,42,39,75
1959-02-15,SYR,121,27,31,PHW,101,25,33,52,64
1959-02-15,MNL,109,24,33,STL,98,41,16,65,49
1959-02-15,NYK,124,31,26,CIN,97,15,43,46,69
1959-02-15,BOS,120,43,15,DET,94,24,33,67,48
1959-02-17,NYK,112,32,26,STL,93,41,17,73,43
1959-02-17,DET,90,24,34,MNL,97,25,33,49,67
1959-02-17,BOS,95,44,15,PHW,84,25,34,69,49
1959-02-18,CIN,116,15,44,NYK,118,33,26,48,70
1959-02-18,MNL,105,26,33,DET,95,24,35,50,68
1959-02-19,SYR,113,28,31,BOS,105,45,15,73,46
1959-02-20,DET,106,24,36,BOS,111,45,16,69,52
1959-02-20,MNL,116,27,33,NYK,106,34,26,61,59
1959-02-21,STL,121,41,18,CIN,120,15,45,56,63
1959-02-21,PHW,113,25,35,SYR,112,29,31,54,66
1959-02-21,DET,114,24,37,NYK,101,34,27,58,64
1959-02-22,CIN,112,15,46,BOS,129,46,16,61,62
1959-02-22,SYR,139,29,32,DET,108,25,37,54,69
1959-02-22,STL,120,42,18,MNL,106,28,33,70,51
1959-02-22,NYK,111,34,28,PHW,90,26,35,60,63
1959-02-24,NYK,134,35,28,BOS,122,47,16,82,44
1959-02-24,SYR,109,30,32,CIN,113,15,47,45,79
1959-02-25,PHW,134,26,36,NYK,123,36,28,62,64
1959-02-25,DET,100,25,38,STL,104,43,18,68,56
1959-02-25,MNL,116,28,34,CIN,96,16,47,44,81
1959-02-26,SYR,130,30,33,STL,111,44,18,74,51
1959-02-26,BOS,125,47,17,PHW,109,27,36,74,53
1959-02-26,CIN,106,16,48,DET,101,25,39,41,87
1959-02-27,BOS,173,48,17,MNL,139,29,34,77,51
1959-02-27,STL,128,44,19,SYR,113,31,33,75,52
1959-02-28,CIN,124,17,48,STL,122,45,19,62,67
1959-02-28,NYK,112,36,29,MNL,107,29,35,65,64
1959-03-01,SYR,140,31,34,NYK,115,37,29,68,63
1959-03-01,STL,104,45,20,BOS,102,49,17,94,37
1959-03-01,DET,117,25,40,CIN,101,18,48,43,88
1959-03-01,MNL,100,29,36,PHW,98,27,37,56,73
1959-03-03,NYK,120,37,30,SYR,127,32,34,69,64
1959-03-03,BOS,119,49,18,MNL,112,30,36,79,54
1959-03-03,PHW,116,27,38,DET,107,26,40,53,78
1959-03-03,STL,113,46,20,CIN,102,18,49,64,69
1959-03-04,CIN,128,18,50,MNL,122,30,37,48,87
1959-03-04,NYK,118,37,31,PHW,115,28,38,65,69
1959-03-04,BOS,120,50,18,SYR,114,33,34,83,52
1959-03-04,DET,127,26,41,STL,97,47,20,73,61
1959-03-05,SYR,142,33,35,BOS,118,51,18,84,53
1959-03-05,MNL,135,30,38,NYK,115,38,31,68,69
1959-03-05,PHW,106,28,39,STL,101,47,21,75,60
1959-03-06,PHW,118,29,39,SYR,114,34,35,63,74
1959-03-06,DET,98,27,41,MNL,99,31,38,58,79
1959-03-07,STL,137,47,22,DET,128,27,42,74,64
1959-03-07,PHW,93,30,39,CIN,86,19,50,49,89
1959-03-08,BOS,141,51,19,CIN,131,19,51,70,70
1959-03-08,NYK,127,38,32,DET,120,27,43,65,75
1959-03-08,MNL,120,32,38,STL,104,48,22,80,60
1959-03-08,SYR,133,34,36,PHW,103,31,39,65,75
1959-03-10,BOS,116,52,19,NYK,138,39,32,91,51
1959-03-10,CIN,96,19,52,PHW,102,31,40,50,92
1959-03-11,SYR,130,35,36,STL,132,48,23,83,59
1959-03-11,MNL,118,33,38,DET,123,27,44,60,82
1959-10-17,BOS,129,0,0,CIN,125,0,0,0,0
1959-10-18,MNL,105,0,0,DET,106,0,0,0,0
1959-10-24,NYK,109,0,0,PHW,118,0,0,0,0
1959-10-24,SYR,109,0,0,BOS,121,1,0,1,0
1959-10-24,CIN,108,0,1,DET,103,1,0,1,1
1959-10-24,STL,87,0,0,MNL,94,0,1,0,1
1959-10-25,CIN,103,1,1,MNL,102,1,1,2,2
1959-10-28,DET,117,1,1,SYR,102,0,1,1,2
1959-10-30,CIN,127,2,1,SYR,136,0,2,2,3
1959-10-31,PHW,120,1,0,DET,112,2,1,3,1
1959-10-31,NYK,109,0,1,BOS,123,2,0,2,1
1959-10-31,SYR,117,1,2,MNL,108,1,2,2,4
1959-10-31,STL,109,0,1,CIN,102,2,2,2,3
1959-11-01,CIN,109,2,3,BOS,124,3,0,5,3
1959-11-01,MNL,101,1,3,STL,138,1,1,2,4
1959-11-03,STL,98,2,1,BOS,103,4,0,6,1
1959-11-03,NYK,99,0,2,MNL,93,1,4,1,6
1959-11-04,PHW,124,2,0,SYR,113,2,2,4,2
1959-11-04,DET,101,2,2,NYK,107,1,2,3,4
1959-11-06,MNL,113,1,5,DET,118,2,3,3,8
1959-11-07,STL,117,2,2,NYK,113,2,2,4,4
1959-11-07,DET,111,3,3,MNL,113,1,6,4,9
1959-11-07,BOS,115,5,0,PHW,106,3,0,8,0
1959-11-07,SYR,101,2,3,CIN,103,2,4,4,7
1959-11-08,MNL,136,2,6,BOS,115,6,0,8,6
1959-11-08,SYR,118,2,4,DET,107,3,4,5,8
1959-11-08,PHW,134,3,1,CIN,106,3,4,6,5
1959-11-10,PHW,126,4,1,NYK,125,2,3,6,4
1959-11-10,BOS,128,6,1,DET,109,3,5,9,6
1959-11-10,STL,134,3,2,MNL,105,3,6,6,8
1959-11-11,BOS,151,7,1,CIN,118,3,5,10,6
1959-11-11,DET,105,3,6,PHW,119,5,1,8,7
1959-11-12,CIN,116,3,6,PHW,124,6,1,9,7
1959-11-12,NYK,104,2,4,SYR,113,3,4,5,8
1959-11-12,DET,107,3,7,MNL,93,3,7,6,14
1959-11-14,BOS,113,8,1,STL,111,4,2,12,3
1959-11-14,SYR,116,4,4,NYK,108,2,5,6,9
1959-11-14,DET,111,4,7,CIN,103,3,7,7,14
1959-11-14,PHW,104,7,1,MNL,98,3,8,10,9
1959-11-15,CIN,128,3,8,BOS,134,9,1,12,9
1959-11-15,MNL,106,3,9,PHW,100,8,1,11,10
1959-11-15,NYK,94,2,6,DET,103,5,7,7,13
1959-11-17,DET,129,6,7,BOS,132,10,1,16,8
1959-11-17,SYR,121,5,4,CIN,116,3,9,8,13
1959-11-17,NYK,105,2,7,STL,97,4,3,6,10
1959-11-18,MNL,105,4,9,NYK,106,3,7,7,16
1959-11-18,SYR,138,6,4,BOS,103,11,1,17,5
1959-11-18,DET,110,6,8,CIN,93,3,10,9,18
1959-11-19,CIN,109,3,11,NYK,130,4,7,7,18
1959-11-20,PHW,117,8,2,STL,118,4,4,12,6
1959-11-20,BOS,114,11,2,SYR,101,7,4,18,6
1959-11-20,MNL,105,4,10,DET,85,7,8,11,18
1959-11-21,NYK,127,5,7,BOS,128,12,2,17,9
1959-11-21,STL,107,5,4,DET,109,7,9,12,13
1959-11-21,SYR,116,7,5,PHW,107,8,3,15,8
1959-11-21,CIN,93,3,12,MNL,99,5,10,8,22
1959-11-22,DET,115,8,9,NYK,104,5,8,13,17
1959-11-22,PHW,114,8,4,SYR,103,8,5,16,9
1959-11-22,CIN,106,3,13,STL,100,5,5,8,18
1959-11-24,NYK,107,5,9,SYR,120,8,6,13,15
1959-11-24,DET,104,9,9,CIN,91,4,13,13,22
1959-11-25,BOS,113,13,2,PHW,123,9,4,22,6
1959-11-25,DET,97,10,9,STL,104,5,6,15,15
1959-11-25,MNL,93,6,10,SYR,100,9,6,15,16
1959-11-26,PHW,143,10,4,BOS,130,13,3,23,7
1959-11-26,STL,112,6,6,SYR,95,10,6,16,12
1959-11-26,CIN,114,4,14,MNL,95,6,11,10,25
1959-11-28,BOS,136,13,4,DET,110,10,10,23,14
1959-11-28,NYK,108,5,10,PHW,109,11,4,16,14
1959-11-28,CIN,105,5,14,SYR,111,10,7,15,21
1959-11-28,STL,102,7,6,MNL,91,6,12,13,18
1959-11-29,PHW,126,12,4,NYK,127,5,11,17,15
1959-11-29,MNL,93,6,13,BOS,109,14,4,20,17
1959-12-01,SYR,101,11,7,STL,106,8,6,19,13
1959-12-01,NYK,100,6,11,MNL,103,6,14,12,25
1959-12-02,SYR,130,11,8,STL,121,9,6,20,14
1959-12-02,NYK,118,6,12,CIN,135,5,15,11,27
1959-12-03,BOS,114,15,4,CIN,111,6,15,21,19
1959-12-03,PHW,123,12,5,MNL,109,7,14,19,19
1959-12-04,PHW,124,13,5,STL,112,9,7,22,12
1959-12-04,BOS,122,16,4,NYK,107,6,13,22,17
1959-12-04,DET,120,10,11,MNL,101,7,15,17,26
1959-12-05,STL,113,9,8,PHW,112,14,5,23,13
1959-12-05,NYK,124,6,14,DET,108,11,11,17,25
1959-12-05,SYR,108,12,8,MNL,95,7,16,19,24
1959-12-06,PHW,118,14,6,DET,116,11,12,25,18
1959-12-06,CIN,104,6,16,STL,118,10,8,16,24
1959-12-06,MNL,104,7,17,BOS,121,17,4,24,21
1959-12-08,NYK,105,7,14,BOS,121,18,4,25,18
1959-12-08,CIN,105,6,17,STL,101,11,8,17,25
1959-12-08,SYR,93,13,8,MNL,89,7,18,20,26
1959-12-09,CIN,129,7,17,DET,119,11,13,18,30
1959-12-09,BOS,137,19,4,PHW,116,15,6,34,10
1959-12-09,MNL,96,7,19,SYR,86,14,8,21,27
1959-12-10,PHW,131,15,7,CIN,112,8,17,23,24
1959-12-10,STL,129,11,9,DET,111,11,14,22,23
1959-12-11,NYK,152,7,15,SYR,121,14,9,21,24
1959-12-11,BOS,122,20,4,STL,99,12,9,32,13
1959-12-12,PHW,117,16,7,BOS,126,21,4,37,11
1959-12-12,MNL,97,8,19,CIN,107,8,18,16,37
1959-12-13,DET,147,11,15,NYK,129,8,15,19,30
1959-12-13,SYR,150,14,10,PHW,121,16,8,30,18
1959-12-13,STL,118,12,10,CIN,98,9,18,21,28
1959-12-15,NYK,110,8,16,STL,119,13,10,21,26
1959-12-15,PHW,131,16,9,CIN,107,9,19,25,28
1959-12-16,SYR,116,15,10,NYK,113,8,17,23,27
1959-12-16,DET,106,12,15,STL,107,14,10,26,25
1959-12-16,CIN,105,9,20,PHW,114,17,9,26,29
1959-12-17,BOS,137,22,4,NYK,126,8,18,30,22
1959-12-19,BOS,119,23,4,NYK,116,8,19,31,23
1959-12-19,CIN,113,9,21,MNL,131,8,20,17,41
1959-12-19,DET,120,12,16,SYR,112,16,10,28,26
1959-12-19,STL,102,15,10,PHW,89,18,9,33,19
1959-12-20,SYR,127,16,11,BOS,132,24,4,40,15
1959-12-20,NYK,132,8,20,CIN,118,9,22,17,42
1959-12-20,STL,102,16,10,DET,86,13,16,29,26
1959-12-22,NYK,127,9,20,CIN,119,9,23,18,43
1959-12-22,DET,104,13,17,BOS,136,25,4,38,21
1959-12-25,PHW,129,18,10,SYR,121,16,12,34,22
1959-12-25,NYK,119,10,20,BOS,123,26,4,36,24
1959-12-25,CIN,121,9,24,DET,103,13,18,22,42
1959-12-25,STL,112,17,10,MNL,96,9,20,26,30
1959-12-26,PHW,116,19,10,NYK,122,10,21,29,31
1959-12-26,DET,105,13,19,MNL,108,9,21,22,40
1959-12-26,SYR,117,16,13,STL,104,18,10,34,23
1959-12-27,CIN,111,10,24,BOS,122,27,4,37,28
1959-12-27,MNL,119,10,21,DET,109,13,20,23,41
1959-12-28,STL,120,18,11,SYR,106,17,13,35,24
1959-12-28,BOS,107,28,4,MNL,104,11,21,39,25
1959-12-28,PHW,109,19,11,CIN,104,10,25,29,36
1959-12-30,CIN,127,10,26,SYR,131,17,14,27,40
1959-12-30,NYK,124,11,21,DET,109,13,21,24,42
1959-12-30,PHW,122,20,11,MNL,107,11,22,31,33
1959-12-30,STL,82,19,11,BOS,96,29,4,48,15
1959-12-31,NYK,127,12,21,MNL,102,11,23,23,44
1960-01-01,CIN,128,10,27,BOS,115,30,4,40,31
1960-01-01,DET,119,13,22,STL,107,19,12,32,34
1960-01-01,MNL,98,11,24,SYR,109,18,14,29,38
1960-01-02,CIN,118,11,27,NYK,126,13,21,24,48
1960-01-02,PHW,118,21,11,BOS,117,30,5,51,16
1960-01-02,STL,114,19,13,DET,113,14,22,33,35
1960-01-03,SYR,114,19,14,BOS,113,30,6,49,20
1960-01-03,DET,114,14,23,CIN,112,11,28,25,51
1960-01-03,STL,110,20,13,NYK,108,14,21,34,34
1960-01-04,BOS,127,30,7,SYR,120,20,14,50,21
1960-01-05,SYR,145,20,15,BOS,143,31,7,51,22
1960-01-05,PHW,126,22,11,MNL,111,11,25,33,36
1960-01-05,NYK,121,14,22,DET,110,15,23,29,45
1960-01-06,CIN,129,11,29,NYK,113,15,22,26,51
1960-01-06,PHW,121,23,11,STL,101,21,13,44,24
1960-01-07,SYR,132,21,15,CIN,114,12,29,33,44
1960-01-07,PHW,120,24,11,DET,105,15,24,39,35
1960-01-08,SYR,118,22,15,DET,107,15,25,37,40
1960-01-08,CIN,112,12,30,STL,102,21,14,33,44
1960-01-09,PHW,119,25,11,SYR,112,23,15,48,26
1960-01-09,DET,103,15,26,BOS,126,31,8,46,34
1960-01-09,MNL,121,11,26,CIN,91,13,30,24,56
1960-01-10,STL,121,21,15,BOS,111,32,8,53,23
1960-01-10,CIN,106,13,31,MNL,112,12,26,25,57
1960-01-10,SYR,108,23,16,DET,103,15,27,38,43
1960-01-10,NYK,103,15,23,PHW,116,26,11,41,34
1960-01-12,CIN,123,13,32,NYK,141,15,24,28,56
1960-01-12,SYR,127,24,16,BOS,120,32,9,56,25
1960-01-12,PHW,126,27,11,STL,108,22,15,49,26
1960-01-13,PHW,132,28,11,SYR,131,25,16,53,27
1960-01-13,DET,114,15,28,NYK,113,16,24,31,52
1960-01-13,BOS,134,32,10,STL,112,22,16,54,26
1960-01-14,MNL,126,13,26,NYK,131,16,25,29,51
1960-01-14,SYR,119,25,17,STL,112,22,17,47,34
1960-01-15,STL,141,22,18,SYR,140,26,17,48,35
1960-01-15,CIN,122,13,33,MNL,118,13,27,26,60
1960-01-15,PHW,112,29,11,BOS,124,33,10,62,21
1960-01-16,NYK,132,17,25,CIN,106,14,33,31,58
1960-01-16,MNL,98,13,28,DET,105,16,28,29,56
1960-01-17,BOS,129,34,10,PHW,123,29,12,63,22
1960-01-17,STL,135,23,18,MNL,119,13,29,36,47
1960-01-17,SYR,129,26,18,NYK,117,18,25,44,43
1960-01-17,DET,115,17,28,CIN,110,14,34,31,62
1960-01-19,PHW,114,29,13,NYK,93,18,26,47,39
1960-01-20,BOS,144,35,10,NYK,126,18,27,53,37
1960-01-20,SYR,123,27,18,PHW,129,30,13,57,31
1960-01-20,CIN,108,14,35,STL,119,24,18,38,53
1960-01-23,BOS,130,36,10,SYR,121,27,19,63,29
1960-01-23,DET,130,18,28,PHW,110,31,13,49,41
1960-01-23,MNL,104,13,30,NYK,115,18,28,31,58
1960-01-23,STL,108,25,18,CIN,100,14,36,39,54
1960-01-24,STL,155,26,18,NYK,129,19,28,45,46
1960-01-24,SYR,110,27,20,BOS,131,37,10,64,30
1960-01-24,CIN,95,14,37,PHW,104,31,14,45,51
1960-01-25,PHW,127,32,14,DET,117,19,28,51,42
1960-01-26,NYK,123,19,29,STL,119,27,18,46,47
1960-01-26,SYR,114,27,21,DET,121,19,29,46,50
1960-01-27,PHW,129,33,14,NYK,117,20,29,53,43
1960-01-27,BOS,127,38,10,STL,114,27,19,65,29
1960-01-27,MNL,116,13,31,CIN,112,14,38,27,69
1960-01-27,DET,108,20,29,SYR,144,27,22,47,51
1960-01-29,STL,130,27,20,DET,125,20,30,47,50
1960-01-29,PHW,124,34,14,BOS,116,39,10,73,24
1960-01-29,NYK,128,20,30,CIN,113,14,39,34,69
1960-01-29,MNL,112,14,31,SYR,119,28,22,42,53
1960-01-30,NYK,115,21,30,PHW,108,35,14,56,44
1960-01-30,DET,117,20,31,STL,107,28,20,48,51
1960-01-30,BOS,129,39,11,CIN,107,14,40,53,51
1960-01-31,BOS,146,40,11,DET,128,21,31,61,42
1960-01-31,STL,117,28,21,SYR,110,29,22,57,43
1960-01-31,PHW,114,35,15,MNL,104,14,32,49,47
1960-02-01,PHW,103,36,15,MNL,96,14,33,50,48
1960-02-02,STL,114,29,21,BOS,113,41,11,70,32
1960-02-02,PHW,109,37,15,CIN,107,14,41,51,56
1960-02-02,NYK,102,22,30,SYR,119,29,23,51,53
1960-02-03,STL,125,30,21,NYK,115,22,31,52,52
1960-02-03,BOS,128,41,12,MNL,108,14,34,55,46
1960-02-03,DET,117,21,32,CIN,105,14,42,35,74
1960-02-04,SYR,137,30,23,PHW,110,38,15,68,38
1960-02-04,CIN,102,14,43,DET,121,22,32,36,75
1960-02-05,BOS,124,42,12,SYR,100,31,23,73,35
1960-02-05,MNL,96,14,35,STL,114,31,21,45,56
1960-02-06,PHW,129,38,16,SYR,126,31,24,69,40
1960-02-06,NYK,117,22,32,BOS,143,43,12,65,44
1960-02-06,DET,116,23,32,MNL,101,14,36,37,68
1960-02-07,BOS,135,44,12,NYK,142,22,33,66,45
1960-02-07,SYR,135,31,25,CIN,112,14,44,45,69
1960-02-07,STL,130,32,21,PHW,108,39,16,71,37
1960-02-07,MNL,104,14,37,DET,102,24,32,38,69
1960-02-09,DET,122,24,33,PHW,113,39,17,63,50
1960-02-09,SYR,117,32,25,CIN,111,14,45,46,70
1960-02-09,STL,114,33,21,NYK,104,23,33,56,54
1960-02-09,BOS,129,44,13,MNL,90,15,37,59,50
1960-02-10,BOS,153,45,13,DET,121,25,33,70,46
1960-02-10,NYK,125,23,34,PHW,117,39,18,62,52
1960-02-10,CIN,110,14,46,STL,120,34,21,48,67
1960-02-10,SYR,110,33,25,MNL,109,15,38,48,63
1960-02-11,PHW,139,39,19,STL,120,35,21,74,40
1960-02-11,SYR,116,34,25,NYK,109,24,34,58,59
1960-02-11,MNL,108,15,39,CIN,111,14,47,29,86
1960-02-12,CIN,133,15,47,DET,101,25,34,40,81
1960-02-13,BOS,122,46,13,PHW,120,40,19,86,32
1960-02-13,DET,117,25,35,MNL,123,15,40,40,75
1960-02-13,NYK,122,24,35,STL,104,35,22,59,57
1960-02-14,MNL,119,16,40,SYR,121,35,25,51,65
1960-02-14,PHW,115,40,20,BOS,125,47,13,87,33
1960-02-14,STL,107,35,23,CIN,105,16,47,51,70
1960-02-16,BOS,130,48,13,MNL,122,16,41,64,54
1960-02-16,NYK,125,25,35,SYR,116,36,25,61,60
1960-02-16,CIN,112,16,48,PHW,117,40,21,56,69
1960-02-16,DET,104,25,36,STL,111,36,23,61,59
1960-02-17,STL,131,37,23,MNL,127,16,42,53,65
1960-02-17,PHW,123,41,21,SYR,116,36,26,77,47
1960-02-18,SYR,136,36,27,PHW,122,42,21,78,48
1960-02-18,NYK,104,26,35,BOS,109,49,13,75,48
1960-02-19,DET,116,25,37,BOS,136,50,13,75,50
1960-02-19,MNL,111,16,43,STL,101,38,23,54,66
1960-02-20,SYR,126,37,27,NYK,121,26,36,63,63
1960-02-20,CIN,110,16,49,DET,107,25,38,41,87
1960-02-20,PHW,122,42,22,MNL,106,17,43,59,65
1960-02-20,STL,121,38,24,BOS,105,51,13,89,37
1960-02-21,NYK,122,26,37,PHW,129,43,22,69,59
1960-02-21,SYR,122,38,27,DET,120,25,39,63,66
1960-02-21,CIN,108,17,49,BOS,115,51,14,68,63
1960-02-21,MNL,112,17,44,STL,98,39,24,56,68
1960-02-22,STL,113,39,25,MNL,103,18,44,57,69
1960-02-23,CIN,135,17,50,SYR,133,39,27,56,77
1960-02-23,NYK,112,26,38,MNL,117,18,45,44,83
1960-02-23,PHW,126,44,22,BOS,108,52,14,96,36
1960-02-24,CIN,124,18,50,STL,122,40,25,58,75
1960-02-24,DET,128,25,40,SYR,110,39,28,64,68
1960-02-24,BOS,131,52,15,MNL,110,19,45,71,60
1960-02-25,PHW,131,45,22,NYK,121,26,39,71,61
1960-02-25,BOS,121,53,15,DET,107,26,40,79,55
1960-02-25,SYR,110,39,29,STL,105,40,26,79,55
1960-02-25,MNL,105,19,46,CIN,95,19,50,38,96
1960-02-26,BOS,128,54,15,MNL,111,20,46,74,61
1960-02-27,STL,114,40,27,DET,116,26,41,66,68
1960-02-27,SYR,114,40,29,NYK,111,26,40,66,69
1960-02-27,MNL,109,20,47,PHW,91,46,22,66,69
1960-02-28,NYK,125,26,41,BOS,129,55,15,81,56
1960-02-28,DET,111,27,41,PHW,113,46,23,73,64
1960-02-28,STL,122,40,28,CIN,105,19,51,59,79
1960-03-01,NYK,121,26,42,SYR,124,41,29,67,71
1960-03-01,DET,108,27,42,CIN,106,19,52,46,94
1960-03-01,STL,109,41,28,MNL,101,21,47,62,75
1960-03-02,BOS,133,56,15,PHW,119,47,23,103,38
1960-03-02,MNL,123,21,48,NYK,113,26,43,47,91
1960-03-02,DET,116,28,42,STL,100,42,28,70,70
1960-03-03,MNL,117,22,48,CIN,114,19,53,41,101
1960-03-03,SYR,149,42,29,BOS,108,57,15,99,44
1960-03-03,PHW,110,47,24,DET,101,29,42,76,66
1960-03-04,PHW,136,48,24,NYK,134,26,44,74,68
1960-03-05,SYR,132,43,29,NYK,115,26,45,69,74
1960-03-05,MNL,106,23,48,STL,107,42,29,65,77
1960-03-06,BOS,126,57,16,SYR,117,44,29,101,45
1960-03-06,NYK,120,26,46,DET,112,29,43,55,89
1960-03-06,STL,128,43,29,PHW,109,49,24,92,53
1960-03-06,MNL,114,23,49,CIN,105,19,54,42,103
1960-03-08,STL,122,44,29,DET,101,29,44,73,73
1960-03-09,BOS,148,58,16,NYK,128,27,46,85,62
1960-03-09,SYR,137,44,30,PHW,126,49,25,93,55
1960-03-09,DET,117,29,45,MNL,116,24,49,53,94
1960-03-09,CIN,116,19,55,STL,123,45,29,64,84
1960-03-10,MNL,133,24,50,NYK,108,27,47,51,97
1960-10-19,CIN,140,0,0,LAL,123,0,0,0,0
1960-10-20,NYK,105,0,0,CIN,113,1,0,1,0
1960-10-22,SYR,123,0,0,PHW,133,0,0,0,0
1960-10-22,CIN,119,2,0,NYK,117,0,1,2,1
1960-10-22,BOS,118,0,0,DET,116,0,0,0,0
1960-10-22,STL,112,0,0,LAL,96,0,1,0,1
1960-10-23,CIN,114,3,0,STL,103,1,0,4,0
1960-10-24,LAL,101,0,2,NYK,111,0,2,0,4
1960-10-25,LAL,120,0,3,NYK,118,1,2,1,5
1960-10-25,STL,123,1,1,SYR,100,0,1,1,2
1960-10-26,DET,131,0,1,CIN,117,4,0,4,1
1960-10-27,CIN,143,4,1,SYR,140,0,2,4,3
1960-10-28,PHW,122,1,0,LAL,120,1,3,2,3
1960-10-28,NYK,101,1,3,BOS,110,1,0,2,3
1960-10-29,SYR,125,0,3,LAL,118,1,4,1,7
1960-10-29,DET,115,1,1,NYK,110,1,4,2,5
1960-10-29,BOS,103,2,0,PHW,131,2,0,4,0
1960-10-29,STL,113,2,1,CIN,97,5,1,7,2
1960-11-01,CIN,113,5,2,PHW,131,3,0,8,2
1960-11-02,DET,117,2,1,STL,132,3,1,5,2
1960-11-02,LAL,106,1,5,NYK,96,1,5,2,10
1960-11-04,PHW,136,4,0,DET,121,2,2,6,2
1960-11-05,PHW,130,5,0,DET,123,2,3,7,3
1960-11-05,LAL,112,2,5,SYR,110,1,3,3,8
1960-11-05,BOS,104,2,1,CIN,113,5,3,7,4
1960-11-05,STL,119,4,1,NYK,104,1,6,5,7
1960-11-06,LAL,119,3,5,SYR,113,1,4,4,9
1960-11-08,CIN,120,6,3,BOS,136,2,2,8,5
1960-11-09,STL,126,5,1,DET,120,2,4,7,5
1960-11-09,PHW,125,6,0,LAL,118,4,5,10,5
1960-11-10,NYK,112,1,7,PHW,116,7,0,8,7
1960-11-11,PHW,117,8,0,STL,112,6,1,14,1
1960-11-11,BOS,128,3,2,CIN,110,6,4,9,6
1960-11-11,NYK,112,1,8,SYR,108,1,5,2,13
1960-11-12,BOS,131,4,2,LAL,124,4,6,8,8
1960-11-12,SYR,128,1,6,NYK,117,2,8,3,14
1960-11-12,DET,116,2,5,CIN,112,6,5,8,10
1960-11-12,STL,107,6,2,PHW,105,9,0,15,2
1960-11-13,CIN,113,6,6,DET,125,3,5,9,11
1960-11-15,NYK,108,2,9,LAL,123,4,7,6,16
1960-11-15,CIN,124,6,7,PHW,115,9,1,15,8
1960-11-15,DET,115,4,5,BOS,114,5,2,9,7
1960-11-16,DET,119,5,5,PHW,118,9,2,14,7
1960-11-16,BOS,124,5,3,STL,106,7,2,12,5
1960-11-16,SYR,124,2,6,CIN,87,7,7,9,13
1960-11-17,PHW,105,9,3,SYR,106,3,6,12,9
1960-11-17,STL,112,7,3,DET,105,6,5,13,8
1960-11-18,CIN,129,7,8,STL,128,8,3,15,11
1960-11-18,NYK,99,2,10,PHW,101,9,4,11,14
1960-11-19,LAL,130,5,7,DET,122,6,6,11,13
1960-11-19,STL,121,8,4,CIN,120,8,8,16,12
1960-11-19,PHW,121,10,4,NYK,111,2,11,12,15
1960-11-19,SYR,94,4,6,BOS,114,6,3,10,9
1960-11-20,LAL,135,6,7,DET,131,6,7,12,14
1960-11-20,CIN,103,8,9,BOS,120,7,3,15,12
1960-11-22,NYK,119,2,12,STL,120,9,4,11,16
1960-11-22,LAL,133,7,7,CIN,118,8,10,15,17
1960-11-23,CIN,122,8,11,LAL,118,8,7,16,18
1960-11-23,DET,122,6,8,SYR,115,4,7,10,15
1960-11-23,BOS,122,8,3,NYK,105,2,13,10,16
1960-11-24,PHW,129,11,4,BOS,132,9,3,20,7
1960-11-24,LAL,108,8,8,CIN,100,9,11,17,19
1960-11-24,STL,132,10,4,SYR,97,4,8,14,12
1960-11-25,DET,128,7,8,LAL,141,9,8,16,16
1960-11-25,NYK,110,2,14,BOS,111,10,3,12,17
1960-11-26,NYK,127,2,15,DET,119,7,9,9,24
1960-11-26,STL,126,11,4,LAL,113,10,8,21,12
1960-11-26,BOS,129,11,3,SYR,110,4,9,15,12
1960-11-26,PHW,138,11,5,CIN,108,9,12,20,17
1960-11-27,CIN,118,9,13,NYK,122,3,15,12,28
1960-11-27,LAL,106,10,9,PHW,113,12,5,22,14
1960-11-28,LAL,137,10,10,PHW,112,13,5,23,15
1960-11-29,PHW,122,13,6,LAL,121,11,10,24,16
1960-11-29,STL,109,12,4,BOS,119,12,3,24,7
1960-11-29,NYK,118,4,15,DET,107,7,10,11,25
1960-11-29,SYR,129,4,10,CIN,105,9,14,13,24
1960-11-30,SYR,135,5,10,STL,126,12,5,17,15
1960-11-30,DET,110,7,11,BOS,125,13,3,20,14
1960-12-01,CIN,126,9,15,SYR,137,6,10,15,25
1960-12-01,PHW,117,14,6,LAL,114,11,11,25,17
1960-12-01,NYK,116,5,15,BOS,111,14,3,19,18
1960-12-02,NYK,133,6,15,STL,139,12,6,18,21
1960-12-02,BOS,117,14,4,LAL,120,11,12,25,16
1960-12-03,PHW,127,15,6,STL,131,13,6,28,12
1960-12-03,SYR,130,7,10,NYK,113,6,16,13,26
1960-12-04,DET,116,7,12,CIN,115,9,16,16,28
1960-12-04,LAL,103,12,12,BOS,113,14,5,26,17
1960-12-05,LAL,101,12,13,BOS,123,15,5,27,18
1960-12-06,NYK,112,6,17,CIN,117,9,17,15,34
1960-12-06,STL,146,14,6,DET,110,8,12,22,18
1960-12-06,SYR,107,8,10,PHW,113,15,7,23,17
1960-12-07,BOS,134,16,5,SYR,142,8,11,24,16
1960-12-07,CIN,114,10,17,LAL,112,12,14,22,31
1960-12-07,DET,113,8,13,STL,83,15,6,23,19
1960-12-08,CIN,118,11,17,BOS,115,16,6,27,23
1960-12-08,PHW,114,16,7,NYK,111,6,18,22,25
1960-12-09,BOS,146,16,7,CIN,123,12,17,28,24
1960-12-09,STL,131,15,7,SYR,118,9,11,24,18
1960-12-10,STL,111,16,7,LAL,108,12,15,28,22
1960-12-10,DET,107,9,13,SYR,117,9,12,18,25
1960-12-10,PHW,102,17,7,BOS,97,17,7,34,14
1960-12-11,SYR,132,10,12,PHW,121,18,7,28,19
1960-12-12,LAL,103,12,16,STL,114,17,7,29,23
1960-12-13,NYK,117,6,19,BOS,115,17,8,23,27
1960-12-13,PHW,110,18,8,DET,108,9,14,27,22
1960-12-13,SYR,107,11,12,CIN,105,12,18,23,30
1960-12-14,DET,134,9,15,PHW,126,19,8,28,23
1960-12-14,CIN,121,12,19,NYK,114,7,19,19,38
1960-12-14,LAL,124,12,17,STL,113,18,7,30,24
1960-12-15,BOS,115,17,9,SYR,105,12,12,29,21
1960-12-16,CIN,130,13,19,LAL,116,13,17,26,36
1960-12-16,STL,112,18,8,PHW,107,19,9,37,17
1960-12-16,DET,104,10,15,NYK,108,7,20,17,35
1960-12-17,BOS,140,18,9,LAL,112,13,18,31,27
1960-12-17,STL,116,19,8,NYK,103,8,20,27,28
1960-12-18,CIN,112,14,19,PHW,128,19,10,33,29
1960-12-18,SYR,103,12,13,STL,104,20,8,32,21
1960-12-19,LAL,107,13,19,DET,103,10,16,23,35
1960-12-20,BOS,115,19,9,CIN,112,14,20,33,29
1960-12-20,NYK,122,8,21,SYR,112,12,14,20,35
1960-12-20,DET,97,10,17,LAL,94,14,19,24,36
1960-12-21,PHW,122,20,10,NYK,117,9,21,29,31
1960-12-21,BOS,120,20,9,STL,108,21,8,41,17
1960-12-24,BOS,150,21,9,DET,106,11,17,32,26
1960-12-25,CIN,126,14,21,DET,119,11,18,25,39
1960-12-25,SYR,162,12,15,NYK,100,9,22,21,37
1960-12-26,DET,137,11,19,CIN,132,15,21,26,40
1960-12-26,BOS,119,22,9,PHW,115,21,10,43,19
1960-12-26,NYK,119,9,23,LAL,112,14,20,23,43
1960-12-26,STL,133,21,9,SYR,112,13,15,34,24
1960-12-27,CIN,129,15,22,SYR,124,13,16,28,38
1960-12-27,PHW,116,21,11,BOS,101,23,9,44,20
1960-12-28,SYR,115,13,17,LAL,113,14,21,27,38
1960-12-28,NYK,104,10,23,CIN,114,16,22,26,45
1960-12-28,STL,105,22,9,BOS,99,23,10,45,19
1960-12-29,PHW,128,22,11,CIN,124,17,22,39,33
1960-12-29,LAL,111,14,22,NYK,95,10,24,24,46
1960-12-29,DET,112,12,19,STL,89,23,9,35,28
1960-12-30,PHW,130,23,11,CIN,136,17,23,40,34
1960-12-30,DET,121,13,19,SYR,112,14,17,27,36
1960-12-30,NYK,106,10,25,BOS,120,23,11,33,36
1960-12-30,STL,107,23,10,LAL,99,15,22,38,32
1961-01-01,CIN,114,18,23,STL,112,24,10,42,33
1961-01-01,DET,116,14,19,LAL,105,15,23,29,42
1961-01-01,SYR,96,14,18,BOS,113,24,11,38,29
1961-01-02,SYR,125,14,19,CIN,126,19,23,33,42
1961-01-02,PHW,131,23,12,NYK,115,10,26,33,38
1961-01-02,LAL,123,15,24,DET,113,15,19,30,43
1961-01-03,PHW,128,24,12,DET,125,15,20,39,32
1961-01-03,NYK,104,10,27,SYR,129,14,20,24,47
1961-01-03,LAL,96,16,24,BOS,102,25,11,41,35
1961-01-04,SYR,126,15,20,CIN,134,20,23,35,43
1961-01-05,PHW,139,25,12,SYR,127,15,21,40,33
1961-01-05,CIN,107,21,23,BOS,125,26,11,47,34
1961-01-05,NYK,104,10,28,DET,102,15,21,25,49
1961-01-05,LAL,110,16,25,STL,96,24,11,40,36
1961-01-06,LAL,104,17,25,STL,108,24,12,41,37
1961-01-06,DET,102,15,22,BOS,108,27,11,42,33
1961-01-07,NYK,120,11,28,SYR,117,15,22,26,50
1961-01-08,NYK,121,12,28,PHW,119,26,12,38,40
1961-01-08,SYR,138,15,23,DET,115,15,23,30,46
1961-01-08,STL,133,25,12,BOS,104,28,11,53,23
1961-01-10,STL,119,26,12,CIN,110,21,24,47,36
1961-01-10,LAL,117,17,26,NYK,104,13,28,30,54
1961-01-10,BOS,118,28,12,DET,98,15,24,43,36
1961-01-11,SYR,133,16,23,STL,128,27,12,43,35
1961-01-11,DET,126,15,25,CIN,122,21,25,36,50
1961-01-11,LAL,104,18,26,NYK,109,13,29,31,55
1961-01-12,BOS,124,29,12,SYR,118,17,23,46,35
1961-01-12,DET,124,16,25,CIN,112,21,26,37,51
1961-01-12,PHW,111,26,13,STL,102,27,13,53,26
1961-01-13,BOS,123,30,12,PHW,121,27,13,57,25
1961-01-13,SYR,106,17,24,NYK,105,14,29,31,53
1961-01-14,LAL,123,18,27,CIN,114,21,27,39,54
1961-01-14,PHW,116,27,14,BOS,113,31,12,58,26
1961-01-14,STL,135,27,14,DET,113,17,25,44,39
1961-01-15,BOS,142,31,13,NYK,124,14,30,45,43
1961-01-15,DET,137,17,26,STL,122,28,14,45,40
1961-01-15,SYR,116,18,24,PHW,113,28,14,46,38
1961-01-15,LAL,105,19,27,CIN,109,21,28,40,55
1961-01-18,CIN,128,22,28,DET,144,18,26,40,54
1961-01-18,SYR,129,19,24,PHW,118,28,15,47,39
1961-01-18,BOS,114,32,13,STL,125,28,15,60,28
1961-01-19,PHW,129,28,16,STL,127,29,15,57,31
1961-01-19,CIN,122,22,29,NYK,129,14,31,36,60
1961-01-19,BOS,106,32,14,LAL,103,19,28,51,42
1961-01-20,DET,132,19,26,NYK,128,15,31,34,57
1961-01-21,SYR,127,20,24,BOS,124,33,14,53,38
1961-01-21,STL,145,29,16,NYK,122,15,32,44,48
1961-01-21,PHW,136,29,16,LAL,111,19,29,48,45
1961-01-21,DET,130,20,26,CIN,106,22,30,42,56
1961-01-22,DET,136,21,26,PHW,128,30,16,51,42
1961-01-22,SYR,112,21,24,LAL,109,19,30,40,54
1961-01-22,CIN,115,22,31,STL,108,30,16,52,47
1961-01-24,STL,114,30,17,PHW,112,30,17,60,34
1961-01-24,NYK,112,15,33,BOS,125,33,15,48,48
1961-01-24,LAL,116,19,31,SYR,107,22,24,41,55
1961-01-24,CIN,104,23,31,DET,106,22,26,45,57
1961-01-25,DET,138,23,26,CIN,125,23,32,46,58
1961-01-25,LAL,117,20,31,SYR,112,22,25,42,56
1961-01-25,STL,116,31,17,NYK,109,15,34,46,51
1961-01-26,PHW,121,30,18,BOS,129,34,15,64,33
1961-01-27,CIN,126,23,33,SYR,138,22,26,45,59
1961-01-27,NYK,130,15,35,PHW,119,30,19,45,54
1961-01-27,BOS,140,35,15,DET,111,24,26,59,41
1961-01-28,STL,136,32,17,CIN,116,23,34,55,51
1961-01-28,PHW,114,30,20,NYK,108,16,35,46,55
1961-01-29,BOS,128,36,15,PHW,115,31,20,67,35
1961-01-29,LAL,137,21,31,DET,113,24,27,45,58
1961-01-29,STL,125,33,17,SYR,108,23,26,56,43
1961-01-30,LAL,117,22,31,DET,116,24,28,46,59
1961-01-30,CIN,116,23,35,BOS,88,37,15,60,50
1961-01-31,DET,121,24,29,LAL,112,23,31,47,60
1961-01-31,NYK,106,16,36,SYR,122,23,27,39,63
1961-01-31,STL,103,34,17,BOS,109,37,16,71,33
1961-02-01,STL,137,34,18,DET,131,25,29,59,47
1961-02-01,BOS,124,38,16,NYK,120,16,37,54,53
1961-02-01,SYR,113,24,27,PHW,122,31,21,55,48
1961-02-02,PHW,133,32,21,CIN,118,24,35,56,56
1961-02-02,LAL,116,23,32,STL,115,35,18,58,50
1961-02-03,PHW,136,33,21,CIN,135,24,36,57,57
1961-02-03,DET,121,25,30,SYR,118,24,28,49,58
1961-02-03,BOS,123,39,16,NYK,109,16,38,55,54
1961-02-04,NYK,111,16,39,STL,128,35,19,51,58
1961-02-04,DET,111,26,30,SYR,104,24,29,50,59
1961-02-05,PHW,136,34,21,NYK,128,16,40,50,61
1961-02-05,BOS,123,40,16,STL,121,36,19,76,35
1961-02-05,DET,120,27,30,LAL,125,24,32,51,62
1961-02-05,SYR,129,24,30,CIN,115,24,37,48,67
1961-02-06,LAL,110,25,32,CIN,101,24,38,49,70
1961-02-07,STL,127,36,20,PHW,124,35,21,71,41
1961-02-07,NYK,131,16,41,DET,120,27,31,43,72
1961-02-07,BOS,96,41,16,LAL,95,26,32,67,48
1961-02-08,DET,125,27,32,PHW,123,35,22,62,54
1961-02-08,SYR,130,25,30,BOS,108,42,16,67,46
1961-02-08,LAL,120,26,33,STL,103,37,20,63,53
1961-02-09,PHW,126,35,23,SYR,136,26,30,61,53
1961-02-09,CIN,119,24,39,NYK,115,17,41,41,80
1961-02-09,LAL,113,27,33,STL,123,37,21,64,54
1961-02-10,DET,137,28,32,BOS,134,42,17,70,49
1961-02-10,NYK,131,17,42,PHW,133,35,24,52,66
1961-02-11,STL,123,38,21,CIN,122,25,39,63,60
1961-02-11,SYR,141,27,30,DET,111,29,32,56,62
1961-02-11,BOS,107,42,18,NYK,129,17,43,59,61
1961-02-12,BOS,136,42,19,PHW,125,36,24,78,43
1961-02-12,SYR,148,28,30,DET,122,29,33,57,63
1961-02-12,NYK,104,18,43,CIN,105,25,40,43,83
1961-02-12,STL,95,39,21,LAL,105,27,34,66,55
1961-02-13,CIN,104,26,40,LAL,100,28,34,54,74
1961-02-14,STL,135,39,22,DET,134,29,34,68,56
1961-02-14,BOS,113,43,19,LAL,93,28,35,71,54
1961-02-15,NYK,129,18,44,SYR,127,29,30,47,74
1961-02-15,STL,135,40,22,PHW,98,36,25,76,47
1961-02-16,SYR,132,29,31,NYK,120,19,44,48,75
1961-02-16,PHW,121,36,26,BOS,111,44,19,80,45
1961-02-16,CIN,133,27,40,STL,107,41,22,68,62
1961-02-16,DET,106,29,35,LAL,129,28,36,57,71
1961-02-17,PHW,128,37,26,BOS,133,44,20,81,46
1961-02-17,SYR,115,30,31,DET,113,29,36,59,67
1961-02-18,DET,138,29,37,STL,141,41,23,70,60
1961-02-18,SYR,129,31,31,PHW,110,37,27,68,58
1961-02-18,NYK,106,19,45,LAL,121,29,36,48,81
1961-02-19,CIN,112,28,40,LAL,106,30,36,58,76
1961-02-19,SYR,106,32,31,BOS,116,45,20,77,51
1961-02-19,STL,100,42,23,NYK,123,19,46,61,69
1961-02-20,SYR,126,32,32,LAL,121,30,37,62,69
1961-02-21,SYR,123,33,32,DET,118,29,38,62,70
1961-02-21,STL,126,42,24,CIN,114,29,40,71,64
1961-02-21,NYK,112,20,46,PHW,114,37,28,57,74
1961-02-22,PHW,132,38,28,CIN,131,29,41,67,69
1961-02-22,DET,123,29,39,NYK,117,20,47,49,86
1961-02-22,LAL,105,30,38,BOS,93,46,20,76,58
1961-02-23,PHW,129,39,28,DET,121,30,39,69,67
1961-02-23,SYR,144,34,32,STL,116,43,24,77,56
1961-02-24,BOS,144,46,21,SYR,128,35,32,81,53
1961-02-24,NYK,119,20,48,STL,122,43,25,63,73
1961-02-25,CIN,120,29,42,PHW,129,40,28,69,70
1961-02-25,STL,109,44,25,BOS,122,47,21,91,46
1961-02-26,CIN,122,29,43,STL,148,44,26,73,69
1961-02-26,LAL,121,31,38,PHW,116,41,28,72,66
1961-02-26,SYR,136,35,33,NYK,110,20,49,55,82
1961-02-26,DET,99,30,40,BOS,113,48,21,78,61
1961-02-27,LAL,88,32,38,PHW,113,41,29,73,67
1961-02-28,NYK,116,20,50,BOS,142,49,21,69,71
1961-02-28,PHW,123,42,29,LAL,108,32,39,74,68
1961-02-28,CIN,131,29,44,STL,105,45,26,74,70
1961-03-01,SYR,149,36,33,PHW,128,43,29,79,62
1961-03-01,CIN,137,30,44,DET,122,30,41,60,85
1961-03-01,LAL,144,32,40,NYK,107,20,51,52,91
1961-03-01,BOS,97,50,21,STL,110,45,27,95,48
1961-03-02,LAL,114,33,40,SYR,110,37,33,70,73
1961-03-03,PHW,123,43,30,SYR,116,37,34,80,64
1961-03-03,DET,129,30,42,NYK,112,20,52,50,94
1961-03-04,PHW,116,44,30,SYR,115,37,35,81,65
1961-03-04,BOS,113,50,22,NYK,110,20,53,70,75
1961-03-04,STL,104,46,27,DET,102,31,42,77,69
1961-03-05,BOS,146,51,22,PHW,129,45,30,96,52
1961-03-05,DET,122,31,43,STL,127,47,27,78,70
1961-03-05,NYK,118,20,54,CIN,124,31,44,51,98
1961-03-05,SYR,114,37,36,LAL,125,34,40,71,76
1961-03-07,STL,137,48,27,LAL,136,35,40,83,67
1961-03-07,BOS,124,52,22,CIN,121,32,44,84,66
1961-03-07,NYK,114,20,55,SYR,113,37,37,57,92
1961-03-08,BOS,136,53,22,SYR,127,37,38,90,60
1961-03-08,DET,120,31,44,LAL,103,35,41,66,85
1961-03-08,STL,117,49,27,NYK,94,21,55,70,82
1961-03-09,PHW,135,45,31,NYK,126,21,56,66,87
1961-03-09,SYR,129,37,39,STL,119,50,27,87,66
1961-03-09,BOS,119,54,22,DET,118,32,44,86,66
1961-03-10,DET,120,32,45,PHW,103,46,31,78,76
1961-03-11,BOS,126,55,22,SYR,116,38,39,93,61
1961-03-11,LAL,105,35,42,CIN,108,32,45,67,87
1961-03-11,STL,130,50,28,PHW,87,46,32,96,60
1961-03-12,SYR,134,38,40,BOS,136,56,22,94,62
1961-03-12,LAL,123,35,43,CIN,122,33,45,68,88
1961-03-12,NYK,106,21,57,DET,120,33,45,54,102
1961-10-19,LAL,118,0,0,PHW,113,0,0,0,0
1961-10-19,NYK,120,0,0,CHP,103,0,1,0,1
1961-10-20,PHW,122,0,1,LAL,115,1,0,1,1
1961-10-21,STL,129,1,0,CIN,138,0,0,1,0
1961-10-21,SYR,123,0,0,CHP,103,0,2,0,2
1961-10-21,BOS,137,0,0,DET,102,0,0,0,0
1961-10-21,PHW,132,1,1,NYK,95,1,0,2,1
1961-10-24,LAL,124,1,1,CIN,122,1,0,2,1
1961-10-24,NYK,112,1,1,STL,110,1,1,2,2
1961-10-25,DET,116,0,1,LAL,120,2,1,2,2
1961-10-26,NYK,120,2,1,CIN,117,1,1,3,2
1961-10-26,SYR,107,1,0,STL,110,1,2,2,2
1961-10-27,PHW,122,2,1,SYR,126,1,1,3,2
1961-10-27,LAL,128,3,1,DET,118,0,2,3,3
1961-10-27,CHP,117,0,3,STL,106,2,2,2,5
1961-10-28,LAL,135,4,1,DET,126,0,3,4,4
1961-10-28,SYR,115,2,1,PHW,119,2,2,4,3
1961-10-28,BOS,132,1,0,NYK,102,3,1,4,1
1961-10-28,STL,122,2,3,CHP,95,1,3,3,6
1961-10-29,CIN,139,1,2,SYR,132,2,2,3,4
1961-10-31,NYK,131,3,2,CIN,127,2,2,5,4
1961-10-31,STL,90,3,3,SYR,107,2,3,5,6
1961-11-01,LAL,120,5,1,CIN,115,2,3,7,4
1961-11-01,DET,111,0,4,NYK,95,4,2,4,6
1961-11-03,CHP,129,1,4,NYK,118,4,3,5,7
1961-11-03,LAL,114,6,1,CIN,132,2,4,8,5
1961-11-03,PHW,98,3,2,BOS,112,2,0,5,2
1961-11-03,SYR,94,3,3,STL,106,3,4,6,7
1961-11-04,PHW,135,3,3,DET,132,1,4,4,7
1961-11-04,CHP,112,2,4,LAL,125,6,2,8,6
1961-11-04,STL,112,4,4,NYK,111,4,4,8,8
1961-11-04,BOS,127,3,0,SYR,107,3,4,6,4
1961-11-07,STL,110,5,4,LAL,127,7,2,12,6
1961-11-07,CIN,123,3,4,NYK,98,4,5,7,9
1961-11-08,DET,128,1,5,PHW,132,4,3,5,8
1961-11-08,LAL,124,8,2,STL,118,5,5,13,7
1961-11-08,NYK,130,4,6,CHP,108,2,5,6,11
1961-11-09,DET,116,1,6,BOS,110,4,0,5,6
1961-11-09,PHW,151,5,3,SYR,108,3,5,8,8
1961-11-10,NYK,118,5,6,DET,124,2,6,7,12
1961-11-10,CIN,122,4,4,CHP,117,2,6,6,10
1961-11-11,BOS,128,4,1,PHW,125,6,3,10,4
1961-11-11,STL,132,5,6,DET,119,3,6,8,12
1961-11-11,SYR,135,3,6,NYK,109,5,7,8,13
1961-11-11,CHP,107,2,7,CIN,117,5,4,7,11
1961-11-12,CIN,136,6,4,STL,126,6,6,12,10
1961-11-12,CHP,96,2,8,BOS,112,5,1,7,9
1961-11-13,LAL,127,9,2,CHP,113,2,9,11,11
1961-11-14,NYK,124,5,8,PHW,122,6,4,11,12
1961-11-14,STL,117,6,7,BOS,119,6,1,12,8
1961-11-14,SYR,115,4,6,CIN,119,7,4,11,10
1961-11-15,PHW,145,6,5,CIN,133,8,4,14,9
1961-11-15,DET,127,3,7,STL,122,6,8,9,15
1961-11-15,LAL,133,10,2,CHP,118,2,10,12,12
1961-11-15,SYR,114,4,7,NYK,102,6,8,10,15
1961-11-16,CIN,121,8,5,BOS,127,7,1,15,6
1961-11-17,PHW,121,7,5,LAL,125,11,2,18,7
1961-11-17,NYK,100,6,9,BOS,104,8,1,14,10
1961-11-18,STL,136,6,9,CIN,133,8,6,14,15
1961-11-18,SYR,148,5,7,PHW,130,7,6,12,13
1961-11-18,DET,119,4,7,CHP,112,2,11,6,18
1961-11-18,BOS,101,9,1,LAL,103,12,2,21,3
1961-11-19,CHP,114,2,12,PHW,122,7,7,9,19
1961-11-19,CIN,128,8,7,DET,112,5,7,13,14
1961-11-21,CIN,118,9,7,PHW,125,8,7,17,14
1961-11-21,NYK,107,6,10,CHP,109,2,13,8,23
1961-11-21,DET,108,5,8,LAL,102,13,2,18,10
1961-11-22,BOS,141,9,2,STL,121,7,9,16,11
1961-11-22,NYK,110,6,11,SYR,109,6,7,12,18
1961-11-23,STL,114,7,10,LAL,122,13,3,20,13
1961-11-23,PHW,106,9,7,BOS,119,10,2,19,9
1961-11-23,SYR,117,6,8,CIN,99,9,8,15,16
1961-11-24,DET,142,6,8,STL,135,7,11,13,19
1961-11-24,SYR,125,7,8,CIN,127,9,9,16,17
1961-11-24,NYK,89,7,11,LAL,100,14,3,21,14
1961-11-25,STL,141,7,12,SYR,108,7,9,14,21
1961-11-25,DET,104,7,8,LAL,103,15,3,22,11
1961-11-25,PHW,134,9,8,CHP,102,3,13,12,21
1961-11-25,BOS,116,11,2,NYK,96,7,12,18,14
1961-11-26,CIN,117,10,9,LAL,102,15,4,25,13
1961-11-26,DET,101,8,8,BOS,107,12,2,20,10
1961-11-28,NYK,117,7,13,CIN,131,11,9,18,22
1961-11-28,SYR,121,7,10,LAL,111,15,5,22,15
1961-11-28,STL,111,8,12,PHW,121,10,8,18,20
1961-11-28,BOS,116,13,2,DET,108,8,9,21,11
1961-11-29,CIN,122,12,9,SYR,136,8,10,20,19
1961-11-30,CIN,133,12,10,BOS,130,14,2,26,12
1961-12-01,BOS,140,14,3,CHP,121,3,14,17,17
1961-12-01,LAL,117,15,6,PHW,138,11,8,26,14
1961-12-01,STL,119,8,13,DET,116,8,10,16,23
1961-12-01,NYK,118,7,14,SYR,100,9,10,16,24
1961-12-02,LAL,129,15,7,PHW,119,12,8,27,15
1961-12-02,SYR,132,9,11,CHP,118,3,15,12,26
1961-12-02,DET,118,8,11,STL,109,9,13,17,24
1961-12-03,CIN,96,13,10,BOS,119,15,3,28,13
1961-12-04,LAL,131,16,7,SYR,120,10,11,26,18
1961-12-05,LAL,125,17,7,SYR,120,10,12,27,19
1961-12-05,NYK,105,8,14,PHW,122,12,9,20,23
1961-12-05,CHP,101,3,16,STL,99,9,14,12,30
1961-12-06,PHW,132,13,9,STL,137,9,15,22,24
1961-12-06,LAL,123,18,7,SYR,121,10,13,28,20
1961-12-06,BOS,103,16,3,CIN,102,13,11,29,14
1961-12-06,DET,133,9,11,NYK,97,8,15,17,26
1961-12-08,PHW,147,13,10,LAL,151,19,7,32,17
1961-12-08,CIN,128,13,12,STL,123,10,15,23,27
1961-12-08,BOS,123,17,3,SYR,111,10,14,27,17
1961-12-08,DET,133,10,11,CHP,107,4,16,14,27
1961-12-09,PHW,135,13,11,CHP,113,4,17,17,28
1961-12-09,DET,107,11,11,LAL,114,20,7,31,18
1961-12-09,SYR,102,10,15,BOS,106,18,3,28,18
1961-12-09,STL,102,10,16,NYK,91,8,16,18,32
1961-12-10,CHP,109,4,18,PHW,118,14,11,18,29
1961-12-10,CIN,134,14,12,NYK,94,8,17,22,29
1961-12-11,LAL,132,21,7,STL,119,11,16,32,23
1961-12-11,CIN,133,15,12,CHP,117,4,19,19,31
1961-12-12,NYK,124,8,18,SYR,126,10,16,18,34
1961-12-12,PHW,132,15,11,DET,109,11,12,26,23
1961-12-13,LAL,137,22,7,STL,136,11,17,33,24
1961-12-13,SYR,126,11,16,CIN,136,16,12,27,28
1961-12-13,BOS,123,19,3,PHW,113,16,11,35,14
1961-12-13,CHP,113,4,20,NYK,112,8,19,12,39
1961-12-14,PHW,136,16,12,SYR,125,11,17,27,29
1961-12-14,BOS,123,20,3,CHP,108,5,20,25,23
1961-12-14,CIN,103,17,12,DET,107,11,13,28,25
1961-12-15,STL,120,11,18,NYK,108,8,20,19,38
1961-12-15,CHP,97,5,21,LAL,94,23,7,28,28
1961-12-16,SYR,128,11,18,LAL,123,23,8,34,26
1961-12-16,BOS,130,21,3,STL,113,12,18,33,21
1961-12-16,CHP,110,6,21,PHW,112,17,12,23,33
1961-12-16,DET,110,12,13,CIN,121,17,13,29,26
1961-12-17,LAL,122,23,9,DET,116,12,14,35,23
1961-12-17,NYK,109,8,21,BOS,117,22,3,30,24
1961-12-19,SYR,124,12,18,DET,111,12,15,24,33
1961-12-19,NYK,128,8,22,STL,111,12,19,20,41
1961-12-19,CIN,110,18,13,PHW,117,18,12,36,25
1961-12-19,LAL,104,24,9,BOS,101,23,3,47,12
1961-12-20,DET,102,12,16,PHW,117,19,12,31,28
1961-12-20,LAL,102,25,9,CHP,98,6,22,31,31
1961-12-21,BOS,122,23,4,NYK,103,9,22,32,26
1961-12-23,STL,126,12,20,LAL,129,26,9,38,29
1961-12-23,DET,134,12,17,CIN,125,18,14,30,31
1961-12-23,BOS,122,24,4,NYK,111,9,23,33,27
1961-12-25,NYK,136,9,24,PHW,135,20,12,29,36
1961-12-25,CIN,127,18,15,LAL,141,27,9,45,24
1961-12-25,SYR,122,13,18,BOS,127,25,4,38,22
1961-12-25,CHP,118,6,23,DET,97,13,17,19,40
1961-12-26,STL,118,12,21,CIN,129,18,16,30,37
1961-12-26,BOS,129,26,4,LAL,117,28,9,54,13
1961-12-26,PHW,118,20,13,SYR,111,13,19,33,32
1961-12-26,CHP,108,7,23,DET,101,13,18,20,41
1961-12-27,PHW,131,21,13,NYK,119,10,24,31,37
1961-12-27,CIN,142,19,16,STL,117,12,22,31,38
1961-12-27,LAL,119,28,10,SYR,111,13,20,41,30
1961-12-27,DET,121,13,19,CHP,93,8,23,21,42
1961-12-28,SYR,114,13,21,LAL,121,29,10,42,31
1961-12-28,STL,109,12,23,BOS,117,27,4,39,27
1961-12-29,PHW,123,22,13,LAL,118,30,10,52,23
1961-12-29,CIN,116,20,16,DET,131,14,19,34,35
1961-12-29,CHP,103,8,24,STL,120,12,24,20,48
1961-12-29,NYK,110,10,25,BOS,100,28,4,38,29
1961-12-30,NYK,123,11,25,CIN,119,20,17,31,42
1961-12-30,PHW,111,23,13,BOS,116,28,5,51,18
1961-12-30,SYR,109,13,22,DET,108,15,19,28,41
1961-12-30,STL,101,13,24,CHP,92,8,25,21,49
1962-01-01,DET,139,15,20,STL,145,14,24,29,44
1962-01-01,LAL,114,30,11,PHW,111,23,14,53,25
1962-01-01,CIN,106,20,18,SYR,110,14,22,34,40
1962-01-02,NYK,110,12,25,DET,104,15,21,27,46
1962-01-02,CHP,102,8,26,SYR,127,15,22,23,48
1962-01-02,BOS,136,29,5,STL,99,15,24,44,29
1962-01-03,LAL,124,31,11,PHW,123,23,15,54,26
1962-01-03,CIN,122,20,19,NYK,111,13,25,33,44
1962-01-03,DET,112,15,22,BOS,103,30,5,45,27
1962-01-05,DET,138,16,22,SYR,135,16,22,32,44
1962-01-05,PHW,134,23,16,STL,116,15,25,38,41
1962-01-05,CIN,103,21,19,BOS,124,30,6,51,25
1962-01-06,NYK,115,13,26,DET,111,17,22,30,48
1962-01-06,SYR,120,16,23,CHP,102,8,27,24,50
1962-01-07,NYK,116,14,26,SYR,123,17,23,31,49
1962-01-07,CIN,123,21,20,CHP,113,8,28,29,48
1962-01-07,STL,137,15,26,PHW,112,24,16,39,42
1962-01-07,LAL,95,32,11,BOS,118,31,6,63,17
1962-01-09,PHW,120,24,17,SYR,129,18,23,42,40
1962-01-09,DET,122,17,23,STL,113,16,26,33,49
1962-01-09,CIN,113,22,20,CHP,106,8,29,30,49
1962-01-10,SYR,134,19,23,STL,122,16,27,35,50
1962-01-10,DET,110,18,23,PHW,113,24,18,42,41
1962-01-10,CHP,103,8,30,BOS,90,32,6,40,36
1962-01-11,CIN,145,23,20,PHW,128,25,18,48,38
1962-01-12,NYK,128,14,27,STL,126,16,28,30,55
1962-01-12,BOS,141,32,7,CIN,125,24,20,56,27
1962-01-12,CHP,99,9,30,DET,102,18,24,27,54
1962-01-13,PHW,135,25,19,CHP,117,9,31,34,50
1962-01-13,SYR,127,20,23,BOS,117,33,7,53,30
1962-01-13,DET,112,19,24,CIN,119,24,21,43,45
1962-01-13,STL,107,16,29,LAL,108,32,12,48,41
1962-01-14,BOS,145,33,8,PHW,136,26,19,59,27
1962-01-14,SYR,141,21,23,NYK,118,15,27,36,50
1962-01-14,CIN,119,25,21,STL,114,16,30,41,51
1962-01-14,DET,118,19,25,LAL,108,33,12,52,37
1962-01-17,PHW,136,26,20,STL,130,16,31,42,51
1962-01-17,LAL,129,33,13,NYK,121,15,28,48,41
1962-01-17,DET,116,20,25,BOS,126,34,8,54,33
1962-01-18,PHW,133,27,20,CIN,151,26,21,53,41
1962-01-18,SYR,118,22,23,CHP,111,9,32,31,55
1962-01-19,CHP,113,0,0,STL,114,0,0,0,0
1962-01-19,PHW,136,27,21,DET,125,20,26,47,47
1962-01-19,LAL,108,34,13,NYK,107,15,29,49,42
1962-01-19,BOS,128,35,8,SYR,103,23,23,58,31
1962-01-20,CIN,125,27,21,LAL,124,35,13,62,34
1962-01-20,STL,116,16,32,CHP,112,9,33,25,65
1962-01-20,PHW,123,28,21,DET,107,20,27,48,48
1962-01-20,SYR,101,23,24,BOS,107,36,8,59,32
1962-01-21,SYR,132,23,25,PHW,139,29,21,52,46
1962-01-21,BOS,120,37,8,DET,124,20,28,57,36
1962-01-21,STL,124,17,32,NYK,113,15,30,32,62
1962-01-21,CHP,111,9,34,LAL,112,35,14,44,48
1962-01-22,CIN,115,28,21,DET,106,21,28,49,49
1962-01-22,CHP,94,9,35,NYK,131,15,31,24,66
1962-01-23,STL,115,18,32,SYR,107,23,26,41,58
1962-01-23,NYK,103,16,31,CHP,109,9,36,25,67
1962-01-23,BOS,118,37,9,LAL,103,36,14,73,23
1962-01-24,BOS,123,38,9,STL,135,19,32,57,41
1962-01-24,LAL,136,36,15,CIN,123,29,21,65,36
1962-01-24,PHW,122,30,21,CHP,108,10,36,40,57
1962-01-24,DET,111,21,29,SYR,102,23,27,44,56
1962-01-25,LAL,116,37,15,CIN,112,29,22,66,37
1962-01-25,CHP,102,10,37,NYK,117,16,32,26,69
1962-01-25,DET,101,22,29,SYR,100,23,28,45,57
1962-01-26,NYK,129,17,32,BOS,121,38,10,55,42
1962-01-26,PHW,136,31,21,STL,110,20,32,51,53
1962-01-27,DET,115,23,29,NYK,107,18,32,41,61
1962-01-27,PHW,131,32,21,BOS,106,38,11,70,32
1962-01-27,CHP,102,10,38,SYR,107,23,29,33,67
1962-01-28,CIN,139,29,23,SYR,131,24,29,53,52
1962-01-28,BOS,129,38,12,PHW,133,33,21,71,33
1962-01-28,LAL,124,38,15,CHP,109,10,39,48,54
1962-01-28,STL,110,20,33,DET,97,24,29,44,62
1962-01-30,STL,121,21,33,CIN,131,30,23,51,56
1962-01-30,NYK,116,18,33,PHW,110,34,21,52,54
1962-01-30,LAL,107,39,15,CHP,92,10,40,49,55
1962-01-31,DET,122,24,30,LAL,123,40,15,64,45
1962-01-31,CHP,115,10,41,BOS,122,38,13,48,54
1962-01-31,SYR,138,24,30,NYK,109,19,33,43,63
1962-02-01,BOS,130,39,13,LAL,115,41,15,80,28
1962-02-01,PHW,130,34,22,CIN,109,31,23,65,45
1962-02-02,BOS,143,40,13,CIN,124,31,24,71,37
1962-02-02,PHW,129,35,22,NYK,116,19,34,54,56
1962-02-02,SYR,135,25,30,STL,101,21,34,46,64
1962-02-02,CHP,112,10,42,DET,96,24,31,34,73
1962-02-03,STL,124,21,35,LAL,127,41,16,62,51
1962-02-03,SYR,134,26,30,PHW,112,36,22,62,52
1962-02-03,NYK,121,19,35,CIN,110,31,25,50,60
1962-02-03,DET,116,24,32,CHP,109,11,42,35,74
1962-02-04,PHW,128,36,23,SYR,117,27,30,63,53
1962-02-04,BOS,130,41,13,NYK,114,20,35,61,48
1962-02-04,DET,121,25,32,STL,113,21,36,46,68
1962-02-04,CHP,113,11,43,LAL,105,42,16,53,59
1962-02-05,LAL,134,42,17,CIN,128,31,26,73,43
1962-02-05,CHP,111,12,43,BOS,127,42,13,54,56
1962-02-06,SYR,127,27,31,CHP,123,12,44,39,75
1962-02-06,CIN,118,31,27,DET,119,26,32,57,59
1962-02-06,STL,114,21,37,BOS,129,43,13,64,50
1962-02-06,NYK,116,20,36,LAL,112,43,17,63,53
1962-02-07,DET,113,27,32,CIN,107,31,28,58,60
1962-02-08,NYK,120,21,36,PHW,136,37,23,58,59
1962-02-08,SYR,122,28,31,BOS,110,44,13,72,44
1962-02-08,CIN,113,31,29,LAL,109,43,18,74,47
1962-02-09,BOS,124,44,14,PHW,126,38,23,82,37
1962-02-09,NYK,120,21,37,SYR,111,29,31,50,68
1962-02-10,CIN,134,32,29,STL,118,21,38,53,67
1962-02-10,CHP,126,12,45,NYK,111,22,37,34,82
1962-02-10,PHW,107,39,23,BOS,106,44,15,83,38
1962-02-11,SYR,132,29,32,DET,116,28,32,57,64
1962-02-11,BOS,148,44,16,CHP,115,13,45,57,61
1962-02-11,NYK,111,22,38,PHW,121,40,23,62,61
1962-02-11,STL,129,21,39,CIN,109,33,29,54,68
1962-02-12,LAL,113,43,19,STL,117,22,39,65,58
1962-02-13,CIN,152,33,30,PHW,132,41,23,74,53
1962-02-13,BOS,138,45,16,CHP,117,13,46,58,62
1962-02-14,CHP,125,13,47,CIN,121,34,30,47,77
1962-02-14,NYK,125,22,39,BOS,112,46,16,68,55
1962-02-14,DET,119,28,33,PHW,110,41,24,69,57
1962-02-14,LAL,130,43,20,STL,107,23,39,66,59
1962-02-15,CHP,126,14,47,SYR,121,30,32,44,79
1962-02-16,PHW,136,41,25,CIN,132,34,31,75,56
1962-02-16,DET,127,29,33,LAL,121,44,20,73,53
1962-02-16,CHP,106,15,47,SYR,132,30,33,45,80
1962-02-16,BOS,127,46,17,NYK,104,23,39,69,56
1962-02-17,SYR,136,31,33,CHP,127,15,48,46,81
1962-02-17,NYK,121,23,40,LAL,128,44,21,67,61
1962-02-17,STL,128,23,40,PHW,121,42,25,65,65
1962-02-17,CIN,113,34,32,DET,123,30,33,64,65
1962-02-18,SYR,141,32,33,NYK,126,23,41,55,74
1962-02-18,CIN,138,34,33,CHP,121,15,49,49,82
1962-02-18,DET,119,31,33,STL,112,24,40,55,73
1962-02-18,LAL,125,45,21,BOS,99,47,17,92,38
1962-02-20,CIN,129,35,33,STL,109,24,41,59,74
1962-02-20,PHW,112,42,26,CHP,107,15,50,57,76
1962-02-20,NYK,110,23,42,DET,103,32,33,55,75
1962-02-20,LAL,96,46,21,BOS,115,47,18,93,39
1962-02-21,CHP,125,15,51,CIN,153,36,33,51,84
1962-02-21,STL,123,24,42,DET,126,32,34,56,76
1962-02-21,SYR,150,33,33,PHW,109,43,26,76,59
1962-02-22,PHW,139,43,27,STL,121,24,43,67,70
1962-02-22,LAL,118,46,22,NYK,116,24,42,70,64
1962-02-22,BOS,134,48,18,SYR,106,34,33,82,51
1962-02-23,DET,120,33,34,CIN,134,37,33,70,67
1962-02-23,NYK,130,24,43,STL,118,24,44,48,87
1962-02-23,LAL,124,47,22,CHP,117,15,52,62,74
1962-02-23,BOS,121,49,18,SYR,107,34,34,83,52
1962-02-24,CHP,129,15,53,STL,119,24,45,39,98
1962-02-24,SYR,120,34,35,NYK,117,25,43,59,78
1962-02-24,CIN,118,38,33,LAL,114,48,22,86,55
1962-02-24,PHW,86,44,27,BOS,109,50,18,94,45
1962-02-25,PHW,135,44,28,NYK,149,25,44,69,72
1962-02-25,SYR,106,35,35,BOS,110,51,18,86,53
1962-02-25,CIN,108,39,33,CHP,105,16,53,55,86
1962-02-25,LAL,128,48,23,DET,99,33,35,81,58
1962-02-27,STL,137,24,46,PHW,147,44,29,68,75
1962-02-27,NYK,120,26,44,SYR,130,35,36,61,80
1962-02-27,LAL,107,49,23,DET,100,33,36,82,59
1962-02-27,BOS,115,52,18,CHP,100,16,54,68,72
1962-02-28,CIN,123,40,33,BOS,129,53,18,93,51
1962-02-28,CHP,119,16,55,PHW,128,45,29,61,84
1962-02-28,NYK,119,26,45,DET,109,33,37,59,82
1962-03-01,SYR,137,36,36,CIN,108,40,34,76,70
1962-03-02,PHW,169,46,29,NYK,147,27,45,73,74
1962-03-02,STL,138,24,47,BOS,120,54,18,78,65
1962-03-02,CIN,120,40,35,DET,112,33,38,73,73
1962-03-03,STL,134,25,47,LAL,125,50,23,75,70
1962-03-03,CHP,119,16,56,CIN,126,41,35,57,91
1962-03-03,DET,114,33,39,SYR,128,37,36,70,75
1962-03-04,NYK,128,27,46,PHW,129,47,29,74,75
1962-03-04,BOS,123,54,19,STL,120,26,47,80,66
1962-03-04,CHP,116,16,57,DET,133,33,40,49,97
1962-03-04,SYR,115,38,36,LAL,124,50,24,88,60
1962-03-06,NYK,113,27,47,BOS,106,55,19,82,66
1962-03-07,SYR,129,38,37,STL,126,26,48,64,85
1962-03-07,DET,119,34,40,NYK,112,28,47,62,87
1962-03-07,BOS,153,55,20,PHW,102,48,29,103,49
1962-03-08,CHP,102,16,58,BOS,108,56,20,72,78
1962-03-09,STL,124,26,49,CHP,120,16,59,42,108
1962-03-09,DET,111,35,40,BOS,130,57,20,92,60
1962-03-09,NYK,122,28,48,LAL,100,51,24,79,72
1962-03-10,CHP,128,16,60,NYK,116,29,48,45,108
1962-03-10,SYR,128,39,37,DET,111,35,41,74,78
1962-03-10,STL,116,27,49,CIN,110,42,35,69,84
1962-03-11,SYR,148,40,37,PHW,130,48,30,88,67
1962-03-11,STL,126,28,49,DET,123,35,42,63,91
1962-03-11,BOS,119,58,20,LAL,105,51,25,109,45
1962-03-12,DET,121,35,43,CHP,116,17,60,52,103
1962-03-12,LAL,119,51,26,NYK,106,29,49,80,75
1962-03-13,STL,118,29,49,CHP,124,17,61,46,110
1962-03-13,LAL,120,52,26,CIN,111,42,36,94,62
1962-03-13,BOS,142,59,20,SYR,110,41,37,100,57
1962-03-14,CIN,136,42,37,NYK,134,29,50,71,87
1962-03-14,CHP,115,18,61,PHW,119,48,31,66,92
1962-03-14,LAL,125,53,26,STL,115,29,50,82,76
1962-03-14,DET,105,36,43,SYR,102,41,38,77,81
1962-10-16,NYK,121,0,0,CHZ,119,0,0,0,0
1962-10-16,LAL,122,0,0,DET,106,0,0,0,0
1962-10-19,NYK,116,1,0,LAL,105,1,0,2,0
1962-10-20,BOS,149,0,0,NYK,116,2,0,2,0
1962-10-20,STL,120,0,0,DET,111,0,1,0,1
1962-10-20,CHZ,113,0,1,CIN,109,0,0,0,1
1962-10-20,SYR,108,0,0,LAL,102,1,1,1,1
1962-10-23,NYK,119,2,1,SYR,123,1,0,3,1
1962-10-23,CIN,116,0,1,LAL,115,1,2,1,3
1962-10-23,SFW,140,0,0,DET,113,0,2,0,2
1962-10-23,STL,110,1,0,CHZ,109,1,1,2,1
1962-10-24,STL,121,2,0,CIN,114,1,1,3,1
1962-10-24,CHZ,118,1,2,LAL,107,1,3,2,5
1962-10-26,SFW,132,1,0,DET,131,0,3,1,3
1962-10-26,SYR,130,2,0,CHZ,112,2,2,4,2
1962-10-26,NYK,108,2,2,BOS,133,1,0,3,2
1962-10-26,CIN,118,1,2,STL,102,3,0,4,2
1962-10-27,CHZ,126,2,3,SFW,129,2,0,4,3
1962-10-27,LAL,134,1,4,DET,118,0,4,1,8
1962-10-27,STL,115,3,1,NYK,109,2,3,5,4
1962-10-27,BOS,118,2,0,SYR,98,3,0,5,0
1962-10-28,CIN,131,2,2,SFW,130,3,0,5,2
1962-10-30,SFW,125,3,1,NYK,106,2,4,5,5
1962-10-30,STL,98,4,1,BOS,97,3,0,7,1
1962-10-31,SYR,126,3,1,STL,108,5,1,8,2
1962-10-31,DET,100,0,5,BOS,115,3,1,3,6
1962-10-31,LAL,115,2,4,NYK,95,2,5,4,9
1962-11-02,SFW,143,4,1,NYK,121,2,6,6,7
1962-11-02,CHZ,97,2,4,BOS,107,4,1,6,5
1962-11-03,LAL,127,3,4,SFW,115,5,1,8,5
1962-11-03,BOS,125,5,1,DET,114,0,6,5,7
1962-11-03,SYR,130,4,1,CIN,111,3,2,7,3
1962-11-03,STL,114,5,2,CHZ,109,2,5,7,7
1962-11-04,LAL,125,4,4,NYK,106,2,7,6,11
1962-11-07,STL,112,6,2,NYK,122,2,8,8,10
1962-11-07,SFW,108,5,2,LAL,132,5,4,10,6
1962-11-07,CIN,105,3,3,BOS,106,6,1,9,4
1962-11-08,DET,116,0,7,CIN,114,3,4,3,11
1962-11-09,SFW,134,5,3,CHZ,126,2,6,7,9
1962-11-09,BOS,120,7,1,LAL,133,6,4,13,5
1962-11-09,NYK,119,3,8,CIN,122,3,5,6,13
1962-11-09,SYR,101,5,1,STL,93,6,3,11,4
1962-11-10,CIN,135,4,5,DET,124,1,7,5,12
1962-11-10,SFW,113,6,3,CHZ,108,2,7,8,10
1962-11-10,STL,97,6,4,LAL,96,7,4,13,8
1962-11-11,LAL,105,7,5,CHZ,109,2,8,9,13
1962-11-11,STL,117,7,4,DET,100,1,8,8,12
1962-11-11,BOS,117,7,2,NYK,98,3,9,10,11
1962-11-12,BOS,137,8,2,CIN,126,5,5,13,7
1962-11-13,CIN,127,5,6,DET,109,1,9,6,15
1962-11-13,NYK,102,3,10,BOS,116,9,2,12,12
1962-11-13,STL,132,8,4,SFW,100,7,3,15,7
1962-11-13,LAL,107,7,6,CHZ,84,3,8,10,14
1962-11-14,CIN,125,6,6,SYR,120,6,1,12,7
1962-11-14,DET,123,1,10,SFW,115,7,4,8,14
1962-11-15,SYR,120,6,2,LAL,98,8,6,14,8
1962-11-15,CHZ,95,3,9,NYK,92,3,11,6,20
1962-11-16,CIN,120,7,6,STL,111,9,4,16,10
1962-11-16,SYR,113,7,2,BOS,105,10,2,17,4
1962-11-17,DET,121,2,10,NYK,113,3,12,5,22
1962-11-17,CHZ,109,4,9,LAL,110,8,7,12,16
1962-11-17,BOS,127,10,3,SFW,109,7,5,17,8
1962-11-17,STL,113,9,5,SYR,107,8,2,17,7
1962-11-18,CIN,132,8,6,SFW,120,7,6,15,12
1962-11-18,SYR,110,8,3,CHZ,107,4,10,12,13
1962-11-18,DET,98,3,10,LAL,116,9,7,12,17
1962-11-20,BOS,113,11,3,CHZ,106,4,11,15,14
1962-11-20,NYK,103,3,13,STL,95,10,5,13,18
1962-11-21,SFW,139,7,7,CIN,143,9,6,16,13
1962-11-21,DET,120,3,11,SYR,122,9,3,12,14
1962-11-21,NYK,137,4,13,CHZ,108,4,12,8,25
1962-11-21,BOS,115,12,3,STL,106,10,6,22,9
1962-11-22,SYR,130,10,3,BOS,120,13,3,23,6
1962-11-22,LAL,134,10,7,CIN,110,10,6,20,13
1962-11-22,STL,106,10,7,DET,91,3,12,13,19
1962-11-23,SFW,124,7,8,LAL,129,11,7,18,15
1962-11-23,NYK,116,5,13,SYR,110,11,3,16,16
1962-11-23,BOS,116,13,4,CHZ,104,4,13,17,17
1962-11-23,DET,93,3,13,STL,121,11,7,14,20
1962-11-24,SYR,137,11,4,NYK,126,6,13,17,17
1962-11-24,LAL,129,12,7,CIN,123,10,7,22,14
1962-11-24,CHZ,104,4,14,DET,103,3,14,7,28
1962-11-24,STL,97,12,7,BOS,95,14,4,26,11
1962-11-25,SFW,115,7,9,CIN,128,10,8,17,17
1962-11-26,LAL,128,13,7,CHZ,106,5,14,18,21
1962-11-27,NYK,129,6,14,CIN,139,11,8,17,22
1962-11-27,BOS,125,14,5,DET,115,3,15,17,20
1962-11-27,SFW,107,7,10,CHZ,115,5,15,12,25
1962-11-27,STL,120,13,7,SYR,105,12,4,25,11
1962-11-28,LAL,116,14,7,STL,110,14,7,28,14
1962-11-28,DET,143,3,16,NYK,101,6,15,9,31
1962-11-29,SFW,121,7,11,STL,128,14,8,21,19
1962-11-29,CHZ,85,6,15,SYR,112,12,5,18,20
1962-11-30,CIN,130,12,8,SYR,117,13,5,25,13
1962-12-01,CHZ,121,6,16,CIN,131,13,8,19,24
1962-12-01,DET,117,4,16,NYK,115,6,16,10,32
1962-12-01,BOS,129,15,5,SYR,110,13,6,28,11
1962-12-01,LAL,110,15,7,STL,97,15,8,30,15
1962-12-02,CIN,127,14,8,BOS,128,16,5,30,13
1962-12-02,SFW,116,7,12,STL,122,15,9,22,21
1962-12-04,SYR,129,13,7,DET,130,5,16,18,23
1962-12-04,NYK,112,6,17,LAL,132,16,7,22,24
1962-12-04,STL,104,16,9,CHZ,102,6,17,22,26
1962-12-05,NYK,133,6,18,CHZ,117,6,18,12,36
1962-12-05,DET,93,6,16,BOS,106,17,5,23,21
1962-12-06,CIN,96,14,9,NYK,99,7,18,21,27
1962-12-06,CHZ,106,6,19,STL,93,17,9,23,28
1962-12-07,SYR,149,13,8,CHZ,129,7,19,20,27
1962-12-07,DET,123,6,17,SFW,116,7,13,13,30
1962-12-07,BOS,126,18,5,LAL,112,17,7,35,12
1962-12-08,STL,145,17,10,SFW,129,7,14,24,24
1962-12-08,CIN,128,14,10,LAL,131,17,8,31,18
1962-12-08,SYR,102,14,8,BOS,97,19,5,33,13
1962-12-08,NYK,87,8,18,DET,78,7,17,15,35
1962-12-09,DET,123,7,18,STL,119,18,10,25,28
1962-12-09,SYR,117,15,8,LAL,114,18,8,33,16
1962-12-09,CHZ,110,7,20,SFW,102,7,15,14,35
1962-12-10,DET,109,8,18,CHZ,100,8,20,16,38
1962-12-11,SFW,136,7,16,SYR,124,16,8,23,24
1962-12-11,LAL,124,18,9,CIN,121,14,11,32,20
1962-12-11,NYK,95,9,18,BOS,87,19,6,28,24
1962-12-12,LAL,126,19,9,SYR,120,16,9,35,18
1962-12-12,DET,115,9,18,NYK,106,10,18,19,36
1962-12-12,CHZ,105,8,21,CIN,102,14,12,22,33
1962-12-12,BOS,111,19,7,STL,98,18,11,37,18
1962-12-13,CIN,142,14,13,CHZ,123,9,21,23,34
1962-12-13,BOS,103,20,7,DET,93,10,18,30,25
1962-12-14,SFW,118,8,16,LAL,120,20,9,28,25
1962-12-15,BOS,120,21,7,CIN,124,15,13,36,20
1962-12-15,LAL,113,21,9,SFW,104,8,17,29,26
1962-12-15,CHZ,142,9,22,NYK,101,10,19,19,41
1962-12-15,DET,94,10,19,STL,112,18,12,28,31
1962-12-16,SFW,137,8,18,SYR,144,16,10,24,28
1962-12-16,STL,115,19,12,NYK,108,10,20,29,32
1962-12-16,CHZ,110,10,22,DET,106,10,20,20,42
1962-12-17,LAL,121,22,9,SYR,114,17,10,39,19
1962-12-18,CHZ,113,11,22,DET,110,10,21,21,43
1962-12-18,SFW,130,8,19,STL,110,20,12,28,31
1962-12-18,NYK,103,10,21,CIN,102,16,13,26,34
1962-12-19,CIN,129,16,14,SYR,120,17,11,33,25
1962-12-19,DET,115,10,22,CHZ,113,12,22,22,44
1962-12-19,LAL,135,23,9,STL,106,20,13,43,22
1962-12-21,CIN,129,17,14,CHZ,116,12,23,29,37
1962-12-21,DET,113,11,22,SFW,122,9,19,20,41
1962-12-21,LAL,100,24,9,STL,105,20,14,44,23
1962-12-22,SYR,118,17,12,SFW,123,10,19,27,31
1962-12-22,DET,122,11,23,CHZ,110,12,24,23,47
1962-12-22,BOS,106,21,8,NYK,120,11,21,32,29
1962-12-25,CIN,131,18,14,DET,120,12,23,30,37
1962-12-25,NYK,111,12,21,SYR,123,17,13,29,34
1962-12-25,SFW,94,11,19,STL,91,21,14,32,33
1962-12-26,CHZ,116,12,25,DET,123,12,24,24,49
1962-12-26,BOS,116,21,9,SFW,113,12,19,33,28
1962-12-26,STL,106,21,15,LAL,104,24,10,45,25
1962-12-27,BOS,108,22,9,SFW,102,12,20,34,29
1962-12-27,SYR,128,18,13,NYK,92,12,22,30,35
1962-12-28,SFW,124,12,21,SYR,117,19,13,31,34
1962-12-28,CIN,113,19,14,BOS,121,23,9,42,23
1962-12-29,SYR,123,19,14,LAL,132,24,11,43,25
1962-12-29,NYK,109,12,23,SFW,114,13,21,25,44
1962-12-29,CHZ,108,12,26,CIN,104,19,15,31,41
1962-12-29,STL,102,22,15,BOS,100,24,9,46,24
1962-12-30,DET,130,13,24,LAL,135,25,11,38,35
1962-12-30,CHZ,100,13,26,STL,107,23,15,36,41
1963-01-01,CIN,112,19,16,NYK,106,12,24,31,40
1963-01-02,SFW,120,14,21,BOS,135,24,10,38,31
1963-01-02,DET,138,13,25,CIN,118,20,16,33,41
1963-01-02,SYR,120,19,15,STL,95,24,15,43,30
1963-01-03,NYK,123,12,25,SYR,115,20,15,32,40
1963-01-04,CIN,130,20,17,SFW,129,14,22,34,39
1963-01-04,LAL,125,26,11,BOS,123,25,10,51,21
1963-01-04,NYK,129,13,25,CHZ,108,13,27,26,52
1963-01-04,STL,121,24,16,DET,100,14,25,38,41
1963-01-05,CHZ,126,13,28,SFW,127,14,23,27,51
1963-01-05,SYR,136,20,16,CIN,117,21,17,41,33
1963-01-05,LAL,106,27,11,BOS,104,25,11,52,22
1963-01-05,DET,92,14,26,STL,90,25,16,39,42
1963-01-06,CIN,119,21,18,LAL,120,28,11,49,29
1963-01-06,STL,114,25,17,SFW,103,15,23,40,40
1963-01-06,NYK,102,14,25,DET,103,15,26,29,51
1963-01-06,SYR,114,21,16,CHZ,102,13,29,34,45
1963-01-08,CIN,116,21,19,SYR,119,22,16,43,35
1963-01-08,SFW,112,15,24,BOS,118,25,12,40,36
1963-01-08,STL,96,26,17,LAL,99,29,11,55,28
1963-01-08,DET,109,16,26,NYK,93,14,26,30,52
1963-01-09,CHZ,131,13,30,BOS,123,26,12,39,42
1963-01-09,DET,115,17,26,LAL,123,30,11,47,37
1963-01-09,SYR,112,23,16,CIN,116,21,20,44,36
1963-01-09,STL,110,26,18,NYK,95,14,27,40,45
1963-01-10,CIN,130,22,20,BOS,121,26,13,48,33
1963-01-11,SFW,129,15,25,LAL,134,31,11,46,36
1963-01-11,BOS,134,26,14,SYR,117,23,17,49,31
1963-01-11,DET,116,17,27,CHZ,112,14,30,31,57
1963-01-12,SYR,115,23,18,DET,146,18,27,41,45
1963-01-12,LAL,119,32,11,SFW,114,15,26,47,37
1963-01-12,STL,115,27,18,CIN,109,23,20,50,38
1963-01-12,CHZ,130,14,31,NYK,97,14,28,28,59
1963-01-13,SYR,148,23,19,DET,114,19,27,42,46
1963-01-13,CIN,104,23,21,STL,105,28,18,51,39
1963-01-13,LAL,108,33,11,NYK,102,14,29,47,40
1963-01-13,BOS,143,27,14,CHZ,99,15,31,42,45
1963-01-14,SFW,142,15,27,NYK,134,14,30,29,57
1963-01-17,SFW,100,16,27,NYK,113,14,31,30,58
1963-01-17,BOS,110,28,14,CHZ,93,15,32,43,46
1963-01-18,BOS,122,29,14,CIN,114,23,22,52,36
1963-01-18,CHZ,108,15,33,LAL,116,34,11,49,44
1963-01-19,SYR,149,24,19,BOS,148,30,14,54,33
1963-01-19,STL,116,29,18,SFW,114,16,28,45,46
1963-01-19,CIN,114,23,23,NYK,108,15,31,38,54
1963-01-20,BOS,133,30,15,LAL,121,35,11,65,26
1963-01-20,STL,116,30,18,SFW,115,16,29,46,47
1963-01-20,CHZ,113,15,34,CIN,93,24,23,39,57
1963-01-21,LAL,124,35,12,DET,94,19,28,54,40
1963-01-22,SFW,107,16,30,DET,115,19,29,35,59
1963-01-22,NYK,100,15,32,BOS,124,31,15,46,47
1963-01-22,SYR,93,25,19,STL,113,31,18,56,37
1963-01-23,CIN,138,24,24,BOS,133,32,15,56,39
1963-01-23,LAL,123,36,12,DET,119,20,29,56,41
1963-01-23,CHZ,104,16,34,SYR,94,25,20,41,54
1963-01-24,SFW,138,16,31,DET,114,20,30,36,61
1963-01-24,BOS,111,32,16,STL,109,32,18,64,34
1963-01-25,LAL,122,37,12,SYR,114,25,21,62,33
1963-01-25,NYK,112,15,33,CIN,114,25,24,40,57
1963-01-25,CHZ,111,17,34,DET,113,20,31,37,65
1963-01-25,BOS,113,33,16,STL,98,32,19,65,35
1963-01-26,CIN,142,26,24,CHZ,116,17,35,43,59
1963-01-26,SFW,110,17,31,SYR,116,25,22,42,53
1963-01-27,CIN,143,27,24,CHZ,126,17,36,44,60
1963-01-27,SFW,110,17,32,SYR,119,26,22,43,54
1963-01-27,BOS,123,34,16,NYK,110,15,34,49,50
1963-01-27,STL,101,32,20,LAL,105,38,12,70,32
1963-01-29,STL,123,32,21,SYR,105,27,22,59,43
1963-01-29,NYK,103,15,35,SFW,123,17,33,32,68
1963-01-29,BOS,100,35,16,CHZ,99,17,37,52,53
1963-01-30,LAL,116,39,12,NYK,115,15,36,54,48
1963-01-30,BOS,125,36,16,SFW,111,18,33,54,49
1963-01-31,BOS,128,37,16,CIN,125,28,24,65,40
1963-01-31,LAL,127,40,12,DET,122,21,31,61,43
1963-01-31,NYK,101,15,37,CHZ,116,17,38,32,75
1963-01-31,SYR,112,27,23,STL,100,33,21,60,44
1963-02-01,SFW,133,18,34,CIN,126,28,25,46,59
1963-02-01,CHZ,111,18,38,STL,119,33,22,51,60
1963-02-01,BOS,111,38,16,SYR,125,28,23,66,39
1963-02-01,DET,109,21,32,LAL,119,41,12,62,44
1963-02-02,SYR,117,29,23,CIN,113,28,26,57,49
1963-02-02,STL,97,34,22,LAL,103,42,12,76,34
1963-02-03,BOS,137,38,17,DET,128,21,33,59,50
1963-02-03,SYR,115,30,23,CIN,125,28,27,58,50
1963-02-03,SFW,108,19,34,CHZ,110,18,39,37,73
1963-02-03,NYK,122,15,38,LAL,95,43,12,58,50
1963-02-05,SFW,109,19,35,CHZ,107,19,39,38,74
1963-02-05,STL,120,34,23,DET,105,21,34,55,57
1963-02-05,NYK,100,16,38,SYR,120,30,24,46,62
1963-02-05,CIN,96,29,27,BOS,106,39,17,68,44
1963-02-06,DET,116,21,35,SFW,117,20,35,41,70
1963-02-06,SYR,126,31,24,BOS,109,40,17,71,41
1963-02-06,LAL,107,43,13,CHZ,105,19,40,62,53
1963-02-07,CIN,134,29,28,SFW,129,21,35,50,63
1963-02-08,DET,135,21,36,SYR,162,32,24,53,60
1963-02-08,STL,112,35,23,CIN,116,30,28,65,51
1963-02-08,NYK,97,16,39,BOS,129,40,18,56,57
1963-02-08,LAL,94,44,13,CHZ,91,19,41,63,54
1963-02-09,SYR,122,33,24,NYK,116,16,40,49,64
1963-02-09,BOS,118,41,18,SFW,112,21,36,62,54
1963-02-09,CHZ,106,19,42,LAL,107,45,13,64,55
1963-02-10,BOS,129,42,18,NYK,123,16,41,58,59
1963-02-10,SYR,139,34,24,SFW,115,21,37,55,61
1963-02-10,CIN,124,31,28,LAL,107,46,13,77,41
1963-02-10,STL,95,35,24,DET,102,21,37,56,61
1963-02-12,DET,120,22,37,SFW,115,21,38,43,75
1963-02-12,STL,128,35,25,SYR,100,35,24,70,49
1963-02-12,BOS,120,43,18,LAL,93,46,14,89,32
1963-02-13,SFW,132,21,39,DET,134,23,37,44,76
1963-02-13,BOS,128,44,18,LAL,134,46,15,90,33
1963-02-13,CIN,124,32,28,SYR,122,35,25,67,53
1963-02-13,NYK,102,16,42,STL,103,36,25,52,67
1963-02-14,SYR,136,35,26,CHZ,117,19,43,54,69
1963-02-14,NYK,123,16,43,STL,113,37,25,53,68
1963-02-14,LAL,128,47,15,DET,111,24,37,71,52
1963-02-15,CHZ,131,19,44,NYK,135,17,43,36,87
1963-02-15,BOS,123,44,19,SYR,114,36,26,80,45
1963-02-15,CIN,96,33,28,STL,99,37,26,70,54
1963-02-16,LAL,118,48,15,SFW,122,21,40,69,55
1963-02-16,DET,99,24,38,CIN,110,33,29,57,67
1963-02-16,STL,94,38,26,BOS,114,45,19,83,45
1963-02-17,SYR,143,36,27,DET,124,24,39,60,66
1963-02-17,CHZ,107,19,45,BOS,110,46,19,65,64
1963-02-17,NYK,98,18,43,CIN,109,34,29,52,72
1963-02-19,BOS,129,47,19,CIN,126,35,29,82,48
1963-02-19,NYK,112,18,44,DET,121,24,40,42,84
1963-02-19,SYR,118,37,27,CHZ,110,19,46,56,73
1963-02-19,SFW,111,22,40,LAL,109,48,16,70,56
1963-02-20,DET,113,25,40,BOS,117,48,19,73,59
1963-02-20,SYR,128,38,27,CIN,109,35,30,73,57
1963-02-21,SFW,118,23,40,BOS,135,49,19,72,59
1963-02-21,CIN,115,35,31,NYK,96,18,45,53,76
1963-02-21,CHZ,108,19,47,SYR,91,39,27,58,74
1963-02-22,DET,126,25,41,SYR,117,39,28,64,69
1963-02-22,LAL,113,48,17,BOS,105,50,19,98,36
1963-02-22,STL,115,38,27,CHZ,98,20,47,58,74
1963-02-22,NYK,106,18,46,SFW,93,23,41,41,87
1963-02-23,CIN,102,36,31,DET,105,26,41,62,72
1963-02-23,CHZ,88,20,48,SFW,92,23,42,43,90
1963-02-24,SYR,143,39,29,NYK,126,19,46,58,75
1963-02-24,DET,119,27,41,CIN,110,36,32,63,73
1963-02-24,LAL,109,49,17,BOS,119,50,20,99,37
1963-02-24,STL,127,39,27,SFW,106,24,42,63,69
1963-02-25,LAL,113,49,18,DET,107,28,41,77,59
1963-02-26,NYK,125,19,47,LAL,116,50,18,69,65
1963-02-26,SFW,128,24,43,BOS,112,51,20,75,63
1963-02-26,STL,114,40,27,CIN,107,36,33,76,60
1963-02-27,SYR,122,40,29,LAL,111,50,19,90,48
1963-02-27,CIN,119,36,34,NYK,107,20,47,56,81
1963-02-27,CHZ,98,20,49,STL,93,41,27,61,76
1963-02-28,SYR,132,41,29,NYK,124,20,48,61,77
1963-02-28,DET,112,28,42,CHZ,104,21,49,49,91
1963-03-01,SFW,132,25,43,CIN,125,37,34,62,77
1963-03-01,DET,115,29,42,STL,113,41,28,70,70
1963-03-01,CHZ,114,21,50,LAL,109,50,20,71,70
1963-03-02,SYR,152,42,29,DET,128,30,42,72,71
1963-03-02,BOS,122,51,21,NYK,117,20,49,71,70
1963-03-02,LAL,113,50,21,SFW,122,26,43,76,64
1963-03-03,DET,123,30,43,SYR,127,43,29,73,72
1963-03-03,SFW,123,27,43,CIN,122,37,35,64,78
1963-03-03,STL,104,41,29,CHZ,97,22,50,63,79
1963-03-03,NYK,95,20,50,BOS,102,52,21,72,71
1963-03-04,LAL,111,50,22,CIN,114,37,36,87,58
1963-03-05,NYK,121,20,51,SYR,131,44,29,64,80
1963-03-05,DET,111,30,44,SFW,102,28,43,58,87
1963-03-05,CHZ,116,22,51,STL,93,42,29,64,80
1963-03-06,CHZ,121,23,51,SFW,111,28,44,51,95
1963-03-06,LAL,106,50,23,CIN,97,38,36,88,59
1963-03-07,SYR,129,45,29,NYK,118,20,52,65,81
1963-03-07,DET,104,31,44,BOS,115,53,21,84,65
1963-03-08,NYK,124,20,53,STL,129,42,30,62,83
1963-03-08,DET,131,31,45,SFW,123,28,45,59,90
1963-03-08,CHZ,110,24,51,BOS,109,54,21,78,72
1963-03-09,STL,117,43,30,LAL,101,51,23,94,53
1963-03-10,SYR,163,46,29,SFW,148,28,46,74,75
1963-03-10,STL,132,44,30,NYK,120,20,54,64,84
1963-03-10,BOS,149,54,22,CIN,117,38,37,92,59
1963-03-10,DET,124,32,45,LAL,116,51,24,83,69
1963-03-11,LAL,109,51,25,STL,96,45,30,96,55
1963-03-12,SFW,116,28,47,LAL,110,52,25,80,72
1963-03-12,CHZ,106,25,51,SYR,130,47,29,72,80
1963-03-12,NYK,96,20,55,CIN,110,38,38,58,93
1963-03-13,CIN,128,39,38,SYR,114,48,29,87,67
1963-03-13,BOS,121,55,22,CHZ,108,25,52,80,74
1963-03-13,LAL,98,52,26,STL,112,45,31,97,57
1963-03-13,DET,112,33,45,NYK,89,20,56,53,101
1963-03-14,SFW,109,29,47,STL,114,46,31,75,78
1963-03-15,NYK,116,20,57,CHZ,111,25,53,45,110
1963-03-15,SFW,119,29,48,STL,108,47,31,76,79
1963-03-16,SYR,121,48,30,BOS,125,56,22,104,52
1963-03-16,CHZ,117,25,54,CIN,126,40,38,65,92
1963-03-16,LAL,111,52,27,SFW,105,30,48,82,75
1963-03-17,BOS,125,57,22,SYR,116,48,31,105,53
1963-03-17,CIN,116,41,38,NYK,109,21,57,62,95
1963-03-17,STL,119,47,32,DET,105,34,45,81,77
1963-10-16,DET,115,0,0,PHL,117,0,0,0,0
1963-10-16,BLT,95,0,0,BOS,109,0,0,0,0
1963-10-16,STL,93,0,0,CIN,112,0,0,0,0
1963-10-17,NYK,113,0,0,BLT,115,0,1,0,1
1963-10-17,CIN,92,1,0,BOS,93,1,0,2,0
1963-10-19,PHL,121,1,0,DET,124,0,1,1,1
1963-10-19,STL,117,0,1,LAL,108,0,0,0,1
1963-10-19,BLT,102,1,1,SFW,103,0,0,1,1
1963-10-19,CIN,121,1,1,NYK,97,0,1,1,2
1963-10-22,NYK,117,0,2,LAL,130,0,1,0,3
1963-10-22,CIN,103,2,1,SFW,97,1,0,3,1
1963-10-23,DET,116,1,1,LAL,124,1,1,2,2
1963-10-23,BLT,115,1,2,NYK,106,0,3,1,5
1963-10-23,STL,95,1,1,SFW,99,1,1,2,2
1963-10-25,PHL,112,1,1,NYK,136,0,4,1,5
1963-10-25,CIN,109,3,1,LAL,122,2,1,5,2
1963-10-26,BOS,123,2,0,BLT,108,2,2,4,2
1963-10-26,STL,127,1,2,DET,103,1,2,2,4
1963-10-26,NYK,109,1,4,PHL,101,1,2,2,6
1963-10-26,SFW,102,2,1,CIN,99,3,2,5,3
1963-10-27,BLT,112,2,3,STL,123,2,2,4,5
1963-10-29,NYK,103,2,4,STL,109,3,2,5,6
1963-10-29,SFW,101,3,1,CIN,108,3,3,6,4
1963-10-30,BLT,108,2,4,PHL,111,1,3,3,7
1963-10-30,LAL,107,3,1,CIN,115,4,3,7,4
1963-10-30,STL,121,4,2,NYK,104,2,5,6,7
1963-10-30,DET,102,1,3,BOS,108,3,0,4,3
1963-11-01,LAL,122,3,2,CIN,112,5,3,8,5
1963-11-01,PHL,102,2,3,BOS,119,4,0,6,3
1963-11-02,BOS,117,5,0,DET,109,1,4,6,4
1963-11-02,NYK,123,2,6,BLT,105,2,5,4,11
1963-11-02,SFW,118,3,2,LAL,99,4,2,7,4
1963-11-02,STL,128,5,2,PHL,99,2,4,7,6
1963-11-03,CIN,95,5,4,PHL,93,2,5,7,9
1963-11-06,BOS,139,6,0,CIN,121,6,4,12,4
1963-11-06,BLT,110,2,6,STL,112,6,2,8,8
1963-11-06,LAL,111,4,3,NYK,109,3,6,7,9
1963-11-06,DET,119,1,5,PHL,101,2,6,3,11
1963-11-07,SFW,110,4,2,NYK,88,3,7,7,9
1963-11-08,CIN,116,6,5,BOS,115,7,0,13,5
1963-11-08,PHL,108,2,7,STL,106,7,2,9,9
1963-11-08,LAL,93,5,3,SFW,90,5,2,10,5
1963-11-09,CIN,118,7,5,DET,109,2,5,9,10
1963-11-09,BLT,116,2,7,PHL,100,3,7,5,14
1963-11-09,STL,91,7,3,BOS,113,7,1,14,4
1963-11-09,SFW,84,5,3,NYK,89,3,8,8,11
1963-11-10,LAL,104,6,3,NYK,79,4,8,10,11
1963-11-11,BOS,116,8,1,STL,110,7,4,15,5
1963-11-11,DET,116,2,6,LAL,109,7,3,9,9
1963-11-12,PHL,106,3,8,SFW,102,5,4,8,12
1963-11-13,BOS,114,9,1,LAL,110,7,4,16,5
1963-11-13,NYK,106,4,9,STL,102,7,5,11,14
1963-11-13,CIN,92,8,5,SFW,98,5,5,13,10
1963-11-14,BLT,115,3,7,LAL,123,7,5,10,12
1963-11-14,STL,117,7,6,SFW,105,6,5,13,11
1963-11-15,BOS,133,10,1,NYK,116,5,9,15,10
1963-11-15,SFW,98,6,6,DET,101,3,6,9,12
1963-11-15,PHL,99,4,8,LAL,97,8,5,12,13
1963-11-16,NYK,122,5,10,CIN,114,8,6,13,16
1963-11-16,STL,115,8,6,BLT,112,3,8,11,14
1963-11-16,LAL,115,8,6,DET,95,4,6,12,12
1963-11-17,LAL,112,9,6,STL,117,9,6,18,12
1963-11-17,CIN,110,8,7,BLT,109,3,9,11,16
1963-11-17,SFW,120,6,7,DET,96,4,7,10,14
1963-11-19,CIN,127,9,7,DET,102,4,8,13,15
1963-11-19,NYK,98,6,10,BOS,126,11,1,17,11
1963-11-19,SFW,129,7,7,STL,96,10,6,17,13
1963-11-20,DET,124,4,9,CIN,118,10,7,14,16
1963-11-20,PHL,118,5,8,NYK,101,6,11,11,19
1963-11-21,LAL,111,9,7,STL,99,10,7,19,14
1963-11-23,STL,133,10,8,CIN,121,10,8,20,16
1963-11-23,NYK,108,6,12,DET,99,5,9,11,21
1963-11-24,CIN,122,10,9,STL,113,11,8,21,17
1963-11-26,PHL,115,6,8,BLT,113,3,10,9,18
1963-11-26,NYK,112,7,12,LAL,119,10,7,17,19
1963-11-26,CIN,123,11,9,SFW,112,8,7,19,16
1963-11-27,BLT,119,3,11,CIN,122,12,9,15,20
1963-11-27,DET,105,5,10,STL,113,11,9,16,19
1963-11-27,SFW,118,8,8,NYK,89,7,13,15,21
1963-11-27,BOS,114,12,1,LAL,78,11,7,23,8
1963-11-28,PHL,110,7,8,CIN,125,13,9,20,17
1963-11-28,STL,118,12,9,DET,101,5,11,17,20
1963-11-29,DET,111,5,12,LAL,127,11,8,16,20
1963-11-29,CIN,135,14,9,NYK,110,7,14,21,23
1963-11-29,BLT,100,3,12,SFW,99,9,8,12,20
1963-11-29,BOS,112,13,1,PHL,78,7,9,20,10
1963-11-30,NYK,125,7,15,PHL,132,7,10,14,25
1963-11-30,BLT,120,4,12,DET,101,5,13,9,25
1963-11-30,STL,96,13,9,LAL,97,12,8,25,17
1963-11-30,BOS,109,14,1,SFW,96,9,9,23,10
1963-12-01,PHL,132,8,10,DET,121,5,14,13,24
1963-12-01,CIN,109,15,9,LAL,114,13,8,28,17
1963-12-03,NYK,108,7,16,SFW,116,9,10,16,26
1963-12-04,DET,119,5,15,NYK,120,7,17,12,32
1963-12-04,BLT,118,5,12,LAL,98,14,8,19,20
1963-12-04,STL,105,13,10,SFW,83,10,10,23,20
1963-12-05,CIN,118,15,10,BOS,108,15,1,30,11
1963-12-05,PHL,103,9,10,STL,106,14,10,23,20
1963-12-06,DET,112,5,16,STL,108,15,10,20,26
1963-12-06,BOS,112,15,2,CIN,107,16,10,31,12
1963-12-06,BLT,116,6,12,NYK,102,8,17,14,29
1963-12-06,SFW,101,10,11,LAL,110,14,9,24,20
1963-12-07,STL,129,15,11,PHL,120,9,11,24,22
1963-12-07,NYK,105,8,18,CIN,116,16,11,24,29
1963-12-07,BLT,97,7,12,BOS,114,16,2,23,14
1963-12-08,CIN,116,17,11,PHL,126,9,12,26,23
1963-12-08,LAL,112,15,9,SFW,114,10,12,25,21
1963-12-09,LAL,134,15,10,BLT,120,7,13,22,23
1963-12-10,NYK,113,8,19,BOS,132,17,2,25,21
1963-12-10,SFW,117,11,12,BLT,108,7,14,18,26
1963-12-10,STL,113,16,11,PHL,103,10,12,26,23
1963-12-11,DET,107,6,16,CIN,127,17,12,23,28
1963-12-11,PHL,113,10,13,NYK,103,8,20,18,33
1963-12-11,BOS,104,18,2,STL,95,17,11,35,13
1963-12-12,LAL,120,16,10,BLT,105,7,15,23,25
1963-12-12,CIN,112,18,12,NYK,102,8,21,26,33
1963-12-13,SFW,114,12,12,BLT,116,7,16,19,28
1963-12-13,PHL,84,11,13,BOS,111,19,2,30,15
1963-12-14,NYK,119,8,22,PHL,123,11,14,19,36
1963-12-14,LAL,113,17,10,BLT,108,8,16,25,26
1963-12-14,BOS,105,20,2,CIN,108,19,12,39,14
1963-12-14,STL,104,17,12,DET,92,6,17,23,29
1963-12-15,SFW,122,12,13,BLT,97,8,17,20,30
1963-12-15,LAL,95,18,10,STL,102,18,12,36,22
1963-12-17,BOS,131,20,3,BLT,114,8,18,28,21
1963-12-17,SFW,110,13,13,STL,106,19,12,32,25
1963-12-17,NYK,103,8,23,DET,107,6,18,14,41
1963-12-18,BOS,133,21,3,NYK,111,8,24,29,27
1963-12-18,DET,107,7,18,BLT,124,8,19,15,37
1963-12-18,SFW,104,14,13,STL,96,19,13,33,26
1963-12-18,LAL,116,18,11,PHL,96,12,14,30,25
1963-12-19,BOS,143,22,3,NYK,140,8,25,30,28
1963-12-20,SFW,112,15,13,PHL,114,12,15,27,28
1963-12-20,CIN,103,20,12,BLT,96,9,19,29,31
1963-12-21,NYK,127,8,26,BOS,117,23,3,31,29
1963-12-21,LAL,126,19,11,PHL,113,13,15,32,26
1963-12-21,BLT,108,9,20,CIN,106,21,12,30,32
1963-12-21,DET,91,7,19,STL,100,19,14,26,33
1963-12-22,STL,116,20,14,BLT,104,10,20,30,34
1963-12-22,SFW,118,15,14,PHL,104,13,16,28,30
1963-12-25,NYK,126,9,26,LAL,134,20,11,29,37
1963-12-25,CIN,113,21,13,STL,107,21,14,42,27
1963-12-26,PHL,118,13,17,SFW,112,16,14,29,31
1963-12-26,BOS,126,23,4,LAL,110,21,11,44,15
1963-12-26,BLT,110,10,21,DET,108,7,20,17,41
1963-12-26,STL,107,21,15,NYK,111,9,27,30,42
1963-12-27,PHL,119,14,17,DET,107,7,21,21,38
1963-12-27,CIN,91,22,13,BOS,87,24,4,46,17
1963-12-28,BLT,104,11,21,SFW,106,16,15,27,36
1963-12-28,STL,100,21,16,BOS,107,24,5,45,21
1963-12-28,PHL,114,15,17,LAL,100,21,12,36,29
1963-12-29,LAL,140,21,13,DET,128,7,22,28,35
1963-12-29,CIN,105,23,13,NYK,99,10,27,33,40
1963-12-30,DET,114,7,23,SFW,112,17,15,24,38
1963-12-31,LAL,132,22,13,STL,119,21,17,43,30
1963-12-31,NYK,79,10,28,SFW,101,17,16,27,44
1964-01-02,CIN,112,24,13,DET,111,8,23,32,36
1964-01-02,BLT,124,11,22,NYK,109,10,29,21,51
1964-01-02,SFW,106,18,16,STL,111,21,18,39,34
1964-01-03,NYK,120,10,30,BLT,118,12,22,22,52
1964-01-03,PHL,132,16,17,CIN,110,25,13,41,30
1964-01-03,SFW,101,18,17,BOS,111,25,5,43,22
1964-01-04,LAL,125,23,13,BOS,118,26,5,49,18
1964-01-04,NYK,116,11,30,CIN,125,25,14,36,44
1964-01-04,BLT,113,12,23,PHL,123,17,17,29,40
1964-01-05,PHL,118,18,17,NYK,142,11,31,29,48
1964-01-05,CIN,111,26,14,BLT,106,12,24,38,38
1964-01-05,STL,116,22,18,DET,99,8,24,30,42
1964-01-05,LAL,97,24,13,BOS,95,26,6,50,19
1964-01-07,STL,123,23,18,BLT,113,12,25,35,43
1964-01-07,CIN,130,27,14,PHL,110,18,18,45,32
1964-01-07,SFW,92,18,18,BOS,89,26,7,44,25
1964-01-08,LAL,136,25,13,NYK,118,12,31,37,44
1964-01-08,CIN,126,28,14,PHL,110,18,19,46,33
1964-01-08,DET,99,8,25,BLT,106,12,26,20,51
1964-01-09,PHL,122,18,20,STL,115,24,18,42,38
1964-01-09,DET,125,8,26,BLT,115,13,26,21,52
1964-01-09,SFW,112,19,18,NYK,97,12,32,31,50
1964-01-10,BOS,109,26,8,CIN,92,29,14,55,22
1964-01-10,SFW,114,20,18,LAL,89,26,13,46,31
1964-01-11,PHL,115,19,20,BOS,108,27,8,46,28
1964-01-11,LAL,108,26,14,NYK,118,12,33,38,47
1964-01-11,DET,107,9,26,STL,112,24,19,33,45
1964-01-12,STL,113,25,19,BLT,117,13,27,38,46
1964-01-12,BOS,123,27,9,PHL,112,20,20,47,29
1964-01-12,SFW,112,21,18,NYK,105,13,33,34,51
1964-01-12,CIN,120,29,15,DET,88,9,27,38,42
1964-01-15,STL,109,25,20,LAL,111,26,15,51,35
1964-01-15,BLT,108,14,27,BOS,113,28,9,42,36
1964-01-15,DET,79,9,28,SFW,89,22,18,31,46
1964-01-16,NYK,124,13,34,DET,116,9,29,22,63
1964-01-16,CIN,108,30,15,LAL,95,27,15,57,30
1964-01-17,DET,101,9,30,NYK,99,14,34,23,64
1964-01-17,PHL,91,20,21,SFW,112,23,18,43,39
1964-01-17,BOS,99,29,9,LAL,79,27,16,56,25
1964-01-18,CIN,120,31,15,STL,121,25,21,56,36
1964-01-18,DET,115,10,30,BOS,121,30,9,40,39
1964-01-18,LAL,115,27,17,PHL,111,20,22,47,39
1964-01-18,BLT,93,14,28,SFW,86,24,18,38,46
1964-01-19,STL,114,26,21,CIN,109,31,16,57,37
1964-01-19,BLT,107,15,28,NYK,109,14,35,29,63
1964-01-19,BOS,108,31,9,SFW,105,24,19,55,28
1964-01-20,LAL,107,28,17,DET,118,10,31,38,48
1964-01-21,NYK,124,15,35,CIN,139,31,17,46,52
1964-01-21,BLT,124,15,29,PHL,121,20,23,35,52
1964-01-21,STL,116,27,21,BOS,114,32,9,59,30
1964-01-21,SFW,100,24,20,DET,88,11,31,35,51
1964-01-22,BLT,124,16,29,PHL,116,20,24,36,53
1964-01-22,LAL,110,28,18,DET,101,11,32,39,50
1964-01-22,CIN,109,32,17,BOS,92,32,10,64,27
1964-01-23,BLT,130,17,29,NYK,114,15,36,32,65
1964-01-23,BOS,110,32,11,STL,104,28,21,60,32
1964-01-23,SFW,125,25,20,DET,93,11,33,36,53
1964-01-24,PHL,134,20,25,CIN,111,33,17,53,42
1964-01-24,LAL,118,29,18,SFW,100,26,20,55,38
1964-01-24,BOS,119,33,11,STL,99,28,22,61,33
1964-01-25,NYK,129,15,37,PHL,131,21,25,36,62
1964-01-25,BLT,115,18,29,CIN,99,33,18,51,47
1964-01-25,DET,98,11,34,STL,107,28,23,39,57
1964-01-25,SFW,120,26,21,LAL,95,30,18,56,39
1964-01-26,PHL,120,22,25,BLT,131,19,29,41,54
1964-01-26,STL,106,29,23,DET,104,11,35,40,58
1964-01-26,BOS,115,34,11,NYK,102,15,38,49,49
1964-01-26,LAL,108,30,19,SFW,96,27,21,57,40
1964-01-28,NYK,133,15,39,BOS,127,35,11,50,50
1964-01-28,PHL,117,22,26,SFW,139,27,22,49,48
1964-01-28,DET,93,11,36,LAL,92,31,19,42,55
1964-01-29,STL,104,30,23,NYK,105,16,39,46,62
1964-01-29,PHL,102,22,27,LAL,97,31,20,53,47
1964-01-29,BOS,92,35,12,SFW,100,28,22,63,34
1964-01-30,CIN,133,33,19,NYK,110,17,39,50,58
1964-01-30,DET,109,12,36,SFW,100,29,22,41,58
1964-01-30,BLT,107,20,29,LAL,89,31,21,51,50
1964-01-31,CIN,118,34,19,BLT,106,21,29,55,48
1964-01-31,BOS,114,35,13,PHL,97,23,27,58,40
1964-02-01,BLT,111,21,30,DET,112,13,36,34,66
1964-02-01,PHL,111,23,28,BOS,119,36,13,59,41
1964-02-01,NYK,106,17,40,SFW,125,29,23,46,63
1964-02-01,STL,113,30,24,LAL,96,31,22,61,46
1964-02-02,BLT,118,21,31,SFW,120,30,23,51,54
1964-02-02,BOS,117,37,13,CIN,119,35,19,72,32
1964-02-02,STL,107,31,24,LAL,105,31,23,62,47
1964-02-04,NYK,134,17,41,BLT,137,21,32,38,73
1964-02-04,BOS,113,37,14,STL,101,32,24,69,38
1964-02-04,CIN,118,36,19,LAL,100,31,24,67,43
1964-02-04,SFW,118,31,23,DET,79,14,36,45,59
1964-02-05,BLT,113,22,32,STL,106,32,25,54,57
1964-02-05,LAL,111,31,25,DET,85,14,37,45,62
1964-02-06,PHL,128,23,29,NYK,117,17,42,40,71
1964-02-06,SFW,104,32,23,DET,97,14,38,46,61
1964-02-06,BLT,92,23,32,BOS,94,38,14,61,46
1964-02-07,CIN,126,37,19,PHL,114,24,29,61,48
1964-02-07,BOS,133,39,14,NYK,112,17,43,56,57
1964-02-07,LAL,103,32,25,DET,111,14,39,46,64
1964-02-08,NYK,114,17,44,BOS,135,40,14,57,58
1964-02-08,BLT,105,23,33,CIN,109,38,19,61,52
1964-02-08,PHL,109,24,30,LAL,101,32,26,56,56
1964-02-08,STL,97,32,26,SFW,103,33,23,65,49
1964-02-09,STL,116,32,27,SFW,111,34,23,66,50
1964-02-09,BLT,119,23,34,LAL,110,32,27,55,61
1964-02-09,BOS,120,41,14,PHL,109,25,30,66,44
1964-02-09,CIN,135,39,19,DET,107,15,39,54,58
1964-02-11,DET,118,15,40,SFW,128,34,24,49,64
1964-02-11,BOS,109,42,14,LAL,113,32,28,74,42
1964-02-11,STL,125,33,27,NYK,103,17,45,50,72
1964-02-12,CIN,147,40,19,DET,121,15,41,55,60
1964-02-12,BLT,121,24,34,PHL,115,25,31,49,65
1964-02-12,LAL,97,33,28,BOS,104,42,15,75,43
1964-02-13,SFW,106,35,24,BOS,95,43,15,78,39
1964-02-14,PHL,130,25,32,DET,123,15,42,40,74
1964-02-14,CIN,126,41,19,NYK,114,17,46,58,65
1964-02-15,NYK,124,17,47,CIN,130,42,19,59,66
1964-02-15,BLT,124,25,34,DET,122,15,43,40,77
1964-02-15,STL,118,34,27,PHL,110,26,32,60,59
1964-02-15,SFW,87,36,24,BOS,96,43,16,79,40
1964-02-16,DET,99,15,44,BLT,111,26,34,41,78
1964-02-16,CIN,114,43,19,PHL,97,26,33,69,52
1964-02-16,LAL,90,33,29,BOS,92,44,16,77,45
1964-02-17,CIN,129,44,19,SFW,113,36,25,80,44
1964-02-17,BLT,110,27,34,STL,115,35,27,62,61
1964-02-18,NYK,118,17,48,LAL,117,33,30,50,78
1964-02-18,DET,98,15,45,SFW,108,36,26,51,71
1964-02-18,PHL,93,26,34,BOS,103,45,16,71,50
1964-02-19,PHL,130,26,35,BLT,122,27,35,53,70
1964-02-19,DET,116,15,46,LAL,115,33,31,48,77
1964-02-19,NYK,120,18,48,STL,114,36,27,54,75
1964-02-19,CIN,101,45,19,SFW,108,37,26,82,45
1964-02-20,BOS,129,46,16,BLT,113,27,36,73,52
1964-02-20,DET,101,16,46,LAL,106,33,32,49,78
1964-02-21,PHL,144,27,35,BOS,119,47,16,74,51
1964-02-21,BLT,115,27,37,STL,113,36,28,63,65
1964-02-21,SFW,93,38,26,CIN,101,45,20,83,46
1964-02-22,DET,119,16,47,NYK,125,19,48,35,95
1964-02-22,LAL,105,34,32,CIN,107,46,20,80,52
1964-02-22,STL,95,36,29,BOS,88,47,17,83,46
1964-02-23,SFW,109,38,27,LAL,108,34,33,72,60
1964-02-23,NYK,105,20,48,PHL,114,28,35,48,83
1964-02-23,BLT,129,28,37,DET,104,16,48,44,85
1964-02-24,DET,115,16,49,BOS,113,47,18,63,67
1964-02-25,SFW,117,39,27,CIN,108,47,20,86,47
1964-02-25,STL,115,37,29,PHL,107,29,35,66,64
1964-02-25,NYK,102,20,49,BOS,114,47,19,67,68
1964-02-26,DET,122,17,49,PHL,130,29,36,46,85
1964-02-26,LAL,103,34,34,CIN,97,47,21,81,55
1964-02-26,BLT,87,29,37,BOS,100,48,19,77,56
1964-02-27,STL,97,38,29,SFW,107,40,27,78,56
1964-02-28,PHL,132,30,36,CIN,134,47,22,77,58
1964-02-28,BLT,112,29,38,LAL,115,35,34,64,72
1964-02-28,DET,112,17,50,NYK,110,20,50,37,100
1964-02-28,BOS,107,49,19,SFW,92,41,27,90,46
1964-02-29,STL,115,38,30,LAL,114,36,34,74,64
1964-02-29,PHL,114,30,37,CIN,117,48,22,78,59
1964-02-29,NYK,110,20,51,SFW,136,41,28,61,79
1964-02-29,BOS,115,50,19,DET,108,18,50,68,69
1964-03-01,BLT,111,29,39,CIN,122,49,22,78,61
1964-03-01,BOS,108,51,19,PHL,93,30,38,81,57
1964-03-01,LAL,114,36,35,STL,91,39,30,75,65
1964-03-01,DET,86,18,51,SFW,100,42,28,60,79
1964-03-02,SFW,102,43,28,STL,111,39,31,82,59
1964-03-03,NYK,108,20,52,CIN,117,50,22,70,74
1964-03-03,BOS,108,52,19,PHL,94,30,39,82,58
1964-03-04,BOS,112,53,19,CIN,108,51,22,104,41
1964-03-04,BLT,115,29,40,NYK,108,20,53,49,93
1964-03-04,LAL,105,37,35,STL,110,40,31,77,66
1964-03-05,DET,125,18,52,BLT,120,30,40,48,92
1964-03-05,SFW,102,43,29,STL,104,41,31,84,60
1964-03-05,CIN,111,51,23,BOS,101,54,19,105,42
1964-03-07,LAL,118,37,36,SFW,120,43,30,80,66
1964-03-07,PHL,130,30,40,NYK,115,20,54,50,94
1964-03-07,CIN,104,52,23,BLT,101,30,41,82,64
1964-03-07,DET,94,19,52,BOS,112,54,20,73,72
1964-03-08,BOS,128,55,20,DET,118,19,53,74,73
1964-03-08,STL,135,42,31,BLT,117,30,42,72,73
1964-03-08,NYK,140,20,55,PHL,108,31,40,51,95
1964-03-09,LAL,122,37,37,BLT,112,30,43,67,80
1964-03-10,SFW,129,44,30,BLT,111,30,44,74,74
1964-03-10,NYK,105,21,55,STL,124,43,31,64,86
1964-03-10,DET,114,19,54,CIN,103,53,23,72,77
1964-03-11,STL,111,44,31,PHL,124,31,41,75,72
1964-03-11,LAL,115,38,37,BLT,109,30,45,68,82
1964-03-12,BOS,140,56,20,DET,120,20,54,76,74
1964-03-12,CIN,128,53,24,PHL,111,32,41,85,65
1964-03-12,SFW,125,45,30,BLT,102,30,46,75,76
1964-03-13,PHL,122,32,42,DET,133,20,55,52,97
1964-03-13,SFW,109,46,30,LAL,112,39,37,85,67
1964-03-14,DET,126,21,55,NYK,124,21,56,42,111
1964-03-14,PHL,128,32,43,BLT,122,30,47,62,90
1964-03-14,STL,118,44,32,CIN,110,54,24,98,56
1964-03-14,LAL,95,40,37,SFW,111,46,31,86,68
1964-03-15,NYK,139,21,57,DET,125,22,55,43,112
1964-03-15,BOS,129,57,20,BLT,105,30,48,87,68
1964-03-15,CIN,124,54,25,STL,101,45,32,99,57
1964-03-15,LAL,120,40,38,PHL,95,33,43,73,81
1964-03-16,SFW,110,47,31,PHL,111,33,44,80,75
1964-03-17,BOS,127,58,20,NYK,121,22,57,80,77
1964-03-17,STL,115,45,33,DET,99,22,56,67,89
1964-03-17,LAL,121,41,38,PHL,97,34,44,75,82
1964-03-18,DET,106,22,57,STL,96,46,33,68,90
1964-03-18,BLT,108,30,49,BOS,95,59,20,89,69
1964-03-18,SFW,89,47,32,PHL,85,34,45,81,77
1964-10-16,PHL,125,0,0,DET,113,0,0,0,0
1964-10-17,NYK,109,0,0,LAL,113,0,1,0,1
1964-10-17,BLT,121,0,0,SFW,101,0,0,0,0
1964-10-17,STL,94,0,0,CIN,91,1,0,1,0
1964-10-17,BOS,112,0,0,DET,81,0,1,0,1
1964-10-18,CIN,117,1,1,SFW,108,0,1,1,2
1964-10-20,CIN,121,2,1,LAL,113,1,1,3,2
1964-10-21,BLT,105,1,0,LAL,108,1,2,2,2
1964-10-21,DET,108,0,2,SFW,104,0,2,0,4
1964-10-22,PHL,135,1,0,BLT,138,1,1,2,1
1964-10-22,BOS,104,1,0,DET,102,1,2,2,2
1964-10-23,SFW,92,0,3,LAL,94,2,2,2,5
1964-10-24,NYK,108,0,1,DET,118,1,3,1,4
1964-10-24,BOS,131,2,0,BLT,103,2,1,4,1
1964-10-24,STL,126,1,0,PHL,86,1,1,2,1
1964-10-25,CIN,109,3,1,PHL,107,1,2,4,3
1964-10-25,BLT,100,2,2,BOS,112,3,0,5,2
1964-10-25,NYK,108,0,2,DET,95,2,3,2,5
1964-10-27,NYK,103,1,2,BOS,131,4,0,5,2
1964-10-27,SFW,101,0,4,BLT,90,2,3,2,7
1964-10-27,PHL,100,1,3,STL,81,2,0,3,3
1964-10-28,STL,117,2,1,BOS,119,5,0,7,1
1964-10-28,LAL,112,3,2,BLT,102,2,4,5,6
1964-10-29,LAL,95,4,2,BLT,98,2,5,6,7
1964-10-30,CIN,119,4,1,STL,118,2,2,6,3
1964-10-30,NYK,94,1,3,PHL,90,2,3,3,6
1964-10-30,DET,90,2,4,BOS,106,6,0,8,4
1964-10-31,PHL,116,2,4,NYK,105,2,3,4,7
1964-10-31,STL,107,2,3,DET,99,2,5,4,8
1964-10-31,SFW,98,1,4,BLT,102,3,5,4,9
1964-10-31,BOS,122,7,0,CIN,94,5,1,12,1
1964-11-01,LAL,115,4,3,STL,116,3,3,7,6
1964-11-01,CIN,114,5,2,DET,101,2,6,7,8
1964-11-04,DET,108,2,7,BLT,121,4,5,6,12
1964-11-04,SFW,104,1,5,STL,105,4,3,5,8
1964-11-05,LAL,106,4,4,NYK,96,2,4,6,8
1964-11-06,SFW,133,1,6,NYK,127,2,5,3,11
1964-11-06,CIN,106,6,2,BLT,111,5,5,11,7
1964-11-07,BOS,130,8,0,DET,113,2,8,10,8
1964-11-07,PHL,105,3,4,CIN,103,6,3,9,7
1964-11-07,LAL,130,5,4,SFW,103,2,6,7,10
1964-11-07,STL,134,5,3,BLT,99,6,5,11,8
1964-11-08,SFW,130,2,7,NYK,121,2,6,4,13
1964-11-08,CIN,103,6,4,BOS,106,9,0,15,4
1964-11-10,DET,119,2,9,BLT,117,6,6,8,15
1964-11-10,LAL,108,6,4,NYK,101,2,7,8,11
1964-11-10,PHL,99,4,4,SFW,110,3,7,7,11
1964-11-11,STL,116,6,3,CIN,118,6,5,12,8
1964-11-11,BLT,114,6,7,PHL,123,4,5,10,12
1964-11-11,BOS,110,10,0,SFW,84,4,7,14,7
1964-11-12,NYK,123,2,8,LAL,132,7,4,9,12
1964-11-12,PHL,110,5,5,BOS,109,11,0,16,5
1964-11-12,DET,121,3,9,SFW,99,4,8,7,17
1964-11-13,BOS,112,11,1,LAL,114,8,4,19,5
1964-11-13,CIN,123,7,5,STL,106,6,4,13,9
1964-11-14,BLT,127,6,8,LAL,115,9,4,15,12
1964-11-14,NYK,110,2,9,CIN,111,8,5,10,14
1964-11-14,PHL,102,6,5,BOS,113,11,2,17,7
1964-11-14,STL,108,6,5,SFW,94,4,9,10,14
1964-11-15,CIN,106,9,5,SFW,122,4,10,13,15
1964-11-15,DET,105,4,9,LAL,111,9,5,13,14
1964-11-17,SFW,108,5,10,CIN,114,9,6,14,16
1964-11-17,STL,114,7,5,PHL,107,6,6,13,11
1964-11-17,BLT,102,7,8,BOS,99,12,2,19,10
1964-11-18,LAL,90,0,0,CIN,92,0,0,0,0
1964-11-18,DET,124,4,10,PHL,111,6,7,10,17
1964-11-18,BOS,100,12,3,STL,97,8,5,20,8
1964-11-20,LAL,131,10,5,CIN,121,10,6,20,11
1964-11-20,BOS,127,13,3,NYK,120,2,10,15,13
1964-11-20,PHL,115,6,8,STL,118,8,6,14,14
1964-11-20,BLT,105,8,8,DET,106,5,10,13,18
1964-11-21,SFW,104,5,11,CIN,111,10,7,15,18
1964-11-21,PHL,108,6,9,BOS,96,14,3,20,12
1964-11-21,STL,100,9,6,DET,94,6,10,15,16
1964-11-21,NYK,103,2,11,BLT,94,8,9,10,20
1964-11-22,SFW,97,5,12,DET,99,6,11,11,23
1964-11-24,STL,108,10,6,BLT,109,8,10,18,16
1964-11-24,NYK,101,3,11,SFW,93,5,13,8,24
1964-11-25,BOS,122,14,4,SFW,118,5,14,19,18
1964-11-25,LAL,130,11,5,DET,117,7,11,18,16
1964-11-25,BLT,125,9,10,CIN,116,11,7,20,17
1964-11-25,PHL,124,7,9,NYK,93,4,11,11,20
1964-11-26,PHL,128,8,9,SFW,117,5,15,13,24
1964-11-26,STL,110,10,7,BOS,98,15,4,25,11
1964-11-27,CIN,133,11,8,PHL,112,9,9,20,17
1964-11-27,LAL,117,12,5,DET,111,7,12,19,17
1964-11-28,SFW,109,5,16,LAL,106,13,5,18,21
1964-11-28,BOS,129,15,5,CIN,98,12,8,27,13
1964-11-28,DET,93,7,13,PHL,101,9,10,16,23
1964-11-28,NYK,106,4,12,STL,91,11,7,15,19
1964-11-29,LAL,126,13,6,BLT,110,10,10,23,16
1964-11-29,CIN,105,12,9,NYK,95,5,12,17,21
1964-11-29,STL,94,11,8,PHL,97,10,10,21,18
1964-12-01,SFW,137,6,16,BLT,136,10,11,16,27
1964-12-01,PHL,117,11,10,LAL,118,14,6,25,16
1964-12-01,NYK,113,5,13,BOS,117,16,5,21,18
1964-12-01,CIN,129,13,9,DET,107,7,14,20,23
1964-12-02,DET,125,7,15,CIN,115,14,9,21,24
1964-12-02,SFW,114,7,16,BLT,120,10,12,17,28
1964-12-02,STL,105,11,9,LAL,102,15,6,26,15
1964-12-02,BOS,116,17,5,NYK,91,5,14,22,19
1964-12-04,BLT,108,11,12,STL,106,12,9,23,21
1964-12-04,PHL,119,11,11,DET,106,8,15,19,26
1964-12-04,CIN,104,14,10,LAL,90,15,7,29,17
1964-12-04,SFW,112,7,17,BOS,85,18,5,25,22
1964-12-05,PHL,125,12,11,BLT,108,12,12,24,23
1964-12-05,DET,110,8,16,NYK,100,5,15,13,31
1964-12-05,SFW,81,8,17,BOS,105,18,6,26,23
1964-12-06,CIN,124,15,10,BLT,113,12,13,27,23
1964-12-06,LAL,109,15,8,PHL,104,13,11,28,19
1964-12-06,STL,115,12,10,NYK,94,5,16,17,26
1964-12-08,NYK,100,5,17,DET,102,9,16,14,33
1964-12-08,LAL,98,16,8,BOS,108,19,6,35,14
1964-12-08,PHL,102,13,12,BLT,97,12,14,25,26
1964-12-08,SFW,93,8,18,STL,113,13,10,21,28
1964-12-09,DET,114,10,16,CIN,122,16,10,26,26
1964-12-09,BLT,90,12,15,NYK,111,5,18,17,33
1964-12-10,CIN,101,17,10,BOS,116,20,6,37,16
1964-12-10,LAL,91,16,9,STL,95,14,10,30,19
1964-12-11,PHL,109,14,12,BOS,118,21,6,35,18
1964-12-11,SFW,100,8,19,DET,104,10,17,18,36
1964-12-12,STL,109,15,10,CIN,115,17,11,32,21
1964-12-12,SFW,124,8,20,DET,107,11,17,19,37
1964-12-12,NYK,133,6,18,PHL,106,14,13,20,31
1964-12-12,BOS,112,22,6,BLT,99,12,16,34,22
1964-12-13,LAL,116,16,10,DET,115,11,18,27,28
1964-12-13,NYK,115,7,18,PHL,121,14,14,21,32
1964-12-14,PHL,119,15,14,SFW,112,9,20,24,34
1964-12-15,NYK,132,7,19,SFW,134,9,21,16,40
1964-12-15,LAL,116,17,10,DET,131,11,19,28,29
1964-12-15,BOS,124,23,6,STL,109,15,11,38,17
1964-12-16,DET,120,12,19,LAL,126,17,11,29,30
1964-12-16,BLT,140,12,17,PHL,120,16,14,28,31
1964-12-16,BOS,107,24,6,SFW,106,10,21,34,27
1964-12-16,STL,117,15,12,NYK,103,7,20,22,32
1964-12-17,NYK,113,7,21,BOS,112,25,6,32,27
1964-12-18,SFW,117,10,22,PHL,111,16,15,26,37
1964-12-18,DET,114,12,20,STL,108,16,12,28,32
1964-12-18,CIN,111,18,11,LAL,107,18,11,36,22
1964-12-19,LAL,113,18,12,PHL,140,16,16,34,28
1964-12-19,STL,105,16,13,BOS,115,25,7,41,20
1964-12-19,NYK,105,8,21,CIN,133,19,11,27,32
1964-12-19,BLT,104,13,17,DET,99,13,20,26,37
1964-12-20,SFW,111,11,22,PHL,113,17,16,28,38
1964-12-21,LAL,125,18,13,NYK,113,8,22,26,35
1964-12-22,SFW,118,11,23,NYK,124,8,23,19,46
1964-12-23,LAL,135,19,13,PHL,117,18,16,37,29
1964-12-25,CIN,130,20,11,STL,125,16,14,36,25
1964-12-25,NYK,108,9,23,BLT,114,14,17,23,40
1964-12-25,BOS,118,26,7,DET,106,13,21,39,28
1964-12-26,PHL,125,18,17,CIN,135,21,11,39,28
1964-12-26,LAL,129,20,13,SFW,122,11,24,31,37
1964-12-26,BLT,116,15,17,NYK,118,9,24,24,41
1964-12-26,STL,84,16,15,BOS,97,27,7,43,22
1964-12-27,BLT,126,15,18,CIN,119,22,11,37,29
1964-12-27,BOS,112,28,7,DET,106,13,22,41,29
1964-12-27,NYK,89,10,24,STL,99,16,16,26,40
1964-12-28,DET,123,13,23,NYK,117,10,25,23,48
1964-12-28,BOS,133,29,7,LAL,112,21,13,50,20
1964-12-28,CIN,113,22,12,SFW,108,11,25,33,37
1964-12-29,STL,122,17,16,SFW,104,11,26,28,42
1964-12-30,DET,120,14,23,STL,125,18,16,32,39
1964-12-30,PHL,117,18,18,LAL,115,21,14,39,32
1964-12-30,BLT,114,16,18,BOS,121,30,7,46,25
1964-12-30,NYK,118,10,26,SFW,102,11,27,21,53
1965-01-01,CIN,140,23,12,BLT,124,16,19,39,31
1965-01-01,NYK,101,11,26,SFW,100,11,28,22,54
1965-01-02,STL,112,19,16,LAL,115,21,15,40,31
1965-01-02,BLT,129,16,20,SFW,103,11,29,27,49
1965-01-02,DET,89,14,24,BOS,101,31,7,45,31
1965-01-03,BLT,142,17,20,SFW,132,11,30,28,50
1965-01-03,STL,92,19,17,LAL,99,22,15,41,32
1965-01-03,CIN,85,24,12,BOS,89,32,7,56,19
1965-01-05,NYK,116,12,26,CIN,125,24,13,36,39
1965-01-05,STL,109,19,18,DET,108,14,25,33,43
1965-01-06,DET,121,14,26,BLT,129,18,20,32,46
1965-01-06,BOS,138,33,7,STL,106,20,18,53,25
1965-01-06,CIN,116,25,13,NYK,102,12,27,37,40
1965-01-06,PHL,121,19,18,SFW,102,11,31,30,49
1965-01-07,BLT,110,19,20,DET,105,14,27,33,47
1965-01-07,LAL,104,23,15,BOS,112,34,7,57,22
1965-01-08,CIN,114,26,13,PHL,107,20,18,46,31
1965-01-08,SFW,91,11,32,BOS,94,35,7,46,39
1965-01-08,STL,83,20,19,NYK,82,12,28,32,47
1965-01-09,BLT,119,20,20,CIN,128,27,13,47,33
1965-01-09,NYK,115,12,29,DET,118,14,28,26,57
1965-01-09,LAL,103,23,16,BOS,107,36,7,59,23
1965-01-09,STL,102,21,19,PHL,104,20,19,41,38
1965-01-10,BLT,120,20,21,NYK,122,12,30,32,51
1965-01-10,CIN,140,28,13,DET,114,15,28,43,41
1965-01-11,DET,128,15,29,LAL,127,23,17,38,46
1965-01-11,STL,100,21,20,PHL,90,21,19,42,39
1965-01-14,PHL,126,21,20,BLT,138,20,22,41,42
1965-01-14,DET,100,16,29,LAL,104,23,18,39,47
1965-01-15,CIN,124,29,13,LAL,106,24,18,53,31
1965-01-15,BOS,104,37,7,PHL,95,21,21,58,28
1965-01-15,SFW,87,11,33,NYK,89,13,30,24,63
1965-01-16,SFW,89,11,34,NYK,102,14,30,25,64
1965-01-16,STL,107,22,20,BLT,87,21,22,43,42
1965-01-17,STL,118,23,20,LAL,105,24,19,47,39
1965-01-17,BOS,101,38,7,CIN,98,30,13,68,20
1965-01-18,PHL,109,21,22,DET,95,16,30,37,52
1965-01-19,CIN,103,30,14,STL,99,24,20,54,34
1965-01-19,DET,103,16,31,PHL,97,22,22,38,53
1965-01-20,BLT,105,21,23,BOS,131,39,7,60,30
1965-01-20,LAL,119,24,20,NYK,103,15,30,39,50
1965-01-20,DET,90,17,31,CIN,102,31,14,48,45
1965-01-21,PHL,111,22,23,SFW,102,11,35,33,58
1965-01-22,STL,110,24,21,BLT,117,21,24,45,45
1965-01-22,LAL,117,25,20,NYK,107,15,31,40,51
1965-01-22,PHL,109,23,23,DET,103,17,32,40,55
1965-01-22,BOS,104,40,7,SFW,94,11,36,51,43
1965-01-23,CIN,102,32,14,DET,105,17,33,49,47
1965-01-23,PHL,104,24,23,BOS,100,41,7,65,30
1965-01-23,BLT,106,22,24,STL,97,24,22,46,46
1965-01-24,BLT,114,23,24,STL,106,24,23,47,47
1965-01-24,CIN,124,32,15,SFW,103,11,37,43,52
1965-01-24,BOS,117,41,8,LAL,93,26,20,67,28
1965-01-25,BOS,142,42,8,BLT,104,24,24,66,32
1965-01-26,SFW,107,11,38,CIN,115,33,15,44,53
1965-01-26,DET,107,18,33,PHL,105,25,23,43,56
1965-01-26,NYK,99,15,32,LAL,111,26,21,41,53
1965-01-27,LAL,119,27,21,CIN,112,34,15,61,36
1965-01-27,DET,122,19,33,BLT,108,24,25,43,58
1965-01-27,STL,117,24,24,NYK,100,15,33,39,57
1965-01-27,BOS,115,43,8,PHL,98,25,24,68,32
1965-01-28,SFW,105,11,39,CIN,90,34,16,45,55
1965-01-29,LAL,137,28,21,CIN,133,34,17,62,38
1965-01-29,STL,124,25,24,BLT,119,24,26,49,50
1965-01-29,PHL,118,25,25,BOS,105,44,8,69,33
1965-01-29,NYK,106,15,34,DET,99,20,33,35,67
1965-01-30,SFW,99,12,39,LAL,109,29,21,41,60
1965-01-30,DET,121,20,34,STL,97,26,24,46,58
1965-01-30,NYK,90,16,34,BOS,97,44,9,60,43
1965-01-31,PHL,127,26,25,CIN,122,34,18,60,43
1965-01-31,STL,107,26,25,DET,110,21,34,47,59
1965-01-31,BOS,123,45,9,NYK,95,16,35,61,44
1965-01-31,LAL,96,30,21,SFW,94,12,40,42,61
1965-02-02,DET,121,22,34,LAL,118,31,21,53,55
1965-02-02,PHL,119,27,25,STL,105,26,26,53,51
1965-02-02,NYK,113,16,36,SFW,102,12,41,28,77
1965-02-03,BOS,114,46,9,BLT,122,24,27,70,36
1965-02-03,DET,111,23,34,SFW,106,12,42,35,76
1965-02-03,CIN,130,34,19,LAL,99,31,22,65,41
1965-02-03,PHL,116,28,25,NYK,95,17,36,45,61
1965-02-04,PHL,123,29,25,STL,119,26,27,55,52
1965-02-05,BOS,114,46,10,CIN,113,35,19,81,29
1965-02-05,DET,112,24,34,NYK,118,17,37,41,71
1965-02-05,BLT,112,25,27,SFW,120,12,43,37,70
1965-02-06,PHL,127,30,25,CIN,122,35,20,65,45
1965-02-06,BLT,116,25,28,LAL,112,31,23,56,51
1965-02-06,NYK,109,18,37,DET,106,24,35,42,72
1965-02-06,STL,108,26,28,SFW,101,13,43,39,71
1965-02-07,DET,119,24,36,BLT,112,26,28,50,64
1965-02-07,STL,126,27,28,SFW,103,13,44,40,72
1965-02-07,BOS,101,47,10,LAL,97,31,24,78,34
1965-02-08,LAL,117,31,25,PHL,98,31,25,62,50
1965-02-09,CIN,134,35,21,BOS,121,48,10,83,31
1965-02-09,SFW,114,13,45,PHL,132,31,26,44,71
1965-02-09,NYK,103,19,37,STL,108,28,28,47,65
1965-02-10,NYK,115,19,38,CIN,112,36,21,55,59
1965-02-10,DET,106,25,36,BOS,117,48,11,73,47
1965-02-10,LAL,99,32,25,PHL,110,32,26,64,51
1965-02-11,CIN,130,36,22,DET,109,25,37,61,59
1965-02-11,SFW,106,13,46,PHL,100,33,26,46,72
1965-02-11,BLT,94,26,29,STL,124,29,28,55,57
1965-02-12,STL,144,30,28,BLT,100,26,30,56,58
1965-02-12,LAL,114,32,26,SFW,95,14,46,46,72
1965-02-12,BOS,94,49,11,NYK,92,20,38,69,49
1965-02-13,BLT,123,26,31,DET,117,25,38,51,69
1965-02-13,NYK,123,20,39,BOS,113,50,11,70,50
1965-02-13,CIN,108,37,22,PHL,106,33,27,70,49
1965-02-13,SFW,105,14,47,LAL,129,33,26,47,73
1965-02-14,BOS,126,50,12,BLT,111,27,31,77,43
1965-02-14,STL,92,31,28,CIN,99,38,22,69,50
1965-02-16,SFW,106,14,48,DET,114,25,39,39,87
1965-02-16,CIN,111,39,22,STL,103,31,29,70,51
1965-02-16,NYK,106,21,39,BLT,102,27,32,48,71
1965-02-17,BOS,121,51,12,STL,114,31,30,82,42
1965-02-17,BLT,125,27,33,CIN,114,40,22,67,55
1965-02-17,NYK,98,22,39,LAL,118,34,26,56,65
1965-02-18,PHL,110,33,28,LAL,117,35,26,68,54
1965-02-18,BOS,119,52,12,STL,109,31,31,83,43
1965-02-18,SFW,106,14,49,DET,107,26,39,40,88
1965-02-19,BLT,111,28,33,LAL,119,36,26,64,59
1965-02-20,SFW,108,14,50,BOS,114,53,12,67,62
1965-02-20,DET,98,27,39,STL,110,31,32,58,71
1965-02-20,PHL,111,33,29,NYK,92,22,40,55,69
1965-02-21,LAL,129,37,26,BOS,114,54,12,91,38
1965-02-21,STL,112,32,32,DET,107,27,40,59,72
1965-02-21,BLT,106,28,34,PHL,107,34,29,62,63
1965-02-21,NYK,109,22,41,CIN,104,40,23,62,64
1965-02-22,PHL,122,35,29,BLT,112,28,35,63,64
1965-02-22,SFW,97,14,51,STL,107,33,32,47,83
1965-02-23,BLT,131,28,36,CIN,127,40,24,68,60
1965-02-23,NYK,132,23,41,PHL,104,36,29,59,70
1965-02-24,DET,106,27,41,PHL,104,36,30,63,71
1965-02-24,SFW,103,14,52,STL,111,34,32,48,84
1965-02-24,BLT,111,29,36,NYK,100,24,41,53,77
1965-02-24,LAL,95,38,26,BOS,97,54,13,92,39
1965-02-26,SFW,112,14,53,BOS,130,55,13,69,66
1965-02-26,LAL,106,38,27,STL,90,35,32,73,59
1965-02-27,DET,117,28,41,CIN,115,40,25,68,66
1965-02-27,NYK,102,24,42,BLT,99,30,36,54,78
1965-02-28,LAL,122,39,27,PHL,118,36,31,75,58
1965-02-28,CIN,126,40,26,NYK,117,25,42,65,68
1965-02-28,BLT,129,30,37,SFW,116,14,54,44,91
1965-02-28,STL,102,35,33,BOS,108,56,13,91,46
1965-03-01,CIN,110,41,26,DET,130,29,41,70,67
1965-03-02,LAL,126,40,27,PHL,117,36,32,76,59
1965-03-02,CIN,121,41,27,SFW,105,14,55,55,82
1965-03-02,NYK,98,25,43,STL,99,35,34,60,77
1965-03-03,STL,124,36,34,PHL,110,36,33,72,67
1965-03-03,BLT,151,31,37,CIN,108,42,27,73,64
1965-03-03,DET,110,30,41,SFW,107,14,56,44,97
1965-03-03,BOS,102,57,13,LAL,104,41,27,98,40
1965-03-04,SFW,115,14,57,DET,110,31,41,45,98
1965-03-05,BLT,128,32,37,BOS,124,57,14,89,51
1965-03-05,CIN,109,42,28,PHL,110,36,34,78,62
1965-03-05,NYK,103,25,44,LAL,105,42,27,67,71
1965-03-06,STL,109,37,34,LAL,107,43,27,80,61
1965-03-06,PHL,103,37,34,BOS,98,57,15,94,49
1965-03-06,DET,93,31,42,NYK,96,25,45,56,87
1965-03-06,SFW,93,15,57,CIN,97,42,29,57,86
1965-03-07,BOS,133,57,16,PHL,111,38,34,95,50
1965-03-07,STL,132,38,34,NYK,106,26,45,64,79
1965-03-07,BLT,111,33,37,DET,105,31,43,64,80
1965-03-07,LAL,106,43,28,CIN,104,43,29,86,57
1965-03-08,SFW,102,15,58,BLT,111,34,37,49,95
1965-03-09,NYK,124,26,46,PHL,122,38,35,64,81
1965-03-09,LAL,123,44,28,BLT,114,35,37,79,65
1965-03-10,PHL,123,38,36,NYK,134,27,46,65,82
1965-03-10,STL,137,39,34,CIN,113,43,30,82,64
1965-03-10,DET,106,31,44,BOS,124,58,16,89,60
1965-03-11,LAL,121,45,28,BLT,116,35,38,80,66
1965-03-11,BOS,112,59,16,DET,100,31,45,90,61
1965-03-11,SFW,99,15,59,STL,101,40,34,55,93
1965-03-12,CIN,118,43,31,BOS,108,60,16,103,47
1965-03-12,SFW,93,15,60,LAL,115,46,28,61,88
1965-03-13,PHL,131,38,37,DET,116,31,46,69,83
1965-03-13,BLT,102,35,39,NYK,114,28,46,63,85
1965-03-13,LAL,106,47,28,STL,101,41,34,88,62
1965-03-14,BLT,143,35,40,PHL,126,39,37,74,77
1965-03-14,LAL,108,48,28,STL,115,41,35,89,63
1965-03-14,NYK,103,29,46,CIN,113,44,31,73,77
1965-03-14,BOS,106,60,17,SFW,98,15,61,75,78
1965-03-16,PHL,107,39,38,SFW,115,15,62,54,100
1965-03-16,CIN,111,45,31,NYK,102,29,47,74,78
1965-03-16,DET,99,31,47,LAL,100,48,29,79,76
1965-03-17,NYK,119,29,48,BOS,114,61,17,90,65
1965-03-17,BLT,117,36,40,LAL,106,49,29,85,69
1965-03-17,STL,101,42,35,SFW,94,16,62,58,97
1965-03-18,CIN,113,46,31,BLT,110,37,40,83,71
1965-03-20,PHL,122,39,39,CIN,125,47,31,86,70
1965-03-20,NYK,118,30,48,BLT,114,37,41,67,89
1965-03-20,STL,107,43,35,DET,98,31,48,74,83
1965-03-20,LAL,98,49,30,SFW,112,16,63,65,93
1965-03-21,PHL,127,39,40,BLT,105,37,42,76,82
1965-03-21,STL,112,44,35,NYK,103,31,48,75,83
1965-03-21,BOS,116,61,18,CIN,99,48,31,109,49
1965-10-15,SFW,115,0,1,LAL,122,1,0,1,1
1965-10-15,CIN,100,0,0,STL,111,0,0,0,0
1965-10-16,NYK,111,0,0,DET,103,0,0,0,0
1965-10-16,BLT,101,0,0,PHL,133,0,0,0,0
1965-10-16,BOS,102,0,0,CIN,98,0,1,0,1
1965-10-16,STL,94,1,0,LAL,106,2,0,3,0
1965-10-17,CIN,144,0,2,BLT,124,0,1,0,3
1965-10-19,CIN,99,1,2,SFW,100,0,2,1,4
1965-10-20,DET,116,0,1,NYK,103,1,0,1,1
1965-10-20,BLT,119,0,2,STL,99,1,1,1,3
1965-10-20,BOS,100,1,0,LAL,96,3,0,4,0
1965-10-23,STL,120,1,2,BOS,110,2,0,3,2
1965-10-23,BLT,108,1,2,SFW,123,1,2,2,4
1965-10-23,PHL,120,1,0,DET,103,1,1,2,1
1965-10-23,NYK,106,1,1,LAL,101,3,1,4,2
1965-10-26,LAL,104,3,2,NYK,102,2,1,5,3
1965-10-26,DET,98,1,2,BLT,117,1,3,2,5
1965-10-27,BLT,107,2,3,DET,108,1,3,3,6
1965-10-28,LAL,140,4,2,NYK,116,2,2,6,4
1965-10-28,CIN,113,1,3,BOS,108,2,1,3,4
1965-10-29,BLT,121,2,4,CIN,131,2,3,4,7
1965-10-29,DET,108,2,3,BOS,106,2,2,4,5
1965-10-29,SFW,110,2,2,NYK,100,2,3,4,5
1965-10-30,LAL,122,5,2,SFW,124,3,2,8,4
1965-10-30,PHL,134,2,0,CIN,114,3,3,5,3
1965-10-30,STL,122,2,2,DET,95,3,3,5,5
1965-10-31,CIN,113,3,4,DET,107,3,4,6,8
1965-10-31,SFW,103,4,2,NYK,104,2,4,6,6
1965-10-31,BOS,105,2,3,BLT,100,2,5,4,8
1965-11-03,LAL,120,5,3,STL,116,3,2,8,5
1965-11-03,BLT,129,2,6,NYK,114,3,4,5,10
1965-11-03,CIN,122,4,4,SFW,108,4,3,8,7
1965-11-03,DET,110,3,5,PHL,100,3,0,6,5
1965-11-04,SFW,121,4,4,PHL,119,3,1,7,5
1965-11-04,NYK,108,3,5,BLT,107,3,6,6,11
1965-11-05,BLT,118,3,7,BOS,129,3,3,6,10
1965-11-05,LAL,118,6,3,STL,116,3,3,9,6
1965-11-05,PHL,133,3,2,SFW,115,5,4,8,6
1965-11-05,DET,114,4,5,CIN,120,5,4,9,9
1965-11-06,NYK,103,4,5,CIN,114,6,4,10,9
1965-11-06,STL,131,3,4,LAL,101,7,3,10,7
1965-11-06,SFW,110,5,5,DET,100,4,6,9,11
1965-11-06,BOS,101,4,3,PHL,91,4,2,8,5
1965-11-07,BLT,137,3,8,LAL,116,7,4,10,12
1965-11-09,BOS,130,5,3,BLT,116,4,8,9,11
1965-11-09,PHL,118,4,3,LAL,110,7,5,11,8
1965-11-09,SFW,107,6,5,DET,102,4,7,10,12
1965-11-10,LAL,133,7,6,DET,125,4,8,11,14
1965-11-10,CIN,124,7,4,NYK,119,4,6,11,10
1965-11-10,BLT,124,4,9,STL,117,4,4,8,13
1965-11-11,PHL,109,5,3,SFW,101,7,5,12,8
1965-11-11,BOS,87,6,3,STL,83,4,5,10,8
1965-11-12,PHL,123,6,3,BOS,114,7,3,13,6
1965-11-12,LAL,107,8,6,NYK,106,4,7,12,13
1965-11-12,DET,102,4,9,SFW,103,7,6,11,15
1965-11-13,CIN,135,8,4,BLT,132,5,9,13,13
1965-11-13,NYK,119,4,8,PHL,127,7,3,11,11
1965-11-13,STL,138,4,6,SFW,113,8,6,12,12
1965-11-13,BOS,122,7,4,DET,93,4,10,11,14
1965-11-14,LAL,129,9,6,BLT,114,5,10,14,16
1965-11-15,SFW,123,8,7,BLT,112,5,11,13,18
1965-11-16,SFW,105,9,7,BOS,108,8,4,17,11
1965-11-16,PHL,107,8,3,STL,98,5,6,13,9
1965-11-16,NYK,120,4,9,DET,95,4,11,8,20
1965-11-17,LAL,125,10,6,BOS,115,9,4,19,10
1965-11-17,CIN,131,9,4,PHL,115,9,3,18,7
1965-11-18,BLT,120,5,12,NYK,104,5,9,10,21
1965-11-19,LAL,135,0,0,SFW,124,0,0,0,0
1965-11-19,PHL,124,9,4,BLT,134,6,12,15,16
1965-11-19,DET,109,4,12,NYK,116,5,10,9,22
1965-11-19,BOS,129,9,5,CIN,103,10,4,19,9
1965-11-20,LAL,133,11,6,SFW,117,9,8,20,14
1965-11-20,BLT,117,7,12,PHL,112,9,5,16,17
1965-11-20,NYK,108,6,10,BOS,122,10,5,16,15
1965-11-20,STL,110,5,7,DET,101,4,13,9,20
1965-11-21,CIN,120,10,5,BLT,114,8,12,18,17
1965-11-21,LAL,104,12,6,PHL,110,9,6,21,12
1965-11-22,SFW,112,9,9,STL,108,6,7,15,16
1965-11-23,NYK,125,6,11,SFW,134,10,9,16,20
1965-11-23,DET,118,4,14,CIN,115,11,5,15,19
1965-11-24,LAL,127,12,7,PHL,124,10,6,22,13
1965-11-24,DET,130,5,14,BLT,124,8,13,13,27
1965-11-24,BOS,125,11,5,NYK,110,6,12,17,17
1965-11-24,CIN,112,11,6,STL,108,6,8,17,14
1965-11-25,STL,119,6,9,SFW,113,11,9,17,18
1965-11-26,SFW,120,11,10,PHL,132,10,7,21,17
1965-11-26,BOS,134,12,5,DET,114,6,14,18,19
1965-11-26,CIN,117,12,6,NYK,113,6,13,18,19
1965-11-26,BLT,110,8,14,LAL,107,13,7,21,21
1965-11-27,NYK,129,6,14,CIN,132,13,6,19,20
1965-11-27,SFW,117,11,11,PHL,124,11,7,22,18
1965-11-27,STL,136,7,9,BLT,110,9,14,16,23
1965-11-27,BOS,101,13,5,LAL,95,13,8,26,13
1965-11-28,DET,110,6,15,LAL,128,13,9,19,24
1965-11-28,BLT,110,9,15,STL,102,8,9,17,24
1965-11-30,CIN,126,14,6,LAL,120,14,9,28,15
1965-11-30,NYK,138,6,15,STL,119,8,10,14,25
1965-11-30,BLT,129,10,15,PHL,108,12,7,22,22
1965-12-01,BLT,139,11,15,NYK,125,7,15,18,30
1965-12-01,LAL,121,14,10,CIN,105,15,6,29,16
1965-12-01,DET,101,6,16,STL,110,8,11,14,27
1965-12-02,SFW,125,11,12,CIN,119,15,7,26,19
1965-12-03,LAL,118,15,10,CIN,122,15,8,30,18
1965-12-03,BOS,103,14,5,PHL,119,12,8,26,13
1965-12-04,DET,130,6,17,BLT,119,12,15,18,32
1965-12-04,STL,94,9,11,BOS,100,14,6,23,17
1965-12-05,CIN,108,16,8,BOS,99,15,6,31,14
1965-12-05,STL,113,9,12,SFW,99,12,12,21,24
1965-12-06,PHL,116,13,8,LAL,107,15,11,28,19
1965-12-07,NYK,131,7,16,LAL,127,15,12,22,28
1965-12-07,BOS,112,15,7,STL,96,10,12,25,19
1965-12-08,BLT,129,12,16,PHL,127,14,8,26,24
1965-12-08,DET,115,7,17,SFW,113,12,13,19,30
1965-12-08,BOS,108,16,7,LAL,106,15,13,31,20
1965-12-08,STL,104,10,13,NYK,93,8,16,18,29
1965-12-09,CIN,109,17,8,SFW,110,12,14,29,22
1965-12-10,BLT,145,13,16,SFW,127,13,14,26,30
1965-12-10,PHL,114,14,9,DET,116,8,17,22,26
1965-12-10,CIN,110,17,9,LAL,129,15,14,32,23
1965-12-10,STL,106,11,13,NYK,109,8,17,19,30
1965-12-11,PHL,135,14,10,CIN,132,17,10,31,20
1965-12-11,NYK,150,9,17,BLT,127,14,16,23,33
1965-12-11,LAL,126,16,14,STL,108,11,14,27,28
1965-12-11,BOS,143,17,7,SFW,106,13,15,30,22
1965-12-12,LAL,123,17,14,STL,101,11,15,28,29
1965-12-14,NYK,141,10,17,SFW,137,13,16,23,33
1965-12-14,BLT,142,14,17,DET,129,9,17,23,34
1965-12-14,CIN,112,17,11,PHL,109,15,10,32,21
1965-12-15,SFW,128,13,17,STL,113,11,16,24,33
1965-12-15,BOS,110,18,7,CIN,117,18,11,36,18
1965-12-15,BLT,111,15,17,NYK,108,11,17,26,34
1965-12-15,LAL,108,18,14,PHL,122,15,11,33,25
1965-12-17,LAL,117,18,15,PHL,127,16,11,34,26
1965-12-17,DET,112,9,18,BOS,114,18,8,27,26
1965-12-17,SFW,102,14,17,STL,103,11,17,25,34
1965-12-18,SFW,116,14,18,PHL,120,17,11,31,29
1965-12-18,NYK,122,11,18,CIN,114,19,11,30,29
1965-12-18,BLT,143,16,17,DET,114,9,19,25,36
1965-12-19,LAL,132,18,16,SFW,120,14,19,32,35
1965-12-20,SFW,124,14,20,PHL,118,18,11,32,31
1965-12-22,BLT,129,17,17,CIN,127,19,12,36,29
1965-12-22,BOS,123,19,8,NYK,120,12,18,31,26
1965-12-22,SFW,114,15,20,DET,104,9,20,24,40
1965-12-23,LAL,122,19,16,DET,112,9,21,28,37
1965-12-25,CIN,119,19,13,SFW,113,16,20,35,33
1965-12-25,NYK,111,12,19,STL,131,12,17,24,36
1965-12-25,LAL,115,20,16,DET,106,9,22,29,38
1965-12-25,BLT,99,18,17,BOS,113,20,8,38,25
1965-12-26,STL,115,13,17,CIN,117,20,13,33,30
1965-12-26,PHL,121,18,12,SFW,107,16,21,34,33
1965-12-26,BOS,120,21,8,BLT,99,18,18,39,26
1965-12-27,CIN,138,21,13,NYK,116,12,20,33,33
1965-12-27,LAL,108,21,16,STL,100,13,18,34,34
1965-12-28,SFW,120,16,22,DET,107,9,23,25,45
1965-12-28,STL,100,13,19,LAL,107,22,16,35,35
1965-12-28,PHL,102,19,12,BOS,93,22,8,41,20
1965-12-29,DET,112,9,24,PHL,113,20,12,29,36
1965-12-29,BLT,144,18,19,SFW,111,17,22,35,41
1965-12-29,CIN,111,22,13,LAL,109,23,16,45,29
1965-12-29,NYK,96,12,21,BOS,99,22,9,34,30
1965-12-30,DET,117,9,25,LAL,114,23,17,32,42
1965-12-30,BOS,116,23,9,SFW,113,17,23,40,32
1965-12-30,STL,130,13,20,PHL,113,21,12,34,32
1966-01-01,NYK,147,12,22,CIN,122,23,13,35,35
1966-01-01,BLT,116,19,19,DET,112,10,25,29,44
1966-01-01,STL,100,14,20,BOS,98,24,9,38,29
1966-01-02,PHL,133,21,13,NYK,122,13,22,34,35
1966-01-02,LAL,113,23,18,BOS,124,24,10,47,28
1966-01-02,SFW,136,17,24,DET,113,10,26,27,50
1966-01-02,CIN,138,23,14,BLT,107,20,19,43,33
1966-01-03,CIN,130,24,14,STL,114,15,20,39,34
1966-01-04,NYK,127,13,23,PHL,129,22,13,35,36
1966-01-04,SFW,122,18,24,BLT,111,20,20,38,44
1966-01-05,SFW,118,19,24,NYK,117,13,24,32,48
1966-01-05,LAL,120,23,19,BOS,113,25,10,48,29
1966-01-05,CIN,117,25,14,DET,103,10,27,35,41
1966-01-05,BLT,114,20,21,STL,101,15,21,35,42
1966-01-06,PHL,133,23,13,BLT,127,21,21,44,34
1966-01-06,CIN,109,26,14,DET,97,10,28,36,42
1966-01-07,PHL,120,24,13,LAL,126,24,19,48,32
1966-01-07,SFW,114,20,24,BOS,115,25,11,45,35
1966-01-07,DET,137,10,29,STL,97,15,22,25,51
1966-01-08,NYK,133,13,25,LAL,127,25,19,38,44
1966-01-08,BLT,115,21,22,CIN,126,27,14,48,36
1966-01-08,STL,115,15,23,PHL,105,24,14,39,37
1966-01-08,SFW,96,20,25,BOS,124,26,11,46,36
1966-01-09,BLT,130,21,23,NYK,124,14,25,35,48
1966-01-09,STL,117,16,23,PHL,127,24,15,40,38
1966-01-09,DET,98,11,29,LAL,111,25,20,36,49
1966-01-12,SFW,122,20,26,NYK,114,14,26,34,52
1966-01-12,DET,129,11,30,PHL,111,25,15,36,45
1966-01-12,BOS,114,27,11,LAL,102,26,20,53,31
1966-01-13,CIN,107,28,14,STL,102,16,24,44,38
1966-01-14,STL,119,16,25,BLT,121,22,23,38,48
1966-01-14,SFW,110,21,26,LAL,118,26,21,47,47
1966-01-14,PHL,112,25,16,BOS,100,28,11,53,27
1966-01-15,LAL,152,27,21,NYK,123,14,27,41,48
1966-01-15,DET,122,12,30,BLT,117,23,23,35,53
1966-01-16,STL,136,16,26,BLT,128,23,24,39,50
1966-01-16,BOS,137,28,12,PHL,122,26,16,54,28
1966-01-16,CIN,108,29,14,DET,106,13,30,42,44
1966-01-17,STL,115,17,26,NYK,106,14,28,31,54
1966-01-18,PHL,128,26,17,BLT,117,23,25,49,42
1966-01-18,DET,116,13,31,BOS,115,29,12,42,43
1966-01-18,CIN,119,30,14,LAL,108,28,21,58,35
1966-01-18,STL,109,18,26,NYK,107,14,29,32,55
1966-01-19,PHL,110,27,17,DET,93,14,31,41,48
1966-01-19,BOS,129,29,13,BLT,89,23,26,52,39
1966-01-20,BLT,123,23,27,LAL,121,28,22,51,49
1966-01-20,STL,103,19,26,DET,92,14,32,33,58
1966-01-21,LAL,109,28,23,SFW,120,21,27,49,50
1966-01-21,DET,117,14,33,STL,108,20,26,34,59
1966-01-21,PHL,109,28,17,NYK,98,14,30,42,47
1966-01-21,BOS,113,30,13,CIN,96,31,14,61,27
1966-01-22,STL,119,20,27,NYK,111,14,31,34,58
1966-01-22,BLT,132,24,27,BOS,107,31,13,55,40
1966-01-23,STL,98,21,27,PHL,104,29,17,50,44
1966-01-24,CIN,135,31,15,SFW,112,22,27,53,42
1966-01-24,PHL,110,30,17,STL,107,21,28,51,45
1966-01-25,STL,142,21,29,SFW,107,22,28,43,57
1966-01-25,PHL,110,31,17,LAL,106,28,24,59,41
1966-01-25,CIN,113,32,15,BOS,101,31,14,63,29
1966-01-25,NYK,115,14,32,DET,100,15,33,29,65
1966-01-26,DET,110,15,34,LAL,126,28,25,43,59
1966-01-26,NYK,115,15,32,SFW,103,22,29,37,61
1966-01-27,BOS,131,31,15,DET,112,15,35,46,50
1966-01-28,LAL,138,29,25,BLT,123,25,27,54,52
1966-01-28,BOS,105,32,15,DET,108,15,36,47,51
1966-01-28,STL,104,22,29,SFW,114,22,30,44,59
1966-01-28,PHL,125,32,17,CIN,103,33,15,65,32
1966-01-29,CIN,116,33,16,STL,115,22,30,55,46
1966-01-29,NYK,107,16,32,BOS,119,32,16,48,48
1966-01-29,SFW,108,23,30,BLT,95,25,28,48,58
1966-01-30,LAL,136,30,25,BLT,122,25,29,55,54
1966-01-30,BOS,118,33,16,NYK,115,16,33,49,49
1966-01-30,STL,115,22,31,CIN,98,34,16,56,47
1966-01-30,PHL,117,33,17,DET,98,16,36,49,53
1966-01-31,SFW,131,24,30,BLT,118,25,30,49,60
1966-02-01,SFW,127,25,30,CIN,125,34,17,59,47
1966-02-01,NYK,112,16,34,BLT,109,25,31,41,65
1966-02-01,BOS,100,34,16,DET,81,16,37,50,53
1966-02-02,LAL,119,31,25,CIN,118,34,18,65,43
1966-02-02,DET,99,16,38,BOS,93,35,16,51,54
1966-02-02,STL,96,23,31,PHL,89,34,17,57,48
1966-02-03,BLT,122,25,32,STL,113,24,31,49,63
1966-02-04,LAL,132,32,25,CIN,125,34,19,66,44
1966-02-04,DET,113,17,38,NYK,115,17,34,34,72
1966-02-04,BOS,117,35,17,STL,95,24,32,59,49
1966-02-05,NYK,120,18,34,PHL,113,34,18,52,52
1966-02-05,BLT,113,26,32,BOS,94,36,17,62,49
1966-02-06,CIN,117,34,20,SFW,116,26,30,60,50
1966-02-06,STL,109,24,33,LAL,105,33,25,57,58
1966-02-06,BOS,100,36,18,PHL,99,34,19,70,37
1966-02-07,PHL,132,34,20,LAL,125,33,26,67,46
1966-02-07,DET,124,17,39,CIN,118,35,20,52,59
1966-02-07,BOS,112,37,18,SFW,107,26,31,63,49
1966-02-07,BLT,111,27,32,STL,104,25,33,52,65
1966-02-08,NYK,136,19,34,PHL,123,35,20,54,54
1966-02-08,CIN,128,35,21,BLT,113,28,32,63,53
1966-02-08,SFW,113,26,32,DET,103,18,39,44,71
1966-02-09,BOS,121,38,18,NYK,117,20,34,58,52
1966-02-09,BLT,116,28,33,LAL,123,33,27,61,60
1966-02-09,DET,91,18,40,PHL,108,35,21,53,61
1966-02-10,SFW,128,27,32,BOS,117,39,18,66,50
1966-02-11,NYK,122,20,35,DET,107,18,41,38,76
1966-02-11,BOS,99,39,19,SFW,96,28,32,67,51
1966-02-11,PHL,113,36,21,CIN,94,36,21,72,42
1966-02-12,BLT,136,28,34,SFW,127,28,33,56,67
1966-02-12,NYK,140,21,35,LAL,127,34,27,55,62
1966-02-12,CIN,143,36,22,DET,116,18,42,54,64
1966-02-12,BOS,85,40,19,PHL,83,37,21,77,40
1966-02-13,BOS,110,41,19,LAL,120,34,28,75,47
1966-02-13,STL,104,25,34,CIN,102,37,22,62,56
1966-02-14,SFW,125,28,34,NYK,138,22,35,50,69
1966-02-14,PHL,149,37,22,DET,123,18,43,55,65
1966-02-15,LAL,132,35,28,NYK,124,23,35,58,63
1966-02-15,CIN,136,37,23,BOS,123,41,20,78,43
1966-02-15,PHL,121,38,22,STL,109,26,34,64,56
1966-02-15,BLT,114,29,34,DET,105,18,44,47,78
1966-02-16,SFW,108,28,35,NYK,112,23,36,51,71
1966-02-17,LAL,121,36,28,PHL,136,39,22,75,50
1966-02-18,DET,120,18,45,NYK,118,24,36,42,81
1966-02-18,BLT,118,30,34,CIN,114,38,23,68,57
1966-02-18,SFW,128,28,36,BOS,106,41,21,69,57
1966-02-19,SFW,119,29,36,PHL,123,40,22,69,58
1966-02-19,NYK,124,24,37,CIN,113,38,24,62,61
1966-02-19,LAL,111,36,29,BOS,115,41,22,77,51
1966-02-20,DET,129,19,45,CIN,133,38,25,57,70
1966-02-20,STL,126,26,35,BLT,123,31,34,57,69
1966-02-21,LAL,108,36,30,BOS,115,42,22,78,52
1966-02-21,CIN,113,39,25,PHL,107,41,22,80,47
1966-02-22,PHL,117,41,23,DET,112,19,46,60,69
1966-02-22,NYK,113,25,37,STL,108,27,35,52,72
1966-02-22,SFW,108,29,37,BOS,116,43,22,72,59
1966-02-23,LAL,140,36,31,CIN,133,40,25,76,56
1966-02-23,BLT,119,31,35,PHL,115,42,23,73,58
1966-02-23,NYK,100,26,37,DET,98,19,47,45,84
1966-02-24,BOS,134,44,22,STL,106,27,36,71,58
1966-02-25,PHL,130,42,24,NYK,124,27,37,69,61
1966-02-25,SFW,125,29,38,CIN,119,40,26,69,64
1966-02-26,DET,118,19,48,LAL,131,37,31,56,79
1966-02-26,SFW,103,30,38,CIN,112,40,27,70,65
1966-02-26,PHL,114,43,24,BLT,98,32,35,75,59
1966-02-26,NYK,95,27,38,BOS,100,45,22,72,60
1966-02-27,STL,125,27,37,DET,114,19,49,46,86
1966-02-27,BLT,132,32,36,BOS,92,46,22,78,58
1966-02-28,STL,108,28,37,DET,103,19,50,47,87
1966-03-01,NYK,112,27,39,SFW,114,30,39,57,78
1966-03-01,DET,122,19,51,BLT,110,33,36,52,87
1966-03-01,CIN,102,41,27,PHL,100,44,24,85,51
1966-03-01,STL,95,29,37,BOS,120,46,23,75,60
1966-03-02,DET,131,20,51,SFW,118,31,39,51,90
1966-03-02,BLT,119,33,37,LAL,113,38,31,71,68
1966-03-02,BOS,140,47,23,NYK,104,27,40,74,63
1966-03-03,PHL,135,44,25,SFW,125,31,40,75,65
1966-03-04,NYK,121,27,41,DET,119,21,51,48,92
1966-03-04,STL,132,29,38,BOS,112,48,23,77,61
1966-03-04,LAL,123,38,32,BLT,106,34,37,72,69
1966-03-04,CIN,103,42,27,PHL,107,45,25,87,52
1966-03-05,CIN,149,42,28,NYK,145,28,41,70,69
1966-03-05,SFW,123,31,41,LAL,125,39,32,70,73
1966-03-05,PHL,102,46,25,BOS,85,48,24,94,49
1966-03-06,DET,125,21,52,CIN,137,43,28,64,80
1966-03-06,BOS,110,48,25,PHL,113,47,25,95,50
1966-03-06,STL,119,30,38,NYK,106,28,42,58,80
1966-03-06,LAL,126,40,32,BLT,105,34,38,74,70
1966-03-07,BOS,106,48,26,STL,104,31,38,79,64
1966-03-08,NYK,133,28,43,LAL,132,41,32,69,75
1966-03-08,BLT,130,34,39,SFW,109,31,42,65,81
1966-03-08,PHL,112,48,25,STL,106,31,39,79,64
1966-03-09,LAL,119,41,33,CIN,116,44,28,85,61
1966-03-09,PHL,123,49,25,STL,115,31,40,80,65
1966-03-09,SFW,125,31,43,BLT,115,35,39,66,82
1966-03-10,CIN,120,44,29,BOS,124,49,26,93,55
1966-03-11,NYK,123,29,43,BLT,126,35,40,64,83
1966-03-11,LAL,114,42,33,DET,116,21,53,63,86
1966-03-12,PHL,134,50,25,NYK,126,29,44,79,69
1966-03-12,CIN,113,44,30,STL,114,31,41,75,71
1966-03-13,SFW,121,32,43,DET,119,22,53,54,96
1966-03-13,NYK,113,29,45,PHL,115,51,25,80,70
1966-03-13,STL,115,32,41,CIN,106,44,31,76,72
1966-03-13,BOS,129,50,26,BLT,98,36,40,86,66
1966-03-15,SFW,109,33,43,STL,110,33,41,66,84
1966-03-15,LAL,135,42,34,DET,108,22,54,64,88
1966-03-15,CIN,125,44,32,NYK,107,29,46,73,78
1966-03-16,BLT,118,36,41,NYK,113,29,47,65,88
1966-03-17,SFW,116,33,44,STL,112,34,41,67,85
1966-03-17,PHL,115,52,25,NYK,106,29,48,81,73
1966-03-17,DET,103,22,55,BOS,128,51,26,73,81
1966-03-18,LAL,132,43,34,STL,120,34,42,77,76
1966-03-18,BLT,125,37,41,CIN,105,45,32,82,73
1966-03-19,PHL,127,53,25,CIN,121,45,33,98,58
1966-03-19,SFW,125,34,44,LAL,119,44,34,78,78
1966-03-19,NYK,113,29,49,BOS,126,52,26,81,75
1966-03-19,STL,115,34,43,DET,112,22,56,56,99
1966-03-20,DET,117,22,57,STL,121,35,43,57,100
1966-03-20,LAL,124,44,35,SFW,112,35,44,79,79
1966-03-20,BLT,104,38,41,PHL,108,54,25,92,66
1966-03-20,BOS,121,53,26,CIN,104,45,34,98,60
1966-03-22,NYK,126,29,50,STL,125,36,43,65,93
1966-10-15,BLT,115,0,0,LAL,126,0,0,0,0
1966-10-15,BOS,121,0,0,SFW,113,0,0,0,0
1966-10-15,PHL,128,0,0,NYK,112,0,0,0,0
1966-10-15,CIN,103,0,0,DET,99,0,0,0,0
1966-10-15,STL,97,0,0,CHI,104,0,0,0,0
1966-10-18,NYK,122,0,1,LAL,119,1,0,1,1
1966-10-18,CHI,119,1,0,SFW,116,0,1,1,1
1966-10-18,DET,114,0,1,CIN,112,1,0,1,1
1966-10-19,CHI,134,2,0,LAL,124,1,1,3,1
1966-10-19,BLT,109,0,1,NYK,131,1,1,1,2
1966-10-20,SFW,121,0,2,CHI,111,3,0,3,2
1966-10-20,DET,105,1,1,STL,113,0,1,1,2
1966-10-21,SFW,136,1,2,DET,119,1,2,2,4
1966-10-21,PHL,119,1,0,STL,110,1,1,2,1
1966-10-21,LAL,101,1,2,CHI,108,3,1,4,3
1966-10-21,BOS,111,1,0,BLT,91,0,2,1,2
1966-10-22,STL,133,1,2,CIN,123,1,1,2,3
1966-10-22,BLT,112,0,3,PHL,141,2,0,2,3
1966-10-22,NYK,97,2,1,BOS,126,2,0,4,1
1966-10-23,DET,119,1,3,SFW,110,2,2,3,5
1966-10-23,CHI,105,4,1,NYK,124,2,2,6,3
1966-10-25,PHL,130,3,0,BLT,110,0,4,3,4
1966-10-26,LAL,122,1,3,NYK,133,3,2,4,5
1966-10-26,BLT,122,0,5,CIN,116,1,2,1,7
1966-10-27,CIN,121,1,3,STL,118,2,2,3,5
1966-10-27,BOS,123,3,0,CHI,100,4,2,7,2
1966-10-28,DET,129,2,3,CHI,117,4,3,6,6
1966-10-28,LAL,124,1,4,NYK,114,4,2,5,6
1966-10-28,BLT,104,1,5,SFW,105,2,3,3,8
1966-10-29,CIN,115,2,3,SFW,127,3,3,5,6
1966-10-29,STL,110,2,3,LAL,109,2,4,4,7
1966-10-29,DET,103,3,3,BLT,97,1,6,4,9
1966-10-29,PHL,138,4,0,BOS,96,4,0,8,0
1966-10-30,DET,124,4,3,LAL,121,2,5,6,8
1966-11-01,CHI,121,4,4,SFW,137,4,3,8,7
1966-11-02,CIN,131,2,4,NYK,129,4,3,6,7
1966-11-02,BOS,133,4,1,LAL,108,2,6,6,7
1966-11-02,CHI,102,4,5,BLT,94,1,7,5,12
1966-11-03,PHL,120,5,0,STL,108,3,3,8,3
1966-11-03,NYK,123,4,4,SFW,108,5,3,9,7
1966-11-03,BOS,137,5,1,CHI,108,5,5,10,6
1966-11-04,PHL,134,6,0,SFW,129,5,4,11,4
1966-11-04,DET,115,5,3,CIN,120,3,4,8,7
1966-11-04,LAL,131,2,7,BLT,98,1,8,3,15
1966-11-05,STL,122,3,4,SFW,120,5,5,8,9
1966-11-05,NYK,115,5,4,DET,104,5,4,10,8
1966-11-05,CIN,99,4,4,CHI,113,5,6,9,10
1966-11-05,BOS,105,6,1,PHL,87,7,0,13,1
1966-11-06,SFW,120,5,6,BLT,117,1,9,6,15
1966-11-06,CHI,134,6,6,STL,102,4,4,10,10
1966-11-08,NYK,121,6,4,STL,135,4,5,10,9
1966-11-08,LAL,102,3,7,BLT,104,1,10,4,17
1966-11-08,CHI,101,7,6,BOS,112,7,1,14,7
1966-11-08,PHL,118,7,1,DET,100,5,5,12,6
1966-11-09,SFW,128,6,6,BLT,122,2,10,8,16
1966-11-09,CHI,98,7,7,NYK,103,6,5,13,12
1966-11-10,LAL,132,3,8,DET,133,5,6,8,14
1966-11-10,CIN,112,4,5,BOS,113,8,1,12,6
1966-11-11,PHL,126,8,1,CHI,113,7,8,15,9
1966-11-11,BOS,111,9,1,NYK,106,7,5,16,6
1966-11-11,BLT,104,2,11,CIN,119,4,6,6,17
1966-11-11,SFW,132,7,6,LAL,93,3,9,10,15
1966-11-12,NYK,134,7,6,BLT,124,2,12,9,18
1966-11-12,CIN,98,5,6,PHL,112,9,1,14,7
1966-11-12,STL,115,5,5,BOS,92,10,1,15,6
1966-11-12,LAL,144,3,10,DET,88,6,6,9,16
1966-11-13,CHI,126,7,9,PHL,132,10,1,17,10
1966-11-13,SFW,135,8,6,DET,96,6,7,14,13
1966-11-14,SFW,115,9,6,DET,104,6,8,15,14
1966-11-15,NYK,109,8,6,PHL,113,11,1,19,7
1966-11-15,STL,107,6,5,CHI,99,7,10,13,15
1966-11-16,CIN,112,5,7,LAL,124,4,10,9,17
1966-11-16,PHL,117,12,1,NYK,108,8,7,20,8
1966-11-16,DET,101,6,9,STL,104,7,5,13,14
1966-11-17,DET,123,6,10,NYK,108,8,8,14,18
1966-11-17,BLT,120,2,13,CHI,102,7,11,9,24
1966-11-18,PHL,145,13,1,CHI,120,7,12,20,13
1966-11-18,BOS,143,10,2,BLT,119,3,13,13,15
1966-11-18,DET,121,7,10,LAL,118,5,10,12,20
1966-11-19,BLT,125,3,14,BOS,147,11,2,14,16
1966-11-19,PHL,134,14,1,CIN,110,5,8,19,9
1966-11-19,LAL,109,5,11,SFW,144,10,6,15,17
1966-11-19,NYK,116,8,9,CHI,104,7,13,15,22
1966-11-19,STL,105,8,5,DET,87,8,10,16,15
1966-11-20,CIN,125,5,9,BLT,123,3,15,8,24
1966-11-21,SFW,134,11,6,STL,117,9,5,20,11
1966-11-22,NYK,118,9,9,CIN,121,6,9,15,18
1966-11-22,BLT,125,3,16,SFW,117,12,6,15,22
1966-11-23,LAL,154,5,12,CHI,130,7,14,12,26
1966-11-23,BLT,110,4,16,SFW,120,12,7,16,23
1966-11-23,CIN,111,7,9,PHL,106,15,1,22,10
1966-11-23,BOS,123,12,2,STL,103,9,6,21,8
1966-11-23,DET,118,8,11,NYK,100,9,10,17,21
1966-11-24,PHL,140,15,2,SFW,123,13,7,28,9
1966-11-24,STL,78,9,7,BOS,101,13,2,22,9
1966-11-25,LAL,117,6,12,CHI,121,7,15,13,27
1966-11-25,BLT,115,4,17,PHL,129,16,2,20,19
1966-11-25,CIN,115,8,9,NYK,109,9,11,17,20
1966-11-25,DET,107,9,11,BOS,105,14,2,23,13
1966-11-26,SFW,131,13,8,CHI,129,8,15,21,23
1966-11-26,STL,126,9,8,LAL,133,6,13,15,21
1966-11-26,PHL,131,17,2,DET,123,10,11,27,13
1966-11-26,NYK,125,9,12,BLT,114,4,18,13,30
1966-11-26,BOS,118,14,3,CIN,87,9,9,23,12
1966-11-29,PHL,137,18,2,STL,116,9,9,27,11
1966-11-29,NYK,118,10,12,LAL,114,7,13,17,25
1966-11-29,SFW,108,14,8,CHI,101,8,16,22,24
1966-11-29,DET,104,10,12,BOS,100,15,3,25,15
1966-11-30,DET,119,11,12,PHL,128,19,2,30,14
1966-11-30,CIN,115,9,10,NYK,119,11,12,20,22
1966-11-30,BLT,111,4,19,LAL,126,7,14,11,33
1966-12-02,PHL,138,20,2,LAL,130,8,14,28,16
1966-12-02,BOS,116,15,4,DET,119,11,13,26,17
1966-12-02,STL,109,9,10,NYK,107,12,12,21,22
1966-12-03,BLT,120,4,20,PHL,137,21,2,25,22
1966-12-03,CIN,118,9,11,LAL,130,8,15,17,26
1966-12-03,SFW,123,15,8,STL,111,10,10,25,18
1966-12-03,NYK,109,12,13,BOS,120,15,5,27,18
1966-12-03,DET,104,12,13,CHI,98,8,17,20,30
1966-12-04,LAL,118,9,15,STL,123,10,11,19,26
1966-12-06,PHL,129,22,2,CHI,119,8,18,30,20
1966-12-06,NYK,116,12,14,SFW,126,16,8,28,22
1966-12-06,BOS,130,16,5,DET,111,13,13,29,18
1966-12-07,LAL,130,9,16,STL,128,11,11,20,27
1966-12-07,DET,116,13,14,NYK,118,12,15,25,29
1966-12-07,BLT,116,4,21,SFW,106,17,8,21,29
1966-12-07,CHI,103,8,19,PHL,117,23,2,31,21
1966-12-07,BOS,119,17,5,CIN,91,9,12,26,17
1966-12-08,CHI,132,8,20,BLT,120,5,21,13,41
1966-12-08,SFW,124,17,9,STL,106,11,12,28,21
1966-12-09,LAL,118,10,16,SFW,119,18,9,28,25
1966-12-09,PHL,112,24,2,NYK,107,13,15,37,17
1966-12-09,CIN,99,9,13,BOS,117,18,5,27,18
1966-12-10,NYK,138,13,16,BLT,129,5,22,18,38
1966-12-10,STL,123,11,13,PHL,133,25,2,36,15
1966-12-10,SFW,123,19,9,CIN,120,9,14,28,23
1966-12-10,BOS,125,19,5,CHI,110,9,20,28,25
1966-12-11,LAL,119,10,17,CIN,118,9,15,19,32
1966-12-11,BOS,117,20,5,PHL,103,26,2,46,7
1966-12-13,SFW,112,20,9,CIN,126,9,16,29,25
1966-12-13,NYK,112,14,16,PHL,127,26,3,40,19
1966-12-13,BLT,122,5,23,CHI,94,9,21,14,44
1966-12-14,LAL,124,11,17,CIN,126,10,16,21,33
1966-12-14,BLT,116,6,23,NYK,106,14,17,20,40
1966-12-14,CHI,93,9,22,DET,87,13,15,22,37
1966-12-15,STL,116,11,14,BOS,114,21,5,32,19
1966-12-16,CIN,120,11,16,CHI,128,10,22,21,38
1966-12-16,DET,113,13,16,BLT,121,7,23,20,39
1966-12-16,PHL,124,27,3,STL,113,12,14,39,17
1966-12-17,NYK,116,14,18,STL,114,12,15,26,33
1966-12-17,SFW,110,20,10,BOS,118,21,6,41,16
1966-12-17,BLT,106,8,23,CHI,110,11,22,19,45
1966-12-17,PHL,120,28,3,DET,105,13,17,41,20
1966-12-18,LAL,127,11,18,BOS,125,22,6,33,24
1966-12-18,CIN,138,11,17,BLT,114,8,24,19,41
1966-12-19,CHI,102,12,22,STL,97,12,16,24,38
1966-12-20,BOS,116,22,7,DET,113,13,18,35,25
1966-12-20,SFW,130,20,11,LAL,107,12,18,32,29
1966-12-21,LAL,123,12,19,PHL,129,29,3,41,22
1966-12-21,STL,118,12,17,BLT,109,8,25,20,42
1966-12-21,CHI,110,13,22,NYK,107,15,18,28,40
1966-12-22,SFW,114,21,11,PHL,116,30,3,51,14
1966-12-23,LAL,107,12,20,PHL,118,31,3,43,23
1966-12-23,BOS,114,23,7,STL,103,13,17,36,24
1966-12-23,CHI,102,14,22,DET,103,13,19,27,41
1966-12-25,NYK,133,15,19,CHI,132,14,23,29,42
1966-12-25,BLT,127,8,26,DET,129,14,19,22,45
1966-12-25,CIN,112,12,17,SFW,124,21,12,33,29
1966-12-26,PHL,134,32,3,CIN,118,12,18,44,21
1966-12-26,STL,120,13,18,SFW,111,22,12,35,30
1966-12-26,DET,109,15,19,NYK,114,16,19,31,38
1966-12-26,BOS,121,24,7,LAL,106,12,21,36,28
1966-12-26,CHI,108,14,24,BLT,96,8,27,22,51
1966-12-27,CIN,131,12,19,DET,123,15,20,27,39
1966-12-27,STL,113,14,18,BLT,111,8,28,22,46
1966-12-28,NYK,121,17,19,LAL,115,12,22,29,41
1966-12-28,BLT,115,8,29,SFW,138,22,13,30,42
1966-12-28,PHL,113,33,3,BOS,108,25,7,58,10
1966-12-29,CIN,114,13,19,LAL,125,12,23,25,42
1966-12-29,STL,110,15,18,BOS,112,25,8,40,26
1966-12-30,BLT,115,8,30,NYK,130,18,19,26,49
1966-12-30,PHL,137,34,3,DET,113,15,21,49,24
1966-12-30,CHI,106,15,24,BOS,110,26,8,41,32
1966-12-30,CIN,102,13,20,SFW,107,23,13,36,33
1966-12-31,NYK,107,19,19,CIN,103,13,21,32,40
1967-01-01,LAL,111,13,23,BOS,110,27,8,40,31
1967-01-01,STL,128,15,19,NYK,105,20,19,35,38
1967-01-02,STL,122,16,19,DET,120,15,22,31,41
1967-01-03,NYK,142,20,20,PHL,148,35,3,55,23
1967-01-03,SFW,121,24,13,BOS,126,27,9,51,22
1967-01-03,CHI,116,15,25,CIN,111,13,22,28,47
1967-01-03,DET,117,15,23,BLT,110,8,31,23,54
1967-01-04,BLT,126,8,32,DET,132,16,23,24,55
1967-01-04,PHL,136,36,3,CHI,115,16,25,52,28
1967-01-04,LAL,122,14,23,STL,101,17,19,31,42
1967-01-05,PHL,104,37,3,NYK,112,20,21,57,24
1967-01-05,SFW,122,24,14,LAL,91,15,23,39,37
1967-01-06,DET,126,17,23,CHI,135,16,26,33,49
1967-01-06,SFW,129,25,14,STL,118,17,20,42,34
1967-01-06,PHL,121,37,4,BLT,115,8,33,45,37
1967-01-06,LAL,102,15,24,BOS,99,28,9,43,33
1967-01-07,NYK,129,21,21,BLT,126,8,34,29,55
1967-01-07,CIN,125,13,23,CHI,112,17,26,30,49
1967-01-07,SFW,110,26,14,BOS,108,28,10,54,24
1967-01-08,LAL,118,16,24,NYK,121,22,21,38,45
1967-01-08,STL,117,17,21,DET,115,17,24,34,45
1967-01-08,CHI,108,17,27,PHL,117,38,4,55,31
1967-01-08,BLT,94,8,35,CIN,126,14,23,22,58
1967-01-11,LAL,141,16,25,SFW,126,27,14,43,39
1967-01-11,CHI,102,17,28,CIN,106,15,23,32,51
1967-01-12,SFW,127,27,15,NYK,123,23,21,50,36
1967-01-12,BLT,137,8,36,STL,116,18,21,26,57
1967-01-13,BLT,118,9,36,DET,119,17,25,26,61
1967-01-13,SFW,117,28,15,NYK,119,23,22,51,37
1967-01-13,CIN,125,16,23,LAL,115,17,25,33,48
1967-01-13,PHL,125,39,4,STL,107,18,22,57,26
1967-01-13,BOS,122,28,11,CHI,102,17,29,45,40
1967-01-14,CHI,122,17,30,LAL,121,17,26,34,56
1967-01-14,DET,121,18,25,SFW,136,28,16,46,41
1967-01-14,BLT,106,9,37,BOS,115,29,11,38,48
1967-01-14,CIN,116,17,23,STL,105,18,23,35,46
1967-01-15,DET,116,18,26,LAL,127,17,27,35,53
1967-01-15,CHI,131,18,30,NYK,116,24,22,42,52
1967-01-15,STL,114,18,24,SFW,112,29,16,47,40
1967-01-15,BOS,95,30,11,PHL,110,40,4,70,15
1967-01-16,BLT,100,9,38,STL,98,19,24,28,62
1967-01-17,PHL,119,41,4,NYK,111,24,23,65,27
1967-01-17,CHI,101,19,30,BOS,109,30,12,49,42
1967-01-18,LAL,121,18,27,STL,123,19,25,37,52
1967-01-18,CHI,111,19,31,SFW,107,29,17,48,48
1967-01-18,CIN,106,18,23,BOS,119,31,12,49,35
1967-01-18,DET,105,18,27,PHL,113,42,4,60,31
1967-01-19,BLT,122,10,38,CIN,118,18,24,28,62
1967-01-19,SFW,123,29,18,NYK,102,24,24,53,42
1967-01-19,PHL,127,43,4,CHI,102,20,31,63,35
1967-01-20,CHI,125,20,32,DET,124,18,28,38,60
1967-01-20,BOS,129,32,12,BLT,117,11,38,43,50
1967-01-20,SFW,142,30,18,STL,115,20,25,50,43
1967-01-20,PHL,119,44,4,LAL,108,18,28,62,32
1967-01-21,BLT,126,11,39,LAL,119,18,29,29,68
1967-01-21,STL,114,20,26,NYK,124,24,25,44,51
1967-01-21,CIN,122,18,25,DET,108,18,29,36,54
1967-01-22,BOS,121,33,12,LAL,120,18,30,51,42
1967-01-22,CHI,118,21,32,BLT,114,12,39,33,71
1967-01-22,STL,104,20,27,NYK,101,25,25,45,52
1967-01-23,PHL,112,45,4,STL,105,21,27,66,31
1967-01-24,SFW,146,31,18,BLT,125,12,40,43,58
1967-01-24,NYK,118,25,26,CIN,126,19,25,44,51
1967-01-24,PHL,106,46,4,BOS,118,34,12,80,16
1967-01-24,CHI,95,22,32,DET,108,18,30,40,62
1967-01-25,CIN,132,20,25,NYK,125,25,27,45,52
1967-01-25,LAL,128,18,31,BLT,115,12,41,30,72
1967-01-25,DET,105,19,30,BOS,112,35,12,54,42
1967-01-25,CHI,102,22,33,STL,103,21,28,43,61
1967-01-26,CIN,110,21,25,DET,118,19,31,40,56
1967-01-27,SFW,143,32,18,BLT,116,12,42,44,60
1967-01-27,PHL,110,46,5,CIN,107,21,26,67,31
1967-01-27,BOS,112,36,12,DET,106,20,31,56,43
1967-01-28,LAL,133,19,31,BLT,118,12,43,31,74
1967-01-28,CIN,113,21,27,STL,112,22,28,43,55
1967-01-28,NYK,112,25,28,BOS,114,37,12,62,40
1967-01-29,CHI,122,22,34,LAL,142,20,31,42,65
1967-01-29,CIN,121,22,27,SFW,118,33,18,55,45
1967-01-29,STL,114,22,29,PHL,108,47,5,69,34
1967-01-29,BOS,141,38,12,NYK,106,25,29,63,41
1967-01-30,BOS,121,39,12,SFW,108,33,19,72,31
1967-01-30,STL,106,23,29,LAL,99,21,31,44,60
1967-01-31,NYK,139,25,30,STL,120,24,29,49,59
1967-01-31,SFW,108,33,20,DET,106,20,32,53,52
1967-02-01,LAL,143,21,32,PHL,133,47,6,68,38
1967-02-01,BLT,107,12,44,BOS,111,40,12,52,56
1967-02-01,DET,104,20,33,NYK,101,26,30,46,63
1967-02-02,CIN,131,23,27,BLT,125,12,45,35,72
1967-02-02,SFW,137,34,20,PHL,120,47,7,81,27
1967-02-03,CHI,118,22,35,CIN,113,24,27,46,62
1967-02-03,BOS,113,41,12,STL,131,24,30,65,42
1967-02-03,NYK,124,26,31,DET,111,21,33,47,64
1967-02-03,LAL,129,22,32,SFW,80,35,20,57,52
1967-02-04,SFW,127,35,21,PHL,140,47,8,82,29
1967-02-04,STL,119,25,30,CHI,111,23,35,48,65
1967-02-04,NYK,102,27,31,DET,101,21,34,48,65
1967-02-04,BLT,109,12,46,CIN,99,24,28,36,74
1967-02-05,CHI,141,23,36,SFW,142,35,22,58,58
1967-02-05,LAL,123,23,32,PHL,130,48,8,71,40
1967-02-05,BOS,137,41,13,CIN,121,24,29,65,42
1967-02-05,DET,114,21,35,STL,104,26,30,47,65
1967-02-06,BLT,107,13,46,STL,98,26,31,39,77
1967-02-07,PHL,126,49,8,SFW,123,36,22,85,30
1967-02-07,CIN,123,24,30,BOS,138,42,13,66,43
1967-02-07,NYK,117,28,31,LAL,122,23,33,51,64
1967-02-07,STL,109,26,32,BLT,96,14,46,40,78
1967-02-07,CHI,90,23,37,DET,98,22,35,45,72
1967-02-08,LAL,121,24,33,BLT,108,14,47,38,80
1967-02-08,CIN,106,24,31,PHL,118,50,8,74,39
1967-02-08,NYK,106,28,32,CHI,103,23,38,51,70
1967-02-09,BLT,128,14,48,BOS,124,43,13,57,61
1967-02-10,BOS,137,43,14,SFW,136,36,23,79,37
1967-02-10,PHL,148,51,8,LAL,131,25,33,76,41
1967-02-10,NYK,122,29,32,CHI,121,23,39,52,71
1967-02-10,CIN,133,24,32,DET,104,23,35,47,67
1967-02-11,BLT,139,15,48,PHL,133,52,8,67,56
1967-02-11,NYK,125,30,32,SFW,122,36,24,66,56
1967-02-11,DET,117,23,36,CIN,132,25,32,48,68
1967-02-11,CHI,98,23,40,STL,104,27,32,50,72
1967-02-12,DET,134,23,37,SFW,127,36,25,59,62
1967-02-12,LAL,129,25,34,CHI,121,23,41,48,75
1967-02-12,STL,118,28,32,CIN,115,26,32,54,64
1967-02-12,BOS,113,44,14,PHL,112,52,9,96,23
1967-02-13,PHL,131,52,10,CIN,123,26,33,78,43
1967-02-13,STL,139,29,32,NYK,109,31,32,60,64
1967-02-14,SFW,128,36,26,BOS,122,45,14,81,40
1967-02-15,DET,121,24,37,PHL,127,53,10,77,47
1967-02-15,CIN,127,26,34,NYK,118,31,33,57,67
1967-02-15,LAL,124,26,34,BOS,114,45,15,71,49
1967-02-16,SFW,125,37,26,CHI,124,23,42,60,68
1967-02-16,NYK,121,31,34,STL,120,30,32,61,66
1967-02-16,CIN,122,27,34,DET,110,24,38,51,72
1967-02-17,BLT,132,16,48,STL,133,30,33,46,81
1967-02-17,LAL,119,27,34,BOS,120,45,16,72,50
1967-02-17,CIN,118,28,34,PHL,127,54,10,82,44
1967-02-18,SFW,130,38,26,BOS,124,46,16,84,42
1967-02-18,NYK,124,32,34,CIN,123,28,35,60,69
1967-02-18,DET,118,24,39,BLT,113,16,49,40,88
1967-02-19,STL,122,31,33,PHL,123,55,10,86,43
1967-02-19,LAL,119,27,35,CHI,133,23,43,50,78
1967-02-19,DET,104,25,39,BLT,131,16,50,41,89
1967-02-20,STL,104,31,34,CIN,112,28,36,59,70
1967-02-21,SFW,136,39,26,LAL,133,27,36,66,62
1967-02-21,NYK,114,33,34,BOS,143,46,17,79,51
1967-02-21,STL,109,31,35,DET,112,25,40,56,75
1967-02-22,BLT,120,17,50,BOS,135,47,17,64,67
1967-02-22,CHI,117,24,43,NYK,103,33,35,57,78
1967-02-22,LAL,103,27,37,CIN,102,29,36,56,73
1967-02-23,BOS,122,48,17,NYK,117,33,36,81,53
1967-02-24,SFW,122,40,26,CIN,137,29,37,69,63
1967-02-24,PHL,149,56,10,BLT,118,17,51,73,61
1967-02-24,DET,102,26,40,LAL,101,28,37,54,77
1967-02-25,STL,133,31,36,LAL,134,28,38,59,74
1967-02-25,SFW,116,40,27,CIN,129,30,37,70,64
1967-02-25,NYK,116,33,37,BLT,114,17,52,50,89
1967-02-26,LAL,141,29,38,CIN,127,31,37,60,75
1967-02-26,STL,119,31,37,BOS,130,49,17,80,54
1967-02-26,BLT,124,17,53,CHI,106,25,43,42,96
1967-02-27,STL,105,31,38,DET,94,27,40,58,78
1967-02-28,NYK,127,34,37,SFW,123,40,28,74,65
1967-02-28,LAL,119,30,38,DET,117,27,41,57,79
1967-02-28,PHL,127,57,10,CIN,107,31,38,88,48
1967-03-01,BOS,137,50,17,SFW,125,40,29,90,46
1967-03-01,CHI,129,25,44,PHL,122,58,10,83,54
1967-03-01,CIN,122,31,39,LAL,116,31,38,62,77
1967-03-01,BLT,122,18,53,STL,112,32,38,50,91
1967-03-01,DET,118,27,42,NYK,101,35,37,62,79
1967-03-02,PHL,136,58,11,SFW,128,40,30,98,41
1967-03-02,BOS,114,51,17,CHI,108,26,44,77,61
1967-03-03,LAL,138,31,39,NYK,132,35,38,66,77
1967-03-03,BOS,111,52,17,CIN,104,32,39,84,56
1967-03-03,PHL,129,59,11,DET,103,28,42,87,53
1967-03-04,STL,122,32,39,CHI,125,26,45,58,84
1967-03-04,CIN,109,32,40,BLT,102,19,53,51,93
1967-03-04,SFW,111,40,31,NYK,102,35,39,75,70
1967-03-05,CHI,113,27,45,CIN,106,33,40,60,85
1967-03-05,PHL,131,60,11,DET,106,28,43,88,54
1967-03-05,BOS,130,53,17,LAL,105,32,39,85,56
1967-03-05,SFW,103,41,31,NYK,115,35,40,76,71
1967-03-05,STL,132,32,40,BLT,103,19,54,51,94
1967-03-06,CIN,129,33,41,STL,122,33,40,66,81
1967-03-06,PHL,119,61,11,LAL,117,32,40,93,51
1967-03-06,BOS,127,54,17,DET,103,28,44,82,61
1967-03-07,NYK,119,36,40,LAL,131,32,41,68,81
1967-03-07,CHI,117,28,45,BOS,114,55,17,83,62
1967-03-08,BOS,113,55,18,PHL,115,62,11,117,29
1967-03-08,DET,120,28,45,BLT,113,19,55,47,100
1967-03-08,LAL,104,33,41,STL,106,33,41,66,82
1967-03-10,CHI,132,29,45,BLT,115,19,56,48,101
1967-03-10,SFW,105,41,32,STL,111,34,41,75,73
1967-03-10,LAL,118,33,42,DET,103,29,45,62,87
1967-03-11,SFW,120,41,33,LAL,125,34,42,75,75
1967-03-11,CIN,147,34,41,CHI,119,30,45,64,86
1967-03-11,PHL,114,63,11,BOS,116,55,19,118,30
1967-03-12,NYK,120,36,41,PHL,131,63,12,99,53
1967-03-12,STL,120,35,41,CIN,119,35,41,70,82
1967-03-12,BOS,123,56,19,BLT,118,19,57,75,76
1967-03-12,LAL,104,35,42,DET,120,29,46,64,88
1967-03-13,STL,123,36,41,BOS,122,57,19,93,60
1967-03-13,CHI,117,30,46,CIN,133,35,42,65,88
1967-03-13,SFW,135,41,34,DET,109,30,46,71,80
1967-03-14,SFW,110,42,34,PHL,139,64,12,106,46
1967-03-14,CHI,98,30,47,STL,111,37,41,67,88
1967-03-15,LAL,123,35,43,PHL,138,65,12,100,55
1967-03-15,BLT,121,19,58,NYK,114,36,42,55,100
1967-03-15,CIN,112,36,42,BOS,108,57,20,93,62
1967-03-15,DET,91,30,47,CHI,98,30,48,60,95
1967-03-16,SFW,145,42,35,PHL,131,66,12,108,47
1967-03-16,CIN,114,37,42,STL,111,38,41,75,83
1967-03-16,DET,109,30,48,BOS,132,57,21,87,69
1967-03-17,BLT,133,20,58,LAL,135,35,44,55,102
1967-03-17,CHI,120,31,48,SFW,117,43,35,74,83
1967-03-18,NYK,123,36,43,BOS,140,58,21,94,64
1967-03-18,PHL,135,66,13,BLT,119,20,59,86,72
1967-03-18,CIN,127,38,42,SFW,112,43,36,81,78
1967-03-18,STL,102,38,42,DET,99,30,49,68,91
1967-03-19,BLT,129,20,60,PHL,132,67,13,87,73
1967-03-19,DET,127,30,50,SFW,135,43,37,73,87
1967-03-19,BOS,124,59,21,NYK,113,36,44,95,65
1967-03-19,CHI,122,32,48,LAL,109,36,44,68,92
1967-10-13,SFW,144,0,0,SEA,116,0,0,0,0
1967-10-14,SDR,98,0,0,STL,99,0,0,0,0
1967-10-14,BOS,105,0,0,CHI,90,0,0,0,0
1967-10-15,SFW,102,1,0,STL,107,1,0,2,0
1967-10-17,NYK,124,0,1,SFW,122,1,1,1,2
1967-10-17,DET,131,1,0,CIN,108,0,0,1,0
1967-10-17,CHI,105,0,1,LAL,107,0,0,0,1
1967-10-17,SDR,105,0,1,STL,123,2,0,2,1
1967-10-18,CIN,122,0,1,SFW,118,1,2,1,3
1967-10-18,BLT,121,0,0,NYK,98,1,1,1,1
1967-10-18,PHL,103,0,0,LAL,87,1,0,1,0
1967-10-19,CHI,106,0,2,SFW,116,1,3,1,5
1967-10-19,STL,100,3,0,LAL,95,1,1,4,1
1967-10-20,SEA,114,0,1,SDR,121,0,2,0,3
1967-10-20,CHI,99,0,3,STL,126,4,0,4,3
1967-10-21,PHL,116,1,0,DET,111,2,0,3,0
1967-10-21,STL,115,5,0,SFW,110,2,3,7,3
1967-10-21,SDR,110,1,2,SEA,117,0,2,1,4
1967-10-21,BLT,109,1,0,BOS,125,1,0,2,0
1967-10-21,CIN,109,1,1,CHI,107,0,4,1,5
1967-10-21,NYK,106,1,2,LAL,114,1,2,2,4
1967-10-22,SFW,137,2,4,SDR,126,1,3,3,7
1967-10-22,SEA,94,1,2,CIN,106,2,1,3,3
1967-10-24,NYK,130,1,3,STL,135,6,0,7,3
1967-10-24,BLT,136,1,1,SEA,125,1,3,2,4
1967-10-24,SFW,116,3,4,CIN,106,3,1,6,5
1967-10-24,PHL,124,2,0,DET,102,2,1,4,1
1967-10-25,LAL,132,2,2,CIN,116,3,2,5,4
1967-10-25,PHL,117,3,0,NYK,114,1,4,4,4
1967-10-25,SDR,109,1,4,BLT,125,2,1,3,5
1967-10-25,BOS,118,2,0,STL,104,7,0,9,0
1967-10-25,DET,107,2,2,CHI,99,0,5,2,7
1967-10-27,LAL,125,3,2,CHI,117,0,6,3,8
1967-10-27,PHL,132,4,0,SEA,115,1,4,5,4
1967-10-27,SDR,113,1,5,CIN,116,3,3,4,8
1967-10-27,SFW,124,4,4,BLT,111,3,1,7,5
1967-10-27,DET,109,3,2,BOS,128,3,0,6,2
1967-10-28,STL,116,7,1,SEA,109,1,5,8,6
1967-10-28,NYK,98,1,5,DET,111,3,3,4,8
1967-10-28,BOS,104,4,0,PHL,95,5,0,9,0
1967-10-29,LAL,118,4,2,BLT,105,3,2,7,4
1967-10-29,SFW,125,5,4,CHI,105,0,7,5,11
1967-10-29,SDR,99,1,6,CIN,108,4,3,5,9
1967-10-31,SEA,114,1,6,CHI,104,0,8,1,14
1967-10-31,SFW,108,6,4,NYK,103,1,6,7,10
1967-10-31,STL,114,8,1,BLT,103,3,3,11,4
1967-11-01,DET,132,4,3,SFW,137,7,4,11,7
1967-11-01,SDR,139,1,7,SEA,125,2,6,3,13
1967-11-01,LAL,113,5,2,NYK,129,1,7,6,9
1967-11-01,PHL,136,5,1,BLT,111,3,4,8,5
1967-11-01,CIN,96,5,3,STL,101,9,1,14,4
1967-11-02,SEA,105,2,7,CHI,119,0,9,2,16
1967-11-03,BLT,113,3,5,DET,115,4,4,7,9
1967-11-03,BOS,105,5,0,LAL,104,5,3,10,3
1967-11-03,SEA,100,2,8,NYK,134,2,7,4,15
1967-11-04,SDR,121,2,7,NYK,125,3,7,5,14
1967-11-04,DET,127,5,4,BLT,118,3,6,8,10
1967-11-04,PHL,117,6,1,SFW,110,8,4,14,5
1967-11-04,CIN,104,5,4,LAL,106,5,4,10,8
1967-11-04,STL,111,10,1,BOS,104,6,0,16,1
1967-11-05,SDR,107,2,8,NYK,115,4,7,6,15
1967-11-07,SFW,126,8,5,SEA,112,2,9,10,14
1967-11-07,CHI,106,1,9,STL,111,11,1,12,10
1967-11-07,SDR,105,2,9,PHL,130,7,1,9,10
1967-11-07,CIN,103,5,5,BOS,113,6,1,11,6
1967-11-08,SDR,114,2,10,PHL,129,8,1,10,11
1967-11-08,DET,110,6,4,NYK,108,5,7,11,11
1967-11-08,BLT,122,3,7,CIN,100,5,6,8,13
1967-11-08,STL,111,12,1,SEA,96,2,10,14,11
1967-11-09,DET,119,7,4,SEA,118,2,11,9,15
1967-11-09,NYK,123,5,8,CIN,106,5,7,10,15
1967-11-09,CHI,93,1,10,BOS,107,7,1,8,11
1967-11-10,DET,140,8,4,STL,143,13,1,21,5
1967-11-10,BOS,115,8,1,BLT,114,4,7,12,8
1967-11-10,SFW,123,9,5,PHL,104,9,1,18,6
1967-11-11,BLT,134,4,8,SEA,129,2,12,6,20
1967-11-11,LAL,111,6,4,PHL,115,9,2,15,6
1967-11-11,CIN,109,5,8,SDR,108,2,11,7,19
1967-11-11,NYK,110,6,8,BOS,105,9,1,15,9
1967-11-11,STL,94,14,1,SFW,93,10,5,24,6
1967-11-12,STL,116,15,1,SDR,105,2,12,17,13
1967-11-12,LAL,97,6,5,CHI,96,1,11,7,16
1967-11-14,BLT,123,5,8,SFW,129,10,6,15,14
1967-11-14,BOS,114,9,2,SEA,111,2,13,11,15
1967-11-14,NYK,122,7,8,SDR,109,2,13,9,21
1967-11-14,DET,124,8,5,STL,107,16,1,24,6
1967-11-14,PHL,122,10,2,CIN,102,6,8,16,10
1967-11-15,DET,123,9,5,PHL,120,11,2,20,7
1967-11-15,LAL,124,7,5,CHI,115,1,12,8,17
1967-11-15,BOS,113,10,2,SFW,110,11,6,21,8
1967-11-15,SDR,122,2,14,NYK,108,8,8,10,22
1967-11-16,SDR,99,3,14,CHI,91,1,13,4,27
1967-11-17,SEA,130,2,14,SDR,124,4,14,6,28
1967-11-17,BOS,119,11,2,CIN,120,6,9,17,11
1967-11-17,PHL,125,11,3,STL,117,16,2,27,5
1967-11-17,SFW,111,11,7,CHI,109,1,14,12,21
1967-11-17,BLT,116,5,9,LAL,107,8,5,13,14
1967-11-18,CHI,132,1,15,DET,130,10,5,11,20
1967-11-18,SDR,124,4,15,SFW,142,12,7,16,22
1967-11-18,PHL,111,12,3,BOS,116,11,3,23,6
1967-11-18,STL,107,16,3,LAL,127,8,6,24,9
1967-11-18,NYK,93,8,9,BLT,101,6,9,14,18
1967-11-19,SEA,132,3,14,DET,130,10,6,13,20
1967-11-20,SEA,118,4,14,DET,120,10,7,14,21
1967-11-21,SEA,137,4,15,LAL,132,9,6,13,21
1967-11-21,NYK,125,8,10,CHI,123,2,15,10,25
1967-11-21,BOS,121,12,3,SDR,114,4,16,16,19
1967-11-21,SFW,124,13,7,DET,98,11,7,24,14
1967-11-22,CIN,123,7,9,NYK,122,9,10,16,19
1967-11-22,STL,115,16,4,PHL,113,12,4,28,8
1967-11-22,BOS,124,13,3,SDR,110,4,17,17,20
1967-11-22,BLT,100,7,9,CHI,105,2,16,9,25
1967-11-23,LAL,132,9,7,DET,120,11,8,20,15
1967-11-23,PHL,128,12,5,SDR,117,4,18,16,23
1967-11-23,SEA,133,5,15,BOS,106,14,3,19,18
1967-11-23,CHI,106,3,16,NYK,96,9,11,12,27
1967-11-24,CIN,153,8,9,SEA,133,6,15,14,24
1967-11-24,DET,130,11,9,SDR,122,4,19,15,28
1967-11-24,SFW,122,14,7,LAL,121,10,7,24,14
1967-11-24,CHI,104,4,16,PHL,122,13,5,17,21
1967-11-25,CIN,123,9,9,DET,133,12,9,21,18
1967-11-25,BLT,126,7,10,BOS,118,14,4,21,14
1967-11-25,PHL,114,14,5,CHI,119,4,17,18,22
1967-11-25,LAL,112,10,8,SFW,131,15,7,25,15
1967-11-25,NYK,111,9,12,SEA,110,6,16,15,28
1967-11-25,STL,110,17,4,SDR,109,4,20,21,24
1967-11-26,LAL,109,10,9,STL,105,18,4,28,13
1967-11-28,LAL,134,11,9,STL,117,18,5,29,14
1967-11-28,BOS,118,14,5,DET,111,13,9,27,14
1967-11-28,BLT,110,8,10,SFW,117,16,7,24,17
1967-11-28,NYK,108,10,12,PHL,110,14,6,24,18
1967-11-28,CHI,108,5,17,SEA,111,6,17,11,34
1967-11-29,DET,127,13,10,LAL,123,12,9,25,19
1967-11-29,CIN,99,9,10,NYK,119,10,13,19,23
1967-11-29,PHL,95,15,6,SFW,113,17,7,32,13
1967-11-30,SDR,87,4,21,STL,129,18,6,22,27
1967-12-01,BOS,123,15,5,LAL,119,12,10,27,15
1967-12-01,BLT,123,8,11,CIN,109,9,11,17,22
1967-12-01,PHL,133,15,7,SEA,109,7,17,22,24
1967-12-01,SFW,124,18,7,STL,101,19,6,37,13
1967-12-01,CHI,102,5,18,NYK,100,11,13,16,31
1967-12-02,PHL,130,16,7,BLT,121,9,11,25,18
1967-12-02,CIN,110,9,12,CHI,126,6,18,15,30
1967-12-02,DET,112,14,10,BOS,107,16,5,30,15
1967-12-02,NYK,106,11,14,LAL,122,12,11,23,25
1967-12-02,SDR,127,4,22,SFW,103,19,7,23,29
1967-12-03,SEA,109,7,18,STL,123,19,7,26,25
1967-12-05,PHL,122,17,7,LAL,128,13,11,30,18
1967-12-05,SFW,133,19,8,SEA,121,7,19,26,27
1967-12-05,NYK,148,11,15,BLT,117,9,12,20,27
1967-12-05,DET,111,15,10,SDR,110,5,22,20,32
1967-12-05,CHI,105,7,18,CIN,104,9,13,16,31
1967-12-06,BLT,125,9,13,LAL,136,14,11,23,24
1967-12-06,DET,135,16,10,CHI,121,8,18,24,28
1967-12-06,BOS,115,16,6,NYK,113,12,15,28,21
1967-12-06,CIN,107,9,14,PHL,108,17,8,26,22
1967-12-07,CHI,108,8,19,SDR,118,5,23,13,42
1967-12-08,SEA,114,7,20,CHI,115,8,20,15,40
1967-12-08,PHL,117,18,8,NYK,109,12,16,30,24
1967-12-08,BOS,123,17,6,BLT,108,9,14,26,20
1967-12-08,SDR,137,6,23,SFW,107,20,8,26,31
1967-12-08,DET,103,17,10,LAL,115,15,11,32,21
1967-12-08,STL,101,20,7,CIN,95,9,15,29,22
1967-12-09,NYK,121,0,0,DET,124,0,0,0,0
1967-12-09,SFW,119,20,9,CHI,112,9,20,29,29
1967-12-09,BLT,109,9,15,PHL,123,19,8,28,23
1967-12-09,SDR,109,7,23,LAL,127,16,11,23,34
1967-12-09,CIN,108,9,16,BOS,104,18,6,27,22
1967-12-10,SEA,133,7,21,LAL,123,17,11,24,32
1967-12-10,STL,114,21,7,BLT,112,9,16,30,23
1967-12-12,NYK,142,12,17,STL,145,22,7,34,24
1967-12-12,BLT,140,9,17,DET,117,17,11,26,28
1967-12-12,PHL,118,20,8,SEA,107,8,21,28,29
1967-12-12,SDR,118,7,24,CHI,104,9,21,16,45
1967-12-13,DET,129,17,12,NYK,117,12,18,29,30
1967-12-13,CIN,136,10,16,BLT,108,10,17,20,33
1967-12-13,SFW,104,21,9,CHI,109,9,22,30,31
1967-12-14,BOS,102,18,7,PHL,101,21,8,39,15
1967-12-14,LAL,101,17,12,CHI,106,10,22,27,34
1967-12-15,CIN,147,11,16,DET,130,18,12,29,28
1967-12-15,CHI,115,11,22,SEA,122,8,22,19,44
1967-12-15,BOS,114,19,7,SDR,101,8,24,27,31
1967-12-15,PHL,107,21,9,STL,98,23,7,44,16
1967-12-15,BLT,97,10,18,SFW,110,21,10,31,28
1967-12-16,CHI,123,11,23,PHL,143,22,9,33,32
1967-12-16,STL,117,23,8,SFW,110,22,10,45,18
1967-12-16,DET,110,18,13,CIN,122,12,16,30,29
1967-12-16,NYK,126,12,19,SDR,102,8,25,20,44
1967-12-17,SEA,124,9,22,PHL,139,23,9,32,31
1967-12-17,LAL,117,17,13,BOS,123,20,7,37,20
1967-12-17,SDR,117,8,26,DET,115,18,14,26,40
1967-12-17,STL,97,24,8,SFW,79,22,11,46,19
1967-12-18,SEA,122,9,23,DET,140,18,15,27,38
1967-12-19,NYK,133,13,19,CIN,118,13,16,26,35
1967-12-19,SEA,114,9,24,BOS,118,21,7,30,31
1967-12-19,BLT,117,10,19,STL,98,25,8,35,27
1967-12-20,LAL,131,17,14,NYK,138,14,19,31,33
1967-12-20,SEA,122,9,25,PHL,160,24,9,33,34
1967-12-20,SDR,116,9,26,BOS,126,22,7,31,33
1967-12-20,SFW,113,22,13,DET,109,19,15,41,28
1967-12-21,CHI,108,11,24,BLT,116,11,19,22,43
1967-12-22,BOS,120,23,7,CIN,117,13,17,36,24
1967-12-22,BLT,117,12,19,CHI,112,11,25,23,44
1967-12-22,SEA,120,10,26,NYK,108,15,19,25,45
1967-12-22,LAL,133,17,15,DET,105,19,16,36,31
1967-12-22,SFW,103,23,13,SDR,97,9,27,32,40
1967-12-23,SFW,131,24,13,SEA,124,11,26,35,39
1967-12-23,SDR,119,9,28,DET,123,19,17,28,45
1967-12-24,SEA,113,11,27,SFW,127,25,13,36,40
1967-12-25,NYK,124,15,20,BOS,134,24,7,39,27
1967-12-25,CIN,118,13,18,SEA,112,11,28,24,46
1967-12-25,BLT,105,13,19,PHL,108,25,9,38,28
1967-12-25,SDR,104,9,29,LAL,101,18,15,27,44
1967-12-26,SEA,137,11,29,NYK,135,15,21,26,50
1967-12-26,PHL,126,26,9,CIN,121,14,18,40,27
1967-12-26,DET,127,20,17,STL,110,25,9,45,26
1967-12-26,BOS,104,25,7,SFW,117,26,13,51,20
1967-12-26,CHI,101,11,26,LAL,104,18,16,29,42
1967-12-27,CIN,132,14,19,LAL,127,19,16,33,35
1967-12-27,STL,116,25,10,BOS,113,25,8,50,18
1967-12-27,NYK,105,15,22,PHL,114,27,9,42,31
1967-12-28,SEA,125,12,29,SDR,143,10,29,22,58
1967-12-28,CIN,126,15,19,SFW,122,27,13,42,32
1967-12-29,PHL,133,28,9,BOS,123,25,9,53,18
1967-12-29,NYK,115,15,23,LAL,126,19,17,34,40
1967-12-29,BLT,130,13,20,CIN,113,16,19,29,39
1967-12-29,STL,122,26,10,DET,111,21,17,47,27
1967-12-29,CHI,107,11,27,SFW,100,27,14,38,41
1967-12-30,PHL,122,29,9,DET,107,21,18,50,27
1967-12-30,STL,104,27,10,LAL,106,20,17,47,27
1967-12-31,SEA,124,12,30,SFW,126,27,15,39,45
1967-12-31,LAL,147,21,17,SDR,118,11,29,32,46
1968-01-01,CHI,109,12,27,BLT,103,14,20,26,47
1968-01-01,SEA,94,12,31,STL,115,27,11,39,42
1968-01-02,NYK,119,15,24,CIN,125,16,20,31,44
1968-01-02,SFW,119,28,15,LAL,118,22,17,50,32
1968-01-02,DET,114,21,19,BLT,113,14,21,35,40
1968-01-02,CHI,95,13,27,BOS,84,25,10,38,37
1968-01-03,SDR,126,11,30,STL,124,28,11,39,41
1968-01-03,PHL,115,30,9,NYK,129,15,25,45,34
1968-01-03,LAL,103,22,18,BOS,113,25,11,47,29
1968-01-03,BLT,94,14,22,CHI,113,14,27,28,49
1968-01-04,SFW,98,29,15,STL,106,28,12,57,27
1968-01-05,DET,142,22,19,CIN,141,17,20,39,39
1968-01-05,SEA,121,12,32,BOS,128,26,11,38,43
1968-01-05,PHL,125,30,10,LAL,113,22,19,52,29
1968-01-05,NYK,121,16,25,CHI,99,15,27,31,52
1968-01-06,BLT,130,14,23,LAL,127,22,20,36,43
1968-01-06,CIN,109,17,21,CHI,114,15,28,32,49
1968-01-06,SDR,104,12,30,SEA,122,12,33,24,63
1968-01-06,SFW,107,29,16,BOS,101,27,11,56,27
1968-01-06,NYK,118,17,25,DET,101,23,19,40,44
1968-01-06,STL,96,29,12,PHL,107,31,10,60,22
1968-01-07,CIN,134,17,22,PHL,118,32,10,49,32
1968-01-08,SEA,113,13,33,NYK,119,18,25,31,58
1968-01-09,BLT,121,15,23,CIN,118,18,22,33,45
1968-01-09,STL,121,29,13,CHI,109,16,28,45,41
1968-01-09,SDR,105,12,31,NYK,118,19,25,31,56
1968-01-09,SFW,102,30,16,DET,118,23,20,53,36
1968-01-10,PHL,122,32,11,STL,134,30,13,62,24
1968-01-10,SDR,122,12,32,DET,118,24,20,36,52
1968-01-10,CIN,133,18,23,BLT,117,16,23,34,46
1968-01-10,BOS,123,27,12,SEA,110,13,34,40,46
1968-01-10,LAL,101,22,21,NYK,115,20,25,42,46
1968-01-11,CIN,120,19,23,BOS,116,28,12,47,35
1968-01-11,BLT,101,16,24,STL,108,31,13,47,37
1968-01-12,BOS,148,28,13,DET,126,24,21,52,34
1968-01-12,SFW,127,30,17,NYK,117,21,25,51,42
1968-01-12,PHL,133,32,12,BLT,116,16,25,48,37
1968-01-12,STL,111,32,13,SDR,89,13,32,45,45
1968-01-13,CIN,122,20,23,SDR,116,13,33,33,56
1968-01-13,CHI,110,16,29,BLT,106,16,26,32,55
1968-01-13,DET,106,24,22,PHL,115,33,12,57,34
1968-01-14,STL,99,33,13,CHI,92,17,29,50,42
1968-01-15,SEA,129,13,35,NYK,113,21,26,34,61
1968-01-15,BOS,111,29,13,SFW,102,31,17,60,30
1968-01-16,CIN,148,21,23,SFW,121,31,18,52,41
1968-01-16,SEA,142,14,35,BLT,116,16,27,30,62
1968-01-16,CHI,123,17,30,SDR,110,13,34,30,64
1968-01-17,LAL,125,22,22,PHL,116,34,12,56,34
1968-01-17,BLT,109,16,28,NYK,111,21,27,37,55
1968-01-17,DET,117,24,23,SFW,109,31,19,55,42
1968-01-17,SDR,110,13,35,CHI,104,18,30,31,65
1968-01-17,BOS,114,30,13,STL,102,34,13,64,26
1968-01-18,CIN,129,22,23,SDR,126,14,35,36,58
1968-01-18,STL,119,34,14,BLT,116,16,29,50,43
1968-01-19,SFW,131,31,20,PHL,120,34,13,65,33
1968-01-19,DET,133,25,23,SEA,119,15,35,40,58
1968-01-19,BOS,120,31,13,NYK,114,22,27,53,40
1968-01-20,LAL,151,23,22,SFW,122,32,20,55,42
1968-01-20,CIN,128,23,23,DET,120,26,23,49,46
1968-01-20,BLT,118,16,30,BOS,115,32,13,48,43
1968-01-20,STL,120,35,14,SEA,115,15,36,50,50
1968-01-20,CHI,111,18,31,PHL,135,34,14,52,45
1968-01-21,LAL,154,24,22,SEA,123,15,37,39,59
1968-01-21,BOS,139,32,14,SDR,112,14,36,46,50
1968-01-21,DET,103,26,24,NYK,115,22,28,48,52
1968-01-21,STL,98,36,14,CHI,90,18,32,54,46
1968-01-25,CHI,118,18,33,NYK,126,23,28,41,61
1968-01-25,CIN,116,24,23,LAL,118,25,22,49,45
1968-01-25,SDR,113,14,37,BLT,127,17,30,31,67
1968-01-25,DET,108,26,25,PHL,123,35,14,61,39
1968-01-25,STL,105,37,14,BOS,93,33,14,70,28
1968-01-26,PHL,123,36,14,CIN,113,24,24,60,38
1968-01-26,BOS,112,33,15,LAL,118,26,22,59,37
1968-01-26,SFW,110,32,21,BLT,125,18,30,50,51
1968-01-26,STL,103,38,14,NYK,94,24,28,62,42
1968-01-27,SDR,122,14,38,BLT,123,19,30,33,68
1968-01-27,DET,125,26,26,LAL,119,27,22,53,48
1968-01-27,CIN,111,24,25,STL,120,39,14,63,39
1968-01-28,NYK,133,24,29,SFW,130,32,22,56,51
1968-01-28,SEA,135,15,38,BLT,126,20,30,35,68
1968-01-28,LAL,128,27,23,STL,113,40,14,67,37
1968-01-28,BOS,115,33,16,PHL,103,37,14,70,30
1968-01-30,NYK,131,25,29,BLT,134,20,31,45,60
1968-01-30,CHI,119,18,34,SFW,123,32,23,50,57
1968-01-30,PHL,125,37,15,BOS,118,34,16,71,31
1968-01-30,SEA,128,16,38,LAL,116,28,23,44,61
1968-01-30,CIN,121,24,26,DET,101,27,26,51,52
1968-01-31,CIN,126,25,26,NYK,128,25,30,50,56
1968-01-31,BOS,118,34,17,CHI,109,18,35,52,52
1968-01-31,BLT,113,21,31,DET,108,27,27,48,58
1968-01-31,LAL,110,28,24,STL,102,40,15,68,39
1968-02-01,SDR,114,14,39,SFW,128,33,23,47,62
1968-02-01,SEA,110,17,38,STL,113,40,16,57,54
1968-02-01,NYK,112,26,30,CHI,103,18,36,44,66
1968-02-02,SFW,127,34,23,SDR,121,14,40,48,63
1968-02-02,PHL,131,38,15,DET,121,27,28,65,43
1968-02-02,CHI,113,18,37,CIN,125,25,27,43,64
1968-02-02,LAL,151,29,24,SEA,113,17,39,46,63
1968-02-02,BOS,120,35,17,BLT,99,22,31,57,48
1968-02-03,LAL,133,30,24,SDR,122,14,41,44,65
1968-02-03,BLT,121,22,32,PHL,133,39,15,61,47
1968-02-03,CIN,111,26,27,STL,125,41,16,67,43
1968-02-03,NYK,108,27,30,BOS,112,36,17,63,47
1968-02-04,LAL,137,31,24,SEA,131,17,40,48,64
1968-02-04,PHL,141,40,15,SFW,117,35,23,75,38
1968-02-04,DET,117,27,29,BLT,115,22,33,49,62
1968-02-04,BOS,108,37,17,NYK,110,27,31,64,48
1968-02-04,STL,106,42,16,CIN,100,26,28,68,44
1968-02-05,SEA,132,17,41,CIN,129,26,29,43,70
1968-02-05,BLT,121,22,34,SDR,108,14,42,36,76
1968-02-06,CHI,124,18,38,SFW,126,35,24,53,62
1968-02-06,LAL,146,32,24,CIN,102,26,30,58,54
1968-02-06,NYK,121,28,31,STL,100,43,16,71,47
1968-02-06,DET,120,28,29,SDR,93,14,43,42,72
1968-02-07,BLT,111,23,34,NYK,114,29,31,52,65
1968-02-07,PHL,125,41,15,SDR,103,14,44,55,59
1968-02-07,BOS,102,37,18,STL,101,43,17,80,35
1968-02-08,SEA,115,18,41,LAL,110,33,24,51,65
1968-02-08,CHI,131,18,39,DET,110,29,29,47,68
1968-02-08,SFW,126,36,24,CIN,109,26,31,62,55
1968-02-08,BLT,106,23,35,SDR,102,14,45,37,80
1968-02-09,PHL,118,42,15,CHI,113,19,39,61,54
1968-02-09,STL,121,43,18,NYK,111,30,31,73,49
1968-02-09,LAL,122,33,25,SFW,104,37,24,70,49
1968-02-09,BOS,107,38,18,DET,100,29,30,67,48
1968-02-10,DET,109,29,31,BLT,114,24,35,53,66
1968-02-10,STL,108,44,18,CHI,107,19,40,63,58
1968-02-10,SDR,99,14,46,CIN,101,26,32,40,78
1968-02-10,NYK,115,30,32,PHL,97,43,15,73,47
1968-02-11,SEA,146,9,26,SFW,118,22,12,31,38
1968-02-11,BLT,136,25,35,SDR,116,14,47,39,82
1968-02-11,BOS,104,39,18,LAL,141,34,25,73,43
1968-02-11,PHL,119,43,16,STL,93,45,18,88,34
1968-02-12,CIN,104,27,32,CHI,112,19,41,46,73
1968-02-13,BLT,116,26,35,LAL,119,35,25,61,60
1968-02-13,DET,115,29,32,BOS,127,39,19,68,51
1968-02-13,STL,123,45,19,CIN,111,27,33,72,52
1968-02-13,SFW,105,37,25,PHL,112,44,16,81,41
1968-02-13,CHI,114,20,41,SDR,102,14,48,34,89
1968-02-14,SEA,125,19,41,PHL,149,45,16,64,57
1968-02-14,NYK,114,31,32,SDR,102,14,49,45,81
1968-02-14,BOS,118,40,19,DET,96,29,33,69,52
1968-02-15,CIN,132,27,34,SEA,119,19,42,46,76
1968-02-15,SDR,114,14,50,SFW,134,37,26,51,76
1968-02-15,LAL,132,36,25,CHI,105,21,41,57,66
1968-02-16,BLT,147,26,36,SEA,118,19,43,45,79
1968-02-16,SFW,118,38,26,LAL,116,37,25,75,51
1968-02-16,CHI,108,21,42,BOS,124,41,19,62,61
1968-02-16,SDR,108,14,51,PHL,124,46,16,60,67
1968-02-16,CIN,125,28,34,NYK,91,32,32,60,66
1968-02-17,LAL,134,37,26,PHL,135,47,16,84,42
1968-02-17,CIN,117,29,34,BLT,115,27,36,56,70
1968-02-17,NYK,134,32,33,SEA,111,19,44,51,77
1968-02-17,STL,99,46,19,BOS,113,42,19,88,38
1968-02-18,STL,107,46,20,CHI,113,21,43,67,63
1968-02-18,SDR,111,14,52,PHL,106,48,16,62,68
1968-02-18,DET,123,29,34,SFW,104,39,26,68,60
1968-02-18,CIN,107,30,34,BOS,100,43,19,73,53
1968-02-20,CHI,124,22,43,DET,121,30,34,52,77
1968-02-20,BLT,127,27,37,STL,115,46,21,73,58
1968-02-20,NYK,115,33,33,SFW,112,39,27,72,60
1968-02-20,BOS,126,43,20,CIN,110,31,34,74,54
1968-02-20,PHL,140,48,17,SEA,108,19,45,67,62
1968-02-21,LAL,122,37,27,BOS,117,44,20,81,47
1968-02-21,BLT,126,28,37,SFW,117,39,28,67,65
1968-02-21,CHI,108,23,43,SEA,106,19,46,42,89
1968-02-22,STL,151,46,22,DET,128,30,35,76,57
1968-02-22,CIN,99,31,35,BLT,112,29,37,60,72
1968-02-23,SDR,122,15,52,SEA,127,19,47,34,99
1968-02-23,SFW,127,39,29,BOS,122,44,21,83,50
1968-02-23,PHL,138,49,17,DET,117,30,36,79,53
1968-02-23,LAL,131,38,27,CIN,115,31,36,69,63
1968-02-23,STL,118,47,22,BLT,110,30,37,77,59
1968-02-24,BOS,141,44,22,SEA,137,20,47,64,69
1968-02-24,BLT,140,30,38,DET,132,30,37,60,75
1968-02-24,SFW,127,40,29,CIN,114,31,37,71,66
1968-02-24,NYK,109,34,33,CHI,101,24,43,58,76
1968-02-25,STL,119,48,22,PHL,126,50,17,98,39
1968-02-25,DET,115,30,38,NYK,124,35,33,65,71
1968-02-25,SDR,112,15,53,LAL,127,39,27,54,80
1968-02-26,SDR,110,15,54,BOS,118,45,22,60,76
1968-02-27,PHL,127,51,17,SFW,107,41,29,92,46
1968-02-27,LAL,117,40,27,CIN,106,31,38,71,65
1968-02-27,NYK,102,36,33,STL,108,48,23,84,56
1968-02-28,BLT,122,31,38,NYK,126,36,34,67,72
1968-02-28,BOS,135,46,22,SFW,110,41,30,87,52
1968-02-29,SDR,114,15,55,CIN,120,31,39,46,94
1968-02-29,LAL,117,41,27,CHI,107,24,44,65,71
1968-02-29,STL,105,49,23,NYK,102,37,34,86,57
1968-03-01,DET,131,30,39,STL,121,50,23,80,62
1968-03-01,SDR,114,15,56,BLT,156,31,39,46,95
1968-03-01,SFW,101,41,31,CIN,122,32,39,73,70
1968-03-01,BOS,94,47,22,CHI,87,24,45,71,67
1968-03-02,LAL,127,42,27,SEA,121,20,48,62,75
1968-03-02,SFW,117,41,32,BLT,109,32,39,73,71
1968-03-02,NYK,133,37,35,DET,107,31,39,68,74
1968-03-03,SEA,128,20,49,CIN,138,33,39,53,88
1968-03-03,BOS,127,48,22,PHL,133,52,17,100,39
1968-03-03,DET,134,31,40,CHI,123,24,46,55,86
1968-03-03,LAL,121,43,27,BLT,114,32,40,75,67
1968-03-03,STL,106,50,24,SDR,104,15,57,65,81
1968-03-05,SEA,121,20,50,BLT,126,32,41,52,91
1968-03-05,CHI,119,24,47,DET,121,32,40,56,87
1968-03-05,SFW,117,42,32,STL,134,51,24,93,56
1968-03-05,PHL,134,53,17,SDR,103,15,58,68,75
1968-03-05,NYK,91,38,35,BOS,113,48,23,86,58
1968-03-06,DET,140,33,40,SDR,118,15,59,48,99
1968-03-06,CIN,108,34,39,PHL,106,54,17,88,56
1968-03-06,LAL,96,44,27,STL,112,52,24,96,51
1968-03-06,BOS,103,49,23,NYK,91,38,36,87,59
1968-03-07,STL,150,53,24,SEA,133,20,51,73,75
1968-03-07,CIN,117,35,39,PHL,125,54,18,89,57
1968-03-07,CHI,118,24,48,BOS,112,50,23,74,71
1968-03-07,SDR,102,15,60,LAL,119,44,28,59,88
1968-03-08,LAL,130,45,28,SDR,122,15,61,60,89
1968-03-08,CIN,118,35,40,DET,129,34,40,69,80
1968-03-08,SEA,116,20,52,BLT,122,33,41,53,93
1968-03-08,PHL,101,55,18,BOS,96,50,24,105,42
1968-03-09,SFW,132,42,33,LAL,137,46,28,88,61
1968-03-09,SDR,111,15,62,SEA,115,20,53,35,115
1968-03-09,CHI,109,25,48,STL,115,54,24,79,72
1968-03-10,STL,121,55,24,DET,133,35,40,90,64
1968-03-10,SEA,112,21,53,SFW,118,42,34,63,87
1968-03-10,BOS,111,50,25,CIN,137,35,41,85,66
1968-03-10,NYK,108,38,37,PHL,119,56,18,94,55
1968-03-10,LAL,89,47,28,BLT,119,34,41,81,69
1968-03-11,SEA,112,21,54,BOS,119,50,26,71,80
1968-03-11,CHI,104,25,49,CIN,98,36,41,61,90
1968-03-12,DET,139,36,40,SEA,123,21,55,57,95
1968-03-12,SFW,121,43,34,BOS,124,51,26,94,60
1968-03-12,PHL,139,57,18,CHI,115,26,49,83,67
1968-03-12,NYK,107,38,38,BLT,104,35,41,73,79
1968-03-13,CIN,142,36,42,SEA,123,21,56,57,98
1968-03-13,PHL,120,58,18,NYK,130,39,38,97,56
1968-03-13,SDR,118,15,63,BOS,144,52,26,67,89
1968-03-13,LAL,142,47,29,SFW,106,43,35,90,64
1968-03-13,BLT,96,35,42,CHI,100,26,50,61,92
1968-03-14,CIN,102,37,42,STL,96,55,25,92,67
1968-03-15,SFW,118,43,36,DET,122,37,40,80,76
1968-03-15,PHL,122,58,19,BLT,115,35,43,93,62
1968-03-15,LAL,123,48,29,NYK,112,40,38,88,67
1968-03-15,CHI,101,27,50,SEA,113,21,57,48,107
1968-03-16,CHI,122,27,51,PHL,144,59,19,86,70
1968-03-16,BLT,111,35,44,BOS,136,53,26,88,70
1968-03-16,LAL,135,49,29,DET,108,38,40,87,69
1968-03-16,STL,124,55,26,SEA,106,22,57,77,83
1968-03-17,BOS,139,54,26,BLT,147,35,45,89,71
1968-03-17,SDR,121,15,64,CHI,129,27,52,42,116
1968-03-17,LAL,120,50,29,DET,116,38,41,88,70
1968-03-17,SFW,104,43,37,NYK,130,40,39,83,76
1968-03-18,PHL,158,60,19,LAL,128,51,29,111,48
1968-03-18,SFW,118,43,38,NYK,123,41,39,84,77
1968-03-18,SEA,82,22,58,DET,88,38,42,60,100
1968-03-19,PHL,130,61,19,CIN,131,38,42,99,61
1968-03-19,LAL,121,51,30,SDR,109,15,65,66,95
1968-03-19,SEA,122,22,59,CHI,104,28,52,50,111
1968-03-20,BLT,119,36,45,PHL,137,61,20,97,65
1968-03-20,BOS,116,54,27,DET,125,39,42,93,69
1968-03-20,SDR,112,15,66,CHI,121,28,53,43,119
1968-03-20,NYK,108,42,39,CIN,106,39,42,81,81
1968-10-15,NYK,96,0,0,CHI,100,0,0,0,0
1968-10-16,BLT,124,0,0,DET,116,0,0,0,0
1968-10-16,ATL,110,0,0,CIN,125,0,0,0,0
1968-10-16,MIL,84,0,0,CHI,89,1,0,1,0
1968-10-17,SDR,128,0,0,SEA,110,0,0,0,0
1968-10-18,SFW,108,0,0,SDR,123,1,0,1,0
1968-10-18,PHX,116,0,0,SEA,107,0,1,0,1
1968-10-18,PHL,114,0,0,LAL,96,0,0,0,0
1968-10-18,DET,88,0,1,BOS,106,0,0,0,1
1968-10-19,BLT,121,1,0,PHL,124,1,0,2,0
1968-10-19,CIN,127,1,0,DET,115,0,2,1,2
1968-10-19,ATL,125,0,1,MIL,107,0,1,0,2
1968-10-19,CHI,96,2,0,BOS,106,1,0,3,0
1968-10-19,SEA,95,0,2,SFW,107,0,1,0,3
1968-10-20,PHX,122,1,0,BLT,134,1,1,2,1
1968-10-21,BLT,111,2,1,SEA,104,0,3,2,4
1968-10-22,NYK,117,0,1,PHL,114,2,0,2,1
1968-10-22,CIN,107,2,0,LAL,103,0,1,2,1
1968-10-22,SFW,109,1,1,PHX,101,1,1,2,2
1968-10-23,SEA,118,0,4,SDR,117,2,0,2,4
1968-10-23,MIL,112,0,2,NYK,114,1,1,1,3
1968-10-23,DET,117,0,3,LAL,110,0,2,0,5
1968-10-23,BOS,108,2,0,CIN,101,3,0,5,0
1968-10-23,ATL,106,1,1,CHI,91,2,1,3,2
1968-10-24,SDR,115,2,1,BLT,119,3,1,5,2
1968-10-24,PHX,109,1,2,NYK,92,2,1,3,3
1968-10-25,DET,132,1,3,PHL,122,2,1,3,4
1968-10-25,SEA,123,1,4,ATL,112,2,1,3,5
1968-10-25,LAL,117,0,3,BLT,111,4,1,4,4
1968-10-26,PHL,122,2,2,CHI,118,2,2,4,4
1968-10-26,SFW,107,2,1,BLT,106,4,2,6,3
1968-10-26,NYK,98,2,2,CIN,92,3,1,5,3
1968-10-26,BOS,102,3,0,MIL,89,0,3,3,3
1968-10-27,LAL,152,1,3,SDR,116,2,2,3,5
1968-10-27,SEA,114,2,4,BLT,126,4,3,6,7
1968-10-27,PHX,100,2,2,ATL,123,2,2,4,4
1968-10-29,LAL,125,2,3,ATL,124,3,2,5,5
1968-10-29,MIL,112,0,4,BLT,129,5,3,5,7
1968-10-29,CHI,103,2,3,BOS,97,4,0,6,3
1968-10-30,BOS,117,4,1,DET,119,2,3,6,4
1968-10-30,SDR,127,2,3,ATL,116,3,3,5,6
1968-10-30,CIN,118,3,2,NYK,114,3,2,6,4
1968-10-30,BLT,112,6,3,SFW,110,3,1,9,4
1968-10-30,SEA,108,2,5,PHX,115,2,3,4,8
1968-10-31,MIL,134,0,5,DET,118,3,3,3,8
1968-10-31,PHX,112,3,3,CHI,103,3,3,6,6
1968-11-01,CIN,132,4,2,MIL,114,1,5,5,7
1968-11-01,ATL,109,3,4,SFW,105,3,2,6,6
1968-11-01,NYK,103,3,3,BLT,119,7,3,10,6
1968-11-01,LAL,101,3,3,CHI,114,3,4,6,7
1968-11-01,BOS,118,4,2,PHL,99,3,2,7,4
1968-11-02,PHL,113,3,3,CIN,119,5,2,8,5
1968-11-02,DET,112,3,4,NYK,104,3,4,6,8
1968-11-02,MIL,102,1,6,SFW,101,3,3,4,9
1968-11-02,SEA,101,2,6,CHI,95,4,4,6,10
1968-11-03,PHX,109,4,3,LAL,127,3,4,7,7
1968-11-03,SEA,108,3,6,NYK,122,3,5,6,11
1968-11-03,SDR,121,3,3,CHI,107,4,5,7,8
1968-11-03,ATL,103,4,4,BOS,123,5,2,9,6
1968-11-04,PHX,108,4,4,SFW,119,3,4,7,8
1968-11-05,CHI,109,4,6,LAL,112,4,4,8,10
1968-11-05,SDR,113,4,3,NYK,109,4,5,8,8
1968-11-06,CIN,133,6,2,CHI,122,4,7,10,9
1968-11-06,BLT,140,8,3,ATL,119,4,5,12,8
1968-11-06,DET,127,4,4,SEA,118,3,7,7,11
1968-11-06,MIL,115,2,6,LAL,128,5,4,7,10
1968-11-06,SFW,94,4,4,NYK,93,4,6,8,10
1968-11-07,CHI,120,4,8,SEA,105,3,8,7,16
1968-11-08,DET,122,5,4,SFW,118,5,4,10,8
1968-11-08,BOS,112,6,2,SEA,114,3,9,9,11
1968-11-08,ATL,114,4,6,SDR,101,5,3,9,9
1968-11-08,LAL,102,6,4,NYK,100,4,7,10,11
1968-11-09,BLT,109,9,3,SDR,107,5,4,14,7
1968-11-09,ATL,113,5,6,SFW,106,5,5,10,11
1968-11-09,CHI,104,5,8,CIN,110,7,2,12,10
1968-11-09,MIL,97,2,7,BOS,98,6,3,8,10
1968-11-09,PHL,114,3,4,SEA,94,4,9,7,13
1968-11-10,PHX,130,4,5,DET,128,6,4,10,9
1968-11-10,LAL,130,7,4,NYK,109,4,8,11,12
1968-11-11,PHL,127,4,4,SEA,117,4,10,8,14
1968-11-11,BOS,134,7,3,SDR,113,5,5,12,8
1968-11-12,BLT,115,10,3,CIN,126,8,2,18,5
1968-11-12,MIL,127,2,8,SEA,114,4,11,6,19
1968-11-12,CHI,115,5,9,SDR,108,5,6,10,15
1968-11-12,SFW,123,5,6,ATL,108,6,6,11,12
1968-11-13,SDR,122,5,7,DET,120,6,5,11,12
1968-11-13,SEA,113,4,12,ATL,142,6,7,10,19
1968-11-13,CIN,111,9,2,BLT,115,10,4,19,6
1968-11-14,PHX,109,5,5,DET,111,6,6,11,11
1968-11-14,NYK,101,4,9,CIN,110,9,3,13,12
1968-11-15,SEA,128,4,13,PHX,124,5,6,9,19
1968-11-15,LAL,127,8,4,SDR,119,6,7,14,11
1968-11-15,ATL,115,7,7,PHL,116,5,4,12,11
1968-11-15,BOS,116,8,3,CIN,105,10,3,18,6
1968-11-15,SFW,133,6,6,DET,105,7,6,13,12
1968-11-15,BLT,129,11,4,MIL,102,3,8,14,12
1968-11-16,CIN,130,10,4,ATL,125,7,8,17,12
1968-11-16,SEA,123,5,13,DET,119,7,7,12,20
1968-11-16,SFW,112,7,6,LAL,119,9,4,16,10
1968-11-16,SDR,112,6,8,BOS,120,9,3,15,11
1968-11-16,NYK,119,4,10,CHI,97,6,9,10,19
1968-11-16,PHL,136,6,4,MIL,92,3,9,9,13
1968-11-17,PHX,98,5,7,BOS,130,10,3,15,10
1968-11-17,LAL,105,10,4,SEA,94,6,13,16,17
1968-11-19,PHL,126,7,4,PHX,110,5,8,12,12
1968-11-19,CHI,109,6,10,SFW,121,7,7,13,17
1968-11-19,NYK,107,5,10,SDR,113,6,9,11,19
1968-11-19,DET,121,7,8,CIN,107,11,4,18,12
1968-11-19,LAL,116,11,4,BOS,106,11,3,22,7
1968-11-19,MIL,119,3,10,ATL,98,7,9,10,19
1968-11-20,BLT,114,12,4,SDR,110,7,9,19,13
1968-11-20,CIN,113,11,5,SFW,107,8,7,19,12
1968-11-20,ATL,111,7,10,NYK,106,5,11,12,21
1968-11-20,SEA,92,6,14,BOS,139,11,4,17,18
1968-11-21,DET,121,8,8,ATL,129,8,10,16,18
1968-11-21,CHI,120,6,11,MIL,111,4,10,10,21
1968-11-22,SDR,126,7,10,SEA,111,6,15,13,25
1968-11-22,PHL,121,8,4,BLT,110,13,4,21,8
1968-11-22,NYK,114,5,12,CHI,107,7,11,12,23
1968-11-22,BOS,133,12,4,PHX,106,5,9,17,13
1968-11-22,LAL,98,12,4,SFW,100,8,8,20,12
1968-11-23,BLT,128,13,5,DET,127,8,9,21,14
1968-11-23,SFW,132,9,8,SEA,119,6,16,15,24
1968-11-23,MIL,115,4,11,PHX,112,5,10,9,21
1968-11-23,CIN,105,12,5,PHL,120,9,4,21,9
1968-11-23,NYK,111,6,12,BOS,100,13,4,19,16
1968-11-23,CHI,96,7,12,ATL,114,9,10,16,22
1968-11-24,SDR,135,8,10,PHL,128,10,4,18,14
1968-11-24,SEA,141,6,17,MIL,120,5,11,11,28
1968-11-24,ATL,111,10,10,BLT,118,14,5,24,15
1968-11-24,LAL,103,12,5,CHI,100,7,13,19,18
1968-11-25,SEA,123,7,17,MIL,113,5,12,12,29
1968-11-26,DET,134,8,10,SDR,120,9,10,17,20
1968-11-26,PHX,119,5,11,PHL,126,10,5,15,16
1968-11-26,NYK,104,7,12,LAL,100,13,5,20,17
1968-11-26,BLT,102,15,5,ATL,99,10,11,25,16
1968-11-26,SEA,99,8,17,CHI,98,7,14,15,31
1968-11-27,BOS,131,13,5,NYK,117,8,12,21,17
1968-11-27,DET,125,9,10,PHX,111,5,12,14,22
1968-11-27,SDR,123,9,11,BLT,107,16,5,25,16
1968-11-27,SFW,106,10,8,CHI,119,7,15,17,23
1968-11-27,ATL,94,10,12,CIN,91,12,6,22,18
1968-11-28,PHL,122,11,5,LAL,107,13,6,24,11
1968-11-28,SEA,115,9,17,MIL,103,5,13,14,30
1968-11-29,SFW,140,10,9,MIL,119,5,14,15,23
1968-11-29,CIN,122,12,7,DET,112,10,10,22,17
1968-11-29,BLT,124,16,6,PHX,106,5,13,21,19
1968-11-29,BOS,92,14,5,LAL,93,13,7,27,12
1968-11-29,SDR,89,10,11,CHI,110,8,15,18,26
1968-11-30,PHL,113,12,5,BOS,117,14,6,26,11
1968-11-30,CIN,109,13,7,ATL,126,11,12,24,19
1968-11-30,NYK,120,8,13,DET,108,10,11,18,24
1968-11-30,SFW,101,11,9,MIL,107,5,15,16,24
1968-11-30,CHI,100,9,15,PHX,96,5,14,14,29
1968-12-01,LAL,119,14,7,MIL,112,6,15,20,22
1968-12-01,SDR,116,10,12,SFW,105,11,10,21,22
1968-12-01,BLT,110,17,6,CHI,100,10,15,27,21
1968-12-02,PHX,108,5,15,SEA,118,10,17,15,32
1968-12-03,BLT,127,18,6,CIN,129,13,8,31,14
1968-12-03,SFW,127,11,11,SEA,122,11,17,22,28
1968-12-03,MIL,115,6,16,BOS,137,15,6,21,22
1968-12-03,LAL,122,15,7,PHX,108,5,16,20,23
1968-12-03,CHI,103,10,16,SDR,108,11,12,21,28
1968-12-03,NYK,126,9,13,ATL,93,12,12,21,25
1968-12-04,ATL,113,12,13,NYK,121,10,13,22,26
1968-12-04,DET,106,10,12,BLT,112,18,7,28,19
1968-12-04,BOS,101,16,6,MIL,99,6,17,22,23
1968-12-04,PHL,110,12,6,SDR,99,12,12,24,18
1968-12-04,PHX,126,5,17,SFW,97,12,11,17,28
1968-12-05,CHI,92,10,17,PHL,109,13,6,23,23
1968-12-05,BLT,108,19,7,LAL,90,16,7,35,14
1968-12-06,BOS,132,17,6,DET,118,10,13,27,19
1968-12-06,MIL,112,6,18,PHL,121,14,6,20,24
1968-12-06,SDR,117,12,13,PHX,106,6,17,18,30
1968-12-06,SEA,109,11,18,SFW,100,12,12,23,30
1968-12-06,ATL,94,12,14,LAL,99,16,8,28,22
1968-12-07,CIN,114,14,8,BOS,117,18,6,32,14
1968-12-07,NYK,119,11,13,MIL,113,6,19,17,32
1968-12-07,SFW,107,12,13,SEA,115,12,18,24,31
1968-12-07,PHL,140,15,6,DET,106,10,14,25,20
1968-12-07,CHI,90,10,18,LAL,81,17,8,27,26
1968-12-08,LAL,132,17,9,SDR,118,13,13,30,22
1968-12-08,PHL,122,16,6,MIL,117,6,20,22,26
1968-12-08,CIN,120,14,9,NYK,115,12,13,26,22
1968-12-08,PHX,99,6,18,ATL,121,12,15,18,33
1968-12-10,SDR,132,13,14,PHL,120,17,6,30,20
1968-12-10,NYK,111,12,14,PHX,106,6,19,18,33
1968-12-10,BOS,101,19,6,BLT,115,20,7,39,13
1968-12-10,SFW,100,12,14,ATL,111,13,15,25,29
1968-12-10,MIL,96,6,21,CIN,107,15,9,21,30
1968-12-10,CHI,100,11,18,DET,83,10,15,21,33
1968-12-11,PHL,143,17,7,PHX,123,6,20,23,27
1968-12-11,CIN,116,16,9,SDR,110,14,14,30,23
1968-12-11,BLT,118,21,7,NYK,110,13,14,34,21
1968-12-11,DET,106,10,16,BOS,108,19,7,29,23
1968-12-11,MIL,106,6,22,SFW,96,12,15,18,37
1968-12-12,SEA,91,13,18,ATL,93,14,15,27,33
1968-12-13,CIN,130,17,9,PHX,123,6,21,23,30
1968-12-13,LAL,103,18,9,ATL,105,15,15,33,24
1968-12-13,BOS,98,20,7,SFW,108,12,16,32,23
1968-12-13,MIL,101,7,22,SDR,96,14,15,21,37
1968-12-13,CHI,83,12,18,NYK,94,13,15,25,33
1968-12-14,SEA,120,13,19,LAL,136,18,10,31,29
1968-12-14,DET,118,10,17,PHX,123,6,22,16,39
1968-12-14,CIN,121,18,9,MIL,115,8,22,26,31
1968-12-14,NYK,112,14,15,SDR,105,14,16,28,31
1968-12-14,BLT,110,22,7,BOS,101,20,8,42,15
1968-12-14,PHL,137,18,7,SFW,91,13,16,31,23
1968-12-15,LAL,115,19,10,SEA,114,13,20,32,30
1968-12-15,PHL,110,19,7,NYK,104,15,15,34,22
1968-12-15,CIN,119,19,9,PHX,101,7,22,26,31
1968-12-17,PHX,128,7,23,PHL,145,20,7,27,30
1968-12-17,LAL,112,20,10,CIN,108,20,9,40,19
1968-12-17,NYK,114,15,16,SFW,99,13,17,28,33
1968-12-17,CHI,83,12,19,ATL,87,16,15,28,34
1968-12-18,ATL,122,17,15,MIL,116,8,23,25,38
1968-12-18,PHX,123,7,24,CIN,114,20,10,27,34
1968-12-18,DET,124,10,18,SDR,112,14,17,24,35
1968-12-18,SEA,111,13,21,PHL,115,21,7,34,28
1968-12-18,BLT,109,23,7,SFW,100,13,18,36,25
1968-12-18,BOS,98,20,9,NYK,104,16,16,36,25
1968-12-19,CHI,113,12,20,MIL,111,8,24,20,44
1968-12-20,SDR,109,14,18,PHL,116,22,7,36,25
1968-12-20,BLT,125,24,7,CHI,102,13,20,37,27
1968-12-20,LAL,133,21,10,SFW,101,13,19,34,29
1968-12-20,MIL,100,8,25,SEA,92,13,22,21,47
1968-12-20,DET,87,11,18,NYK,135,17,16,28,34
1968-12-21,SDR,132,14,19,CIN,124,20,11,34,30
1968-12-21,BLT,131,25,7,PHX,117,8,24,33,31
1968-12-21,ATL,120,18,15,DET,110,11,19,29,34
1968-12-21,NYK,131,18,16,SEA,105,13,23,31,39
1968-12-21,CHI,94,13,21,BOS,102,20,10,33,31
1968-12-21,SFW,109,13,20,PHL,94,23,7,36,27
1968-12-22,MIL,127,9,25,PHX,116,8,25,17,50
1968-12-22,LAL,102,22,10,PHL,99,23,8,45,18
1968-12-23,SDR,95,15,19,SFW,125,14,20,29,39
1968-12-25,MIL,113,10,25,DET,119,11,20,21,45
1968-12-25,BLT,118,26,7,SEA,112,13,24,39,31
1968-12-25,NYK,110,19,16,PHL,109,23,9,42,25
1968-12-25,PHX,99,8,26,LAL,119,23,10,31,36
1968-12-25,CIN,103,20,12,CHI,98,13,22,33,34
1968-12-26,PHL,125,23,10,BLT,120,27,7,50,17
1968-12-26,SFW,119,15,20,PHX,118,8,27,23,47
1968-12-26,BOS,139,21,10,MIL,106,10,26,31,36
1968-12-26,CHI,104,13,23,CIN,96,21,12,34,35
1968-12-26,ATL,126,19,15,SEA,96,13,25,32,40
1968-12-26,DET,94,12,20,LAL,95,24,10,36,30
1968-12-27,BLT,136,27,8,MIL,122,10,27,37,35
1968-12-27,SDR,109,15,20,NYK,111,20,16,35,36
1968-12-28,PHX,126,8,28,SDR,136,15,21,23,49
1968-12-28,CIN,123,21,13,PHL,128,24,10,45,23
1968-12-28,SEA,108,13,26,NYK,111,21,16,34,42
1968-12-28,DET,131,12,21,SFW,102,16,20,28,41
1968-12-28,ATL,110,20,15,BOS,97,22,10,42,25
1968-12-28,CHI,93,14,23,LAL,86,25,10,39,33
1968-12-29,NYK,120,22,16,SEA,112,13,27,35,43
1968-12-29,LAL,111,25,11,DET,108,13,21,38,32
1968-12-29,ATL,101,21,15,BLT,99,28,8,49,23
1968-12-29,MIL,97,10,28,CHI,102,15,23,25,51
1968-12-30,SDR,126,16,21,LAL,131,26,11,42,32
1968-12-30,SEA,120,13,28,PHX,118,8,29,21,57
1968-12-30,CHI,103,16,23,SFW,97,16,21,32,44
1968-12-31,BOS,112,22,11,CIN,114,21,14,43,25
1968-12-31,NYK,121,23,16,BLT,110,28,9,51,25
1968-12-31,LAL,107,27,11,DET,127,13,22,40,33
1968-12-31,MIL,107,10,29,PHL,128,25,10,35,39
1969-01-01,CIN,101,22,14,SFW,106,16,22,38,36
1969-01-01,PHX,87,8,30,BOS,93,22,12,30,42
1969-01-02,MIL,109,10,30,CIN,113,22,15,32,45
1969-01-02,SDR,95,16,22,BOS,107,23,12,39,34
1969-01-02,CHI,88,17,23,ATL,106,22,15,39,38
1969-01-03,CIN,125,23,15,BLT,130,28,10,51,25
1969-01-03,DET,106,14,22,ATL,128,23,15,37,37
1969-01-03,MIL,121,10,31,PHX,104,8,31,18,62
1969-01-03,SFW,104,17,22,BOS,102,24,12,41,34
1969-01-03,PHL,130,26,10,LAL,101,27,12,53,22
1969-01-04,BLT,117,29,10,PHL,112,27,10,56,20
1969-01-04,ATL,111,24,15,LAL,121,27,13,51,28
1969-01-04,SDR,122,16,23,SEA,105,14,28,30,51
1969-01-04,NYK,111,24,16,DET,103,14,23,38,39
1969-01-04,CHI,103,17,24,PHX,92,8,32,25,56
1969-01-05,PHL,126,27,11,DET,119,14,24,41,35
1969-01-05,ATL,97,24,16,PHX,96,8,33,32,49
1969-01-05,SFW,86,18,22,BOS,134,24,13,42,35
1969-01-06,CIN,106,23,16,CHI,104,18,24,41,40
1969-01-06,SEA,97,14,29,BOS,121,25,13,39,42
1969-01-07,DET,117,14,25,PHL,114,28,11,42,36
1969-01-07,PHX,116,8,34,SEA,112,14,30,22,64
1969-01-07,SFW,108,18,23,SDR,113,17,23,35,46
1969-01-07,CHI,102,18,25,NYK,101,25,16,43,41
1969-01-07,CIN,101,24,16,MIL,116,11,31,35,47
1969-01-07,BLT,93,30,10,LAL,100,28,13,58,23
1969-01-08,PHL,112,28,12,ATL,111,25,16,53,28
1969-01-08,SDR,107,18,23,BLT,108,30,11,48,34
1969-01-08,BOS,113,26,13,DET,104,15,25,41,38
1969-01-08,MIL,101,12,31,NYK,115,25,17,37,48
1969-01-09,PHX,120,9,34,NYK,134,26,17,35,51
1969-01-09,CIN,110,24,17,SEA,119,14,31,38,48
1969-01-10,SDR,104,18,24,BLT,106,31,11,49,35
1969-01-10,MIL,115,12,32,SEA,104,15,31,27,63
1969-01-10,ATL,104,25,17,DET,101,15,26,40,43
1969-01-10,BOS,88,27,13,LAL,82,29,13,56,26
1969-01-11,DET,118,15,27,CIN,115,24,18,39,45
1969-01-11,PHX,107,9,35,BLT,118,32,11,41,46
1969-01-11,PHL,101,29,12,BOS,111,28,13,57,25
1969-01-11,ATL,104,26,17,LAL,100,29,14,55,31
1969-01-11,CHI,119,19,25,SEA,86,15,32,34,57
1969-01-11,SFW,77,18,24,NYK,85,27,17,45,41
1969-01-12,CIN,111,24,19,DET,113,16,27,40,46
1969-01-12,MIL,114,13,32,BOS,110,29,13,42,45
1969-01-12,SDR,102,18,25,NYK,105,28,17,46,42
1969-01-16,CIN,120,24,20,SDR,109,18,26,42,46
1969-01-16,ATL,112,27,17,PHX,107,9,36,36,53
1969-01-16,CHI,99,20,25,SFW,112,18,25,38,50
1969-01-17,PHL,129,29,13,SDR,124,18,27,47,40
1969-01-17,DET,123,17,27,MIL,108,14,32,31,59
1969-01-17,ATL,112,28,17,PHX,107,9,37,37,54
1969-01-17,LAL,128,29,15,CIN,107,25,20,54,35
1969-01-17,BOS,102,29,14,SFW,99,19,25,48,39
1969-01-17,NYK,114,29,17,SEA,94,15,33,44,50
1969-01-18,NYK,117,30,17,MIL,109,14,33,44,50
1969-01-18,CHI,107,20,26,SDR,102,18,28,38,54
1969-01-18,BOS,111,30,14,SEA,97,15,34,45,48
1969-01-19,PHX,118,9,38,SDR,136,18,29,27,67
1969-01-19,LAL,132,30,15,CIN,117,25,21,55,36
1969-01-19,DET,120,18,27,CHI,111,21,26,39,53
1969-01-19,PHL,97,30,13,SFW,98,19,26,49,39
1969-01-19,ATL,100,29,17,NYK,96,31,17,60,34
1969-01-20,BLT,122,33,11,BOS,109,31,14,64,25
1969-01-20,MIL,102,14,34,DET,101,19,27,33,61
1969-01-21,SDR,124,19,29,ATL,113,30,17,49,46
1969-01-21,SFW,107,20,26,CIN,113,25,22,45,48
1969-01-21,NYK,113,31,18,SEA,106,15,35,46,53
1969-01-21,MIL,105,15,34,LAL,122,31,15,46,49
1969-01-21,CHI,93,21,27,BLT,116,34,11,55,38
1969-01-22,PHL,140,30,14,NYK,137,32,18,62,32
1969-01-22,DET,116,19,28,LAL,115,32,15,51,43
1969-01-22,PHX,107,9,39,ATL,125,30,18,39,57
1969-01-22,CHI,95,21,28,BOS,94,31,15,52,43
1969-01-22,BLT,94,35,11,SEA,98,15,36,50,47
1969-01-24,BOS,111,31,16,PHL,120,31,14,62,30
1969-01-24,SFW,114,20,27,SDR,107,20,29,40,56
1969-01-24,DET,107,20,28,NYK,106,32,19,52,47
1969-01-24,ATL,110,31,18,LAL,106,32,16,63,34
1969-01-24,PHX,117,9,40,CHI,106,22,28,31,68
1969-01-25,SDR,133,20,30,PHX,120,10,40,30,70
1969-01-25,BLT,109,35,12,ATL,112,32,18,67,30
1969-01-25,PHL,124,32,14,DET,106,21,28,53,42
1969-01-25,NYK,113,32,20,MIL,96,15,35,47,55
1969-01-26,ATL,115,33,18,PHL,119,33,14,66,32
1969-01-26,CIN,113,26,22,LAL,126,32,17,58,39
1969-01-26,SDR,111,21,30,CHI,95,22,29,43,59
1969-01-26,PHX,93,10,41,SFW,117,21,27,31,68
1969-01-26,BOS,124,31,17,BLT,86,35,13,66,30
1969-01-27,SEA,128,16,36,MIL,107,15,36,31,72
1969-01-27,BLT,126,35,14,DET,106,21,29,56,43
1969-01-28,LAL,125,33,17,CHI,118,22,30,55,47
1969-01-28,CIN,100,26,23,SFW,107,22,27,48,50
1969-01-28,BOS,108,32,17,ATL,96,33,19,65,36
1969-01-28,NYK,121,33,20,PHL,88,34,14,67,34
1969-01-29,DET,126,21,30,SFW,133,23,27,44,57
1969-01-29,SEA,124,17,36,BOS,122,33,17,50,53
1969-01-29,SDR,120,22,30,LAL,122,34,17,56,47
1969-01-29,PHX,111,10,42,MIL,107,15,37,25,79
1969-01-29,PHL,119,34,15,ATL,96,33,20,67,35
1969-01-30,DET,144,21,31,SEA,118,18,36,39,67
1969-01-30,CIN,116,26,24,PHL,115,35,15,61,39
1969-01-30,BLT,106,36,14,NYK,109,34,20,70,34
1969-01-30,SFW,101,24,27,CHI,111,22,31,46,58
1969-01-31,ATL,112,33,21,SEA,119,18,37,51,58
1969-01-31,PHL,105,35,16,BLT,108,36,15,71,31
1969-01-31,LAL,105,35,17,MIL,104,15,38,50,55
1969-01-31,CHI,102,23,31,DET,103,22,31,45,62
1969-01-31,BOS,116,33,18,CIN,101,27,24,60,42
1969-02-01,SFW,101,24,28,LAL,106,36,17,60,45
1969-02-01,ATL,119,33,22,DET,99,23,31,56,53
1969-02-01,CIN,111,27,25,SEA,96,19,37,46,62
1969-02-01,SDR,101,22,31,MIL,95,15,39,37,70
1969-02-01,NYK,109,35,20,BOS,82,34,18,69,38
1969-02-02,PHX,122,11,42,MIL,121,15,40,26,82
1969-02-02,LAL,117,37,17,SFW,122,24,29,61,46
1969-02-02,DET,106,23,32,BLT,128,37,15,60,47
1969-02-02,PHL,112,35,17,CHI,104,23,32,58,49
1969-02-02,ATL,115,34,22,SDR,103,23,31,57,53
1969-02-02,BOS,94,34,19,NYK,95,36,20,70,39
1969-02-03,BLT,132,38,15,CHI,122,23,33,61,48
1969-02-03,SEA,114,19,38,LAL,107,37,18,56,56
1969-02-04,SDR,135,23,32,BOS,126,34,20,57,52
1969-02-04,PHX,125,12,42,PHL,116,36,17,48,59
1969-02-04,CIN,125,28,25,DET,114,23,33,51,58
1969-02-04,SFW,111,25,29,SEA,116,20,38,45,67
1969-02-04,CHI,98,23,34,MIL,107,15,41,38,75
1969-02-04,NYK,122,37,20,ATL,97,35,22,72,42
1969-02-05,SEA,115,21,38,PHL,119,36,18,57,56
1969-02-05,BLT,124,39,15,BOS,112,34,21,73,36
1969-02-05,DET,108,23,34,CHI,120,23,35,46,69
1969-02-05,MIL,102,16,41,NYK,111,38,20,54,61
1969-02-05,SDR,110,24,32,CIN,93,29,25,53,57
1969-02-06,PHX,103,13,42,CIN,124,29,26,42,68
1969-02-07,SDR,130,25,32,PHX,119,13,43,38,75
1969-02-07,BOS,107,34,22,ATL,109,35,23,69,45
1969-02-07,MIL,107,16,42,BLT,114,40,15,56,57
1969-02-07,LAL,106,37,19,PHL,109,37,18,74,37
1969-02-07,CHI,98,24,35,NYK,105,39,20,63,55
1969-02-07,SEA,102,21,39,CIN,97,30,26,51,65
1969-02-08,DET,123,23,35,SDR,119,26,32,49,67
1969-02-08,SFW,116,25,30,CIN,117,30,27,55,57
1969-02-08,PHX,104,13,44,LAL,122,37,20,50,64
1969-02-08,ATL,106,36,23,CHI,97,24,36,60,59
1969-02-09,SEA,120,22,39,SFW,121,25,31,47,70
1969-02-09,BOS,122,34,23,PHL,117,38,18,72,41
1969-02-09,LAL,134,38,20,PHX,116,13,45,51,65
1969-02-09,MIL,117,16,43,SDR,109,26,33,42,76
1969-02-09,ATL,101,37,23,BLT,102,41,15,78,38
1969-02-11,CHI,116,24,37,BLT,124,42,15,66,52
1969-02-11,CIN,112,31,27,PHL,129,38,19,69,46
1969-02-11,ATL,87,37,24,SFW,92,26,31,63,55
1969-02-12,CIN,114,31,28,SDR,118,26,34,57,62
1969-02-12,BLT,120,43,15,SFW,110,27,31,70,46
1969-02-12,DET,106,24,35,BOS,113,35,23,59,58
1969-02-12,MIL,106,17,43,ATL,113,37,25,54,68
1969-02-12,NYK,112,40,20,PHX,105,13,46,53,66
1969-02-12,SEA,92,22,40,LAL,109,39,20,61,60
1969-02-13,CHI,120,24,38,DET,101,24,36,48,74
1969-02-14,DET,128,24,37,PHX,123,13,47,37,84
1969-02-14,BLT,132,44,15,MIL,122,17,44,61,59
1969-02-14,PHL,111,39,19,SFW,127,27,32,66,51
1969-02-14,LAL,115,40,20,SDR,109,27,34,67,54
1969-02-14,ATL,104,38,25,BOS,101,36,23,74,48
1969-02-15,CHI,101,25,38,CIN,111,31,29,56,67
1969-02-15,NYK,98,41,20,SFW,92,28,32,69,52
1969-02-16,SEA,127,22,41,DET,119,25,37,47,78
1969-02-16,CIN,113,32,29,PHX,125,13,48,45,77
1969-02-16,ATL,106,39,25,SFW,113,28,33,67,58
1969-02-16,PHL,127,39,20,BOS,102,36,24,75,44
1969-02-16,MIL,106,17,45,LAL,97,41,20,58,65
1969-02-17,BLT,112,45,15,CIN,117,32,30,77,45
1969-02-17,MIL,123,18,45,ATL,111,39,26,57,71
1969-02-18,CIN,123,33,30,ATL,124,39,27,72,57
1969-02-18,SFW,121,29,33,DET,114,25,38,54,71
1969-02-18,SEA,114,23,41,CHI,113,25,39,48,80
1969-02-18,SDR,113,27,35,PHL,125,40,20,67,55
1969-02-18,BOS,116,36,25,PHX,110,14,48,50,73
1969-02-18,NYK,109,42,20,LAL,113,41,21,83,41
1969-02-19,SEA,124,24,41,DET,131,25,39,49,80
1969-02-19,SFW,134,30,33,PHL,117,41,20,71,53
1969-02-19,CIN,110,33,31,NYK,100,42,21,75,52
1969-02-19,BLT,110,45,16,LAL,88,42,21,87,37
1969-02-20,BLT,124,46,16,PHX,121,14,49,60,65
1969-02-20,SDR,118,27,36,SFW,128,31,33,58,69
1969-02-20,DET,87,26,39,ATL,97,40,27,66,66
1969-02-21,PHX,121,14,50,CHI,133,25,40,39,90
1969-02-21,SEA,109,24,42,PHL,115,41,21,65,63
1969-02-21,LAL,102,42,22,BOS,124,37,25,79,47
1969-02-22,SFW,122,32,33,PHL,129,42,21,74,54
1969-02-22,DET,107,26,40,MIL,108,19,45,45,85
1969-02-22,NYK,104,42,22,SDR,108,27,37,69,59
1969-02-22,PHX,100,14,51,BOS,124,38,25,52,76
1969-02-23,LAL,121,42,23,PHL,125,43,21,85,44
1969-02-23,SEA,118,24,43,BOS,116,39,25,63,68
1969-02-23,CIN,109,34,31,BLT,126,47,16,81,47
1969-02-23,MIL,107,20,45,PHX,103,14,52,34,97
1969-02-23,ATL,124,41,27,SDR,92,28,37,69,64
1969-02-24,BLT,123,48,16,DET,119,26,41,74,57
1969-02-24,SFW,108,32,34,CHI,119,26,40,58,74
1969-02-25,CIN,119,34,32,PHL,120,44,21,78,53
1969-02-25,MIL,114,21,45,SDR,112,28,38,49,83
1969-02-25,LAL,114,42,24,SEA,111,25,43,67,67
1969-02-25,NYK,122,42,23,ATL,101,42,27,84,50
1969-02-25,SFW,101,32,35,CHI,99,27,40,59,75
1969-02-25,BOS,112,39,26,PHX,99,14,53,53,79
1969-02-26,SEA,122,25,44,CHI,124,27,41,52,85
1969-02-26,PHL,104,45,21,PHX,97,14,54,59,75
1969-02-26,BOS,88,40,26,NYK,92,43,23,83,49
1969-02-27,DET,126,26,42,PHL,123,46,21,72,63
1969-02-27,MIL,126,22,45,BLT,117,49,16,71,61
1969-02-27,SDR,127,28,39,CIN,112,34,33,62,72
1969-02-28,BOS,122,40,27,ATL,120,42,28,82,55
1969-02-28,LAL,121,43,24,PHX,117,14,55,57,79
1969-02-28,DET,116,27,42,BLT,134,49,17,76,59
1969-02-28,SFW,131,33,35,CIN,115,34,34,67,69
1969-02-28,PHL,123,46,22,MIL,102,23,45,69,67
1969-03-01,SEA,134,25,45,CIN,122,34,35,59,80
1969-03-01,SFW,118,34,35,PHX,119,14,56,48,91
1969-03-01,SDR,113,29,39,LAL,119,44,24,73,63
1969-03-01,NYK,115,44,23,BOS,96,41,27,85,50
1969-03-02,DET,112,27,43,PHL,126,47,22,74,65
1969-03-02,ATL,112,42,29,MIL,108,23,46,65,75
1969-03-02,BOS,99,41,28,CHI,92,28,41,69,69
1969-03-02,LAL,107,45,24,SFW,92,34,36,79,60
1969-03-03,MIL,132,23,47,PHL,143,48,22,71,69
1969-03-03,SEA,107,26,45,CIN,113,34,36,60,81
1969-03-04,PHX,122,15,56,CIN,141,35,36,50,92
1969-03-04,SEA,130,26,46,SDR,116,29,40,55,86
1969-03-04,CHI,114,28,42,PHL,113,49,22,77,64
1969-03-04,LAL,108,46,24,BLT,116,50,17,96,41
1969-03-04,NYK,102,45,23,DET,99,27,44,72,67
1969-03-04,SFW,99,34,37,BOS,95,42,28,76,65
1969-03-05,DET,128,27,45,NYK,120,46,23,73,68
1969-03-05,MIL,108,23,48,CHI,124,29,42,52,90
1969-03-05,SFW,114,35,37,BLT,107,51,17,86,54
1969-03-06,CHI,125,30,42,PHX,117,15,57,45,99
1969-03-06,MIL,110,23,49,CIN,112,36,36,59,85
1969-03-06,ATL,138,43,29,PHL,99,49,23,92,52
1969-03-06,SDR,110,29,41,BOS,97,42,29,71,70
1969-03-07,SFW,135,36,37,BLT,130,51,18,87,55
1969-03-07,PHL,131,49,24,CHI,113,31,42,80,66
1969-03-07,DET,114,28,45,CIN,105,37,36,65,81
1969-03-07,LAL,105,46,25,BOS,99,42,30,88,55
1969-03-07,NYK,119,46,24,PHX,87,15,58,61,82
1969-03-08,SEA,138,27,46,BLT,117,51,19,78,65
1969-03-09,PHX,146,15,59,SDR,133,30,41,45,100
1969-03-09,DET,121,29,45,MIL,126,23,50,52,95
1969-03-09,LAL,120,47,25,BLT,109,51,20,98,45
1969-03-09,ATL,134,44,29,CIN,107,37,37,81,66
1969-03-09,PHL,110,50,24,NYK,101,47,24,97,48
1969-03-09,BOS,138,42,31,SFW,89,37,37,79,68
1969-03-10,PHX,121,16,59,BLT,140,51,21,67,80
1969-03-10,MIL,106,24,50,SFW,123,37,38,61,88
1969-03-11,SDR,116,30,42,PHX,106,16,60,46,102
1969-03-11,NYK,121,47,25,PHL,101,51,24,98,49
1969-03-11,LAL,137,48,25,DET,101,29,46,77,71
1969-03-11,CHI,102,31,43,ATL,90,45,29,76,72
1969-03-12,PHL,117,51,25,BOS,126,43,31,94,56
1969-03-12,SEA,125,28,46,SDR,112,31,42,59,88
1969-03-12,BLT,111,52,21,NYK,110,48,25,100,46
1969-03-12,ATL,109,45,30,CHI,90,32,43,77,73
1969-03-12,SFW,97,38,38,LAL,85,49,25,87,63
1969-03-13,MIL,118,24,51,SEA,141,29,46,53,97
1969-03-13,CIN,120,37,38,BOS,110,44,31,81,69
1969-03-13,CHI,106,32,44,PHL,113,51,26,83,70
1969-03-13,SDR,120,31,43,DET,105,29,47,60,90
1969-03-14,CIN,128,38,38,BLT,130,53,21,91,59
1969-03-14,SFW,114,39,38,DET,110,29,48,68,86
1969-03-14,LAL,111,49,26,MIL,103,24,52,73,78
1969-03-15,PHX,124,16,61,SDR,141,32,43,48,104
1969-03-15,PHL,122,52,26,ATL,120,46,30,98,56
1969-03-15,NYK,121,48,26,CIN,108,38,39,86,65
1969-03-15,BLT,99,54,21,BOS,98,44,32,98,53
1969-03-15,CHI,101,32,45,SEA,83,30,46,62,91
1969-03-16,ATL,131,46,31,SEA,127,30,47,76,78
1969-03-16,SDR,120,33,43,DET,111,29,49,62,92
1969-03-16,BOS,73,44,33,LAL,108,50,26,94,59
1969-03-17,PHX,95,16,62,DET,119,29,50,45,112
1969-03-18,BLT,130,55,21,SEA,120,30,48,85,69
1969-03-18,SFW,115,40,38,ATL,128,47,31,87,69
1969-03-18,SDR,128,34,43,MIL,108,24,53,58,96
1969-03-18,CHI,92,33,45,LAL,93,51,26,84,71
1969-03-19,CIN,136,38,40,LAL,128,52,26,90,66
1969-03-19,PHL,136,53,26,SEA,115,30,49,83,75
1969-03-19,PHX,110,16,63,MIL,117,24,54,40,117
1969-03-19,NYK,104,49,26,BLT,100,56,21,105,47
1969-03-19,BOS,104,44,34,CHI,92,33,46,77,80
1969-03-20,SDR,115,35,43,ATL,97,48,31,83,74
1969-03-21,CIN,119,39,40,BOS,145,45,34,84,74
1969-03-21,DET,110,30,50,SEA,104,30,50,60,100
1969-03-21,PHX,104,16,64,NYK,139,50,26,66,90
1969-03-21,CHI,103,33,47,BLT,115,56,22,89,69
1969-03-21,LAL,116,52,27,ATL,103,48,32,100,59
1969-03-21,SFW,103,40,39,MIL,100,25,54,65,93
1969-03-22,CIN,134,39,41,SEA,127,30,51,69,92
1969-03-22,BLT,108,57,22,PHL,116,54,26,111,48
1969-03-22,SDR,106,36,43,MIL,120,25,55,61,98
1969-03-22,SFW,90,41,39,NYK,117,51,26,92,65
1969-03-23,SDR,128,36,44,ATL,121,48,33,84,77
1969-03-23,PHX,118,16,65,MIL,128,26,55,42,120
1969-03-23,DET,158,31,50,CHI,114,33,48,64,98
1969-03-23,LAL,128,53,27,NYK,111,52,26,105,53
1969-03-23,BOS,126,46,34,BLT,98,57,23,103,57
1969-03-24,PHL,119,55,26,CIN,125,40,41,95,67
1969-03-24,BOS,111,47,34,SDR,107,37,44,84,78
1969-10-15,ATL,124,0,0,SEA,119,0,0,0,0
1969-10-15,BLT,98,0,0,CHI,93,0,0,0,0
1969-10-15,CIN,89,0,0,NYK,94,0,0,0,0
1969-10-16,PHX,116,0,0,SDR,114,0,0,0,0
1969-10-17,PHL,131,0,0,LAL,126,0,0,0,0
1969-10-17,BOS,108,0,0,CIN,110,0,1,0,1
1969-10-17,CHI,87,0,1,NYK,116,1,0,1,1
1969-10-18,CHI,131,0,2,SEA,126,0,1,0,3
1969-10-18,SFW,124,0,0,SDR,125,0,1,0,1
1969-10-18,CIN,123,1,1,PHL,134,1,0,2,1
1969-10-18,BLT,124,1,0,BOS,117,0,1,1,1
1969-10-18,ATL,121,1,0,PHX,116,1,0,2,0
1969-10-18,MIL,119,0,0,DET,110,0,0,0,0
1969-10-18,NYK,99,2,0,LAL,96,0,1,2,1
1969-10-19,MIL,130,1,0,SEA,106,0,2,1,2
1969-10-21,BLT,137,2,0,LAL,142,0,2,2,2
1969-10-21,DET,98,0,1,BOS,97,0,2,0,3
1969-10-22,PHL,122,2,0,PHX,119,1,1,3,1
1969-10-22,CIN,109,1,2,LAL,116,1,2,2,4
1969-10-22,SDR,102,1,1,MIL,115,2,0,3,1
1969-10-22,ATL,93,2,0,SFW,94,0,1,2,1
1969-10-23,NYK,109,3,0,SFW,112,1,1,4,1
1969-10-24,BLT,131,2,1,CIN,126,1,3,3,4
1969-10-24,PHX,115,1,2,CHI,116,1,2,2,4
1969-10-24,LAL,123,2,2,MIL,112,3,0,5,2
1969-10-24,BOS,110,0,3,ATL,122,2,1,2,4
1969-10-24,DET,92,1,1,NYK,116,3,1,4,2
1969-10-25,SDR,107,1,2,PHX,115,1,3,2,5
1969-10-25,SEA,106,0,3,LAL,130,3,2,3,5
1969-10-25,SFW,118,2,1,MIL,104,3,1,5,2
1969-10-25,ATL,104,3,1,DET,125,1,2,4,3
1969-10-25,NYK,128,4,1,BLT,99,3,1,7,2
1969-10-25,PHL,98,3,0,CIN,109,1,4,4,4
1969-10-26,LAL,129,4,2,CHI,125,2,2,6,4
1969-10-26,PHX,99,2,3,MIL,119,3,2,5,5
1969-10-28,SEA,114,0,4,CHI,116,2,3,2,7
1969-10-28,DET,110,2,2,BLT,125,3,2,5,4
1969-10-28,MIL,107,4,2,BOS,120,0,4,4,6
1969-10-29,ATL,117,3,2,SDR,113,1,3,4,5
1969-10-29,BLT,105,4,2,PHL,129,3,1,7,3
1969-10-29,SFW,87,3,1,CHI,101,3,3,6,4
1969-10-30,NYK,123,5,1,SDR,110,1,4,6,5
1969-10-30,PHX,106,2,4,CIN,104,2,4,4,8
1969-10-30,DET,81,2,3,MIL,102,4,3,6,6
1969-10-31,PHL,125,4,1,MIL,129,5,3,9,4
1969-10-31,SEA,129,0,5,CIN,121,2,5,2,10
1969-10-31,BOS,118,1,4,SDR,113,1,5,2,9
1969-10-31,CHI,118,4,3,BLT,109,4,3,8,6
1969-11-01,BLT,137,4,4,ATL,140,4,2,8,6
1969-11-01,PHL,123,4,2,BOS,131,2,4,6,6
1969-11-01,DET,130,2,4,SDR,113,1,6,3,10
1969-11-01,SFW,120,3,2,CIN,97,2,6,5,8
1969-11-02,LAL,116,5,2,CIN,124,2,7,7,9
1969-11-02,ATL,125,5,2,SEA,113,1,5,6,7
1969-11-03,MIL,93,6,3,NYK,109,6,1,12,4
1969-11-04,PHL,113,4,3,CHI,109,5,3,9,6
1969-11-04,BLT,124,4,5,SFW,105,4,2,8,7
1969-11-04,DET,102,3,4,SEA,116,1,6,4,10
1969-11-04,PHX,99,3,4,NYK,116,7,1,10,5
1969-11-05,PHL,130,5,3,BLT,139,5,5,10,8
1969-11-05,ATL,128,6,2,BOS,121,3,4,9,6
1969-11-05,CIN,133,3,7,SDR,120,1,7,4,14
1969-11-06,CHI,137,5,4,ATL,142,7,2,12,6
1969-11-06,CIN,109,4,7,SFW,130,4,3,8,10
1969-11-07,DET,134,3,5,PHL,128,5,4,8,9
1969-11-07,LAL,120,5,3,PHX,122,3,5,8,8
1969-11-07,BLT,126,6,5,SEA,112,2,6,8,11
1969-11-07,SDR,111,1,8,NYK,129,8,1,9,9
1969-11-07,BOS,110,3,5,SFW,111,5,3,8,8
1969-11-08,CIN,130,4,8,BLT,121,7,5,11,13
1969-11-08,PHL,117,5,5,SEA,125,2,7,7,12
1969-11-08,MIL,100,6,4,DET,96,4,5,10,9
1969-11-08,ATL,106,8,2,SFW,93,6,3,14,5
1969-11-08,CHI,103,5,5,BOS,87,3,6,8,11
1969-11-09,PHX,140,4,5,DET,129,4,6,8,11
1969-11-09,MIL,105,7,4,BLT,116,7,6,14,10
1969-11-09,LAL,102,5,4,NYK,112,9,1,14,5
1969-11-10,ATL,133,9,2,CHI,132,6,5,15,7
1969-11-10,SDR,100,1,9,SFW,99,6,4,7,13
1969-11-11,BOS,118,3,7,MIL,129,7,5,10,12
1969-11-11,ATL,124,10,2,PHL,107,5,6,15,8
1969-11-11,SFW,103,6,5,NYK,116,10,1,16,6
1969-11-11,LAL,102,5,5,DET,110,4,7,9,12
1969-11-11,CHI,106,6,6,SEA,100,3,7,9,13
1969-11-12,SDR,132,2,9,DET,119,5,7,7,16
1969-11-12,CIN,116,5,8,BOS,107,3,8,8,16
1969-11-13,SEA,117,3,8,DET,113,5,8,8,16
1969-11-13,PHX,110,5,5,PHL,124,5,7,10,12
1969-11-14,LAL,127,5,6,PHX,112,5,6,10,12
1969-11-14,SDR,148,3,9,SEA,112,4,8,7,17
1969-11-14,SFW,109,6,6,ATL,120,11,2,17,8
1969-11-14,BOS,108,3,9,BLT,109,8,6,11,15
1969-11-14,MIL,122,8,5,CHI,100,7,6,15,11
1969-11-15,SEA,146,4,9,PHL,136,6,7,10,16
1969-11-15,BLT,129,9,6,MIL,120,9,5,18,11
1969-11-15,SDR,133,4,9,ATL,118,12,2,16,11
1969-11-15,PHX,114,5,7,LAL,111,6,6,11,13
1969-11-15,CHI,124,7,7,SFW,105,6,7,13,14
1969-11-15,CIN,104,6,8,DET,105,5,9,11,17
1969-11-15,NYK,113,11,1,BOS,98,3,10,14,11
1969-11-16,LAL,138,6,7,PHL,125,6,8,12,15
1969-11-16,MIL,129,9,6,SFW,123,6,8,15,14
1969-11-16,PHX,139,6,7,ATL,118,12,3,18,10
1969-11-18,BLT,142,10,6,SDR,138,5,9,15,15
1969-11-18,BOS,120,3,11,PHX,119,7,7,10,18
1969-11-18,CHI,127,8,7,PHL,119,6,9,14,16
1969-11-18,DET,114,6,9,LAL,125,7,7,13,16
1969-11-18,SFW,127,6,9,MIL,110,10,6,16,15
1969-11-19,BLT,133,11,6,PHX,118,7,8,18,14
1969-11-19,PHL,116,6,10,SDR,125,5,10,11,20
1969-11-19,SEA,116,5,9,ATL,137,12,4,17,13
1969-11-19,BOS,122,4,11,CHI,106,9,7,13,18
1969-11-19,CIN,103,6,9,LAL,116,8,7,14,16
1969-11-21,CIN,133,6,10,CHI,119,9,8,15,18
1969-11-21,BLT,126,12,6,PHX,116,7,9,19,15
1969-11-21,SEA,115,5,10,MIL,117,10,7,15,17
1969-11-21,SFW,118,7,9,BOS,115,5,11,12,20
1969-11-21,DET,106,6,10,ATL,118,13,4,19,14
1969-11-21,LAL,100,9,7,SDR,98,6,10,15,17
1969-11-21,PHL,94,6,11,NYK,98,12,1,18,12
1969-11-22,SDR,125,6,11,BOS,116,5,12,11,23
1969-11-22,ATL,116,14,4,PHL,132,6,12,20,16
1969-11-22,NYK,128,13,1,PHX,114,7,10,20,11
1969-11-22,CHI,125,9,9,MIL,106,11,7,20,16
1969-11-22,SFW,98,8,9,LAL,106,10,7,18,16
1969-11-23,CIN,137,7,10,PHX,123,7,11,14,21
1969-11-23,SEA,116,5,11,BOS,125,5,13,10,24
1969-11-23,LAL,97,11,7,BLT,129,13,6,24,13
1969-11-24,SDR,112,7,11,SEA,105,5,12,12,23
1969-11-24,MIL,104,11,8,CIN,129,8,10,19,18
1969-11-25,PHX,124,7,12,BLT,134,14,6,21,18
1969-11-25,MIL,130,11,9,ATL,115,14,5,25,14
1969-11-25,SEA,106,5,13,SFW,114,8,10,13,23
1969-11-25,DET,104,6,11,CHI,103,10,9,16,20
1969-11-25,NYK,103,14,1,LAL,96,11,8,25,9
1969-11-26,SDR,125,8,11,SFW,126,9,10,17,21
1969-11-26,BOS,114,6,13,PHL,135,7,12,13,25
1969-11-26,DET,109,7,11,CHI,129,10,10,17,21
1969-11-26,ATL,108,14,6,NYK,138,15,1,29,7
1969-11-26,MIL,100,12,9,LAL,81,11,9,23,18
1969-11-27,SFW,116,10,10,BLT,118,15,6,25,16
1969-11-28,CHI,126,11,10,SDR,119,8,12,19,22
1969-11-28,LAL,108,11,10,SFW,114,10,11,21,21
1969-11-28,CIN,105,9,10,NYK,106,16,1,25,11
1969-11-28,BOS,105,6,14,ATL,130,14,7,20,21
1969-11-28,PHL,110,8,12,DET,91,7,12,15,24
1969-11-29,SEA,130,5,14,PHX,129,7,13,12,27
1969-11-29,ATL,128,15,7,CIN,111,9,11,24,18
1969-11-29,MIL,111,13,9,PHL,129,9,12,22,21
1969-11-29,BLT,106,16,6,BOS,121,6,15,22,21
1969-11-30,LAL,114,11,11,CHI,116,12,10,23,21
1969-11-30,PHX,116,7,14,SEA,108,6,14,13,28
1969-11-30,CIN,115,9,12,PHL,107,10,12,19,24
1969-11-30,MIL,111,13,10,SDR,99,8,13,21,23
1969-12-02,PHL,114,10,13,MIL,122,14,10,24,23
1969-12-02,PHX,121,8,14,CHI,110,13,10,21,24
1969-12-02,SFW,116,11,11,DET,109,7,13,18,24
1969-12-02,NYK,129,17,1,SEA,109,6,15,23,16
1969-12-02,BLT,129,16,7,CIN,107,10,12,26,19
1969-12-03,SDR,146,8,14,CHI,131,13,11,21,25
1969-12-03,CIN,117,10,13,SEA,118,6,16,16,29
1969-12-03,BOS,113,7,15,BLT,105,17,7,24,22
1969-12-03,SFW,102,12,11,DET,106,7,14,19,25
1969-12-04,ATL,119,16,7,SEA,111,7,16,23,23
1969-12-04,PHX,119,9,14,LAL,109,11,12,20,26
1969-12-05,CIN,156,10,14,ATL,127,17,7,27,21
1969-12-05,PHX,114,10,14,CHI,113,13,12,23,26
1969-12-05,LAL,128,11,13,DET,109,8,14,19,27
1969-12-05,SFW,112,12,12,SDR,107,9,14,21,26
1969-12-05,BLT,107,17,8,NYK,116,18,1,35,9
1969-12-05,BOS,104,8,15,PHL,105,10,14,18,29
1969-12-05,MIL,131,15,10,SEA,98,7,17,22,27
1969-12-06,SEA,132,7,18,BLT,129,17,9,24,27
1969-12-06,SDR,115,9,15,LAL,128,12,13,21,28
1969-12-06,CHI,116,13,13,BOS,114,8,16,21,29
1969-12-06,PHL,120,11,14,CIN,102,11,14,22,28
1969-12-06,NYK,124,19,1,MIL,99,16,10,35,11
1969-12-07,PHX,113,11,14,DET,118,8,15,19,29
1969-12-07,LAL,103,13,13,ATL,104,17,8,30,21
1969-12-08,BLT,125,17,10,CHI,122,14,13,31,23
1969-12-08,SDR,102,9,16,DET,111,9,15,18,31
1969-12-09,ATL,117,18,8,SFW,115,13,12,31,20
1969-12-09,SEA,109,8,18,DET,104,10,15,18,33
1969-12-09,CHI,109,14,14,PHX,102,11,15,25,29
1969-12-09,NYK,101,20,1,CIN,103,11,15,31,16
1969-12-09,PHL,123,12,14,LAL,99,13,14,25,28
1969-12-10,CIN,122,12,15,PHL,121,13,14,25,29
1969-12-10,SDR,126,9,17,ATL,107,19,8,28,25
1969-12-10,BLT,107,18,10,PHX,137,11,16,29,26
1969-12-10,BOS,111,8,17,LAL,99,13,15,21,32
1969-12-10,MIL,95,16,11,NYK,96,20,2,36,13
1969-12-11,DET,119,10,16,CIN,116,13,15,23,31
1969-12-11,SEA,112,9,18,NYK,105,21,2,30,20
1969-12-11,CHI,110,15,14,SFW,104,13,13,28,27
1969-12-12,SEA,116,10,18,PHX,130,12,16,22,34
1969-12-12,PHL,125,13,15,DET,111,11,16,24,31
1969-12-12,MIL,123,16,12,SFW,109,13,14,29,26
1969-12-12,CHI,108,16,14,BLT,123,18,11,34,25
1969-12-12,ATL,121,19,9,LAL,107,13,16,32,25
1969-12-12,BOS,107,9,17,SDR,104,10,17,19,34
1969-12-13,PHX,126,13,16,CIN,110,13,16,26,32
1969-12-13,BLT,117,19,11,SDR,105,10,18,29,29
1969-12-13,ATL,100,20,9,MIL,121,17,12,37,21
1969-12-13,DET,97,11,17,SFW,104,13,15,24,32
1969-12-14,PHX,130,14,16,CIN,137,13,17,27,33
1969-12-14,LAL,131,13,17,SEA,127,10,19,23,36
1969-12-14,PHL,126,14,15,CHI,121,16,15,30,30
1969-12-14,MIL,118,18,12,SDR,105,10,19,28,31
1969-12-16,NYK,124,21,3,ATL,125,20,10,41,13
1969-12-16,SFW,125,14,15,SEA,119,10,20,24,35
1969-12-16,PHX,119,14,17,PHL,141,15,15,29,32
1969-12-16,CHI,101,16,16,SDR,110,10,20,26,36
1969-12-16,BOS,117,10,17,DET,98,11,18,21,35
1969-12-17,ATL,133,21,10,BLT,138,20,11,41,21
1969-12-17,DET,107,11,19,SDR,114,11,20,22,39
1969-12-17,BOS,106,11,17,MIL,124,19,12,30,29
1969-12-17,SEA,117,10,21,CIN,104,14,17,24,38
1969-12-18,CHI,114,16,17,ATL,112,21,11,37,28
1969-12-19,SEA,123,11,21,PHL,116,16,15,27,36
1969-12-19,MIL,115,20,12,BOS,111,11,18,31,30
1969-12-19,SDR,119,12,20,SFW,111,15,15,27,35
1969-12-19,LAL,109,14,17,CIN,117,14,18,28,35
1969-12-19,BLT,108,21,11,DET,105,11,20,32,31
1969-12-19,CHI,99,17,17,NYK,108,21,4,38,21
1969-12-20,DET,114,11,21,PHX,113,14,18,25,39
1969-12-20,SDR,126,13,20,CIN,111,15,18,28,38
1969-12-20,SFW,109,15,16,PHL,122,16,16,31,32
1969-12-20,ATL,122,21,12,BOS,106,11,19,32,31
1969-12-20,NYK,128,22,4,BLT,91,22,11,44,15
1969-12-21,LAL,133,14,18,PHL,117,17,16,31,34
1969-12-21,ATL,118,22,12,CHI,111,17,18,39,30
1969-12-21,MIL,118,21,12,PHX,111,14,19,35,31
1969-12-21,SEA,112,12,21,SDR,96,14,20,26,41
1969-12-23,SFW,119,15,17,SEA,115,13,21,28,38
1969-12-23,BOS,117,11,20,CHI,112,17,19,28,39
1969-12-23,SDR,115,14,21,LAL,109,15,18,29,39
1969-12-25,CIN,120,15,19,SFW,124,16,17,31,36
1969-12-25,PHX,127,14,20,BOS,116,12,20,26,40
1969-12-25,BLT,121,22,12,PHL,113,17,17,39,29
1969-12-25,NYK,112,23,4,DET,111,12,21,35,25
1969-12-26,PHL,141,17,18,SFW,121,17,17,34,35
1969-12-26,SEA,112,13,22,BOS,122,12,21,25,43
1969-12-26,CIN,130,15,20,ATL,110,23,12,38,32
1969-12-26,LAL,114,15,19,NYK,106,24,4,39,23
1969-12-26,DET,101,12,22,MIL,114,22,12,34,34
1969-12-27,NYK,119,24,5,SEA,117,13,23,37,28
1969-12-27,BLT,147,23,12,SFW,112,17,18,40,30
1969-12-27,SDR,110,15,21,BOS,111,13,21,28,42
1969-12-27,CIN,112,16,20,MIL,110,23,12,39,32
1969-12-27,ATL,112,24,13,PHL,107,18,18,42,31
1969-12-28,MIL,133,23,13,BLT,124,24,12,47,25
1969-12-28,PHX,116,15,20,NYK,135,25,6,40,26
1969-12-28,PHL,138,18,19,SFW,112,17,19,35,38
1969-12-28,LAL,109,16,19,BOS,99,14,21,30,40
1969-12-29,ATL,122,25,13,SDR,118,15,22,40,35
1969-12-29,DET,103,12,23,CIN,110,17,20,29,43
1969-12-30,BLT,124,24,13,MIL,126,24,13,48,26
1969-12-30,SEA,134,13,24,PHX,121,15,21,28,45
1969-12-30,CIN,125,18,20,SDR,120,15,23,33,43
1969-12-30,SFW,105,17,20,LAL,100,17,19,34,39
1969-12-30,NYK,116,26,6,CHI,96,17,20,43,26
1969-12-31,MIL,143,25,13,SDR,126,15,24,40,37
1969-12-31,BOS,124,14,22,DET,121,12,24,26,46
1969-12-31,ATL,122,26,13,BLT,111,24,14,50,27
1969-12-31,PHL,129,19,19,CHI,109,17,21,36,40
1970-01-01,SEA,111,14,24,CHI,114,17,22,31,46
1970-01-02,PHX,121,15,22,SDR,120,15,25,30,47
1970-01-02,PHL,121,20,19,ATL,117,27,13,47,32
1970-01-02,BLT,118,24,15,CIN,116,19,20,43,35
1970-01-02,MIL,118,26,13,NYK,105,27,6,53,19
1970-01-02,LAL,125,17,20,SFW,95,18,20,35,40
1970-01-02,DET,92,12,25,BOS,110,15,22,27,47
1970-01-03,PHX,114,16,22,DET,109,12,26,28,48
1970-01-03,SEA,109,14,25,LAL,126,18,20,32,45
1970-01-03,NYK,104,27,7,BOS,111,16,22,43,29
1970-01-03,ATL,102,27,14,CIN,104,19,21,46,35
1970-01-03,SFW,116,18,21,CHI,102,18,22,36,43
1970-01-04,CIN,129,20,21,BLT,128,25,15,45,36
1970-01-04,MIL,125,27,13,ATL,126,27,15,54,28
1970-01-04,SDR,140,15,26,CHI,121,18,23,33,49
1970-01-04,PHL,130,21,19,BOS,120,17,22,38,41
1970-01-04,LAL,120,19,20,PHX,112,17,22,36,42
1970-01-04,DET,116,12,27,SEA,110,14,26,26,53
1970-01-05,SFW,118,19,21,DET,102,13,27,32,48
1970-01-06,CIN,128,21,21,PHX,124,17,23,38,44
1970-01-06,CHI,105,18,24,LAL,100,20,20,38,44
1970-01-06,BLT,99,25,16,NYK,129,27,8,52,24
1970-01-06,ATL,101,28,15,SEA,97,14,27,42,42
1970-01-07,MIL,138,27,14,CIN,119,22,21,49,35
1970-01-07,BLT,121,25,17,DET,116,13,28,38,45
1970-01-07,BOS,106,17,23,ATL,112,29,15,46,38
1970-01-07,SFW,94,20,21,NYK,99,28,8,48,29
1970-01-08,CHI,152,19,24,PHX,123,17,24,36,48
1970-01-08,SDR,120,16,26,SFW,103,20,22,36,48
1970-01-09,PHL,132,22,19,SEA,135,14,28,36,47
1970-01-09,BOS,130,17,24,BLT,142,26,17,43,41
1970-01-09,MIL,120,28,14,PHX,116,17,25,45,39
1970-01-09,ATL,112,30,15,LAL,127,20,21,50,36
1970-01-09,SFW,93,20,23,NYK,123,29,8,49,31
1970-01-10,DET,129,13,29,SEA,128,15,28,28,57
1970-01-10,PHX,119,17,26,PHL,117,22,20,39,46
1970-01-10,SDR,123,17,26,NYK,115,30,8,47,34
1970-01-10,CHI,116,20,24,LAL,112,21,21,41,45
1970-01-10,MIL,124,29,14,BOS,109,17,25,46,39
1970-01-10,BLT,130,27,17,ATL,109,30,16,57,33
1970-01-11,PHX,125,18,26,CIN,118,22,22,40,48
1970-01-12,NYK,130,30,9,PHX,114,19,26,49,35
1970-01-12,CHI,117,21,24,PHL,113,22,21,43,45
1970-01-12,DET,113,14,29,ATL,100,30,17,44,46
1970-01-13,SDR,126,18,26,BLT,144,28,17,46,43
1970-01-13,PHL,136,22,22,ATL,105,30,18,52,40
1970-01-13,BOS,111,17,26,SEA,102,15,29,32,55
1970-01-13,DET,115,15,29,SFW,102,20,24,35,53
1970-01-13,CIN,92,22,23,MIL,112,30,14,52,37
1970-01-14,BOS,123,18,26,DET,118,16,29,34,55
1970-01-14,MIL,115,31,14,LAL,113,21,22,52,36
1970-01-14,SEA,122,15,30,PHL,110,23,22,38,52
1970-01-14,ATL,101,30,19,SFW,103,20,25,50,44
1970-01-15,CHI,130,22,24,CIN,120,22,24,44,48
1970-01-15,PHX,124,19,27,BLT,115,29,17,48,44
1970-01-16,PHL,127,23,23,SFW,105,21,25,44,48
1970-01-16,BOS,103,19,26,LAL,108,21,23,40,49
1970-01-16,SEA,119,16,30,CHI,103,23,24,39,54
1970-01-16,DET,102,16,30,NYK,104,31,9,47,39
1970-01-16,ATL,117,30,20,CIN,100,22,25,52,45
1970-01-17,PHX,131,20,27,SEA,134,17,30,37,57
1970-01-17,MIL,130,32,14,CHI,132,23,25,55,39
1970-01-17,SDR,115,18,27,BLT,131,29,18,47,45
1970-01-18,PHX,134,20,28,BLT,133,30,18,50,46
1970-01-18,PHL,141,24,23,CIN,116,22,26,46,49
1970-01-18,MIL,123,32,15,SFW,107,21,26,53,41
1970-01-18,ATL,125,31,20,CHI,107,24,25,55,45
1970-01-18,BOS,109,19,27,NYK,102,32,9,51,36
1970-01-18,DET,106,16,31,LAL,100,22,23,38,54
1970-01-22,PHX,129,21,28,SEA,120,18,30,39,58
1970-01-22,BLT,119,30,19,DET,115,17,31,47,50
1970-01-22,LAL,122,22,24,SFW,108,21,27,43,51
1970-01-22,MIL,115,33,15,SDR,106,18,28,51,43
1970-01-22,CIN,111,22,27,BOS,104,20,27,42,54
1970-01-23,PHX,132,22,28,SFW,138,21,28,43,56
1970-01-23,PHL,133,25,23,BLT,118,31,19,56,42
1970-01-23,CHI,117,24,26,NYK,120,32,10,56,36
1970-01-23,BOS,105,20,28,DET,109,17,32,37,60
1970-01-23,LAL,128,23,24,SEA,100,18,31,41,55
1970-01-24,DET,128,18,32,CHI,122,24,27,42,59
1970-01-24,SEA,121,18,32,LAL,122,24,24,42,56
1970-01-24,NYK,127,33,10,SDR,114,18,29,51,39
1970-01-24,BLT,112,31,20,PHL,111,26,23,57,43
1970-01-24,MIL,125,34,15,CIN,109,23,27,57,42
1970-01-24,SFW,99,22,28,PHX,109,22,29,44,57
1970-01-25,PHL,159,26,24,SDR,131,18,30,44,54
1970-01-25,CIN,129,23,28,BLT,122,32,20,55,48
1970-01-25,ATL,116,32,20,MIL,131,35,15,67,35
1970-01-25,CHI,120,24,28,DET,111,19,32,43,60
1970-01-25,LAL,118,25,24,PHX,106,23,29,48,53
1970-01-25,BOS,96,20,29,NYK,102,34,10,54,39
1970-01-26,CIN,116,24,28,CHI,115,25,28,49,56
1970-01-26,SFW,104,22,29,ATL,131,32,21,54,50
1970-01-26,MIL,103,36,15,PHL,122,27,24,63,39
1970-01-27,LAL,124,26,24,SDR,109,18,31,44,55
1970-01-27,NYK,133,35,10,BOS,100,20,30,55,40
1970-01-28,SEA,120,18,33,ATL,119,33,21,51,54
1970-01-28,BLT,123,32,21,CHI,115,25,29,57,50
1970-01-28,CIN,114,25,28,MIL,126,36,16,61,44
1970-01-28,SDR,108,18,32,LAL,113,27,24,45,56
1970-01-28,BOS,112,20,31,PHL,100,28,24,48,55
1970-01-29,NYK,127,36,10,DET,106,19,33,55,43
1970-01-29,PHX,111,23,30,ATL,102,33,22,56,52
1970-01-29,SEA,105,19,33,SFW,101,22,30,41,63
1970-01-30,SDR,119,18,33,SEA,117,20,33,38,66
1970-01-30,DET,129,19,34,BLT,117,33,21,52,55
1970-01-30,SFW,125,22,31,PHX,116,24,30,46,61
1970-01-30,CHI,105,25,30,MIL,121,37,16,62,46
1970-01-30,BOS,108,21,31,CIN,103,25,29,46,60
1970-01-30,PHL,100,28,25,NYK,104,37,10,65,35
1970-01-30,LAL,102,28,24,ATL,87,33,23,61,47
1970-01-31,BLT,120,33,22,BOS,117,22,31,55,53
1970-01-31,CIN,117,25,30,DET,115,20,34,45,64
1970-01-31,PHX,106,24,31,MIL,107,38,16,62,47
1970-01-31,NYK,123,38,10,CHI,104,25,31,63,41
1970-02-01,ATL,124,33,24,BLT,133,34,22,67,46
1970-02-01,SEA,118,20,34,MIL,116,39,16,59,50
1970-02-01,PHL,112,28,26,LAL,113,29,24,57,50
1970-02-01,DET,111,20,35,NYK,117,39,10,59,45
1970-02-01,CHI,115,25,32,CIN,108,26,30,51,62
1970-02-01,BOS,105,22,32,SFW,123,23,31,45,63
1970-02-01,SDR,103,19,33,PHX,105,24,32,43,65
1970-02-02,ATL,125,33,25,DET,121,20,36,53,61
1970-02-03,PHX,131,25,32,PHL,123,28,27,53,59
1970-02-03,BLT,115,35,22,SEA,120,21,34,56,56
1970-02-03,CIN,114,26,31,LAL,124,30,24,56,55
1970-02-03,NYK,118,40,10,SFW,98,24,31,64,41
1970-02-03,BOS,93,22,33,CHI,85,26,32,48,65
1970-02-04,SDR,123,19,34,MIL,141,39,17,58,51
1970-02-04,CIN,115,26,32,SEA,121,22,34,48,66
1970-02-04,DET,125,20,37,LAL,109,31,24,51,61
1970-02-04,ATL,111,34,25,NYK,96,41,10,75,35
1970-02-05,CHI,105,26,33,SFW,127,24,32,50,65
1970-02-06,BLT,153,35,23,DET,148,21,37,56,60
1970-02-06,SDR,124,19,35,PHL,129,28,28,47,63
1970-02-06,PHX,122,26,32,SFW,117,25,33,51,65
1970-02-06,BOS,127,23,33,SEA,117,23,34,46,67
1970-02-06,LAL,105,31,25,MIL,118,40,17,71,42
1970-02-06,ATL,104,35,25,CHI,93,27,34,62,59
1970-02-06,CIN,92,26,33,NYK,135,41,11,67,44
1970-02-07,PHX,121,27,32,LAL,117,31,26,58,58
1970-02-07,NYK,121,42,11,CIN,114,26,34,68,45
1970-02-07,SFW,111,25,34,PHL,115,29,28,54,62
1970-02-07,DET,113,21,38,SEA,109,23,35,44,73
1970-02-08,SEA,118,23,36,PHL,117,30,28,53,64
1970-02-08,BOS,130,24,33,CIN,117,26,35,50,68
1970-02-08,LAL,125,31,27,SDR,113,19,36,50,63
1970-02-08,CHI,117,27,35,ATL,107,36,25,63,60
1970-02-08,BLT,120,36,23,MIL,106,41,17,77,40
1970-02-10,PHL,131,30,29,MIL,139,41,18,71,47
1970-02-10,BOS,117,25,33,PHX,122,28,32,53,65
1970-02-10,DET,115,22,38,CIN,117,26,36,48,74
1970-02-10,LAL,106,32,27,BLT,111,37,23,69,50
1970-02-10,SFW,113,25,35,ATL,104,36,26,61,61
1970-02-11,SDR,131,19,37,ATL,155,36,27,55,64
1970-02-11,MIL,127,42,18,PHX,120,29,32,71,50
1970-02-11,NYK,118,43,11,BOS,125,25,34,68,45
1970-02-11,SEA,119,24,36,BLT,117,38,23,62,59
1970-02-11,SFW,115,26,35,LAL,125,32,28,58,63
1970-02-11,CIN,124,27,36,DET,113,22,39,49,75
1970-02-12,CHI,122,28,35,PHX,121,29,33,57,68
1970-02-12,LAL,136,33,28,ATL,114,37,27,70,55
1970-02-13,SEA,141,25,36,BLT,138,38,24,63,60
1970-02-13,DET,132,22,40,PHX,120,29,34,51,74
1970-02-13,SFW,110,26,36,CIN,128,28,36,54,72
1970-02-13,PHL,106,30,30,NYK,151,43,12,73,42
1970-02-14,SDR,141,19,38,SFW,123,26,37,45,75
1970-02-14,MIL,127,43,18,BOS,117,26,34,69,52
1970-02-14,NYK,116,44,12,PHL,114,30,31,74,43
1970-02-14,CHI,116,29,35,LAL,113,34,28,63,63
1970-02-15,ATL,146,37,28,BOS,125,26,35,63,63
1970-02-15,PHL,159,30,32,PHX,125,29,35,59,67
1970-02-15,SDR,150,20,38,CIN,123,29,36,49,74
1970-02-15,DET,126,23,40,CHI,119,30,35,53,75
1970-02-15,MIL,96,44,18,LAL,98,34,29,78,47
1970-02-16,BOS,117,26,36,SFW,114,26,38,52,74
1970-02-16,BLT,140,38,25,SDR,109,21,38,59,63
1970-02-17,SEA,118,26,36,PHX,129,29,36,55,72
1970-02-17,NYK,114,45,12,LAL,93,35,29,80,41
1970-02-18,ATL,139,38,28,CIN,125,29,37,67,65
1970-02-18,SDR,122,21,39,SEA,119,26,37,47,76
1970-02-18,PHX,113,30,36,BOS,116,27,36,57,72
1970-02-18,BLT,117,39,25,LAL,103,35,30,74,55
1970-02-18,SFW,102,26,39,MIL,109,44,19,70,58
1970-02-19,PHL,133,31,32,DET,114,24,40,55,72
1970-02-20,SEA,125,26,38,BOS,127,28,36,54,74
1970-02-20,BLT,119,40,25,DET,122,24,41,64,66
1970-02-20,CHI,126,30,36,PHL,119,32,32,62,68
1970-02-20,PHX,126,30,37,SDR,117,22,39,52,76
1970-02-20,LAL,119,35,31,MIL,114,45,19,80,50
1970-02-21,NYK,106,25,5,ATL,122,23,13,48,18
1970-02-21,MIL,140,45,20,SEA,127,26,39,71,59
1970-02-21,CIN,127,29,38,CHI,119,31,36,60,74
1970-02-21,SFW,116,26,40,BOS,111,29,36,55,76
1970-02-21,DET,110,25,41,PHL,112,32,33,57,74
1970-02-21,SDR,121,22,40,LAL,106,36,31,58,71
1970-02-22,SEA,131,26,40,SFW,127,27,40,53,80
1970-02-22,PHX,124,31,37,MIL,144,46,20,77,57
1970-02-22,CIN,136,30,38,PHL,116,33,33,63,71
1970-02-22,ATL,114,39,28,DET,116,25,42,64,70
1970-02-22,BLT,110,40,26,NYK,104,46,12,86,38
1970-02-22,LAL,108,36,32,BOS,96,29,37,65,69
1970-02-23,CHI,127,31,37,SDR,125,23,40,54,77
1970-02-24,SEA,130,27,40,SFW,122,27,41,54,81
1970-02-24,BLT,128,41,26,SDR,118,23,41,64,67
1970-02-24,DET,136,26,42,MIL,111,47,20,73,62
1970-02-24,LAL,106,37,32,ATL,118,39,29,76,61
1970-02-25,SFW,104,25,32,CHI,112,26,34,51,66
1970-02-25,BOS,147,29,38,SDR,124,23,42,52,80
1970-02-25,MIL,115,47,21,BLT,113,42,26,89,47
1970-02-25,SEA,120,28,40,ATL,112,40,29,68,69
1970-02-25,PHL,122,33,34,DET,105,27,42,60,76
1970-02-26,DET,123,27,43,PHX,131,31,38,58,81
1970-02-27,BOS,125,30,38,PHX,134,32,38,62,76
1970-02-27,MIL,131,48,21,DET,113,27,44,75,65
1970-02-27,PHL,125,34,34,SDR,111,23,43,57,77
1970-02-27,BLT,114,42,27,ATL,107,40,30,82,57
1970-02-27,LAL,111,37,33,CHI,101,32,37,69,70
1970-02-27,SFW,99,27,42,SEA,107,29,40,56,82
1970-02-28,SEA,140,30,40,CHI,104,32,38,62,78
1970-02-28,NYK,115,46,13,BLT,101,43,27,89,40
1970-03-01,SDR,135,23,44,CHI,122,32,39,55,83
1970-03-01,MIL,120,49,21,CIN,114,31,38,80,59
1970-03-01,BOS,114,30,39,LAL,120,38,33,68,72
1970-03-01,PHL,104,35,34,BLT,99,43,28,78,62
1970-03-01,DET,116,27,45,SFW,99,27,43,54,88
1970-03-01,ATL,98,40,31,PHX,109,33,38,73,69
1970-03-02,BLT,118,43,29,CIN,110,31,39,74,68
1970-03-03,MIL,127,50,21,PHL,116,36,34,86,55
1970-03-03,SEA,126,31,40,SDR,114,24,44,55,84
1970-03-03,PHX,111,34,38,CHI,123,32,40,66,78
1970-03-03,NYK,115,47,13,SFW,100,27,44,74,57
1970-03-03,ATL,101,40,32,LAL,93,39,33,79,65
1970-03-04,SDR,125,24,45,CIN,127,31,40,55,85
1970-03-04,BOS,115,30,40,SFW,110,27,45,57,85
1970-03-04,BLT,91,44,29,LAL,94,39,34,83,63
1970-03-05,MIL,117,51,21,ATL,126,41,32,92,53
1970-03-06,PHL,150,36,35,BOS,134,31,40,67,75
1970-03-06,SEA,126,32,40,CIN,122,32,40,64,80
1970-03-06,DET,118,28,45,MIL,121,51,22,79,67
1970-03-06,LAL,100,40,34,BLT,105,44,30,84,64
1970-03-06,SFW,107,27,46,PHX,97,34,39,61,85
1970-03-07,DET,134,28,46,SDR,126,24,46,52,92
1970-03-07,SFW,119,28,46,CIN,121,32,41,60,87
1970-03-07,PHL,104,37,35,NYK,111,48,13,85,48
1970-03-08,BOS,134,31,41,MIL,138,52,22,83,63
1970-03-08,PHX,130,34,40,ATL,119,42,32,76,72
1970-03-08,LAL,144,40,35,CIN,116,33,41,73,76
1970-03-08,SEA,106,33,40,BLT,109,45,30,78,70
1970-03-08,NYK,116,49,13,PHL,133,38,36,87,49
1970-03-09,PHL,131,37,36,SDR,112,24,47,61,83
1970-03-09,MIL,124,53,22,SEA,105,33,41,86,63
1970-03-10,ATL,140,42,33,MIL,127,54,22,96,55
1970-03-10,DET,115,29,46,BOS,112,31,42,60,88
1970-03-10,CHI,111,33,40,SDR,106,24,48,57,88
1970-03-10,LAL,106,41,35,SFW,104,28,47,69,82
1970-03-11,CIN,127,33,42,BOS,144,31,43,64,85
1970-03-11,ATL,122,43,33,SDR,121,24,49,67,82
1970-03-11,SFW,115,28,48,BLT,112,46,30,74,78
1970-03-12,CIN,165,33,43,SDR,151,24,50,57,93
1970-03-13,LAL,128,42,35,PHL,117,39,36,81,71
1970-03-13,CHI,134,34,40,BOS,113,32,43,66,83
1970-03-13,SFW,108,29,48,BLT,114,46,31,75,79
1970-03-13,SEA,115,33,42,NYK,103,49,14,82,56
1970-03-14,CHI,111,35,40,DET,96,30,46,65,86
1970-03-15,SDR,137,24,51,PHL,128,39,37,63,88
1970-03-15,BOS,127,32,44,BLT,130,47,31,79,75
1970-03-15,CIN,116,34,43,SEA,113,34,42,68,85
1970-03-15,ATL,126,44,33,PHX,111,35,40,79,73
1970-03-15,MIL,107,54,23,CHI,130,36,40,90,63
1970-03-15,LAL,106,43,35,NYK,101,49,15,92,50
1970-03-16,CHI,142,37,40,CIN,140,35,43,72,83
1970-03-17,PHL,125,39,38,ATL,128,45,33,84,71
1970-03-17,PHX,133,35,41,SFW,121,29,49,64,90
1970-03-17,SDR,125,25,51,BOS,117,32,45,57,96
1970-03-17,DET,106,30,47,NYK,122,49,16,79,63
1970-03-17,CHI,102,38,40,SEA,109,34,43,72,83
1970-03-18,LAL,122,44,35,BOS,137,32,46,76,81
1970-03-18,BLT,113,48,31,PHL,119,39,39,87,70
1970-03-18,NYK,108,50,16,MIL,116,54,24,104,40
1970-03-19,PHX,127,36,41,BOS,123,33,46,69,87
1970-03-19,SDR,132,26,51,DET,118,30,48,56,99
1970-03-20,CHI,131,38,41,BLT,138,48,32,86,73
1970-03-20,BOS,119,33,47,SEA,123,35,43,68,90
1970-03-20,PHL,112,40,39,MIL,138,55,24,95,63
1970-03-20,LAL,117,44,36,DET,111,30,49,74,85
1970-03-20,CIN,111,35,44,SFW,118,29,50,64,94
1970-03-20,PHX,127,37,41,SDR,104,27,51,64,92
1970-03-20,ATL,110,46,33,NYK,102,50,17,96,50
1970-03-21,BLT,127,49,32,SFW,123,30,50,79,82
1970-03-22,SDR,129,27,52,PHX,130,38,41,65,93
1970-03-22,DET,126,30,50,ATL,130,47,33,77,83
1970-03-22,LAL,121,45,36,SEA,118,36,43,81,79
1970-03-22,CHI,129,38,42,MIL,115,56,24,94,66
1970-03-22,BOS,115,33,48,NYK,112,50,18,83,66
1970-03-22,PHL,132,40,40,SFW,112,30,51,70,91
1970-10-13,NYK,114,5,5,BOS,107,8,6,13,11
1970-10-13,CHI,111,16,10,SDR,96,1,1,17,11
1970-10-14,CIN,104,0,0,NYK,128,0,0,0,0
1970-10-14,SEA,117,0,0,DET,123,0,0,0,0
1970-10-14,BUF,107,0,0,CLE,92,0,0,0,0
1970-10-14,PHL,110,0,0,CHI,107,0,0,0,0
1970-10-14,BLT,123,37,37,SDR,105,2,3,39,40
1970-10-15,PHX,119,0,0,BOS,100,0,0,0,0
1970-10-16,CHI,102,0,1,LAL,106,0,0,0,1
1970-10-16,POR,115,0,0,CLE,112,0,1,0,1
1970-10-16,PHL,127,43,32,SDR,119,2,4,45,36
1970-10-16,SFW,106,37,37,DET,120,38,35,75,72
1970-10-17,BLT,118,0,0,LAL,116,1,0,1,0
1970-10-17,CIN,105,0,1,PHL,123,1,0,1,1
1970-10-17,NYK,96,1,0,CHI,99,0,2,1,2
1970-10-17,ATL,98,0,0,MIL,107,0,0,0,0
1970-10-17,PHX,107,1,0,DET,110,1,0,2,0
1970-10-17,SEA,126,0,1,BOS,114,0,1,0,2
1970-10-17,SFW,128,0,0,CLE,108,0,2,0,2
1970-10-17,BUF,93,20,57,SDR,102,2,5,22,62
1970-10-18,POR,115,1,0,BOS,133,0,2,1,2
1970-10-20,BLT,105,1,0,SFW,125,1,0,2,0
1970-10-20,DET,115,2,0,MIL,114,1,0,3,0
1970-10-20,BUF,89,1,0,PHL,98,2,0,3,0
1970-10-20,POR,120,1,1,CLE,98,0,3,1,4
1970-10-20,SDR,115,3,5,PHX,114,45,29,48,34
1970-10-21,BOS,118,1,2,DET,121,3,0,4,2
1970-10-21,PHL,117,3,0,LAL,141,1,1,4,1
1970-10-21,ATL,102,0,1,SFW,100,2,0,2,1
1970-10-21,SEA,110,1,1,PHX,106,1,1,2,2
1970-10-21,CIN,105,32,39,BLT,117,38,37,70,76
1970-10-22,DET,120,4,0,ATL,101,1,1,5,1
1970-10-22,SDR,140,4,5,CLE,110,15,61,19,66
1970-10-22,NYK,95,34,26,SFW,92,37,38,71,64
1970-10-23,BLT,98,1,1,NYK,92,1,1,2,2
1970-10-23,BOS,131,1,3,CIN,126,0,2,1,5
1970-10-23,LAL,122,2,1,PHL,127,3,1,5,2
1970-10-23,PHX,108,1,2,CLE,104,0,4,1,6
1970-10-23,SEA,141,2,1,POR,111,2,1,4,2
1970-10-24,MIL,122,1,1,BLT,120,2,1,3,2
1970-10-24,ATL,109,1,2,BOS,113,2,3,3,5
1970-10-24,SFW,118,2,1,POR,115,2,2,4,3
1970-10-24,BUF,95,1,1,DET,114,5,0,6,1
1970-10-24,SDR,116,5,5,PHL,111,44,32,49,37
1970-10-25,MIL,126,2,1,SEA,107,3,1,5,2
1970-10-25,LAL,123,2,2,CLE,96,0,5,2,7
1970-10-25,POR,116,2,3,CHI,131,1,2,3,5
1970-10-25,PHX,117,45,30,SDR,98,6,5,51,35
1970-10-26,DET,142,6,0,SEA,111,3,2,9,2
1970-10-26,CIN,126,0,3,ATL,107,1,3,1,6
1970-10-27,POR,119,2,4,BUF,108,1,2,3,6
1970-10-27,MIL,126,62,13,SDR,113,6,6,68,19
1970-10-28,BLT,103,2,2,DET,109,7,0,9,2
1970-10-28,BOS,89,3,3,NYK,126,1,2,4,5
1970-10-28,CIN,131,1,3,SEA,118,3,3,4,6
1970-10-28,PHX,105,2,2,CHI,118,2,2,4,4
1970-10-28,SFW,108,3,1,PHL,111,4,1,7,2
1970-10-28,CLE,99,15,62,SDR,110,6,7,21,69
1970-10-29,NYK,114,35,26,SDR,107,7,7,42,33
1970-10-30,BOS,127,3,4,PHX,112,2,3,5,7
1970-10-30,PHL,110,5,1,BLT,123,2,3,7,4
1970-10-30,LAL,104,3,2,BUF,90,1,3,4,5
1970-10-30,SFW,98,3,2,CHI,101,3,2,6,4
1970-10-30,CLE,110,0,6,CIN,125,2,3,2,9
1970-10-30,POR,104,3,4,SEA,115,3,4,6,8
1970-10-31,BLT,106,3,3,PHX,103,2,4,5,7
1970-10-31,CIN,100,3,3,MIL,121,3,1,6,4
1970-10-31,NYK,107,2,2,DET,89,8,0,10,2
1970-10-31,SEA,122,4,4,CHI,119,4,2,8,6
1970-10-31,POR,107,3,5,BUF,102,1,4,4,9
1970-10-31,PHL,102,5,2,BOS,133,4,4,9,6
1970-10-31,ATL,117,33,42,SDR,121,7,8,40,50
1970-11-01,CLE,107,0,7,ATL,131,1,4,1,11
1970-11-02,PHL,141,5,3,CLE,87,0,8,5,11
1970-11-02,PHX,110,2,5,BUF,102,1,5,3,10
1970-11-02,SFW,99,3,3,NYK,111,3,2,6,5
1970-11-03,DET,115,8,1,CIN,112,3,4,11,5
1970-11-03,CHI,113,4,3,SEA,101,5,4,9,7
1970-11-03,POR,108,4,5,LAL,128,4,2,8,7
1970-11-04,BOS,115,5,4,PHL,113,6,3,11,7
1970-11-04,CIN,115,3,5,PHX,133,3,5,6,10
1970-11-04,ATL,105,2,4,DET,117,9,1,11,5
1970-11-04,BUF,101,1,6,SEA,126,5,5,6,11
1970-11-04,CLE,108,0,9,MIL,110,4,1,4,10
1970-11-04,SFW,111,3,4,BLT,100,4,3,7,7
1970-11-04,SDR,100,8,8,NYK,109,36,26,44,34
1970-11-05,DET,121,10,1,BUF,109,1,7,11,8
1970-11-05,POR,135,4,6,BLT,131,4,4,8,10
1970-11-06,BOS,116,6,4,SEA,94,6,5,12,9
1970-11-06,PHL,118,6,4,ATL,112,2,5,8,9
1970-11-06,CHI,102,5,3,PHX,105,4,5,9,8
1970-11-06,LAL,106,5,2,NYK,104,4,2,9,4
1970-11-06,POR,103,5,6,SFW,110,4,4,9,10
1970-11-06,SDR,118,8,9,BLT,125,39,37,47,46
1970-11-07,CIN,122,3,6,BOS,140,7,4,10,10
1970-11-07,PHL,134,7,4,SEA,128,6,6,13,10
1970-11-07,ATL,100,2,6,PHX,107,5,5,7,11
1970-11-07,CHI,125,5,4,DET,99,11,1,16,5
1970-11-07,BUF,103,1,8,CLE,91,0,10,1,18
1970-11-07,SFW,114,37,39,SDR,102,8,10,45,49
1970-11-08,MIL,125,5,1,PHX,105,6,5,11,6
1970-11-08,LAL,124,6,2,BLT,105,4,5,10,7
1970-11-08,POR,113,5,7,NYK,125,4,3,9,10
1970-11-10,ATL,109,2,7,PHL,104,8,4,10,11
1970-11-10,CHI,118,6,4,LAL,96,7,2,13,6
1970-11-10,SFW,109,5,4,CLE,74,0,11,5,15
1970-11-10,SEA,93,6,7,NYK,91,5,3,11,10
1970-11-10,POR,121,5,8,CIN,138,3,7,8,15
1970-11-11,BLT,107,4,6,PHL,119,8,5,12,11
1970-11-11,BOS,113,8,4,MIL,123,6,1,14,5
1970-11-11,DET,115,11,2,LAL,117,7,3,18,5
1970-11-11,PHX,114,6,6,POR,100,5,9,11,15
1970-11-11,BUF,134,2,8,ATL,118,3,7,5,15
1970-11-11,SDR,127,8,11,CIN,120,32,40,40,51
1970-11-12,NYK,108,5,4,BLT,110,4,7,9,11
1970-11-12,POR,103,5,10,CLE,105,0,12,5,22
1970-11-12,SFW,107,6,4,CIN,121,4,7,10,11
1970-11-13,BOS,114,8,5,ATL,116,3,8,11,13
1970-11-13,PHL,119,9,5,BUF,111,3,8,12,13
1970-11-13,LAL,122,8,3,DET,109,11,3,19,6
1970-11-13,PHX,115,7,6,CIN,109,5,7,12,13
1970-11-13,SEA,111,7,7,CLE,91,1,12,8,19
1970-11-13,SDR,102,9,11,SFW,107,38,39,47,50
1970-11-13,CHI,98,44,29,NYK,106,37,26,81,55
1970-11-14,BLT,122,5,7,BOS,101,8,7,13,14
1970-11-14,NYK,126,6,5,PHL,94,10,5,16,10
1970-11-14,ATL,116,4,8,CHI,120,7,4,11,12
1970-11-14,BUF,107,3,9,MIL,116,7,1,10,10
1970-11-14,POR,126,5,11,CLE,116,1,13,6,24
1970-11-14,SDR,112,9,12,DET,101,39,35,48,47
1970-11-15,MIL,105,8,1,BLT,90,6,7,14,8
1970-11-15,PHX,108,8,6,DET,104,11,4,19,10
1970-11-16,MIL,119,9,1,SFW,100,6,5,15,6
1970-11-16,BLT,98,6,8,CLE,86,1,14,7,22
1970-11-16,POR,118,28,48,SDR,136,10,12,38,60
1970-11-16,BUF,112,20,58,SEA,103,36,38,56,96
1970-11-17,CHI,105,8,4,SFW,111,6,6,14,10
1970-11-17,LAL,116,9,3,ATL,105,4,9,13,12
1970-11-17,DET,91,11,5,PHL,113,10,6,21,11
1970-11-17,POR,101,6,11,BUF,102,3,10,9,21
1970-11-17,NYK,103,38,26,PHX,100,46,30,84,56
1970-11-18,BOS,89,8,8,SFW,90,7,6,15,14
1970-11-18,CIN,107,5,8,CHI,128,8,5,13,13
1970-11-18,PHL,113,11,6,NYK,106,7,5,18,11
1970-11-18,POR,146,6,12,ATL,131,4,10,10,22
1970-11-18,SDR,111,0,0,MIL,117,10,1,10,1
1970-11-18,CLE,98,1,15,BLT,111,7,8,8,23
1970-11-19,DET,112,11,6,PHX,110,9,6,20,12
1970-11-19,NYK,98,7,6,CIN,106,5,9,12,15
1970-11-19,SEA,111,8,7,LAL,110,10,3,18,10
1970-11-20,BLT,121,8,8,PHX,110,9,7,17,15
1970-11-20,BOS,116,8,9,CLE,112,1,16,9,25
1970-11-20,PHL,112,12,6,DET,120,12,6,24,12
1970-11-20,LAL,100,10,4,MIL,117,11,1,21,5
1970-11-20,SDR,121,0,1,SEA,106,9,7,9,8
1970-11-20,SFW,123,8,6,BUF,108,4,10,12,16
1970-11-21,CIN,114,6,9,DET,102,13,6,19,15
1970-11-21,ATL,130,4,11,BLT,103,9,8,13,19
1970-11-21,CHI,110,9,5,BOS,107,9,9,18,14
1970-11-21,SFW,102,9,6,MIL,127,12,1,21,7
1970-11-21,PHL,119,12,7,PHX,125,9,8,21,15
1970-11-21,POR,112,7,12,BUF,108,4,11,11,23
1970-11-21,SEA,114,36,39,SDR,115,11,12,47,51
1970-11-21,NYK,102,39,26,CLE,94,15,63,54,89
1970-11-22,LAL,149,10,5,SEA,124,9,8,19,13
1970-11-22,CLE,99,1,17,PHX,114,10,8,11,25
1970-11-22,POR,104,8,12,MIL,126,13,1,21,13
1970-11-22,ATL,125,5,11,PHL,115,12,8,17,19
1970-11-24,BLT,156,9,9,POR,104,8,13,17,22
1970-11-24,PHL,96,12,9,SFW,104,9,7,21,16
1970-11-24,CHI,108,10,5,MIL,117,14,1,24,6
1970-11-24,BUF,112,4,12,PHX,106,11,8,15,20
1970-11-24,DET,111,39,36,SDR,104,12,12,51,48
1970-11-25,PHL,99,12,10,BUF,92,5,12,17,22
1970-11-25,BOS,122,9,10,POR,115,8,14,17,24
1970-11-25,MIL,113,15,1,DET,87,13,7,28,8
1970-11-25,ATL,111,6,11,NYK,114,7,7,13,18
1970-11-25,CLE,99,1,18,SFW,108,10,7,11,25
1970-11-25,CIN,120,32,41,SDR,138,12,13,44,54
1970-11-26,PHX,126,11,9,SEA,115,9,9,20,18
1970-11-27,BOS,153,10,10,BLT,107,10,9,20,19
1970-11-27,MIL,94,16,1,NYK,103,8,7,24,8
1970-11-27,PHL,109,13,10,CIN,113,7,9,20,19
1970-11-27,CHI,121,10,6,BUF,104,5,13,15,19
1970-11-27,LAL,105,11,5,PHX,116,12,9,23,14
1970-11-27,SEA,101,9,10,SFW,96,11,7,20,17
1970-11-27,CLE,102,1,19,POR,111,8,15,9,34
1970-11-27,SDR,128,13,13,ATL,127,33,43,46,56
1970-11-28,BLT,99,10,10,CHI,91,11,6,21,16
1970-11-28,CIN,105,8,9,CLE,86,1,20,9,29
1970-11-28,DET,98,13,8,BOS,121,11,10,24,18
1970-11-28,NYK,100,9,7,MIL,99,16,2,25,9
1970-11-28,SFW,92,11,8,LAL,88,11,6,22,14
1970-11-28,BUF,111,5,14,POR,95,9,15,14,29
1970-11-28,PHX,116,46,31,SDR,117,14,13,60,44
1970-11-29,MIL,124,16,3,POR,111,9,16,25,19
1970-11-29,SEA,130,10,10,ATL,107,6,12,16,22
1970-11-29,CLE,99,1,21,DET,120,13,9,14,30
1970-11-29,LAL,130,44,30,SDR,112,15,13,59,43
1970-11-30,BOS,109,12,10,BUF,106,6,14,18,24
1970-11-30,PHL,104,13,11,BLT,98,11,10,24,21
1970-12-01,BLT,93,11,11,LAL,97,11,7,22,18
1970-12-01,NYK,114,10,7,SEA,109,11,10,21,17
1970-12-01,CHI,107,11,7,PHL,91,14,11,25,18
1970-12-01,SFW,113,12,8,ATL,106,6,13,18,21
1970-12-01,BUF,116,6,15,BOS,117,13,10,19,25
1970-12-01,POR,114,28,49,SDR,120,15,14,43,63
1970-12-02,BOS,114,14,10,LAL,111,12,7,26,17
1970-12-02,CIN,111,9,9,SEA,119,11,11,20,20
1970-12-02,DET,101,14,9,NYK,82,11,7,25,16
1970-12-02,PHX,126,13,9,ATL,112,6,14,19,23
1970-12-03,MIL,107,17,3,CHI,100,12,7,29,10
1970-12-04,BLT,131,11,12,SEA,116,12,11,23,23
1970-12-04,DET,107,15,9,CHI,103,12,8,27,17
1970-12-04,MIL,128,18,3,PHL,122,14,12,32,15
1970-12-04,LAL,123,12,8,SFW,101,13,8,25,16
1970-12-04,BUF,97,6,16,NYK,91,11,8,17,24
1970-12-04,CLE,107,1,22,BOS,118,15,10,16,32
1970-12-04,POR,121,9,17,PHX,126,14,9,23,26
1970-12-05,CIN,106,9,10,PHL,131,14,13,23,23
1970-12-05,ATL,106,6,15,SEA,100,12,12,18,27
1970-12-05,CHI,97,12,9,BOS,101,16,10,28,19
1970-12-05,SFW,100,13,9,PHX,105,15,9,28,18
1970-12-05,SDR,119,16,14,LAL,116,45,30,61,44
1970-12-05,NYK,117,40,26,BUF,93,21,58,61,84
1970-12-06,LAL,131,13,8,POR,120,9,18,22,26
1970-12-06,CLE,108,1,23,BUF,106,7,16,8,39
1970-12-06,BLT,126,12,12,CIN,118,9,11,21,23
1970-12-06,PHX,108,46,32,SDR,102,17,14,63,46
1970-12-07,CIN,124,9,12,SFW,113,13,10,22,22
1970-12-08,MIL,125,19,3,ATL,104,7,15,26,18
1970-12-08,NYK,139,11,9,POR,121,9,19,20,28
1970-12-08,BUF,102,7,17,BOS,122,17,10,24,27
1970-12-08,PHL,104,15,13,SEA,107,12,13,27,26
1970-12-08,CHI,98,12,10,SFW,87,13,11,25,21
1970-12-08,PHX,112,16,9,LAL,121,14,8,30,17
1970-12-09,BLT,127,13,12,MIL,97,20,3,33,15
1970-12-09,BOS,136,18,10,SEA,121,13,13,31,23
1970-12-09,CIN,118,10,12,ATL,106,7,16,17,28
1970-12-09,DET,99,16,9,SFW,110,13,12,29,21
1970-12-09,CLE,102,2,23,POR,109,9,20,11,43
1970-12-10,BUF,120,7,18,CHI,138,13,10,20,28
1970-12-11,BOS,118,19,10,DET,121,16,10,35,20
1970-12-11,MIL,134,20,4,CLE,92,2,24,22,28
1970-12-11,PHL,101,15,14,SFW,102,14,12,29,26
1970-12-11,CHI,87,14,10,ATL,86,7,17,21,27
1970-12-11,SEA,118,13,14,LAL,126,15,8,28,22
1970-12-11,BUF,105,7,19,POR,120,10,20,17,39
1970-12-11,SDR,110,17,15,PHX,104,47,32,64,47
1970-12-12,BLT,119,14,12,SFW,96,15,12,29,24
1970-12-12,CIN,114,11,12,CLE,95,2,25,13,37
1970-12-12,DET,92,17,10,BUF,93,7,20,24,30
1970-12-12,NYK,118,12,9,PHL,101,15,15,27,24
1970-12-12,ATL,107,7,18,POR,101,11,20,18,38
1970-12-12,PHX,113,16,10,MIL,111,21,4,37,14
1970-12-12,CHI,103,44,30,SDR,98,18,15,62,45
1970-12-13,LAL,100,16,8,DET,103,17,11,33,19
1970-12-13,SEA,107,13,15,MIL,124,21,5,34,20
1970-12-13,ATL,110,8,18,BUF,91,8,20,16,38
1970-12-13,SFW,101,15,13,NYK,94,13,9,28,22
1970-12-13,CLE,95,15,64,SDR,118,18,16,33,80
1970-12-15,NYK,110,13,10,CLE,92,2,26,15,36
1970-12-15,CHI,115,15,10,BLT,97,15,12,30,22
1970-12-15,PHX,123,17,10,SFW,129,16,13,33,23
1970-12-15,BUF,113,8,21,LAL,111,16,9,24,30
1970-12-15,POR,103,28,50,DET,111,40,36,68,86
1970-12-15,PHL,122,44,33,SDR,98,19,16,63,49
1970-12-16,CIN,102,12,12,LAL,118,16,10,28,22
1970-12-16,CLE,84,2,27,NYK,108,14,10,16,37
1970-12-16,SFW,108,17,13,SEA,91,13,16,30,29
1970-12-16,ATL,128,33,44,SDR,117,19,17,52,61
1970-12-17,BOS,102,19,11,BUF,93,9,21,28,32
1970-12-17,PHX,117,17,11,DET,114,18,11,35,22
1970-12-17,SEA,117,13,17,PHL,125,15,16,28,33
1970-12-18,MIL,124,22,5,BOS,114,20,11,42,16
1970-12-18,CHI,137,17,10,CIN,122,12,13,29,23
1970-12-18,SFW,122,18,13,POR,118,11,21,29,34
1970-12-18,BLT,112,15,13,ATL,116,9,18,24,31
1970-12-18,BUF,113,9,22,CLE,94,2,28,11,50
1970-12-18,SDR,116,19,18,DET,129,41,36,60,54
1970-12-19,BLT,134,15,14,BOS,128,20,12,35,26
1970-12-19,CIN,119,12,14,MIL,110,23,5,35,19
1970-12-19,ATL,104,10,18,LAL,116,17,10,27,28
1970-12-19,SFW,99,19,13,PHL,108,16,16,35,29
1970-12-19,SEA,135,13,18,PHX,131,18,11,31,29
1970-12-19,CLE,123,2,29,BUF,112,10,22,12,51
1970-12-19,SDR,118,19,19,POR,108,28,51,47,70
1970-12-19,NYK,98,41,26,CHI,87,45,30,86,56
1970-12-20,MIL,131,23,6,BUF,101,10,23,33,29
1970-12-20,PHX,118,18,12,NYK,133,15,10,33,22
1970-12-20,POR,132,11,22,PHL,134,17,16,28,38
1970-12-20,CLE,103,3,29,CHI,116,18,10,21,39
1970-12-20,DET,136,42,36,CIN,135,32,42,74,78
1970-12-20,SEA,108,36,40,SDR,110,20,19,56,59
1970-12-21,MIL,113,24,6,LAL,88,18,10,42,16
1970-12-22,LAL,115,18,11,ATL,119,10,19,28,30
1970-12-22,PHX,129,18,13,PHL,133,18,16,36,29
1970-12-22,SFW,108,19,14,BOS,138,20,13,39,27
1970-12-22,SEA,119,14,18,NYK,108,16,10,30,28
1970-12-22,CHI,121,19,10,CLE,80,3,30,22,40
1970-12-23,CIN,120,13,14,BLT,115,16,14,29,28
1970-12-23,BUF,103,10,24,CHI,104,20,10,30,34
1970-12-23,SDR,133,21,19,ATL,102,34,44,55,63
1970-12-25,BLT,128,16,15,CHI,112,21,10,37,25
1970-12-25,CIN,117,14,14,CLE,100,3,31,17,45
1970-12-25,NYK,115,16,11,BUF,102,10,25,26,36
1970-12-25,PHL,105,19,16,DET,100,18,12,37,28
1970-12-25,LAL,123,18,12,BOS,113,21,13,39,25
1970-12-25,PHX,127,18,14,ATL,115,11,19,29,33
1970-12-26,MIL,131,25,6,SFW,111,19,15,44,21
1970-12-26,ATL,118,11,20,CIN,130,15,14,26,34
1970-12-26,CHI,114,21,11,DET,117,18,13,39,24
1970-12-26,PHX,115,19,14,POR,103,11,23,30,37
1970-12-26,SEA,124,15,18,BOS,117,21,14,36,32
1970-12-26,CLE,120,3,32,BUF,107,10,26,13,58
1970-12-27,LAL,128,19,12,PHX,110,20,14,39,26
1970-12-27,SDR,101,1,2,CHI,110,21,12,22,14
1970-12-27,POR,135,11,24,BOS,123,21,15,32,39
1970-12-27,CLE,114,4,32,PHL,101,20,16,24,48
1970-12-27,NYK,110,17,11,BLT,105,17,15,34,26
1970-12-28,ATL,104,11,21,SFW,115,19,16,30,37
1970-12-28,MIL,137,26,6,CIN,114,16,14,42,20
1970-12-29,DET,99,19,13,ATL,97,11,22,30,35
1970-12-29,LAL,126,20,12,CHI,117,22,12,42,24
1970-12-29,BUF,113,10,27,PHL,124,20,17,30,44
1970-12-29,CLE,97,5,32,MIL,119,27,6,32,38
1970-12-29,SDR,108,22,19,BOS,110,41,35,63,54
1970-12-30,BLT,106,17,16,BUF,90,10,28,27,44
1970-12-30,CIN,115,16,15,DET,119,20,13,36,28
1970-12-30,NYK,111,18,11,SFW,103,20,16,38,27
1970-12-30,PHL,119,21,17,MIL,107,28,6,49,23
1970-12-30,PHX,132,20,15,LAL,114,21,12,41,27
1970-12-30,SEA,128,16,18,CHI,109,22,13,38,31
1970-12-31,BOS,106,21,16,SFW,144,20,17,41,33
1970-12-31,ATL,119,11,23,CLE,85,5,33,16,56
1971-01-01,SEA,121,17,18,POR,118,12,24,29,42
1971-01-01,CLE,105,5,34,BLT,128,18,16,23,50
1971-01-01,LAL,106,45,31,SDR,117,22,20,67,51
1971-01-02,MIL,118,28,7,CLE,73,5,35,33,42
1971-01-02,NYK,108,19,11,ATL,112,12,23,31,34
1971-01-02,SFW,116,21,17,PHX,122,21,15,42,32
1971-01-02,POR,113,12,25,CHI,136,22,14,34,39
1971-01-02,BUF,103,10,29,CIN,115,16,16,26,45
1971-01-02,PHL,120,22,17,BOS,125,21,17,43,34
1971-01-02,DET,99,21,13,BLT,108,19,16,40,29
1971-01-02,SDR,109,23,20,LAL,108,45,32,68,52
1971-01-03,ATL,128,13,23,BOS,140,22,17,35,40
1971-01-03,PHX,102,22,15,SFW,81,21,18,43,33
1971-01-04,MIL,124,29,7,SEA,110,18,18,47,25
1971-01-04,CLE,106,5,36,POR,119,12,26,17,62
1971-01-05,BLT,109,20,16,SEA,101,18,19,38,35
1971-01-05,PHL,97,22,18,SFW,92,21,19,43,37
1971-01-05,ATL,90,13,24,DET,98,21,14,34,38
1971-01-05,CIN,146,17,16,LAL,112,21,13,38,29
1971-01-05,POR,124,28,52,BOS,120,42,35,70,87
1971-01-05,CHI,116,45,31,SDR,103,24,20,69,51
1971-01-06,BOS,137,23,17,SEA,112,18,20,41,37
1971-01-06,CIN,133,18,16,POR,128,13,26,31,42
1971-01-06,BUF,115,10,30,SFW,108,21,20,31,50
1971-01-06,CLE,94,5,37,NYK,127,19,12,24,49
1971-01-06,MIL,119,30,7,CHI,106,23,14,53,21
1971-01-06,DET,100,43,36,SDR,99,24,21,67,57
1971-01-07,MIL,116,31,7,NYK,106,20,12,51,19
1971-01-07,ATL,102,13,25,BLT,110,21,16,34,41
1971-01-07,CLE,105,5,38,LAL,110,21,14,26,52
1971-01-08,BLT,115,22,16,ATL,104,13,26,35,42
1971-01-08,BOS,122,24,17,PHX,114,23,15,47,32
1971-01-08,DET,115,22,14,CIN,109,19,16,41,30
1971-01-08,PHL,117,23,18,LAL,123,22,14,45,32
1971-01-08,BUF,102,11,30,SEA,110,18,21,29,51
1971-01-08,CHI,105,23,15,POR,113,13,27,36,42
1971-01-08,SDR,117,24,22,SFW,120,39,39,63,61
1971-01-09,CIN,110,19,17,SEA,114,19,21,38,38
1971-01-09,MIL,118,32,7,DET,100,23,14,55,21
1971-01-09,PHL,123,23,19,PHX,112,23,16,46,35
1971-01-09,POR,114,14,27,NYK,96,20,13,34,40
1971-01-09,CLE,111,5,39,BUF,89,11,31,16,70
1971-01-09,SFW,109,40,39,SDR,103,24,23,64,62
1971-01-10,BOS,107,25,17,PHL,115,24,19,49,36
1971-01-10,DET,118,23,15,LAL,109,23,14,46,29
1971-01-10,MIL,151,33,7,BLT,99,23,16,56,23
1971-01-10,ATL,105,13,27,PHX,116,23,17,36,44
1971-01-10,CHI,141,23,16,BUF,113,11,32,34,48
1971-01-14,DET,108,24,15,CLE,106,6,39,30,54
1971-01-14,PHX,107,24,17,NYK,88,20,14,44,31
1971-01-14,SEA,114,20,21,BLT,110,23,17,43,38
1971-01-14,BUF,119,11,33,POR,113,15,27,26,60
1971-01-14,LAL,126,45,33,CIN,120,32,43,77,76
1971-01-14,CHI,108,46,31,PHL,103,45,33,91,64
1971-01-15,BOS,134,25,18,ATL,123,13,28,38,46
1971-01-15,MIL,135,34,7,CIN,116,19,18,53,25
1971-01-15,PHL,99,25,19,CHI,96,24,16,49,35
1971-01-15,BUF,97,12,33,DET,99,25,15,37,48
1971-01-15,SDR,117,24,24,BLT,124,40,37,64,61
1971-01-16,CIN,114,19,19,BUF,113,12,34,31,53
1971-01-16,DET,121,26,15,BOS,118,26,18,52,33
1971-01-16,PHL,115,26,19,CLE,96,6,40,32,59
1971-01-16,ATL,127,13,29,LAL,123,23,15,36,44
1971-01-16,CHI,90,24,17,MIL,110,35,7,59,24
1971-01-16,PHX,117,25,17,BLT,100,23,18,48,35
1971-01-16,SFW,102,21,21,NYK,93,20,15,41,36
1971-01-17,MIL,120,36,7,BOS,113,26,19,62,26
1971-01-17,SEA,96,21,21,BLT,111,23,19,44,40
1971-01-17,SDR,105,24,25,PHL,106,45,34,69,59
1971-01-18,BUF,113,12,35,ATL,123,14,29,26,64
1971-01-18,PHX,118,47,33,CIN,99,32,44,79,77
1971-01-19,DET,106,27,15,SEA,102,21,22,48,37
1971-01-19,CHI,123,24,18,POR,111,15,28,39,46
1971-01-19,LAL,134,23,16,PHL,114,27,19,50,35
1971-01-19,SFW,116,22,21,CIN,108,20,19,42,40
1971-01-19,BUF,79,12,36,CLE,111,6,41,18,77
1971-01-19,NYK,117,42,26,SDR,113,24,26,66,52
1971-01-20,ATL,108,15,29,SEA,112,21,23,36,52
1971-01-20,PHX,114,26,17,CIN,126,20,20,46,37
1971-01-20,BUF,126,12,37,POR,106,15,29,27,66
1971-01-20,BLT,116,41,37,MIL,120,63,13,104,50
1971-01-20,BOS,142,42,36,SDR,112,24,27,66,63
1971-01-20,CHI,109,47,31,NYK,103,43,26,90,57
1971-01-22,BOS,117,26,20,BLT,136,24,19,50,39
1971-01-22,DET,112,28,15,POR,123,15,30,43,45
1971-01-22,MIL,110,37,7,ATL,117,15,30,52,37
1971-01-22,LAL,130,24,16,SFW,110,23,21,47,37
1971-01-22,PHX,116,26,18,PHL,117,27,20,53,38
1971-01-22,SEA,132,22,23,CIN,131,21,20,43,43
1971-01-22,BUF,101,21,59,SDR,94,24,28,45,87
1971-01-23,MIL,142,37,8,POR,117,16,30,53,38
1971-01-23,NYK,128,20,16,BOS,107,26,21,46,37
1971-01-23,SFW,83,23,22,CHI,87,25,18,48,40
1971-01-23,BLT,127,41,38,SDR,120,24,29,65,67
1971-01-24,BOS,121,26,22,CLE,110,7,41,33,63
1971-01-24,DET,105,28,16,NYK,117,21,16,49,32
1971-01-24,ATL,120,16,30,MIL,142,38,8,54,38
1971-01-24,LAL,142,25,16,CIN,131,21,21,46,37
1971-01-24,PHX,113,26,19,CHI,112,26,18,52,37
1971-01-24,SEA,119,23,23,PHL,145,28,20,51,43
1971-01-24,BUF,123,13,37,POR,111,16,31,29,68
1971-01-25,CLE,117,7,42,BOS,116,27,22,34,64
1971-01-25,SDR,114,1,3,BUF,106,14,37,15,40
1971-01-26,BLT,103,25,19,SFW,98,23,23,48,42
1971-01-26,LAL,136,26,16,CHI,111,26,19,52,35
1971-01-26,PHX,114,27,19,BUF,82,14,38,41,57
1971-01-26,PHL,129,29,20,ATL,122,16,31,45,51
1971-01-27,BOS,129,27,23,MIL,132,39,8,66,31
1971-01-27,CIN,115,21,22,BLT,113,26,19,47,41
1971-01-27,DET,112,28,17,SFW,129,23,24,51,41
1971-01-27,ATL,108,16,32,NYK,116,22,16,38,48
1971-01-27,CLE,118,8,42,POR,104,16,32,24,74
1971-01-27,SDR,106,24,30,CHI,111,48,31,72,61
1971-01-28,PHX,118,28,19,LAL,112,27,16,55,35
1971-01-28,SEA,120,23,24,BUF,110,14,39,37,63
1971-01-29,BLT,145,26,20,CIN,118,22,22,48,42
1971-01-29,BOS,111,27,24,NYK,118,23,16,50,40
1971-01-29,PHL,118,30,20,MIL,142,40,8,70,28
1971-01-29,LAL,122,27,17,SEA,115,24,24,51,41
1971-01-29,SFW,106,24,24,BUF,100,14,40,38,64
1971-01-29,ATL,119,16,33,CLE,111,9,42,25,75
1971-01-29,POR,122,16,33,PHX,131,29,19,45,52
1971-01-29,DET,131,44,36,SDR,104,24,31,68,67
1971-01-30,PHX,134,30,19,SEA,116,24,25,54,44
1971-01-30,SFW,87,25,24,LAL,85,28,17,53,41
1971-01-30,CIN,116,32,45,SDR,110,24,32,56,77
1971-01-31,BLT,95,27,20,NYK,125,24,16,51,36
1971-01-31,BOS,132,27,25,PHL,126,30,21,57,46
1971-01-31,MIL,131,41,8,DET,104,28,18,69,26
1971-01-31,LAL,133,28,18,POR,120,16,34,44,52
1971-01-31,CLE,117,9,43,BUF,108,14,41,23,84
1971-01-31,CHI,131,26,20,CIN,99,22,23,48,43
1971-01-31,ATL,131,34,45,SDR,120,24,33,58,78
1971-02-02,DET,116,28,19,BLT,113,27,21,55,40
1971-02-02,SFW,101,26,24,ATL,99,17,33,43,57
1971-02-02,BUF,91,14,42,CLE,101,10,43,24,85
1971-02-02,POR,123,16,35,MIL,111,42,8,58,43
1971-02-02,CHI,118,27,20,SEA,101,24,26,51,46
1971-02-02,PHL,108,30,22,BOS,105,28,25,58,47
1971-02-02,NYK,115,43,27,CIN,108,33,45,76,72
1971-02-02,LAL,133,46,33,SDR,105,24,34,70,67
1971-02-03,BLT,102,27,22,CHI,124,28,20,55,42
1971-02-03,CLE,95,11,43,SEA,98,24,27,35,70
1971-02-03,CIN,134,22,24,BOS,115,28,26,50,50
1971-02-03,SDR,101,24,35,MIL,108,64,13,88,48
1971-02-04,PHX,105,31,19,SFW,117,27,24,58,43
1971-02-04,POR,137,17,35,ATL,123,17,34,34,69
1971-02-05,BOS,114,28,27,CIN,110,23,24,51,51
1971-02-05,DET,108,29,19,NYK,99,25,16,54,35
1971-02-05,CHI,114,29,20,PHL,102,31,22,60,42
1971-02-05,LAL,116,29,18,MIL,93,42,9,71,27
1971-02-05,SEA,120,25,27,ATL,121,17,35,42,62
1971-02-05,BUF,90,14,43,BLT,98,27,23,41,66
1971-02-05,POR,123,18,35,SFW,117,28,24,46,59
1971-02-05,SDR,116,24,36,CLE,105,15,65,39,101
1971-02-06,CIN,109,23,25,PHL,118,31,23,54,48
1971-02-06,NYK,102,25,17,CHI,109,30,20,55,37
1971-02-06,PHX,119,31,20,CLE,91,11,44,42,64
1971-02-06,SFW,85,28,25,MIL,111,42,10,70,35
1971-02-06,SDR,108,25,36,LAL,115,47,33,72,69
1971-02-07,BLT,108,28,23,DET,105,30,19,58,42
1971-02-07,BOS,104,29,27,CHI,96,31,20,60,47
1971-02-07,ATL,121,18,35,CIN,118,23,26,41,61
1971-02-07,LAL,119,30,18,SFW,104,28,26,58,44
1971-02-07,PHL,127,32,23,NYK,99,25,18,57,41
1971-02-07,POR,112,19,35,CLE,103,11,45,30,80
1971-02-07,SEA,107,36,41,SDR,124,25,37,61,78
1971-02-08,MIL,118,43,10,PHX,94,32,20,75,30
1971-02-09,BLT,115,29,23,PHX,120,32,21,61,44
1971-02-09,DET,106,30,20,MIL,107,44,10,74,30
1971-02-09,CLE,111,11,46,LAL,116,31,18,42,64
1971-02-09,CHI,88,31,21,BOS,90,30,27,61,48
1971-02-09,SDR,132,26,37,SEA,115,36,42,62,79
1971-02-10,ATL,114,19,35,BOS,102,31,27,50,62
1971-02-10,BUF,106,14,44,NYK,99,25,19,39,63
1971-02-10,SFW,133,28,27,SEA,122,25,28,53,55
1971-02-11,MIL,122,45,10,LAL,88,32,18,77,28
1971-02-11,SEA,119,25,29,CIN,101,23,27,48,56
1971-02-11,SDR,119,27,37,SFW,111,41,39,68,76
1971-02-12,BLT,109,29,24,BOS,113,31,28,60,52
1971-02-12,DET,118,30,21,PHL,109,33,23,63,44
1971-02-12,ATL,125,20,35,NYK,116,25,20,45,55
1971-02-12,CHI,107,31,22,LAL,88,32,19,63,41
1971-02-12,SFW,133,29,27,CIN,119,23,28,52,55
1971-02-12,CLE,105,11,47,PHX,114,33,21,44,68
1971-02-12,POR,137,20,35,SEA,125,26,29,46,64
1971-02-13,MIL,103,46,10,CHI,96,32,22,78,32
1971-02-13,NYK,114,25,21,PHX,97,34,21,59,42
1971-02-13,CLE,106,11,48,BUF,111,15,44,26,92
1971-02-13,SDR,120,28,37,CIN,116,33,46,61,83
1971-02-14,BLT,112,29,25,PHL,103,33,24,62,49
1971-02-14,DET,108,31,21,BOS,110,32,28,63,49
1971-02-14,ATL,88,21,35,MIL,124,47,10,68,45
1971-02-14,LAL,125,32,20,CIN,113,23,29,55,49
1971-02-14,SEA,146,26,30,SFW,101,30,27,56,57
1971-02-14,BUF,97,16,44,PHX,108,34,22,50,66
1971-02-14,CHI,108,32,23,CLE,83,11,49,43,72
1971-02-16,BOS,116,33,28,PHX,119,35,22,68,50
1971-02-16,DET,110,31,22,BLT,95,30,25,61,47
1971-02-16,CHI,118,33,23,ATL,102,21,36,54,59
1971-02-16,LAL,130,33,20,NYK,115,26,21,59,41
1971-02-16,BUF,103,16,45,MIL,135,48,10,64,55
1971-02-16,POR,102,21,35,CIN,109,23,30,44,65
1971-02-17,BLT,114,30,26,BUF,118,16,46,46,72
1971-02-17,MIL,119,49,10,PHL,114,33,25,82,35
1971-02-17,PHX,133,36,22,CIN,117,24,30,60,52
1971-02-17,SFW,99,30,28,BOS,129,33,29,63,57
1971-02-17,CLE,104,11,50,CHI,109,34,23,45,73
1971-02-17,SEA,130,27,30,POR,126,21,36,48,66
1971-02-18,POR,114,21,37,LAL,136,34,20,55,57
1971-02-18,SDR,115,29,37,NYK,116,44,27,73,64
1971-02-19,CHI,115,35,23,DET,114,32,22,67,45
1971-02-19,LAL,104,35,20,PHL,118,33,26,68,46
1971-02-19,PHX,116,37,22,BOS,112,34,29,71,51
1971-02-19,SEA,112,28,30,MIL,128,50,10,78,40
1971-02-19,CLE,125,11,51,CIN,109,24,31,35,82
1971-02-19,BUF,113,17,46,BLT,120,30,27,47,73
1971-02-19,SFW,103,41,40,SDR,109,29,38,70,78
1971-02-20,BLT,115,31,27,ATL,122,21,37,52,64
1971-02-20,NYK,108,26,22,DET,94,32,23,58,45
1971-02-20,SFW,96,30,29,MIL,104,51,10,81,39
1971-02-20,POR,105,21,38,PHL,118,34,26,55,64
1971-02-20,CIN,120,24,32,BUF,94,17,47,41,79
1971-02-20,SDR,128,30,38,BOS,118,43,36,73,74
1971-02-21,DET,112,32,24,CHI,125,36,23,68,47
1971-02-21,ATL,119,22,37,BLT,121,31,28,53,65
1971-02-21,LAL,124,35,21,BOS,116,34,30,69,51
1971-02-21,PHX,97,38,22,MIL,125,52,10,90,32
1971-02-21,SEA,135,28,31,PHL,128,35,26,63,57
1971-02-21,POR,123,21,39,CLE,105,12,51,33,90
1971-02-22,BUF,91,17,48,SFW,109,30,30,47,78
1971-02-23,BLT,107,32,28,LAL,114,36,21,68,49
1971-02-23,MIL,118,53,10,SFW,107,31,30,84,40
1971-02-23,PHL,119,35,27,POR,113,22,39,57,66
1971-02-23,NYK,109,45,27,SDR,126,31,38,76,65
1971-02-24,BOS,116,34,31,LAL,96,37,21,71,52
1971-02-24,CIN,105,25,32,NYK,125,27,22,52,54
1971-02-24,DET,115,32,25,SFW,117,31,31,63,56
1971-02-24,SEA,123,29,31,CLE,101,12,52,41,83
1971-02-24,ATL,118,22,38,POR,107,22,40,44,78
1971-02-24,MIL,139,65,13,SDR,104,32,38,97,51
1971-02-26,BLT,114,32,29,POR,97,22,41,54,70
1971-02-26,BOS,136,35,31,ATL,129,23,38,58,69
1971-02-26,BUF,122,17,49,DET,127,32,26,49,75
1971-02-26,MIL,135,54,10,CIN,111,25,33,79,43
1971-02-26,PHL,94,36,27,PHX,108,38,23,74,50
1971-02-26,LAL,145,37,22,SEA,121,30,31,67,53
1971-02-27,DET,117,33,26,PHX,124,39,23,72,49
1971-02-27,NYK,113,28,22,POR,102,22,42,50,64
1971-02-27,SFW,107,32,31,LAL,112,38,22,70,53
1971-02-27,SEA,114,30,32,CHI,129,37,23,67,55
1971-02-27,ATL,134,23,39,BUF,117,17,50,40,89
1971-02-28,BLT,104,33,29,NYK,110,29,22,62,51
1971-02-28,BOS,99,36,31,MIL,111,55,10,91,41
1971-02-28,PHL,131,36,28,CIN,121,25,34,61,62
1971-02-28,ATL,105,24,39,DET,106,33,27,57,66
1971-02-28,LAL,107,39,22,CLE,90,12,53,51,75
1971-03-01,MIL,127,56,10,PHL,103,37,28,93,38
1971-03-01,CHI,98,49,31,CIN,94,33,47,82,78
1971-03-02,DET,128,34,27,POR,122,22,43,56,70
1971-03-02,SEA,116,30,33,ATL,128,24,40,54,73
1971-03-02,BUF,118,17,51,LAL,131,40,22,57,73
1971-03-02,PHL,103,46,34,SDR,111,32,39,78,73
1971-03-03,BLT,132,33,30,CIN,133,25,35,58,65
1971-03-03,PHL,120,37,29,POR,104,22,44,59,73
1971-03-03,MIL,112,57,10,LAL,97,41,22,98,32
1971-03-03,PHX,115,40,23,CHI,90,38,23,78,46
1971-03-03,SFW,105,32,32,ATL,109,25,40,57,72
1971-03-03,BOS,128,43,37,SDR,113,33,39,76,76
1971-03-04,MIL,116,58,10,BUF,113,17,52,75,62
1971-03-05,DET,95,35,27,MIL,108,59,10,94,37
1971-03-05,PHL,121,38,29,NYK,116,30,22,68,51
1971-03-05,LAL,104,41,23,ATL,105,26,40,67,63
1971-03-05,SFW,103,32,33,CHI,130,38,24,70,57
1971-03-05,CIN,117,26,35,POR,111,22,45,48,80
1971-03-05,SDR,110,33,40,SEA,111,36,43,69,83
1971-03-06,BUF,120,17,53,CLE,109,12,54,29,107
1971-03-06,NYK,112,30,23,BOS,104,36,32,66,55
1971-03-06,PHL,121,39,29,DET,115,35,28,74,57
1971-03-06,SFW,109,32,34,BLT,103,33,31,65,65
1971-03-06,SEA,121,30,34,LAL,109,41,24,71,58
1971-03-06,SDR,99,33,41,CHI,105,50,31,83,72
1971-03-07,BOS,110,36,33,NYK,116,31,23,67,56
1971-03-07,DET,100,35,29,CLE,104,12,55,47,84
1971-03-07,ATL,122,27,40,CIN,112,27,35,54,75
1971-03-07,LAL,117,41,25,CHI,108,39,24,80,49
1971-03-07,PHX,108,41,23,BLT,117,33,32,74,55
1971-03-07,SDR,135,33,42,POR,121,29,52,62,94
1971-03-08,MIL,104,60,10,SEA,99,31,34,91,44
1971-03-08,POR,98,22,46,BUF,114,18,53,40,99
1971-03-09,DET,108,35,30,PHX,114,41,24,76,54
1971-03-09,NYK,99,32,23,SEA,114,31,35,63,58
1971-03-09,CHI,110,39,25,MIL,103,61,10,100,35
1971-03-09,LAL,95,42,25,BLT,107,34,32,76,57
1971-03-09,SFW,112,33,34,BOS,134,36,34,69,68
1971-03-09,CLE,113,13,55,PHL,124,40,29,53,84
1971-03-09,SDR,106,34,42,BUF,96,22,59,56,101
1971-03-10,CIN,120,27,36,NYK,118,32,24,59,60
1971-03-10,ATL,139,28,40,PHX,98,42,24,70,64
1971-03-11,SEA,130,32,35,DET,97,35,31,67,66
1971-03-11,POR,136,22,47,BLT,118,35,32,57,79
1971-03-11,SDR,115,35,42,BOS,91,44,37,79,79
1971-03-12,CHI,116,40,25,PHX,92,42,25,82,50
1971-03-12,LAL,109,42,26,BUF,116,19,53,61,79
1971-03-12,SFW,111,33,35,SEA,98,33,35,66,70
1971-03-12,CLE,107,13,56,ATL,119,29,40,42,96
1971-03-12,CIN,124,28,36,BOS,108,37,34,65,70
1971-03-12,POR,129,23,47,DET,133,35,32,58,79
1971-03-13,CIN,136,29,36,ATL,127,30,40,59,76
1971-03-13,SFW,116,34,35,DET,107,36,32,70,67
1971-03-13,CHI,111,41,25,PHX,99,42,26,83,51
1971-03-13,SDR,121,36,42,BLT,115,42,38,78,80
1971-03-13,NYK,108,45,28,MIL,103,66,13,111,41
1971-03-14,BOS,117,37,35,CHI,104,42,25,79,60
1971-03-14,MIL,113,61,11,PHX,125,42,27,103,38
1971-03-14,ATL,108,30,41,PHL,101,41,29,71,70
1971-03-14,LAL,110,42,27,DET,100,36,33,78,60
1971-03-14,SEA,124,33,36,BLT,121,35,33,68,69
1971-03-14,POR,122,23,48,BUF,112,20,53,43,101
1971-03-14,CLE,103,13,57,CIN,115,30,36,43,93
1971-03-16,NYK,115,32,25,LAL,82,43,27,75,52
1971-03-16,PHL,125,41,30,ATL,130,31,41,72,71
1971-03-16,CHI,113,42,26,BLT,99,35,34,77,60
1971-03-16,PHX,111,43,27,MIL,119,61,12,104,39
1971-03-16,BUF,102,20,54,CIN,113,31,36,51,90
1971-03-16,CLE,108,13,58,SFW,103,35,35,48,93
1971-03-17,BLT,113,35,35,CLE,109,14,58,49,93
1971-03-17,BOS,112,38,35,LAL,104,43,28,81,63
1971-03-17,CIN,92,32,36,SFW,110,35,36,67,72
1971-03-17,SDR,106,37,42,DET,99,45,36,82,78
1971-03-18,PHX,123,43,28,NYK,131,33,25,76,53
1971-03-18,SEA,122,34,36,MIL,121,62,12,96,48
1971-03-18,CHI,85,43,26,SFW,91,36,36,79,62
1971-03-19,BOS,125,39,35,BLT,117,36,35,75,70
1971-03-19,DET,111,36,34,BUF,105,20,55,56,89
1971-03-19,PHL,147,41,31,CIN,127,32,37,73,68
1971-03-19,ATL,112,32,41,CHI,111,43,27,75,68
1971-03-19,LAL,106,43,29,PHX,111,43,29,86,58
1971-03-19,POR,135,24,48,SEA,128,35,36,59,84
1971-03-19,SDR,111,38,42,MIL,99,66,14,104,56
1971-03-20,BLT,124,36,36,PHL,112,42,31,78,67
1971-03-20,CHI,138,43,28,ATL,121,33,41,76,69
1971-03-20,PHX,114,44,29,SEA,107,35,37,79,66
1971-03-20,CLE,114,14,59,DET,103,37,34,51,93
1971-03-20,BUF,129,20,56,POR,132,25,48,45,104
1971-03-21,BOS,135,40,35,CIN,110,32,38,72,73
1971-03-21,DET,116,37,35,CHI,111,44,28,81,63
1971-03-21,PHL,120,42,32,BLT,108,37,36,79,68
1971-03-21,LAL,101,43,30,NYK,98,34,25,77,55
1971-03-21,SEA,119,35,38,SFW,106,37,36,72,74
1971-03-21,CLE,110,15,59,POR,113,26,48,41,107
1971-03-21,SDR,132,39,42,PHX,114,48,33,87,75
1971-03-23,CLE,112,15,60,POR,114,27,48,42,108
1971-10-12,CIN,127,0,0,ATL,113,0,0,0,0
1971-10-12,NYK,84,0,0,DET,91,0,0,0,0
1971-10-12,CHI,100,0,0,PHL,114,0,0,0,0
1971-10-12,BUF,90,0,0,SEA,123,0,0,0,0
1971-10-14,PHX,97,0,0,MIL,110,0,0,0,0
1971-10-14,HOU,94,0,0,PHL,105,1,0,1,0
1971-10-15,DET,103,1,0,LAL,132,0,0,1,0
1971-10-15,CHI,106,0,1,BLT,82,0,0,0,1
1971-10-15,CLE,109,0,0,BUF,111,0,1,0,1
1971-10-15,POR,88,0,0,SEA,119,1,0,1,0
1971-10-15,BOS,75,12,6,GOS,97,1,0,13,6
1971-10-16,NYK,104,0,1,LAL,119,1,0,1,1
1971-10-16,PHX,128,0,1,HOU,108,0,1,0,2
1971-10-16,ATL,102,0,1,PHL,104,2,0,2,1
1971-10-16,SEA,91,2,0,MIL,98,1,0,3,0
1971-10-16,BUF,89,1,1,CLE,93,0,1,1,2
1971-10-16,BLT,108,7,11,GOS,93,2,0,9,11
1971-10-17,CLE,120,1,1,NYK,121,0,2,1,3
1971-10-17,POR,94,0,1,MIL,127,2,0,2,1
1971-10-17,HOU,99,0,2,DET,112,1,1,1,3
1971-10-19,BOS,134,0,0,BLT,114,0,1,0,1
1971-10-19,CIN,100,1,0,SEA,101,2,1,3,1
1971-10-19,MIL,116,3,0,CLE,82,1,2,4,2
1971-10-19,BUF,106,1,2,LAL,123,2,0,3,2
1971-10-19,POR,99,0,2,DET,101,2,1,2,3
1971-10-19,NYK,93,16,12,GOS,84,2,2,18,14
1971-10-20,PHL,100,3,0,SEA,93,3,1,6,1
1971-10-20,ATL,104,0,2,LAL,126,3,0,3,2
1971-10-20,HOU,110,0,3,CHI,125,1,1,1,4
1971-10-20,CLE,98,1,3,GOS,115,0,0,1,3
1971-10-22,BLT,87,0,2,NYK,110,1,2,1,4
1971-10-22,MIL,124,4,0,BUF,105,1,3,5,3
1971-10-22,ATL,108,0,3,BOS,115,1,0,1,3
1971-10-22,LAL,106,4,0,CHI,113,2,1,6,1
1971-10-22,PHX,109,1,1,DET,116,3,1,4,2
1971-10-22,SEA,110,3,2,HOU,91,0,4,3,6
1971-10-23,BLT,101,0,3,CLE,109,1,4,1,7
1971-10-23,NYK,89,2,2,ATL,95,0,4,2,6
1971-10-23,PHL,88,4,0,MIL,110,5,0,9,0
1971-10-23,BUF,98,1,4,BOS,103,2,0,3,4
1971-10-23,POR,104,0,3,CIN,100,1,1,1,4
1971-10-23,GOS,115,3,3,DET,109,26,50,29,53
1971-10-24,PHX,104,1,2,CHI,105,3,1,4,3
1971-10-24,SEA,119,4,2,CIN,101,1,2,5,4
1971-10-24,CLE,93,2,4,PHL,111,4,1,6,5
1971-10-24,HOU,103,0,5,LAL,113,4,1,4,6
1971-10-25,BOS,136,3,0,ATL,116,1,4,4,4
1971-10-26,DET,103,4,1,HOU,104,0,6,4,7
1971-10-26,MIL,120,6,0,BLT,90,0,4,6,4
1971-10-26,NYK,106,2,3,BOS,101,4,0,6,3
1971-10-26,PHX,126,1,3,CIN,99,1,3,2,6
1971-10-26,POR,111,1,3,CHI,123,4,1,5,4
1971-10-26,GOS,89,4,3,BUF,91,20,57,24,60
1971-10-27,BLT,128,0,5,DET,98,4,2,4,7
1971-10-27,BOS,108,4,1,HOU,97,1,6,5,7
1971-10-27,PHL,120,5,1,CLE,106,2,5,7,6
1971-10-27,ATL,110,1,5,NYK,96,3,3,4,8
1971-10-28,NYK,112,3,4,HOU,94,1,7,4,11
1971-10-28,SEA,106,5,2,BUF,96,1,5,6,7
1971-10-29,BOS,125,5,1,MIL,114,7,0,12,1
1971-10-29,DET,119,4,3,BLT,105,1,5,5,8
1971-10-29,PHL,135,6,1,PHX,137,2,3,8,4
1971-10-29,LAL,119,5,1,CIN,107,1,4,6,5
1971-10-29,CLE,97,2,6,ATL,98,2,5,4,11
1971-10-29,POR,119,1,4,BUF,120,1,6,2,10
1971-10-29,GOS,99,4,4,CHI,83,53,22,57,26
1971-10-30,BLT,101,1,6,PHX,94,3,3,4,9
1971-10-30,NYK,101,4,4,PHL,108,6,2,10,6
1971-10-30,ATL,99,3,5,DET,104,5,3,8,8
1971-10-30,SEA,115,6,2,LAL,106,6,1,12,3
1971-10-30,GOS,116,5,4,CIN,112,27,45,32,49
1971-10-31,CLE,102,2,7,MIL,118,7,1,9,8
1971-10-31,HOU,102,1,8,BUF,87,2,6,3,14
1971-10-31,LAL,105,63,12,GOS,109,6,4,69,16
1971-11-02,CHI,108,5,1,PHX,101,3,4,8,5
1971-11-02,GOS,106,7,4,BLT,91,37,39,44,43
1971-11-03,CIN,124,1,5,PHL,100,7,2,8,7
1971-11-03,HOU,98,2,8,NYK,117,4,5,6,13
1971-11-03,BUF,98,2,7,PHX,100,3,5,5,12
1971-11-03,ATL,100,3,6,CHI,113,6,1,9,7
1971-11-04,HOU,110,2,9,POR,112,1,5,3,14
1971-11-04,GOS,98,8,4,SEA,96,45,29,53,33
1971-11-05,CHI,102,7,1,MIL,104,8,1,15,2
1971-11-05,LAL,110,6,2,BLT,106,2,6,8,8
1971-11-05,BOS,103,6,1,DET,102,6,3,12,4
1971-11-05,SEA,101,7,2,NYK,97,5,5,12,7
1971-11-05,CLE,87,2,8,PHX,107,4,5,6,13
1971-11-05,ATL,117,3,7,BUF,122,2,8,5,15
1971-11-06,BOS,124,7,1,POR,109,2,5,9,6
1971-11-06,MIL,106,9,1,DET,78,6,4,15,5
1971-11-06,PHL,101,7,3,ATL,96,3,8,10,11
1971-11-06,BUF,130,3,8,CHI,99,7,2,10,10
1971-11-06,CIN,110,2,5,PHX,95,5,5,7,10
1971-11-06,GOS,89,9,4,LAL,105,63,13,72,17
1971-11-07,LAL,103,7,2,NYK,96,5,6,12,8
1971-11-07,HOU,106,2,10,BLT,109,2,7,4,17
1971-11-07,CLE,120,2,9,POR,99,2,6,4,15
1971-11-07,SEA,102,45,30,GOS,109,9,5,54,35
1971-11-08,BOS,120,52,24,CIN,109,27,46,79,70
1971-11-09,MIL,118,10,1,PHX,113,5,6,15,7
1971-11-09,CHI,109,7,3,LAL,122,8,2,15,5
1971-11-09,BUF,109,4,8,POR,100,2,7,6,15
1971-11-09,GOS,115,10,5,HOU,99,31,43,41,48
1971-11-10,BLT,106,3,7,CHI,125,7,4,10,11
1971-11-10,CIN,99,3,5,NYK,85,5,7,8,12
1971-11-10,DET,139,6,5,POR,122,2,8,8,13
1971-11-10,PHL,103,8,3,LAL,143,9,2,17,5
1971-11-10,HOU,103,2,11,BOS,142,8,1,10,12
1971-11-10,ATL,110,3,9,MIL,116,11,1,14,10
1971-11-11,SEA,110,8,2,CLE,91,3,9,11,11
1971-11-11,NYK,103,44,31,GOS,112,11,5,55,36
1971-11-12,MIL,111,12,1,HOU,102,2,12,14,13
1971-11-12,PHL,115,8,4,DET,101,7,5,15,9
1971-11-12,LAL,115,10,2,SEA,107,9,2,19,4
1971-11-12,PHX,128,5,7,BOS,119,9,1,14,8
1971-11-12,POR,104,2,9,CLE,106,3,10,5,19
1971-11-12,ATL,106,33,43,GOS,104,12,5,45,48
1971-11-13,BLT,111,3,8,PHL,105,9,4,12,12
1971-11-13,NYK,127,5,8,DET,105,7,6,12,14
1971-11-13,CHI,111,8,4,HOU,102,2,13,10,17
1971-11-13,SEA,116,9,3,BOS,112,9,2,18,5
1971-11-13,BUF,106,5,8,MIL,127,13,1,18,9
1971-11-13,POR,108,2,10,LAL,130,11,2,13,12
1971-11-13,CIN,110,27,47,GOS,101,12,6,39,53
1971-11-14,LAL,128,12,2,BOS,115,9,3,21,5
1971-11-14,PHX,119,6,7,CLE,105,4,10,10,17
1971-11-14,MIL,125,14,1,PHL,114,9,5,23,6
1971-11-16,BLT,110,4,8,HOU,107,2,14,6,22
1971-11-16,NYK,112,6,8,PHX,111,7,7,13,15
1971-11-16,CHI,95,9,4,SEA,87,10,3,19,7
1971-11-16,LAL,108,13,2,CLE,90,4,11,17,13
1971-11-16,BUF,102,5,9,CIN,98,4,5,9,14
1971-11-16,POR,105,2,11,MIL,125,15,1,17,12
1971-11-16,DET,101,26,51,GOS,122,12,7,38,58
1971-11-17,CIN,103,4,6,BLT,113,5,8,9,14
1971-11-17,PHL,112,9,6,HOU,118,2,15,11,21
1971-11-17,ATL,104,3,10,SEA,112,10,4,13,14
1971-11-17,BOS,140,9,4,PHX,121,7,8,16,12
1971-11-18,DET,128,7,7,PHX,126,7,9,14,16
1971-11-18,GOS,115,13,7,POR,105,15,60,28,67
1971-11-19,BLT,126,6,8,BUF,105,6,9,12,17
1971-11-19,BOS,106,10,4,CIN,110,4,7,14,11
1971-11-19,PHL,104,9,7,CHI,148,10,4,19,11
1971-11-19,LAL,106,14,2,HOU,99,3,15,17,17
1971-11-19,SEA,107,11,4,MIL,108,16,1,27,5
1971-11-19,POR,118,2,12,CLE,105,4,12,6,24
1971-11-20,NYK,125,7,8,BLT,114,7,8,14,16
1971-11-20,ATL,115,3,11,PHX,109,7,10,10,21
1971-11-20,CHI,123,11,4,BOS,106,10,5,21,9
1971-11-20,POR,100,3,12,SEA,104,11,5,14,17
1971-11-20,BUF,96,6,10,DET,105,8,7,14,17
1971-11-20,GOS,107,14,7,MIL,100,59,16,73,23
1971-11-21,LAL,112,15,2,MIL,105,17,1,32,3
1971-11-21,SEA,127,12,5,PHL,117,9,8,21,13
1971-11-21,CLE,105,4,13,BOS,128,10,6,14,19
1971-11-21,GOS,96,15,7,HOU,115,31,44,46,51
1971-11-23,DET,104,9,7,MIL,112,17,2,26,9
1971-11-23,NYK,125,8,8,CIN,110,5,7,13,15
1971-11-23,CHI,130,12,4,POR,94,3,13,15,17
1971-11-23,BUF,102,6,11,ATL,97,4,11,10,22
1971-11-23,CLE,104,4,14,BLT,102,7,9,11,23
1971-11-23,PHX,128,7,11,PHL,107,9,9,16,20
1971-11-24,BLT,94,7,10,NYK,114,9,8,16,18
1971-11-24,BOS,108,11,6,BUF,100,7,11,18,17
1971-11-24,CIN,114,5,8,POR,112,3,14,8,22
1971-11-24,MIL,141,18,2,ATL,107,4,12,22,14
1971-11-24,HOU,109,3,16,PHL,108,9,10,12,26
1971-11-25,PHX,122,8,11,DET,103,9,8,17,19
1971-11-25,SEA,115,45,31,LAL,139,64,13,109,44
1971-11-25,GOS,111,15,8,PHL,112,28,48,43,56
1971-11-26,BOS,89,12,7,NYK,104,10,8,22,15
1971-11-26,MIL,120,19,2,POR,105,3,15,22,17
1971-11-26,ATL,105,4,13,BLT,118,8,11,12,24
1971-11-26,LAL,132,16,2,DET,113,9,9,25,11
1971-11-26,CLE,128,5,14,CIN,114,6,8,11,22
1971-11-26,CHI,121,53,23,GOS,89,15,9,68,32
1971-11-27,BLT,125,9,11,BOS,120,12,8,21,19
1971-11-27,CIN,81,6,9,MIL,114,20,2,26,11
1971-11-27,NYK,100,11,8,CHI,99,13,4,24,12
1971-11-27,PHL,116,9,11,POR,93,3,16,12,27
1971-11-27,ATL,95,4,14,CLE,103,6,14,10,28
1971-11-27,SEA,124,13,5,DET,102,9,10,22,15
1971-11-27,BUF,91,21,57,GOS,110,15,10,36,67
1971-11-28,LAL,138,17,2,SEA,121,14,5,31,7
1971-11-28,BOS,130,12,9,ATL,108,4,15,16,24
1971-11-28,CLE,124,7,14,PHL,120,10,11,17,25
1971-11-28,HOU,110,4,16,PHX,116,9,11,13,27
1971-11-30,BLT,103,10,11,CIN,118,6,10,16,21
1971-11-30,NYK,109,12,8,SEA,110,14,6,26,14
1971-11-30,CHI,86,13,5,ATL,85,4,16,17,21
1971-11-30,BUF,101,7,12,HOU,115,4,17,11,29
1971-11-30,POR,111,3,17,PHX,121,10,11,13,28
1971-11-30,MIL,103,59,17,GOS,106,16,10,75,27
1971-12-01,BOS,111,13,9,LAL,124,18,2,31,11
1971-12-01,CIN,101,7,10,CHI,109,14,5,21,15
1971-12-01,DET,103,9,11,ATL,117,4,17,13,28
1971-12-01,PHL,102,10,12,SEA,98,15,6,25,18
1971-12-01,PHX,139,11,11,POR,103,3,18,14,29
1971-12-01,CLE,116,8,14,HOU,106,5,17,13,31
1971-12-02,BUF,109,7,13,BLT,105,10,12,17,25
1971-12-03,BLT,106,10,13,SEA,117,15,7,25,20
1971-12-03,DET,113,9,12,HOU,112,5,18,14,30
1971-12-03,MIL,120,21,2,CIN,82,7,11,28,13
1971-12-03,PHL,116,11,12,LAL,131,19,2,30,14
1971-12-03,CHI,122,15,5,NYK,96,12,9,27,14
1971-12-03,BUF,91,8,13,CLE,90,9,14,17,27
1971-12-03,POR,115,15,61,GOS,107,17,10,32,71
1971-12-04,BOS,117,13,10,HOU,107,5,19,18,29
1971-12-04,CIN,98,7,12,SEA,100,16,7,23,19
1971-12-04,MIL,108,22,2,CHI,105,16,5,38,7
1971-12-04,NYK,130,12,10,BUF,90,9,13,21,23
1971-12-04,ATL,126,5,17,PHL,109,11,13,16,30
1971-12-04,GOS,92,17,11,PHX,128,47,30,64,41
1971-12-05,LAL,123,20,2,POR,107,3,19,23,21
1971-12-05,PHX,120,12,11,GOS,87,2,1,14,12
1971-12-05,CLE,91,9,15,SEA,99,17,7,26,22
1971-12-07,DET,130,10,12,POR,131,3,20,13,32
1971-12-07,MIL,116,23,2,SEA,83,18,7,41,9
1971-12-07,NYK,97,13,10,BOS,105,14,10,27,20
1971-12-07,CHI,115,16,6,CLE,99,9,16,25,22
1971-12-07,BUF,115,9,14,CIN,91,7,13,16,27
1971-12-07,GOS,113,17,12,ATL,116,34,43,51,55
1971-12-08,BLT,115,10,14,POR,97,4,20,14,34
1971-12-08,BOS,126,15,10,CLE,107,9,17,24,27
1971-12-08,CIN,109,7,14,PHL,115,11,14,18,28
1971-12-08,HOU,120,5,20,LAL,125,21,2,26,22
1971-12-09,DET,110,10,13,CHI,107,17,6,27,19
1971-12-09,PHX,135,13,11,ATL,115,6,17,19,28
1971-12-09,LAL,124,65,13,GOS,111,17,13,82,26
1971-12-10,MIL,120,24,2,BOS,104,16,10,40,12
1971-12-10,PHL,106,12,14,CIN,113,7,15,19,29
1971-12-10,CHI,118,17,7,BLT,102,11,14,28,21
1971-12-10,LAL,126,22,2,PHX,117,14,11,36,13
1971-12-10,HOU,95,5,21,ATL,88,6,18,11,39
1971-12-10,BUF,100,10,14,POR,101,4,21,14,35
1971-12-10,CLE,112,9,18,DET,111,11,13,20,31
1971-12-10,SEA,105,45,32,GOS,94,17,14,62,46
1971-12-11,BLT,101,11,15,MIL,107,25,2,36,17
1971-12-11,BOS,99,16,11,CHI,115,18,7,34,18
1971-12-11,CIN,103,8,15,CLE,95,10,18,18,33
1971-12-11,DET,111,11,14,PHL,118,12,15,23,29
1971-12-11,PHX,110,14,12,HOU,111,6,21,20,33
1971-12-11,NYK,134,13,11,POR,102,5,21,18,32
1971-12-12,LAL,104,23,2,ATL,95,6,19,29,21
1971-12-12,HOU,100,7,21,SEA,98,18,8,25,29
1971-12-12,CLE,92,10,19,NYK,103,14,11,24,30
1971-12-12,CIN,83,28,47,BOS,96,53,24,81,71
1971-12-14,BLT,85,11,16,CLE,88,10,20,21,36
1971-12-14,DET,86,11,15,SEA,103,18,9,29,24
1971-12-14,MIL,106,26,2,HOU,98,8,21,34,23
1971-12-14,NYK,100,15,11,PHX,110,14,13,29,24
1971-12-14,CHI,108,19,7,BOS,116,16,12,35,19
1971-12-14,BUF,117,10,15,PHL,110,13,15,23,30
1971-12-14,POR,114,5,22,LAL,129,24,2,29,24
1971-12-15,BOS,112,17,12,SEA,100,19,9,36,21
1971-12-15,CIN,108,9,15,PHX,127,15,13,24,28
1971-12-15,MIL,122,27,2,BUF,108,11,15,38,17
1971-12-15,ATL,115,6,20,HOU,117,8,22,14,42
1971-12-16,DET,107,11,16,CIN,101,9,16,20,32
1971-12-16,GOS,113,17,15,PHL,93,29,48,46,63
1971-12-17,BLT,114,11,17,ATL,103,6,21,17,38
1971-12-17,MIL,120,28,2,SEA,113,19,10,47,12
1971-12-17,CHI,98,19,8,HOU,109,9,22,28,30
1971-12-17,PHX,123,16,13,DET,102,12,16,28,29
1971-12-17,BUF,95,11,16,NYK,115,15,12,26,28
1971-12-17,CLE,109,11,20,BOS,115,18,12,29,32
1971-12-17,POR,127,5,23,PHL,126,13,16,18,39
1971-12-17,LAL,129,66,13,GOS,99,18,15,84,28
1971-12-18,BOS,124,19,12,BUF,91,11,17,30,29
1971-12-18,PHX,106,17,13,LAL,132,25,2,42,15
1971-12-18,SEA,107,19,11,POR,105,6,23,25,34
1971-12-18,ATL,123,6,22,BLT,94,12,17,18,39
1971-12-18,CIN,116,28,48,HOU,126,32,44,60,92
1971-12-18,GOS,129,18,16,DET,102,26,52,44,68
1971-12-19,MIL,111,29,2,BLT,96,12,18,41,20
1971-12-19,LAL,154,26,2,PHL,132,13,17,39,19
1971-12-19,ATL,101,7,22,CIN,99,9,17,16,39
1971-12-19,SEA,130,20,11,PHX,127,17,14,37,25
1971-12-19,CLE,101,11,21,CHI,119,19,9,30,30
1971-12-19,POR,114,6,24,DET,113,12,17,18,41
1971-12-21,CHI,127,20,9,DET,92,12,18,32,27
1971-12-21,PHX,124,17,15,PHL,119,13,18,30,33
1971-12-21,POR,119,7,24,HOU,132,10,22,17,46
1971-12-21,BUF,103,11,18,LAL,117,27,2,38,20
1971-12-21,GOS,87,19,16,NYK,113,44,32,63,48
1971-12-22,BLT,120,12,19,LAL,127,28,2,40,21
1971-12-22,CIN,103,9,18,ATL,106,8,22,17,40
1971-12-22,MIL,98,30,2,BOS,104,20,12,50,14
1971-12-22,DET,104,12,19,CLE,94,11,22,23,41
1971-12-22,SEA,104,21,11,NYK,120,17,12,38,23
1971-12-23,PHX,108,18,15,CHI,117,21,9,39,24
1971-12-23,POR,117,7,25,NYK,120,18,12,25,37
1971-12-23,CLE,115,11,23,ATL,110,9,22,20,45
1971-12-25,CIN,94,9,19,BOS,99,21,12,30,31
1971-12-25,PHL,114,13,19,BLT,117,12,20,25,39
1971-12-25,DET,120,13,19,MIL,118,30,3,43,22
1971-12-25,ATL,140,9,23,BUF,117,11,19,20,42
1971-12-25,PHX,116,18,16,SEA,86,21,12,39,28
1971-12-25,POR,88,7,26,CHI,109,22,9,29,35
1971-12-25,NYK,114,45,32,GOS,89,19,17,64,49
1971-12-26,MIL,114,30,4,ATL,92,10,23,40,27
1971-12-26,LAL,137,29,2,HOU,115,11,22,40,24
1971-12-26,SEA,102,21,13,CHI,103,23,9,44,22
1971-12-26,CLE,108,12,23,BLT,102,13,20,25,43
1971-12-27,ATL,135,10,24,POR,121,7,27,17,51
1971-12-27,BUF,112,11,20,PHL,121,13,20,24,40
1971-12-27,BOS,99,54,24,GOS,97,19,18,73,42
1971-12-28,BLT,119,13,21,CIN,87,9,20,22,41
1971-12-28,DET,100,14,19,NYK,119,19,12,33,31
1971-12-28,PHL,116,14,20,BOS,120,22,12,36,32
1971-12-28,CHI,116,24,9,MIL,105,31,4,55,13
1971-12-28,LAL,105,30,2,BUF,87,11,21,41,23
1971-12-28,CLE,112,13,23,POR,111,7,28,20,51
1971-12-29,MIL,123,31,5,POR,84,7,29,38,34
1971-12-29,PHL,102,14,21,CLE,103,14,23,28,44
1971-12-29,HOU,106,11,23,PHX,124,19,16,30,39
1971-12-29,CIN,102,28,49,GOS,107,19,19,47,68
1971-12-30,NYK,102,20,12,BLT,110,14,21,34,33
1971-12-30,CHI,117,25,9,POR,92,7,30,32,39
1971-12-30,PHX,123,20,16,BUF,102,11,22,31,38
1971-12-30,SEA,106,21,14,LAL,122,31,2,52,16
1971-12-30,HOU,129,11,24,ATL,115,11,24,22,48
1971-12-30,DET,122,26,53,GOS,128,20,19,46,72
1971-12-31,BOS,131,23,12,PHL,119,14,22,37,34
1972-01-01,NYK,104,20,13,CIN,94,9,21,29,34
1972-01-01,SEA,97,21,15,BUF,83,11,23,32,38
1972-01-01,PHX,114,21,16,BOS,104,24,12,45,28
1972-01-02,LAL,122,32,2,BOS,113,24,13,56,15
1972-01-02,PHX,111,22,16,ATL,116,11,25,33,41
1972-01-02,CLE,119,15,23,PHL,148,14,23,29,46
1972-01-02,POR,108,7,31,BUF,90,11,24,18,55
1972-01-02,HOU,107,12,24,DET,109,14,20,26,44
1972-01-03,NYK,101,46,32,MIL,99,59,18,105,50
1972-01-04,DET,127,15,20,PHL,131,15,23,30,43
1972-01-04,CHI,108,26,9,PHX,112,22,17,48,26
1972-01-04,HOU,119,12,25,SEA,110,22,15,34,40
1972-01-04,MIL,121,32,5,NYK,100,21,13,53,18
1972-01-04,POR,91,8,31,ATL,103,12,25,20,56
1972-01-04,GOS,112,21,19,BUF,86,21,58,42,77
1972-01-05,BLT,111,15,21,DET,89,15,21,30,42
1972-01-05,CIN,106,9,22,MIL,115,33,5,42,27
1972-01-05,PHL,107,16,23,CHI,139,26,10,42,33
1972-01-05,SEA,127,22,16,ATL,116,13,25,35,41
1972-01-05,CLE,103,15,24,LAL,113,33,2,48,26
1972-01-05,HOU,105,13,25,BOS,113,24,14,37,39
1972-01-06,GOS,119,22,19,POR,115,16,61,38,80
1972-01-07,PHL,117,16,24,NYK,113,21,14,37,38
1972-01-07,ATL,90,13,26,LAL,134,34,2,47,28
1972-01-07,DET,151,15,22,CIN,132,9,23,24,45
1972-01-07,CHI,94,27,10,BLT,104,16,21,43,31
1972-01-07,SEA,125,23,16,CLE,111,15,25,38,41
1972-01-07,BUF,110,11,25,PHX,123,23,17,34,42
1972-01-07,POR,114,8,32,BOS,120,25,14,33,46
1972-01-08,PHL,130,29,49,PHX,119,48,30,77,79
1972-01-08,MIL,136,59,19,DET,119,26,54,85,73
1972-01-08,NYK,108,47,32,CHI,113,54,23,101,55
1972-01-08,GOS,128,23,19,BOS,106,55,24,78,43
1972-01-08,BLT,110,37,40,ATL,102,35,43,72,83
1972-01-08,POR,125,16,62,CLE,102,23,54,39,116
1972-01-08,CIN,87,28,50,BUF,97,21,59,49,109
1972-01-09,BLT,109,17,21,PHX,103,24,17,41,38
1972-01-09,MIL,120,34,5,LAL,104,35,2,69,7
1972-01-09,DET,101,16,22,BUF,96,11,26,27,48
1972-01-09,CHI,108,27,11,CIN,104,9,24,36,35
1972-01-09,SEA,125,24,16,BOS,119,26,14,50,30
1972-01-09,HOU,112,33,44,GOS,113,24,19,57,63
1972-01-11,DET,103,17,22,LAL,123,35,3,52,25
1972-01-11,MIL,114,35,5,PHX,115,24,18,59,23
1972-01-11,CHI,116,28,11,NYK,91,21,15,49,26
1972-01-11,BUF,107,11,27,CIN,109,9,25,20,52
1972-01-11,POR,114,8,33,BLT,106,18,21,26,54
1972-01-11,SEA,141,25,16,HOU,126,13,26,38,42
1972-01-11,GOS,101,25,19,CLE,92,23,55,48,74
1972-01-12,BOS,113,26,15,CHI,112,29,11,55,26
1972-01-12,CIN,108,10,25,LAL,107,36,3,46,28
1972-01-12,PHL,109,17,24,BUF,111,11,28,28,52
1972-01-12,ATL,104,13,27,MIL,102,35,6,48,33
1972-01-13,SEA,112,26,16,BLT,107,18,22,44,38
1972-01-14,BOS,108,27,15,DET,94,17,23,44,38
1972-01-14,CIN,126,11,25,ATL,102,14,27,25,52
1972-01-14,MIL,104,35,7,CHI,77,29,12,64,19
1972-01-14,PHL,121,17,25,LAL,135,36,4,53,29
1972-01-14,PHX,117,25,18,CLE,107,15,26,40,44
1972-01-14,BUF,100,12,28,POR,102,9,33,21,61
1972-01-14,GOS,115,26,19,NYK,111,47,33,73,52
1972-01-15,DET,121,17,24,PHL,131,17,26,34,50
1972-01-15,ATL,106,14,28,BOS,122,28,15,42,43
1972-01-15,CHI,120,29,13,POR,100,10,33,39,46
1972-01-15,SEA,118,27,16,PHX,110,26,18,53,34
1972-01-15,HOU,112,13,27,CLE,109,15,27,28,54
1972-01-15,GOS,105,27,19,BLT,95,38,40,65,59
1972-01-16,MIL,126,36,7,POR,97,10,34,46,41
1972-01-16,PHX,104,26,19,BLT,107,18,23,44,42
1972-01-16,HOU,108,14,27,NYK,109,21,16,35,43
1972-01-16,CIN,128,12,25,CLE,108,15,28,27,53
1972-01-16,ATL,124,14,29,PHL,116,18,26,32,55
1972-01-20,CIN,87,13,25,HOU,104,14,28,27,53
1972-01-20,PHX,130,26,20,NYK,109,22,16,48,36
1972-01-21,BOS,110,29,15,HOU,105,15,28,44,43
1972-01-21,DET,107,17,25,BLT,102,19,23,36,48
1972-01-21,MIL,120,37,7,CLE,91,15,29,52,36
1972-01-21,PHL,136,18,27,POR,122,10,35,28,62
1972-01-21,SEA,113,28,16,PHX,128,27,20,55,36
1972-01-21,LAL,101,37,4,NYK,104,22,17,59,21
1972-01-21,BUF,93,12,29,CHI,113,30,13,42,42
1972-01-21,ATL,111,35,44,GOS,113,28,19,63,63
1972-01-22,BLT,116,19,24,POR,99,10,36,29,60
1972-01-22,CIN,113,13,26,CLE,96,15,30,28,56
1972-01-22,CHI,115,31,13,HOU,108,15,29,46,42
1972-01-22,PHX,116,28,20,LAL,102,37,5,65,25
1972-01-22,PHL,106,30,49,GOS,113,29,19,59,68
1972-01-23,BOS,115,30,15,POR,105,10,37,40,52
1972-01-23,DET,107,18,25,HOU,109,15,30,33,55
1972-01-23,BLT,132,20,24,CIN,101,14,26,34,50
1972-01-23,MIL,113,38,7,ATL,118,15,29,53,36
1972-01-23,SEA,99,28,17,NYK,101,23,17,51,34
1972-01-24,CHI,110,55,23,GOS,105,30,19,85,42
1972-01-25,MIL,123,38,8,SEA,91,28,18,66,26
1972-01-25,NYK,109,24,17,BOS,106,31,15,55,32
1972-01-25,LAL,129,37,6,PHX,119,29,20,66,26
1972-01-25,BUF,110,12,30,ATL,123,16,29,28,59
1972-01-25,CLE,111,15,31,GOS,117,2,3,17,34
1972-01-25,HOU,118,16,30,POR,104,10,38,26,68
1972-01-26,BLT,115,21,24,BUF,114,12,31,33,55
1972-01-26,BOS,108,31,16,CLE,112,15,32,46,48
1972-01-26,DET,94,18,26,MIL,120,39,8,57,34
1972-01-26,PHL,113,19,27,CIN,102,14,27,33,54
1972-01-26,ATL,119,17,29,SEA,131,28,19,45,48
1972-01-26,HOU,108,17,30,CHI,117,32,13,49,43
1972-01-27,GOS,108,30,20,CHI,107,56,23,86,43
1972-01-28,BOS,122,31,17,NYK,116,25,17,56,34
1972-01-28,CIN,124,14,28,BLT,132,22,24,36,52
1972-01-28,PHL,118,20,27,MIL,127,40,8,60,35
1972-01-28,ATL,124,17,30,DET,106,18,27,35,57
1972-01-28,LAL,118,38,6,HOU,105,17,31,55,37
1972-01-28,PHX,102,29,21,CHI,116,33,13,62,34
1972-01-28,BUF,93,12,32,SEA,104,29,19,41,51
1972-01-28,POR,102,17,62,GOS,105,31,20,48,82
1972-01-29,DET,112,18,28,BOS,124,32,17,50,45
1972-01-29,NYK,110,25,18,SEA,106,30,19,55,37
1972-01-29,CLE,118,16,32,CIN,120,14,29,30,61
1972-01-29,GOS,111,32,20,PHX,100,48,31,80,51
1972-01-30,BLT,112,23,24,MIL,116,41,8,64,32
1972-01-30,BOS,130,33,17,PHL,114,20,28,53,45
1972-01-30,CHI,109,34,13,DET,99,18,29,52,42
1972-01-30,PHX,105,29,22,ATL,103,18,30,47,52
1972-01-30,LAL,153,39,6,POR,131,10,39,49,45
1972-01-30,CLE,98,16,33,BUF,99,12,33,28,66
1972-02-01,BLT,108,23,25,BOS,115,34,17,57,42
1972-02-01,NYK,115,26,18,DET,106,18,30,44,48
1972-02-01,POR,117,10,40,PHX,129,30,22,40,62
1972-02-01,CHI,103,35,13,SEA,121,30,20,65,33
1972-02-01,BUF,99,13,33,CLE,104,16,34,29,67
1972-02-01,GOS,97,33,20,MIL,108,60,19,93,39
1972-02-02,BOS,124,35,17,CHI,100,35,14,70,31
1972-02-02,CIN,116,15,29,NYK,105,27,18,42,47
1972-02-02,DET,133,18,31,CLE,108,17,34,35,65
1972-02-02,PHX,103,31,22,MIL,106,42,8,73,30
1972-02-02,PHL,119,20,29,BUF,104,13,34,33,63
1972-02-02,HOU,111,33,45,SEA,88,46,32,79,77
1972-02-03,GOS,132,33,21,ATL,115,35,45,68,66
1972-02-04,BLT,108,23,26,CHI,110,35,15,58,41
1972-02-04,BOS,122,36,17,CIN,109,16,29,52,46
1972-02-04,PHL,113,21,29,DET,118,19,31,40,60
1972-02-04,LAL,118,40,6,MIL,105,43,8,83,14
1972-02-04,BUF,84,13,35,NYK,103,27,19,40,54
1972-02-04,CLE,112,17,35,SEA,118,31,20,48,55
1972-02-04,POR,114,10,41,HOU,113,17,32,27,73
1972-02-04,PHX,113,48,32,GOS,105,34,21,82,53
1972-02-05,CIN,133,16,30,DET,132,20,31,36,61
1972-02-05,NYK,112,28,19,PHL,104,21,30,49,49
1972-02-05,ATL,120,18,31,CLE,117,17,36,35,67
1972-02-05,CHI,130,36,15,BUF,96,13,36,49,51
1972-02-05,HOU,112,17,33,MIL,119,43,9,60,42
1972-02-05,POR,117,11,41,PHX,118,31,23,42,64
1972-02-05,GOS,96,34,22,LAL,108,67,13,101,35
1972-02-06,BOS,128,37,17,SEA,123,32,20,69,37
1972-02-06,PHL,107,21,31,NYK,109,29,19,50,50
1972-02-06,LAL,151,41,6,BLT,127,23,27,64,33
1972-02-06,PHX,107,32,23,POR,94,11,42,43,65
1972-02-06,CLE,108,17,37,BUF,121,13,37,30,74
1972-02-06,HOU,120,17,34,ATL,113,19,31,36,65
1972-02-06,CHI,119,37,15,CIN,94,17,30,54,45
1972-02-08,NYK,102,30,19,LAL,107,42,6,72,25
1972-02-08,CHI,114,38,15,CLE,90,17,38,55,53
1972-02-08,PHX,120,33,23,PHL,108,21,32,54,55
1972-02-08,BUF,108,14,37,MIL,126,44,9,58,46
1972-02-08,SEA,127,32,21,HOU,119,18,34,50,55
1972-02-08,POR,104,11,43,CIN,100,17,31,28,74
1972-02-08,GOS,111,34,23,BLT,107,38,41,72,64
1972-02-09,BOS,139,38,17,BUF,112,14,38,52,55
1972-02-09,DET,102,20,32,NYK,126,30,20,50,52
1972-02-09,ATL,113,19,32,LAL,117,43,6,62,38
1972-02-09,CLE,121,17,39,MIL,126,45,9,62,48
1972-02-10,PHX,131,34,23,BLT,98,23,28,57,51
1972-02-10,SEA,118,33,21,CIN,96,17,32,50,53
1972-02-10,GOS,121,35,23,PHL,112,30,50,65,73
1972-02-11,BOS,121,39,17,LAL,108,44,6,83,23
1972-02-11,MIL,107,46,9,NYK,113,31,20,77,29
1972-02-11,CHI,102,39,15,ATL,91,19,33,58,48
1972-02-11,BUF,95,14,39,DET,88,20,33,34,72
1972-02-11,POR,110,12,43,PHL,106,21,33,33,76
1972-02-11,HOU,116,18,35,BLT,95,23,29,41,64
1972-02-12,DET,113,20,34,BUF,87,15,39,35,73
1972-02-12,NYK,106,32,20,CLE,91,17,40,49,60
1972-02-12,ATL,106,19,34,CHI,117,40,15,59,49
1972-02-12,PHX,117,35,23,CIN,95,17,33,52,56
1972-02-12,SEA,125,34,21,POR,97,13,43,47,64
1972-02-12,MIL,123,61,19,GOS,100,36,23,97,42
1972-02-13,BLT,110,23,30,LAL,121,44,7,67,37
1972-02-13,BOS,109,40,17,MIL,117,46,10,86,27
1972-02-13,ATL,133,19,35,BUF,119,15,40,34,75
1972-02-13,CLE,121,17,41,DET,136,21,34,38,75
1972-02-13,HOU,112,19,35,CIN,111,17,34,36,69
1972-02-13,POR,117,13,44,SEA,127,35,21,48,65
1972-02-13,CHI,88,56,24,GOS,107,36,24,92,48
1972-02-14,PHL,116,21,34,HOU,130,20,35,41,69
1972-02-15,BLT,113,23,31,HOU,98,21,35,44,66
1972-02-15,DET,105,22,34,ATL,113,20,35,42,69
1972-02-15,LAL,125,45,7,CIN,118,17,35,62,42
1972-02-15,POR,104,13,45,BOS,111,40,18,53,63
1972-02-15,BUF,100,22,59,GOS,103,37,24,59,83
1972-02-16,NYK,110,33,20,HOU,100,21,36,54,56
1972-02-16,PHL,126,21,35,CLE,116,17,42,38,77
1972-02-16,ATL,105,21,35,BLT,103,24,31,45,66
1972-02-16,PHX,110,36,23,LAL,109,46,7,82,30
1972-02-16,SEA,113,36,21,BOS,112,41,18,77,39
1972-02-17,CIN,97,17,36,MIL,111,47,10,64,46
1972-02-17,CHI,99,41,15,NYK,102,34,20,75,35
1972-02-18,BLT,106,24,32,ATL,81,22,35,46,67
1972-02-18,MIL,126,48,10,PHL,132,22,35,70,45
1972-02-18,LAL,125,46,8,POR,114,13,46,59,54
1972-02-18,PHX,126,37,23,BOS,115,41,19,78,42
1972-02-18,DET,97,22,35,CHI,122,41,16,63,51
1972-02-18,BUF,96,15,41,HOU,108,21,37,36,78
1972-02-18,CLE,133,17,43,CIN,109,17,37,34,80
1972-02-18,SEA,110,46,33,GOS,108,38,24,84,57
1972-02-19,CIN,112,17,38,CLE,92,18,43,35,81
1972-02-19,NYK,100,35,20,BUF,95,15,42,50,62
1972-02-19,PHL,105,23,35,BLT,121,25,32,48,67
1972-02-19,CHI,104,42,16,MIL,97,48,11,90,27
1972-02-19,POR,94,13,47,LAL,115,47,8,60,55
1972-02-19,GOS,115,38,25,BOS,111,55,25,93,50
1972-02-20,DET,107,22,36,PHX,121,38,23,60,59
1972-02-20,MIL,103,48,12,CHI,100,43,16,91,28
1972-02-20,ATL,92,22,36,CIN,101,18,38,40,74
1972-02-20,LAL,132,48,8,BOS,113,41,20,89,28
1972-02-20,SEA,109,37,21,POR,105,13,48,50,69
1972-02-20,CLE,111,18,44,NYK,109,36,20,54,64
1972-02-21,BLT,102,26,32,PHL,101,23,36,49,68
1972-02-22,BOS,114,41,21,PHX,103,39,23,80,44
1972-02-22,NYK,122,36,21,POR,105,13,49,49,70
1972-02-22,LAL,134,49,8,DET,135,22,37,71,45
1972-02-22,BUF,99,15,43,BLT,98,27,32,42,75
1972-02-22,CHI,119,43,17,PHL,88,23,37,66,54
1972-02-22,GOS,120,39,25,SEA,104,47,33,86,58
1972-02-23,CIN,110,19,38,POR,106,13,50,32,88
1972-02-23,ATL,120,22,37,PHX,118,39,24,61,61
1972-02-23,SEA,97,38,21,DET,96,23,37,61,58
1972-02-23,CLE,111,19,44,BOS,113,42,21,61,65
1972-02-23,HOU,115,22,37,LAL,110,49,9,71,46
1972-02-23,BLT,105,38,42,MIL,113,62,19,100,61
1972-02-24,CIN,108,20,38,BUF,97,16,43,36,81
1972-02-24,GOS,116,40,25,DET,106,26,55,66,80
1972-02-25,PHL,114,23,38,ATL,110,23,37,46,75
1972-02-25,LAL,109,49,10,CIN,88,21,38,70,48
1972-02-25,BUF,115,16,44,BOS,117,43,21,59,65
1972-02-25,CLE,113,19,45,POR,104,13,51,32,96
1972-02-25,CHI,115,44,17,PHX,107,39,25,83,42
1972-02-26,MIL,119,49,12,PHX,117,39,26,88,38
1972-02-26,NYK,97,37,21,BLT,104,27,33,64,54
1972-02-26,SEA,122,39,21,CIN,106,21,39,60,60
1972-02-26,HOU,122,23,37,DET,106,23,38,46,75
1972-02-26,GOS,106,41,25,CHI,107,56,25,97,50
1972-02-27,BLT,95,28,33,NYK,97,37,22,65,55
1972-02-27,LAL,123,50,10,CHI,118,45,17,95,27
1972-02-27,CLE,125,20,45,PHX,127,39,27,59,72
1972-02-27,ATL,113,23,38,POR,110,13,52,36,90
1972-02-27,HOU,104,34,45,GOS,117,41,26,75,71
1972-02-29,BLT,117,28,34,SEA,118,40,21,68,55
1972-02-29,MIL,131,50,12,DET,113,23,39,73,51
1972-02-29,NYK,111,38,22,LAL,114,51,10,89,32
1972-02-29,BUF,89,16,45,ATL,99,24,38,40,83
1972-02-29,POR,92,13,53,CHI,116,45,18,58,71
1972-02-29,GOS,128,42,26,CIN,120,28,51,70,77
1972-03-01,BOS,115,44,21,CLE,105,20,46,64,67
1972-03-01,DET,102,23,40,SEA,116,41,21,64,61
1972-03-01,MIL,108,51,12,LAL,109,52,10,103,22
1972-03-01,PHL,108,24,38,BUF,99,16,46,40,84
1972-03-01,PHX,90,40,27,BLT,95,28,35,68,62
1972-03-01,HOU,108,24,37,CIN,96,21,40,45,77
1972-03-03,DET,96,23,41,BOS,125,45,21,68,62
1972-03-03,LAL,114,53,10,ATL,104,25,38,78,48
1972-03-03,SEA,112,42,21,CHI,103,46,18,88,39
1972-03-03,BUF,105,16,47,NYK,97,38,23,54,70
1972-03-03,POR,80,13,54,BLT,90,29,35,42,89
1972-03-03,PHL,81,25,38,MIL,94,51,13,76,51
1972-03-03,GOS,108,43,26,HOU,107,34,46,77,72
1972-03-04,NYK,118,38,24,PHL,115,25,39,63,63
1972-03-04,HOU,123,25,37,CLE,130,20,47,45,84
1972-03-04,POR,101,13,55,ATL,120,25,39,38,94
1972-03-04,GOS,114,44,26,SEA,96,47,34,91,60
1972-03-05,BOS,114,46,21,CIN,125,21,41,67,62
1972-03-05,PHL,100,25,40,NYK,98,39,24,64,64
1972-03-05,LAL,94,54,10,BLT,108,30,35,84,45
1972-03-05,PHX,131,40,28,BUF,103,17,47,57,75
1972-03-05,SEA,112,43,21,ATL,110,26,39,69,60
1972-03-05,HOU,97,25,38,CHI,128,46,19,71,57
1972-03-06,MIL,132,52,13,BOS,127,46,22,98,35
1972-03-07,DET,121,23,42,PHX,129,41,28,64,70
1972-03-07,NYK,110,39,25,MIL,101,53,13,92,38
1972-03-07,LAL,114,54,11,PHL,97,26,40,80,51
1972-03-07,SEA,98,44,21,BLT,105,31,35,75,56
1972-03-07,POR,98,13,56,BUF,94,17,48,30,104
1972-03-07,GOS,119,45,26,CLE,112,23,56,68,82
1972-03-08,CIN,122,22,41,PHX,105,42,28,64,69
1972-03-08,ATL,96,26,40,CHI,98,47,19,73,59
1972-03-09,HOU,114,25,39,POR,111,14,56,39,95
1972-03-09,SEA,123,44,22,PHL,128,26,41,70,63
1972-03-10,CIN,104,23,41,CHI,100,48,19,71,60
1972-03-10,LAL,132,55,11,CLE,98,21,47,76,58
1972-03-10,HOU,116,34,47,GOS,119,46,26,80,73
1972-03-11,NYK,106,40,25,PHX,110,42,29,82,54
1972-03-11,HOU,121,26,39,BUF,100,17,49,43,88
1972-03-12,BLT,102,32,35,DET,97,23,43,55,78
1972-03-12,BOS,112,46,23,NYK,109,40,26,86,49
1972-03-12,ATL,135,26,41,CLE,114,21,48,47,89
1972-03-12,LAL,141,56,11,BUF,102,17,50,73,61
1972-03-12,HOU,121,27,39,PHL,112,27,41,54,80
1972-03-12,SEA,99,44,23,MIL,109,53,14,97,37
1972-03-12,CIN,117,28,52,GOS,106,47,26,75,78
1972-03-14,BLT,118,33,35,CLE,127,21,49,54,84
1972-03-14,DET,116,23,44,LAL,129,57,11,80,55
1972-03-14,NYK,115,40,27,ATL,107,27,41,67,68
1972-03-14,CHI,111,48,20,SEA,115,44,24,92,44
1972-03-14,BUF,108,17,51,PHL,105,27,42,44,93
1972-03-14,POR,98,14,57,MIL,109,54,14,68,71
1972-03-14,BOS,124,55,26,GOS,110,47,27,102,53
1972-03-15,CIN,116,24,41,LAL,121,58,11,82,52
1972-03-15,PHL,115,27,43,BOS,120,47,23,74,66
1972-03-15,ATL,134,27,42,SEA,96,45,24,72,66
1972-03-15,PHX,110,43,29,MIL,106,55,14,98,43
1972-03-16,HOU,102,28,39,NYK,103,41,27,69,66
1972-03-16,CLE,101,22,49,BLT,105,33,36,55,85
1972-03-16,GOS,107,47,28,POR,94,17,63,64,91
1972-03-17,BLT,112,34,36,SEA,107,45,25,79,61
1972-03-17,DET,121,23,45,ATL,112,28,42,51,87
1972-03-17,PHL,111,27,44,BOS,127,48,23,75,67
1972-03-17,CHI,126,48,21,BUF,103,18,51,66,72
1972-03-17,LAL,123,59,11,MIL,107,55,15,114,26
1972-03-17,PHX,111,44,29,NYK,106,42,27,86,56
1972-03-17,POR,114,17,64,GOS,109,48,28,65,92
1972-03-18,ATL,115,28,43,CIN,106,24,42,52,85
1972-03-18,HOU,116,28,40,MIL,120,55,16,83,56
1972-03-18,BUF,116,18,52,DET,103,24,45,42,97
1972-03-18,CLE,91,22,50,CHI,109,49,21,71,71
1972-03-18,POR,133,14,58,NYK,86,42,28,56,86
1972-03-18,GOS,134,48,29,PHX,116,49,32,97,61
1972-03-19,BOS,112,49,23,BLT,125,35,36,84,59
1972-03-19,CIN,136,24,43,BUF,105,19,52,43,95
1972-03-19,DET,107,24,46,CHI,115,50,21,74,67
1972-03-19,PHL,115,27,45,SEA,100,45,26,72,71
1972-03-19,CLE,105,22,51,ATL,115,29,43,51,94
1972-03-19,LAL,162,68,13,GOS,99,49,29,117,42
1972-03-21,DET,120,24,47,CIN,117,25,43,49,90
1972-03-21,MIL,111,56,16,HOU,94,28,41,84,57
1972-03-21,PHL,111,28,45,ATL,117,30,43,58,88
1972-03-21,CHI,104,51,21,LAL,109,60,11,111,32
1972-03-21,PHX,160,45,29,POR,128,15,58,60,87
1972-03-21,BUF,114,19,53,BLT,100,36,36,55,89
1972-03-22,BOS,113,49,24,PHL,106,28,46,77,70
1972-03-22,CIN,135,25,44,DET,130,25,47,50,91
1972-03-22,ATL,107,31,43,HOU,106,28,42,59,85
1972-03-22,CLE,124,22,52,LAL,120,61,11,83,63
1972-03-22,NYK,123,42,29,BUF,99,20,53,62,82
1972-03-22,BLT,101,38,43,GOS,121,49,30,87,73
1972-03-24,CIN,132,26,44,BLT,114,36,37,62,81
1972-03-24,DET,112,25,48,BUF,105,20,54,45,102
1972-03-24,MIL,131,57,16,NYK,88,43,29,100,45
1972-03-24,LAL,112,61,12,PHX,110,46,29,107,41
1972-03-24,CLE,119,23,52,HOU,127,28,43,51,95
1972-03-24,PHL,99,28,47,CHI,116,51,22,79,69
1972-03-24,ATL,118,35,46,GOS,102,50,30,85,76
1972-03-25,BLT,85,36,38,HOU,106,29,43,65,81
1972-03-25,MIL,119,58,16,CIN,95,27,44,85,60
1972-03-25,CHI,121,52,22,DET,105,26,48,78,70
1972-03-25,PHX,118,46,30,SEA,99,45,27,91,57
1972-03-25,BUF,116,20,55,BOS,121,50,24,70,79
1972-03-25,NYK,98,43,30,CLE,83,23,53,66,83
1972-03-26,ATL,120,32,43,NYK,106,44,30,76,73
1972-03-26,LAL,124,62,12,SEA,98,45,28,107,40
1972-03-26,BLT,119,36,39,BUF,101,20,56,56,95
1972-03-26,BOS,133,51,24,DET,120,26,49,77,73
1972-03-26,HOU,131,30,43,POR,109,15,59,45,102
1972-03-26,PHL,115,30,51,GOS,116,50,31,80,82
1972-10-10,BUF,109,0,0,ATL,120,0,0,0,0
1972-10-10,CHI,95,0,0,PHL,89,0,0,0,0
1972-10-10,NYK,113,0,1,SEA,89,0,0,0,1
1972-10-11,DET,108,0,0,BOS,121,0,0,0,0
1972-10-11,PHL,100,0,1,SEA,105,0,1,0,2
1972-10-11,KCK,94,0,0,LAL,129,0,0,0,0
1972-10-13,PHX,105,0,0,MIL,117,0,0,0,0
1972-10-13,BOS,112,1,0,LAL,104,1,0,2,0
1972-10-13,PHL,101,0,2,BUF,104,0,1,0,3
1972-10-13,BLT,115,1,0,ATL,98,1,0,2,0
1972-10-13,DET,100,0,1,CHI,91,1,0,1,1
1972-10-13,POR,84,0,0,SEA,92,1,1,1,1
1972-10-14,POR,120,0,1,PHX,124,0,1,0,2
1972-10-14,BUF,113,1,1,HOU,121,0,0,1,1
1972-10-14,KCK,113,0,1,DET,101,1,1,1,2
1972-10-14,CHI,88,1,1,BOS,96,2,0,3,1
1972-10-14,GOS,77,0,0,MIL,81,1,0,1,0
1972-10-15,ATL,109,1,1,NYK,101,1,1,2,2
1972-10-15,PHX,107,1,1,BLT,98,2,0,3,1
1972-10-16,GOS,97,0,1,BLT,96,2,1,2,2
1972-10-17,ATL,115,2,1,BOS,119,3,0,5,1
1972-10-17,BUF,122,1,2,PHL,114,0,3,1,5
1972-10-17,POR,111,0,2,MIL,108,2,0,2,2
1972-10-19,KCK,83,1,1,BLT,94,2,2,3,3
1972-10-20,BOS,126,4,0,BUF,118,2,2,6,2
1972-10-20,HOU,120,1,0,ATL,108,2,2,3,2
1972-10-20,LAL,126,1,1,POR,104,1,2,2,3
1972-10-20,SEA,92,2,1,GOS,101,1,1,3,2
1972-10-20,MIL,109,2,1,DET,86,1,2,3,3
1972-10-21,PHX,129,2,1,SEA,117,2,2,4,3
1972-10-21,BLT,101,3,2,BOS,104,5,0,8,2
1972-10-21,KCK,108,1,2,ATL,101,2,3,3,5
1972-10-21,POR,97,1,3,GOS,104,2,1,3,4
1972-10-21,HOU,97,2,0,CHI,130,1,2,3,2
1972-10-21,DET,103,1,3,CLE,96,0,0,1,3
1972-10-21,BUF,63,2,3,MIL,91,3,1,5,4
1972-10-22,SEA,120,2,3,POR,119,1,4,3,7
1972-10-22,LAL,104,2,1,CHI,99,2,2,4,3
1972-10-23,BOS,105,6,0,PHL,85,0,4,6,4
1972-10-24,POR,110,1,5,ATL,118,2,4,3,9
1972-10-24,PHX,106,3,1,CHI,107,2,3,5,4
1972-10-24,BUF,97,2,4,BOS,105,7,0,9,4
1972-10-24,KCK,94,2,2,LAL,114,3,1,5,3
1972-10-24,NYK,123,1,2,CLE,90,0,1,1,3
1972-10-25,SEA,115,3,3,ATL,118,3,4,6,7
1972-10-25,PHL,108,0,5,CLE,113,0,2,0,7
1972-10-25,HOU,107,2,1,LAL,112,4,1,6,2
1972-10-25,DET,105,2,3,BLT,115,3,3,5,6
1972-10-25,MIL,109,4,1,BUF,92,2,5,6,6
1972-10-26,KCK,107,2,3,MIL,114,5,1,7,4
1972-10-26,GOS,93,3,1,CHI,94,3,3,6,4
1972-10-27,HOU,130,2,2,DET,118,2,4,4,6
1972-10-27,SEA,120,3,4,PHX,115,3,2,6,6
1972-10-27,BOS,123,8,0,CLE,97,1,2,9,2
1972-10-27,POR,95,1,6,CHI,118,4,3,5,9
1972-10-27,LAL,91,5,1,GOS,119,3,2,8,3
1972-10-27,BLT,88,4,3,NYK,92,2,2,6,5
1972-10-28,GOS,122,4,2,ATL,107,4,4,8,6
1972-10-28,BUF,102,2,6,KCK,113,2,4,4,10
1972-10-28,PHL,92,0,6,MIL,96,6,1,6,7
1972-10-29,LAL,133,5,2,PHX,123,3,3,8,5
1972-10-29,POR,111,1,7,DET,119,2,5,3,12
1972-10-29,SEA,94,4,4,CHI,95,5,3,9,7
1972-10-31,ATL,105,4,5,HOU,106,3,2,7,7
1972-10-31,GOS,112,5,2,DET,104,3,5,8,7
1972-10-31,CHI,104,6,3,KCK,95,3,4,9,7
1972-11-01,SEA,106,4,5,DET,116,3,6,7,11
1972-11-01,PHL,104,0,7,HOU,108,4,2,4,9
1972-11-01,KCK,85,3,5,NYK,122,3,2,6,7
1972-11-02,GOS,118,6,2,POR,104,1,8,7,10
1972-11-03,HOU,108,5,2,ATL,114,4,6,9,8
1972-11-03,LAL,116,6,2,DET,107,4,6,10,8
1972-11-03,PHL,101,0,8,KCK,114,3,6,3,14
1972-11-03,CHI,115,7,3,PHX,100,3,4,10,7
1972-11-03,BOS,109,9,0,BLT,96,4,4,13,4
1972-11-03,SEA,80,4,6,NYK,105,4,2,8,8
1972-11-04,ATL,128,5,6,PHL,120,0,9,5,15
1972-11-04,POR,120,1,9,LAL,134,7,2,8,11
1972-11-04,HOU,118,5,3,DET,108,4,7,9,10
1972-11-04,BOS,107,10,0,KCK,118,4,6,14,6
1972-11-04,MIL,104,7,1,PHX,105,3,5,10,6
1972-11-04,GOS,127,7,2,NYK,104,5,2,12,4
1972-11-04,BUF,101,2,7,CHI,99,8,3,10,10
1972-11-04,BLT,108,4,5,CLE,98,1,3,5,8
1972-11-05,SEA,115,4,7,LAL,124,8,2,12,9
1972-11-05,MIL,131,7,2,PHL,113,0,10,7,12
1972-11-06,POR,95,1,10,NYK,111,5,3,6,13
1972-11-07,LAL,122,9,2,HOU,109,6,3,15,5
1972-11-07,ATL,109,6,6,BLT,107,5,5,11,11
1972-11-07,BUF,91,3,7,GOS,105,8,2,11,9
1972-11-08,BOS,128,10,1,GOS,111,9,2,19,3
1972-11-08,KCK,125,5,6,PHL,107,0,11,5,17
1972-11-08,MIL,116,8,2,SEA,103,4,8,12,10
1972-11-08,PHX,107,4,5,CLE,99,1,4,5,9
1972-11-08,BLT,126,5,6,BUF,94,3,8,8,14
1972-11-09,NYK,101,6,3,ATL,99,7,6,13,9
1972-11-10,PHX,115,5,5,HOU,109,6,4,11,9
1972-11-10,SEA,106,4,9,KCK,111,6,6,10,15
1972-11-10,PHL,106,0,12,NYK,125,7,3,7,15
1972-11-10,BUF,104,3,9,BOS,106,11,1,14,10
1972-11-10,DET,121,4,8,GOS,96,9,3,13,11
1972-11-10,LAL,118,10,2,CLE,88,1,5,11,7
1972-11-10,MIL,120,9,2,BLT,82,6,6,15,8
1972-11-11,HOU,112,6,5,PHL,114,0,13,6,18
1972-11-11,BLT,106,6,7,CHI,111,8,4,14,11
1972-11-11,ATL,111,7,7,MIL,102,10,2,17,9
1972-11-11,BOS,121,12,1,DET,118,5,8,17,9
1972-11-12,PHX,119,6,5,PHL,108,1,13,7,18
1972-11-12,SEA,107,4,10,CLE,113,1,6,5,16
1972-11-12,POR,102,1,11,KCK,100,7,6,8,17
1972-11-14,ATL,105,8,7,GOS,114,9,4,17,11
1972-11-14,BLT,104,6,8,HOU,103,6,6,12,14
1972-11-14,KCK,106,7,7,BUF,100,3,10,10,17
1972-11-14,NYK,103,8,3,PHX,97,7,5,15,8
1972-11-14,MIL,92,10,3,LAL,95,11,2,21,5
1972-11-14,POR,100,2,11,CLE,91,2,6,4,17
1972-11-14,CHI,97,9,4,SEA,80,4,11,13,15
1972-11-15,DET,99,5,9,LAL,110,12,2,17,11
1972-11-15,KCK,106,8,7,SEA,97,4,12,12,19
1972-11-15,BOS,113,13,1,PHX,94,7,6,20,7
1972-11-16,GOS,128,10,4,PHL,106,1,14,11,18
1972-11-16,NYK,119,9,3,HOU,100,6,7,15,10
1972-11-17,BLT,117,7,8,PHX,106,7,7,14,15
1972-11-17,LAL,103,13,2,BUF,100,3,11,16,13
1972-11-17,POR,105,3,11,GOS,97,11,4,14,15
1972-11-17,DET,109,5,10,CHI,96,10,4,15,14
1972-11-17,KCK,115,9,7,CLE,96,2,7,11,14
1972-11-17,SEA,105,4,13,PHL,92,1,15,5,28
1972-11-17,BOS,88,14,1,MIL,95,10,4,24,5
1972-11-18,ATL,126,8,8,PHX,122,7,8,15,16
1972-11-18,KCK,127,10,7,HOU,117,6,8,16,15
1972-11-18,POR,100,4,11,SEA,102,5,13,9,24
1972-11-18,GOS,120,11,5,BUF,92,3,12,14,17
1972-11-18,NYK,87,10,3,MIL,86,11,4,21,7
1972-11-18,CHI,95,10,5,BLT,79,8,8,18,13
1972-11-19,LAL,135,14,2,PHL,95,1,16,15,18
1972-11-19,SEA,107,6,13,BUF,84,3,13,9,26
1972-11-21,DET,113,6,10,ATL,110,9,8,15,18
1972-11-21,CHI,113,11,5,HOU,105,6,9,17,14
1972-11-21,MIL,102,11,5,BOS,116,14,2,25,7
1972-11-21,KCK,101,11,7,PHX,96,7,9,18,16
1972-11-21,BUF,88,3,14,BLT,124,8,9,11,23
1972-11-22,BOS,126,15,2,POR,107,4,12,19,14
1972-11-22,HOU,132,6,10,GOS,104,12,5,18,15
1972-11-22,BLT,112,9,9,SEA,90,7,13,16,22
1972-11-23,PHX,128,7,10,DET,122,7,10,14,20
1972-11-23,ATL,110,9,9,SEA,97,7,14,16,23
1972-11-24,LAL,140,15,2,DET,123,7,11,22,13
1972-11-24,MIL,115,11,6,KCK,106,12,7,23,13
1972-11-24,BOS,114,16,2,NYK,97,11,3,27,5
1972-11-24,CHI,100,12,5,GOS,96,12,6,24,11
1972-11-24,PHL,96,1,17,BUF,105,3,15,4,32
1972-11-25,KCK,114,12,8,GOS,133,12,7,24,15
1972-11-25,HOU,114,7,10,SEA,109,7,15,14,25
1972-11-25,PHX,109,8,10,LAL,116,16,2,24,12
1972-11-25,PHL,106,1,18,POR,117,4,13,5,31
1972-11-25,ATL,99,10,9,CHI,100,13,5,23,14
1972-11-25,NYK,97,11,4,BOS,94,17,2,28,6
1972-11-25,BLT,91,10,9,MIL,101,12,6,22,15
1972-11-25,BUF,90,4,15,CLE,103,2,8,6,23
1972-11-26,LAL,112,17,2,PHX,107,8,11,25,13
1972-11-26,SEA,103,7,16,DET,96,7,12,14,28
1972-11-26,MIL,108,13,6,ATL,96,10,10,23,16
1972-11-28,DET,120,7,13,POR,116,5,13,12,26
1972-11-28,GOS,110,13,7,PHX,102,8,12,21,19
1972-11-28,BUF,94,4,16,PHL,101,1,19,5,35
1972-11-28,CHI,91,14,5,KCK,92,12,9,26,14
1972-11-28,HOU,90,8,10,BLT,108,10,10,18,20
1972-11-28,NYK,107,12,4,CLE,84,3,8,15,12
1972-11-29,KCK,110,13,9,POR,102,5,14,18,23
1972-11-29,PHX,109,8,13,ATL,98,10,11,18,24
1972-11-29,BOS,120,17,3,SEA,98,8,16,25,19
1972-11-29,MIL,105,14,6,CHI,97,14,6,28,12
1972-11-29,HOU,102,8,11,BLT,94,11,10,19,21
1972-11-29,PHL,91,2,19,NYK,139,13,4,15,23
1972-11-30,DET,127,8,13,BUF,116,4,17,12,30
1972-12-01,LAL,109,18,2,ATL,114,10,12,28,14
1972-12-01,PHX,115,9,13,GOS,106,14,7,23,20
1972-12-01,PHL,99,2,20,BOS,105,18,3,20,23
1972-12-01,KCK,97,14,9,CHI,106,14,7,28,16
1972-12-01,BLT,103,11,11,HOU,96,9,11,20,22
1972-12-01,BUF,93,4,18,SEA,90,8,17,12,35
1972-12-01,MIL,100,15,6,NYK,74,14,4,29,10
1972-12-02,BOS,131,19,3,PHL,120,2,21,21,24
1972-12-02,HOU,109,9,12,KCK,114,14,10,23,22
1972-12-02,POR,103,5,15,ATL,106,11,12,16,27
1972-12-02,GOS,103,14,8,LAL,112,18,3,32,11
1972-12-02,NYK,119,14,5,BUF,94,5,18,19,23
1972-12-02,CHI,89,15,7,SEA,80,8,18,23,25
1972-12-03,PHX,101,10,13,MIL,119,16,6,26,19
1972-12-05,ATL,122,12,12,POR,121,5,16,17,28
1972-12-05,CHI,130,16,7,DET,108,9,13,25,20
1972-12-05,NYK,125,15,5,KCK,103,15,10,30,15
1972-12-05,GOS,108,14,9,HOU,101,9,13,23,22
1972-12-05,CLE,100,3,9,BLT,103,12,11,15,20
1972-12-05,BUF,108,5,19,PHX,97,10,14,15,33
1972-12-05,LAL,116,19,3,MIL,94,17,6,36,9
1972-12-06,PHL,122,2,22,KCK,117,15,11,17,33
1972-12-06,DET,114,9,14,PHX,105,10,15,19,29
1972-12-06,BLT,115,13,11,POR,102,5,17,18,28
1972-12-06,SEA,95,8,19,MIL,91,17,7,25,26
1972-12-07,PHL,102,3,22,PHX,117,10,16,13,38
1972-12-07,CHI,89,17,7,ATL,94,13,12,30,19
1972-12-08,ATL,134,14,12,BLT,115,14,11,28,23
1972-12-08,HOU,114,9,14,POR,108,5,18,14,32
1972-12-08,PHL,102,3,23,CHI,118,17,8,20,31
1972-12-08,DET,113,10,14,KCK,100,15,12,25,26
1972-12-08,LAL,119,20,3,SEA,100,9,19,29,22
1972-12-08,MIL,124,17,8,GOS,91,15,9,32,17
1972-12-08,BUF,91,6,19,NYK,89,16,5,22,24
1972-12-08,CLE,87,3,10,BOS,96,20,3,23,13
1972-12-09,BLT,120,14,12,KCK,112,15,13,29,25
1972-12-09,NYK,120,16,6,PHL,109,3,24,19,30
1972-12-09,MIL,103,18,8,DET,107,11,14,29,22
1972-12-09,PHX,116,11,16,POR,97,5,19,16,35
1972-12-09,CHI,105,18,8,BUF,94,7,19,25,27
1972-12-09,BOS,123,21,3,CLE,88,3,11,24,14
1972-12-10,KCK,130,15,14,ATL,115,15,12,30,26
1972-12-10,SEA,110,9,20,PHX,102,12,16,21,36
1972-12-10,LAL,137,21,3,POR,101,5,20,26,23
1972-12-12,CHI,105,19,8,LAL,106,22,3,41,11
1972-12-12,BLT,123,15,12,PHL,102,3,25,18,37
1972-12-12,KCK,100,16,14,CLE,99,3,12,19,26
1972-12-12,BUF,95,7,20,HOU,94,10,14,17,34
1972-12-12,POR,94,5,21,MIL,115,18,9,23,30
1972-12-12,NYK,114,17,6,ATL,93,15,13,32,19
1972-12-13,ATL,121,15,14,NYK,120,18,6,33,20
1972-12-13,DET,107,12,14,GOS,110,15,10,27,24
1972-12-13,SEA,103,10,20,MIL,104,19,9,29,29
1972-12-13,PHX,100,12,17,BOS,105,22,3,34,20
1972-12-13,PHL,90,3,26,LAL,128,23,3,26,29
1972-12-15,KCK,140,17,14,DET,132,12,15,29,29
1972-12-15,LAL,98,24,3,BOS,102,23,3,47,6
1972-12-15,SEA,95,10,21,POR,96,5,22,15,43
1972-12-15,BUF,95,8,20,GOS,129,16,10,24,30
1972-12-15,BLT,94,16,12,HOU,91,10,15,26,27
1972-12-15,CHI,90,19,9,NYK,86,18,7,37,16
1972-12-15,MIL,98,20,9,CLE,82,3,13,23,22
1972-12-16,POR,116,6,22,BOS,123,24,3,30,25
1972-12-16,DET,112,12,16,HOU,123,10,16,22,32
1972-12-16,PHL,103,3,27,BUF,126,8,21,11,48
1972-12-16,BLT,105,17,12,GOS,99,17,10,34,22
1972-12-16,ATL,100,16,14,CLE,94,3,14,19,28
1972-12-16,NYK,97,18,8,CHI,83,20,9,38,17
1972-12-17,PHX,112,12,18,KCK,102,18,14,30,32
1972-12-17,SEA,98,10,22,BOS,123,25,3,35,25
1972-12-18,KCK,113,18,15,POR,95,6,23,24,38
1972-12-19,GOS,115,17,11,BOS,112,26,3,43,14
1972-12-19,ATL,119,17,14,KCK,102,19,15,36,29
1972-12-19,CHI,100,20,10,POR,109,6,24,26,34
1972-12-19,BUF,100,9,21,LAL,126,24,4,33,25
1972-12-19,PHX,117,13,18,NYK,84,19,8,32,26
1972-12-19,MIL,121,21,9,SEA,77,10,23,31,32
1972-12-20,DET,141,12,17,PHL,113,3,28,15,45
1972-12-20,KCK,121,19,16,SEA,110,10,24,29,40
1972-12-20,MIL,123,22,9,POR,104,7,24,29,33
1972-12-20,HOU,102,11,16,NYK,124,19,9,30,25
1972-12-20,BLT,90,18,12,LAL,96,25,4,43,16
1972-12-22,LAL,110,26,4,PHX,118,14,18,40,22
1972-12-22,BUF,109,9,22,ATL,110,18,14,27,36
1972-12-22,HOU,116,11,17,PHL,103,3,29,14,46
1972-12-22,DET,109,13,17,SEA,97,10,25,23,42
1972-12-22,POR,97,7,25,CHI,127,20,11,27,36
1972-12-22,KCK,90,20,16,BOS,118,26,4,46,20
1972-12-23,ATL,124,19,14,PHL,112,3,30,22,44
1972-12-23,GOS,127,18,11,CHI,109,21,11,39,22
1972-12-23,MIL,104,23,9,BOS,98,27,4,50,13
1972-12-23,BLT,104,18,13,DET,97,14,17,32,30
1972-12-25,POR,116,7,26,SEA,113,10,26,17,52
1972-12-25,PHX,115,15,18,CHI,108,21,12,36,30
1972-12-25,KCK,99,20,17,MIL,104,24,9,44,26
1972-12-26,HOU,113,12,17,PHX,110,16,18,28,35
1972-12-26,BOS,115,27,5,NYK,106,20,9,47,14
1972-12-26,DET,112,14,18,MIL,105,25,9,39,27
1972-12-26,BUF,104,9,23,BLT,121,19,13,28,36
1972-12-26,CHI,117,21,13,KCK,103,20,18,41,31
1972-12-26,GOS,95,19,11,SEA,97,10,27,29,38
1972-12-26,LAL,116,26,5,POR,92,8,26,34,31
1972-12-27,PHL,120,3,31,ATL,121,20,14,23,45
1972-12-27,HOU,136,13,17,LAL,104,27,5,40,22
1972-12-28,ATL,111,21,14,BLT,112,20,13,41,27
1972-12-28,GOS,118,19,12,CLE,105,3,15,22,27
1972-12-28,MIL,115,25,10,DET,91,15,18,40,28
1972-12-28,NYK,107,20,10,BUF,86,9,24,29,34
1972-12-29,BLT,109,21,13,BUF,118,9,25,30,38
1972-12-29,HOU,101,14,17,MIL,114,26,10,40,27
1972-12-29,BOS,99,28,5,CHI,106,22,13,50,18
1972-12-29,PHX,106,16,19,POR,99,8,27,24,46
1972-12-29,DET,94,15,19,NYK,99,21,10,36,29
1972-12-29,LAL,121,27,6,KCK,92,20,19,47,25
1972-12-29,SEA,99,11,27,CLE,91,3,16,14,43
1972-12-30,ATL,120,21,15,BUF,110,10,25,31,40
1972-12-30,GOS,113,20,12,KCK,107,20,20,40,32
1972-12-30,BOS,117,28,6,PHL,107,3,32,31,38
1972-12-30,POR,104,8,28,PHX,107,17,19,25,47
1972-12-30,NYK,100,22,10,BLT,98,21,14,43,24
1972-12-30,CHI,99,23,13,MIL,92,27,10,50,23
1973-01-01,SEA,103,12,27,LAL,108,28,6,40,33
1973-01-01,MIL,87,27,11,BLT,88,21,15,48,26
1973-01-02,BUF,114,10,26,PHL,110,3,33,13,59
1973-01-02,HOU,110,14,18,BOS,130,29,6,43,24
1973-01-02,GOS,112,21,12,LAL,106,29,6,50,18
1973-01-02,NYK,102,23,10,MIL,92,27,12,50,22
1973-01-02,CHI,100,24,13,ATL,90,22,15,46,28
1973-01-02,POR,104,8,29,KCK,87,20,21,28,50
1973-01-03,HOU,123,14,19,BOS,112,30,6,44,25
1973-01-03,DET,119,15,20,PHX,105,18,19,33,39
1973-01-03,SEA,107,12,28,KCK,100,20,22,32,50
1973-01-03,MIL,105,27,13,ATL,97,22,16,49,29
1973-01-03,BLT,89,22,15,CLE,80,3,17,25,32
1973-01-04,CHI,111,25,13,HOU,97,15,19,40,32
1973-01-04,GOS,108,22,12,POR,83,9,29,31,41
1973-01-05,CHI,115,26,13,PHX,126,18,20,44,33
1973-01-05,ATL,108,22,17,BOS,126,30,7,52,24
1973-01-05,BUF,106,11,26,NYK,129,24,10,35,36
1973-01-05,POR,135,9,30,PHL,102,3,34,12,64
1973-01-05,KCK,103,20,23,DET,100,16,20,36,43
1973-01-05,SEA,96,13,28,GOS,128,23,12,36,40
1973-01-06,KCK,112,21,23,PHX,118,19,20,40,43
1973-01-06,DET,111,16,21,ATL,116,22,18,38,39
1973-01-06,NYK,116,25,10,HOU,106,15,20,40,30
1973-01-06,MIL,110,28,13,BUF,96,11,27,39,40
1973-01-06,CLE,108,3,18,LAL,93,29,7,32,25
1973-01-06,GOS,111,24,12,PHL,79,3,35,27,47
1973-01-07,BLT,98,23,15,BOS,116,31,7,54,22
1973-01-07,POR,96,10,30,DET,101,16,22,26,52
1973-01-07,CHI,119,26,14,BUF,96,11,28,37,42
1973-01-07,MIL,99,29,13,LAL,92,29,8,58,21
1973-01-07,SEA,82,13,29,PHL,85,3,36,16,65
1973-01-09,KCK,115,21,24,NYK,116,26,10,47,34
1973-01-09,ATL,120,23,18,HOU,114,15,21,38,39
1973-01-09,CHI,126,27,14,PHL,110,4,36,31,50
1973-01-09,BUF,106,11,29,CLE,102,4,18,15,47
1973-01-09,GOS,105,25,12,DET,98,17,22,42,34
1973-01-09,POR,93,10,31,BLT,105,23,16,33,47
1973-01-10,PHX,123,20,20,DET,121,17,23,37,43
1973-01-10,BOS,128,32,7,HOU,107,15,22,47,29
1973-01-10,KCK,102,21,25,CHI,100,28,14,49,39
1973-01-10,PHL,96,4,37,LAL,120,29,9,33,46
1973-01-10,SEA,86,13,30,BLT,98,24,16,37,46
1973-01-11,KCK,109,22,25,GOS,108,26,12,48,37
1973-01-11,ATL,107,24,18,NYK,122,27,10,51,28
1973-01-12,PHL,109,4,38,CLE,113,4,19,8,57
1973-01-12,PHX,107,21,20,GOS,108,26,13,47,33
1973-01-12,SEA,113,13,31,DET,104,17,24,30,55
1973-01-12,HOU,103,15,23,NYK,104,28,10,43,33
1973-01-12,BUF,120,12,29,POR,100,10,32,22,61
1973-01-12,MIL,117,30,13,KCK,98,23,25,53,38
1973-01-12,CHI,97,28,15,LAL,109,30,9,58,24
1973-01-12,BOS,133,35,7,ATL,109,26,20,61,27
1973-01-13,HOU,115,15,24,CLE,123,5,19,20,43
1973-01-13,GOS,110,27,13,PHX,116,21,21,48,34
1973-01-13,PHL,95,4,39,BOS,111,33,7,37,46
1973-01-14,ATL,100,24,19,LAL,102,31,9,55,28
1973-01-14,MIL,100,31,13,CHI,95,28,16,59,29
1973-01-14,PHX,94,22,21,BLT,95,25,16,47,37
1973-01-14,SEA,84,14,31,NYK,86,29,10,43,41
1973-01-15,KCK,135,23,26,PHL,108,4,40,27,66
1973-01-15,DET,112,17,25,POR,101,10,33,27,58
1973-01-16,ATL,130,24,20,DET,129,18,25,42,45
1973-01-16,KCK,122,24,26,SEA,125,14,32,38,58
1973-01-16,LAL,104,32,9,BLT,112,26,16,58,25
1973-01-16,BUF,102,13,29,BOS,106,34,7,47,36
1973-01-16,PHX,101,22,22,NYK,102,30,10,52,32
1973-01-16,GOS,98,27,14,CLE,100,6,19,33,33
1973-01-16,MIL,108,32,13,PHL,92,4,41,36,54
1973-01-16,CHI,100,28,17,POR,89,10,34,38,51
1973-01-17,HOU,117,15,25,GOS,123,27,15,42,40
1973-01-17,PHL,105,4,42,ATL,122,25,20,29,62
1973-01-17,DET,104,18,26,SEA,106,15,32,33,58
1973-01-17,BOS,117,36,7,POR,99,10,35,46,42
1973-01-18,ATL,125,26,21,BUF,127,13,30,39,51
1973-01-18,PHX,96,22,23,KCK,119,24,27,46,50
1973-01-19,MIL,108,33,13,POR,105,10,36,43,49
1973-01-19,HOU,104,15,26,CLE,108,7,19,22,45
1973-01-19,BOS,124,37,7,SEA,104,16,32,53,39
1973-01-19,BUF,108,14,30,DET,98,18,27,32,57
1973-01-19,PHL,94,4,43,BLT,110,27,16,31,59
1973-01-19,LAL,95,32,10,NYK,88,31,10,63,20
1973-01-19,CHI,80,29,17,GOS,115,28,15,57,32
1973-01-20,HOU,115,15,27,POR,130,10,37,25,64
1973-01-20,BLT,126,28,16,SEA,106,16,33,44,49
1973-01-20,PHX,104,22,24,LAL,124,33,10,55,34
1973-01-20,DET,112,18,28,CHI,92,29,18,47,46
1973-01-20,ATL,96,26,22,CLE,84,8,19,34,41
1973-01-21,MIL,124,34,13,GOS,108,29,15,63,28
1973-01-21,HOU,107,15,28,NYK,103,31,11,46,39
1973-01-21,LAL,123,34,10,KCK,102,25,27,59,37
1973-01-21,BOS,104,38,7,BUF,97,15,30,53,37
1973-01-21,BLT,108,29,16,PHL,97,4,44,33,60
1973-01-25,MIL,125,35,13,HOU,129,16,28,51,41
1973-01-25,GOS,129,29,16,KCK,115,25,28,54,44
1973-01-25,PHX,112,22,25,SEA,109,16,34,38,59
1973-01-25,NYK,99,31,12,BUF,92,15,31,46,43
1973-01-26,BOS,139,39,7,HOU,126,17,28,56,35
1973-01-26,POR,116,11,37,PHX,120,23,25,34,62
1973-01-26,DET,105,19,28,MIL,117,35,14,54,42
1973-01-26,CHI,110,29,19,BLT,100,30,16,59,35
1973-01-26,LAL,100,35,10,GOS,84,30,16,65,26
1973-01-26,BUF,82,15,32,ATL,118,27,22,42,54
1973-01-27,ATL,129,28,22,KCK,126,25,29,53,51
1973-01-27,PHX,109,24,25,POR,117,11,38,35,63
1973-01-27,NYK,111,32,12,BOS,108,40,7,72,19
1973-01-27,GOS,107,30,17,LAL,122,36,10,66,27
1973-01-27,BLT,115,30,17,BUF,87,15,33,45,50
1973-01-28,HOU,116,17,29,ATL,108,29,22,46,51
1973-01-28,CHI,110,30,19,DET,105,19,29,49,48
1973-01-28,PHL,96,4,45,BUF,101,15,34,19,79
1973-01-28,LAL,130,37,10,SEA,94,16,35,53,45
1973-01-28,BOS,93,40,8,NYK,96,33,12,73,20
1973-01-28,CLE,93,8,20,BLT,102,31,17,39,37
1973-01-29,NYK,97,34,12,GOS,84,30,18,64,30
1973-01-30,ATL,123,29,23,DET,126,19,30,48,53
1973-01-30,POR,120,12,38,HOU,123,18,29,30,67
1973-01-30,BUF,105,16,34,PHL,104,4,46,20,80
1973-01-30,LAL,95,38,10,CHI,92,31,19,69,29
1973-01-30,BLT,104,32,17,GOS,86,30,19,62,36
1973-01-31,PHL,115,4,47,GOS,131,30,20,34,67
1973-01-31,SEA,118,16,36,HOU,109,19,29,35,65
1973-01-31,DET,94,20,30,NYK,91,35,12,55,42
1973-01-31,BOS,94,40,9,CLE,89,8,21,48,30
1973-02-01,PHX,106,24,26,LAL,120,39,10,63,36
1973-02-01,KCK,98,25,30,GOS,96,31,20,56,50
1973-02-02,LAL,126,40,10,HOU,109,19,30,59,40
1973-02-02,BUF,108,17,34,MIL,114,36,14,53,48
1973-02-02,DET,114,21,30,PHL,104,4,48,25,78
1973-02-02,SEA,118,17,36,CHI,104,31,20,48,56
1973-02-02,BOS,99,41,9,ATL,100,29,24,70,33
1973-02-02,BLT,89,33,17,NYK,77,35,13,68,30
1973-02-03,PHX,132,24,27,HOU,123,19,31,43,58
1973-02-03,ATL,105,30,24,BUF,101,17,35,47,59
1973-02-03,GOS,123,31,21,SEA,101,18,36,49,57
1973-02-03,PHL,100,4,49,BOS,104,41,10,45,59
1973-02-03,POR,97,12,39,KCK,105,26,30,38,69
1973-02-03,NYK,95,35,14,CLE,90,8,22,43,36
1973-02-04,HOU,130,19,32,BUF,118,17,36,36,68
1973-02-04,BOS,123,42,10,PHL,115,4,50,46,60
1973-02-04,BLT,115,34,17,LAL,125,41,10,75,27
1973-02-04,CHI,121,31,21,MIL,99,37,14,68,35
1973-02-04,SEA,98,18,37,KCK,120,27,30,45,67
1973-02-06,POR,117,12,40,SEA,118,18,38,30,78
1973-02-06,HOU,123,20,32,PHL,117,4,51,24,83
1973-02-06,MIL,126,37,15,PHX,111,25,27,62,42
1973-02-06,CHI,114,32,21,KCK,107,28,30,60,51
1973-02-06,ATL,112,31,24,BLT,106,34,18,65,42
1973-02-06,BUF,105,17,37,DET,107,22,30,39,67
1973-02-06,CLE,110,8,23,BOS,105,43,10,51,33
1973-02-06,NYK,90,36,14,LAL,95,42,10,78,24
1973-02-07,BOS,113,43,11,LAL,112,43,10,86,21
1973-02-07,BLT,137,34,19,ATL,108,32,24,66,43
1973-02-07,DET,113,23,30,PHX,107,25,28,48,58
1973-02-07,KCK,105,28,31,MIL,98,38,15,66,46
1973-02-08,ATL,132,32,25,CLE,136,9,23,41,48
1973-02-08,PHX,125,25,29,SEA,112,19,38,44,67
1973-02-08,GOS,123,32,21,POR,111,12,41,44,62
1973-02-09,HOU,116,21,32,KCK,121,29,31,50,63
1973-02-09,POR,116,12,42,PHL,105,4,52,16,94
1973-02-09,BUF,95,17,38,BLT,101,35,19,52,57
1973-02-09,BOS,95,44,11,DET,104,24,30,68,41
1973-02-09,MIL,109,38,16,LAL,88,43,11,81,27
1973-02-10,PHX,126,26,29,PHL,121,4,53,30,82
1973-02-10,MIL,135,39,16,GOS,108,33,21,72,37
1973-02-10,KCK,101,30,31,CHI,102,33,21,63,52
1973-02-10,NYK,107,36,15,DET,93,25,30,61,45
1973-02-10,ATL,103,32,26,HOU,91,21,33,53,59
1973-02-11,SEA,125,19,39,BUF,128,17,39,36,78
1973-02-11,POR,97,13,42,BLT,102,36,19,49,61
1973-02-11,CHI,96,34,21,GOS,101,33,22,67,43
1973-02-11,BOS,120,44,12,MIL,96,40,16,84,28
1973-02-11,LAL,108,43,12,PHL,90,4,54,47,66
1973-02-13,KCK,132,30,32,HOU,118,21,34,51,66
1973-02-13,CHI,101,34,22,BOS,105,45,12,79,34
1973-02-13,POR,120,13,43,BUF,100,18,39,31,82
1973-02-13,LAL,101,44,12,SEA,98,19,40,63,52
1973-02-13,DET,96,25,31,MIL,110,40,17,65,48
1973-02-14,PHX,124,27,29,BUF,107,18,40,45,69
1973-02-14,SEA,106,19,41,BLT,107,37,19,56,60
1973-02-14,PHL,106,4,55,MIL,104,41,17,45,72
1973-02-14,KCK,101,31,32,BOS,104,46,12,77,44
1973-02-14,NYK,98,37,15,CHI,100,34,23,71,38
1973-02-15,GOS,94,34,22,BLT,96,38,19,72,41
1973-02-16,SEA,114,19,42,GOS,108,34,23,53,65
1973-02-16,PHL,119,5,55,DET,106,25,32,30,87
1973-02-16,POR,105,14,43,BOS,112,47,12,61,55
1973-02-16,PHX,104,28,29,ATL,111,33,26,61,55
1973-02-16,MIL,105,41,18,HOU,103,21,35,62,53
1973-02-16,LAL,121,45,12,BLT,103,39,19,84,31
1973-02-16,BUF,98,18,41,NYK,102,37,16,55,57
1973-02-16,CHI,100,35,23,CLE,92,10,23,45,46
1973-02-17,HOU,127,21,36,PHX,111,28,30,49,66
1973-02-17,GOS,106,34,24,BOS,110,48,12,82,36
1973-02-17,DET,104,25,33,CLE,106,10,24,35,57
1973-02-17,MIL,111,42,18,KCK,104,31,33,73,51
1973-02-17,POR,103,14,44,LAL,110,46,12,60,56
1973-02-17,NYK,107,38,16,PHL,89,6,55,44,71
1973-02-18,PHX,118,28,31,POR,119,14,45,42,76
1973-02-18,SEA,105,20,42,BOS,106,49,12,69,54
1973-02-18,DET,144,25,34,KCK,100,31,34,56,68
1973-02-18,HOU,99,22,36,CHI,110,36,23,58,59
1973-02-18,PHL,114,6,56,NYK,98,39,16,45,72
1973-02-18,BLT,96,39,20,MIL,93,43,18,82,38
1973-02-18,LAL,92,47,12,ATL,99,34,26,81,38
1973-02-20,GOS,118,34,25,ATL,115,35,26,69,51
1973-02-20,NYK,110,39,17,POR,106,15,45,54,62
1973-02-20,BUF,113,18,42,KCK,106,31,35,49,77
1973-02-20,MIL,118,43,19,CLE,100,11,24,54,43
1973-02-20,BOS,107,50,12,PHX,97,28,32,78,44
1973-02-20,CHI,103,37,23,LAL,89,47,13,84,36
1973-02-21,HOU,139,22,37,SEA,107,20,43,42,80
1973-02-21,DET,106,26,34,LAL,98,47,14,73,48
1973-02-21,BLT,98,40,20,PHX,107,28,33,68,53
1973-02-22,KCK,113,31,36,MIL,116,44,19,75,55
1973-02-23,SEA,124,20,44,ATL,120,35,27,55,71
1973-02-23,PHL,116,7,56,HOU,138,23,37,30,93
1973-02-23,LAL,106,47,15,GOS,111,35,25,82,40
1973-02-23,BUF,106,19,42,PHX,125,29,33,48,75
1973-02-23,DET,107,27,34,BLT,105,40,21,67,55
1973-02-23,CHI,84,38,23,NYK,83,40,17,78,40
1973-02-24,BLT,128,40,22,POR,110,15,46,55,68
1973-02-24,CHI,122,39,23,PHX,100,30,33,69,56
1973-02-24,NYK,125,40,18,BUF,97,19,43,59,61
1973-02-24,GOS,102,36,25,MIL,93,45,19,81,44
1973-02-25,DET,129,28,34,HOU,112,24,37,52,71
1973-02-25,PHL,115,7,57,POR,111,15,47,22,104
1973-02-25,KCK,109,31,37,PHX,111,30,34,61,71
1973-02-25,SEA,85,21,44,CHI,88,40,23,61,67
1973-02-25,LAL,91,47,16,MIL,82,45,20,92,36
1973-02-27,ATL,131,35,28,SEA,130,21,45,56,73
1973-02-27,POR,110,15,48,CHI,125,41,23,56,71
1973-02-27,BUF,105,19,44,HOU,112,24,38,43,82
1973-02-27,LAL,103,48,16,KCK,107,31,38,79,54
1973-02-27,DET,114,29,34,GOS,100,37,25,66,59
1973-02-27,BLT,99,41,22,CLE,95,11,25,52,47
1973-02-27,NYK,123,41,18,BOS,91,51,12,92,30
1973-02-28,BOS,118,51,13,GOS,111,37,26,88,39
1973-02-28,MIL,124,45,21,SEA,110,21,46,66,67
1973-02-28,PHX,107,31,34,KCK,109,32,38,63,72
1973-02-28,PHL,102,8,57,BLT,96,42,22,50,79
1973-03-01,MIL,114,46,21,NYK,100,42,18,88,39
1973-03-02,BUF,120,19,45,SEA,139,21,47,40,92
1973-03-02,GOS,117,37,27,KCK,112,33,38,70,65
1973-03-02,PHL,107,9,57,ATL,130,36,28,45,85
1973-03-02,DET,101,30,34,BOS,115,52,13,82,47
1973-03-02,POR,106,15,49,CLE,92,11,26,26,75
1973-03-02,LAL,108,48,17,CHI,88,42,23,90,40
1973-03-03,ATL,136,37,28,HOU,125,25,38,62,66
1973-03-03,GOS,116,38,27,CHI,117,42,24,80,51
1973-03-03,DET,113,30,35,SEA,115,22,47,52,82
1973-03-03,NYK,75,42,19,BLT,97,42,23,84,42
1973-03-04,BLT,106,0,0,NYK,97,0,0,0,0
1973-03-04,ATL,138,38,28,PHL,130,9,58,47,86
1973-03-04,PHX,117,31,35,CHI,118,43,24,74,59
1973-03-04,BOS,125,53,13,BUF,113,19,46,72,59
1973-03-04,POR,109,16,49,DET,113,30,36,46,85
1973-03-04,HOU,101,25,39,MIL,116,47,21,72,60
1973-03-04,LAL,127,49,17,CLE,84,11,27,60,44
1973-03-06,BUF,112,19,47,BOS,127,54,13,73,60
1973-03-06,PHX,110,31,36,CLE,102,11,28,42,64
1973-03-06,POR,102,16,50,LAL,114,50,17,66,67
1973-03-06,NYK,106,42,20,SEA,94,23,47,65,67
1973-03-06,GOS,108,38,28,DET,93,31,36,69,64
1973-03-06,MIL,96,48,21,CHI,88,44,24,92,45
1973-03-07,HOU,100,25,40,CLE,118,11,29,36,69
1973-03-07,PHL,94,9,59,NYK,120,43,20,52,79
1973-03-08,PHX,134,32,36,BOS,141,55,13,87,49
1973-03-08,ATL,135,39,28,POR,129,16,51,55,79
1973-03-08,BUF,112,19,48,CHI,102,44,25,63,73
1973-03-08,KCK,105,33,39,BLT,93,43,23,76,62
1973-03-09,LAL,111,51,17,BOS,119,56,13,107,30
1973-03-09,HOU,104,25,41,BLT,109,43,24,68,65
1973-03-09,MIL,116,49,21,POR,96,16,52,65,73
1973-03-09,PHL,84,9,60,CHI,104,44,26,53,86
1973-03-10,HOU,131,25,42,CLE,116,12,29,37,71
1973-03-10,ATL,117,40,28,GOS,113,39,28,79,56
1973-03-10,PHX,110,32,37,DET,117,31,37,63,74
1973-03-10,NYK,125,44,20,KCK,102,34,39,78,59
1973-03-10,BUF,106,20,48,POR,101,16,53,36,101
1973-03-10,BLT,99,44,24,CHI,105,45,26,89,50
1973-03-10,PHL,96,9,61,SEA,106,23,48,32,109
1973-03-11,HOU,129,26,42,ATL,118,41,28,67,70
1973-03-11,LAL,141,51,18,DET,117,32,37,83,55
1973-03-11,BOS,122,57,13,NYK,107,45,20,102,33
1973-03-11,PHL,93,9,62,GOS,97,39,29,48,91
1973-03-12,MIL,126,50,21,PHX,95,32,38,82,59
1973-03-13,BUF,112,21,48,LAL,121,52,18,73,66
1973-03-13,NYK,115,45,21,PHX,111,32,39,77,60
1973-03-13,POR,101,16,54,GOS,109,40,29,56,83
1973-03-13,BLT,103,44,25,KCK,99,34,40,78,65
1973-03-13,CHI,104,46,26,SEA,89,24,48,70,74
1973-03-14,PHL,114,9,63,PHX,120,32,40,41,103
1973-03-14,DET,112,32,38,LAL,121,53,18,85,56
1973-03-14,BOS,111,58,13,BLT,107,45,25,103,38
1973-03-15,GOS,141,41,29,HOU,125,27,42,68,71
1973-03-16,POR,141,16,55,HOU,128,27,43,43,98
1973-03-16,ATL,135,41,29,PHX,127,33,40,74,69
1973-03-16,SEA,116,24,49,GOS,106,42,29,66,78
1973-03-16,DET,121,32,39,BUF,100,21,49,53,88
1973-03-16,LAL,98,54,18,NYK,109,46,21,100,39
1973-03-16,BLT,103,45,26,BOS,97,59,13,104,39
1973-03-16,CHI,91,47,26,MIL,99,51,21,98,47
1973-03-17,PHL,115,9,64,BLT,120,46,26,55,90
1973-03-17,GOS,108,42,30,NYK,117,47,21,89,51
1973-03-17,CHI,97,47,27,DET,99,33,39,80,66
1973-03-17,BUF,97,21,50,CLE,114,12,30,33,80
1973-03-18,BLT,129,47,26,PHL,118,9,65,56,91
1973-03-18,LAL,131,54,19,PHX,113,33,41,87,60
1973-03-18,SEA,121,25,49,HOU,112,27,44,52,93
1973-03-18,DET,107,34,39,CHI,119,47,28,81,67
1973-03-18,BOS,109,59,14,KCK,105,34,41,93,55
1973-03-18,ATL,104,42,29,MIL,105,52,21,94,50
1973-03-18,POR,99,17,55,NYK,96,48,21,65,76
1973-03-19,KCK,106,34,42,POR,105,18,55,52,97
1973-03-19,MIL,118,53,21,DET,99,34,40,87,61
1973-03-20,KCK,119,35,42,BUF,115,21,51,56,93
1973-03-20,ATL,114,42,30,LAL,112,55,19,97,49
1973-03-20,CHI,123,48,28,POR,109,18,56,66,84
1973-03-20,GOS,114,42,31,SEA,106,26,49,68,80
1973-03-20,BOS,94,60,14,HOU,89,27,45,87,59
1973-03-21,PHX,134,33,42,BUF,124,21,52,54,94
1973-03-21,KCK,118,36,42,LAL,124,55,20,91,62
1973-03-21,BLT,110,48,26,HOU,118,27,46,75,72
1973-03-21,PHL,109,9,66,CLE,112,13,30,22,96
1973-03-21,DET,122,34,41,POR,109,18,57,52,98
1973-03-21,BOS,106,61,14,CHI,105,49,28,110,42
1973-03-21,SEA,96,26,50,MIL,119,54,21,80,71
1973-03-21,NYK,93,48,22,ATL,98,43,30,91,52
1973-03-22,GOS,98,43,31,MIL,108,55,21,98,52
1973-03-23,SEA,112,26,51,POR,118,18,58,44,109
1973-03-23,PHL,112,9,67,HOU,132,28,46,37,113
1973-03-23,BOS,124,62,14,ATL,108,44,30,106,44
1973-03-23,CLE,104,14,30,BLT,106,48,27,62,57
1973-03-23,LAL,121,56,20,BUF,101,21,53,77,73
1973-03-23,PHX,125,36,43,GOS,124,44,34,80,77
1973-03-24,BLT,120,49,27,CLE,116,14,31,63,58
1973-03-24,ATL,113,44,31,CHI,111,49,29,93,60
1973-03-24,NYK,103,48,23,BOS,108,63,14,111,37
1973-03-24,GOS,106,43,32,BUF,101,21,54,64,86
1973-03-24,DET,110,35,41,KCK,98,36,43,71,84
1973-03-25,HOU,121,29,46,BOS,125,64,14,93,60
1973-03-25,PHX,112,34,42,MIL,114,56,21,90,63
1973-03-25,POR,113,19,58,BUF,107,21,55,40,113
1973-03-25,BLT,112,50,27,ATL,105,45,31,95,58
1973-03-25,PHL,96,9,68,DET,115,36,41,45,109
1973-03-25,SEA,93,26,52,LAL,109,57,20,83,72
1973-03-26,GOS,114,44,32,PHX,120,34,43,78,75
1973-03-26,POR,99,20,58,MIL,118,57,21,77,79
1973-03-27,HOU,121,29,47,BUF,111,21,56,50,103
1973-03-27,ATL,110,45,32,BOS,117,65,14,110,46
1973-03-27,CHI,121,49,30,CLE,105,14,32,63,62
1973-03-27,BLT,98,51,27,DET,112,37,41,88,68
1973-03-27,LAL,84,58,20,MIL,85,58,21,116,41
1973-03-28,SEA,125,26,53,PHX,127,35,43,61,96
1973-03-28,HOU,138,30,47,BUF,122,21,57,51,104
1973-03-28,BOS,120,66,14,BLT,101,51,28,117,42
1973-03-28,GOS,89,44,33,LAL,96,58,21,102,54
1973-10-09,BUF,107,0,0,HOU,105,0,0,0,0
1973-10-09,NYK,101,0,0,DET,100,0,0,0,0
1973-10-09,ATL,128,0,0,CAP,114,0,0,0,0
1973-10-09,CHI,97,0,0,LAL,117,0,0,0,0
1973-10-10,PHL,88,0,0,HOU,104,0,1,0,1
1973-10-10,KCK,90,0,0,CHI,105,0,1,0,1
1973-10-10,PHX,115,0,0,SEA,111,0,0,0,0
1973-10-11,ATL,129,1,0,LAL,102,1,0,2,0
1973-10-12,BOS,118,0,0,BUF,112,1,0,1,0
1973-10-12,CLE,99,0,0,HOU,106,1,1,1,1
1973-10-12,DET,122,0,1,ATL,105,2,0,2,1
1973-10-12,KCK,88,0,1,CHI,84,1,1,1,2
1973-10-12,PHX,84,1,0,MIL,107,0,0,1,0
1973-10-12,SEA,103,0,1,CAP,102,0,1,0,2
1973-10-13,BUF,122,1,1,LAL,125,1,1,2,2
1973-10-13,NYK,85,1,0,HOU,86,2,1,3,1
1973-10-13,PHL,106,0,1,BOS,111,1,0,1,1
1973-10-13,ATL,102,2,1,KCK,117,1,1,3,2
1973-10-13,CHI,101,1,2,DET,94,1,1,2,3
1973-10-13,POR,132,0,0,CAP,87,0,2,0,2
1973-10-13,GOS,85,0,0,MIL,97,1,0,1,0
1973-10-14,CLE,83,0,1,DET,95,1,2,1,3
1973-10-14,SEA,109,1,1,MIL,100,2,0,3,1
1973-10-14,PHX,95,1,1,GOS,120,0,1,1,2
1973-10-16,NYK,117,1,1,BUF,91,1,2,2,3
1973-10-16,HOU,101,3,1,PHL,106,0,2,3,3
1973-10-17,MIL,109,2,1,GOS,95,1,1,3,2
1973-10-17,SEA,106,2,1,KCK,108,2,1,4,2
1973-10-19,BOS,133,2,0,PHL,102,1,2,3,2
1973-10-19,CLE,90,0,2,NYK,92,2,1,2,3
1973-10-19,CHI,117,2,2,CAP,103,0,3,2,5
1973-10-19,DET,94,2,2,MIL,96,3,1,5,3
1973-10-19,LAL,118,2,1,SEA,91,2,2,4,3
1973-10-19,POR,111,1,0,KCK,99,3,1,4,1
1973-10-20,BUF,116,1,3,PHL,110,1,3,2,6
1973-10-20,NYK,69,3,1,CHI,85,3,2,6,3
1973-10-20,CAP,96,0,4,BOS,87,3,0,3,4
1973-10-20,HOU,104,3,2,DET,107,2,3,5,5
1973-10-20,POR,123,2,0,SEA,108,2,3,4,3
1973-10-20,PHX,118,1,2,ATL,108,2,2,3,4
1973-10-20,GOS,100,1,2,KCK,81,3,2,4,4
1973-10-21,CAP,99,1,4,CHI,107,4,2,5,6
1973-10-21,LAL,100,3,1,ATL,119,2,3,5,4
1973-10-21,SEA,116,2,4,PHX,112,2,2,4,6
1973-10-23,NYK,84,3,2,CAP,101,1,5,4,7
1973-10-23,HOU,98,3,3,LAL,107,3,2,6,5
1973-10-23,GOS,121,2,2,PHX,109,2,3,4,5
1973-10-24,BOS,117,3,1,HOU,132,3,4,6,5
1973-10-24,PHL,132,1,4,POR,110,3,0,4,4
1973-10-24,KCK,91,3,3,LAL,92,4,2,7,5
1973-10-24,MIL,130,4,1,BUF,113,2,3,6,4
1973-10-24,PHX,99,2,4,DET,115,3,3,5,7
1973-10-24,SEA,106,3,4,ATL,131,3,3,6,7
1973-10-26,BOS,113,3,2,NYK,101,3,3,6,5
1973-10-26,BUF,104,2,4,CLE,97,0,3,2,7
1973-10-26,PHL,92,2,4,MIL,98,5,1,7,5
1973-10-26,CHI,121,5,2,HOU,113,4,4,9,6
1973-10-26,KCK,98,3,4,PHX,93,2,5,5,9
1973-10-26,LAL,94,5,2,DET,92,4,3,9,5
1973-10-26,POR,127,3,1,ATL,110,4,3,7,4
1973-10-26,SEA,110,3,5,GOS,117,3,2,6,7
1973-10-27,NYK,96,3,4,PHL,90,2,5,5,9
1973-10-27,HOU,92,4,5,CHI,102,6,2,10,7
1973-10-27,MIL,104,6,1,PHX,95,2,6,8,7
1973-10-27,POR,98,4,1,DET,111,4,4,8,5
1973-10-27,GOS,116,4,2,ATL,125,4,4,8,6
1973-10-28,CAP,119,2,5,PHL,99,2,6,4,11
1973-10-28,CLE,102,0,4,BOS,99,4,2,4,6
1973-10-28,KCK,100,4,4,BUF,112,3,4,7,8
1973-10-28,LAL,111,6,2,POR,98,4,2,10,4
1973-10-28,SEA,93,3,6,DET,115,5,4,8,10
1973-10-30,BUF,105,4,4,SEA,103,3,7,7,11
1973-10-30,ATL,122,5,4,PHX,101,2,7,7,11
1973-10-30,KCK,78,4,5,MIL,112,7,1,11,6
1973-10-30,POR,114,4,3,LAL,112,7,2,11,5
1973-10-31,BOS,128,4,3,CLE,110,1,4,5,7
1973-10-31,HOU,91,4,6,NYK,102,4,4,8,10
1973-10-31,DET,114,6,4,SEA,107,3,8,9,12
1973-11-02,BOS,108,5,3,GOS,105,4,3,9,6
1973-11-02,DET,114,7,4,PHX,107,2,8,9,12
1973-11-02,HOU,123,4,7,ATL,125,6,4,10,11
1973-11-02,KCK,109,4,6,SEA,115,3,9,7,15
1973-11-02,LAL,91,7,3,NYK,106,5,4,12,7
1973-11-02,CLE,100,1,5,MIL,118,8,1,9,6
1973-11-02,CHI,107,7,2,BUF,97,5,4,12,6
1973-11-03,BUF,121,5,5,GOS,124,4,4,9,9
1973-11-03,PHL,84,2,7,CAP,112,3,5,5,12
1973-11-03,ATL,109,7,4,BOS,122,6,3,13,7
1973-11-03,CHI,105,8,2,CLE,94,1,6,9,8
1973-11-03,MIL,123,9,1,DET,115,8,4,17,5
1973-11-03,POR,107,5,3,NYK,100,6,4,11,7
1973-11-04,CAP,102,4,5,PHX,99,2,9,6,14
1973-11-04,CLE,110,1,7,ATL,115,7,5,8,12
1973-11-04,KCK,91,4,7,GOS,92,5,4,9,11
1973-11-04,SEA,106,4,9,NYK,111,6,5,10,14
1973-11-04,LAL,106,7,4,HOU,93,4,8,11,12
1973-11-04,CHI,101,53,28,BUF,95,39,36,92,64
1973-11-06,CLE,115,1,8,LAL,96,8,4,9,12
1973-11-07,PHL,122,2,8,PHX,115,2,10,4,18
1973-11-07,HOU,97,4,9,CAP,111,5,5,9,14
1973-11-07,MIL,109,10,1,LAL,92,8,5,18,6
1973-11-07,SEA,130,4,10,BUF,113,5,6,9,16
1973-11-08,ATL,115,8,5,DET,129,8,5,16,10
1973-11-08,GOS,111,6,4,CHI,112,9,2,15,6
1973-11-08,NYK,84,45,32,BOS,94,52,24,97,56
1973-11-09,BOS,122,7,3,PHX,107,2,11,9,14
1973-11-09,PHL,94,3,8,NYK,91,7,5,10,13
1973-11-09,CLE,111,2,8,HOU,106,4,10,6,18
1973-11-09,KCK,96,4,8,CAP,109,6,5,10,13
1973-11-09,POR,122,6,3,BUF,108,5,7,11,10
1973-11-09,SEA,111,5,10,LAL,118,8,6,13,16
1973-11-10,BOS,102,8,3,DET,97,9,5,17,8
1973-11-10,NYK,100,7,6,CLE,90,3,8,10,14
1973-11-10,ATL,120,8,6,PHL,97,4,8,12,14
1973-11-10,MIL,84,11,1,KCK,83,4,9,15,10
1973-11-10,POR,104,7,3,CHI,106,10,2,17,5
1973-11-10,GOS,128,6,5,BUF,105,5,8,11,13
1973-11-11,CAP,91,7,5,MIL,110,12,1,19,6
1973-11-11,SEA,98,5,11,CHI,116,11,2,16,13
1973-11-13,BUF,121,5,9,ATL,114,9,6,14,15
1973-11-13,NYK,104,8,6,SEA,102,5,12,13,18
1973-11-13,HOU,97,4,11,PHL,83,4,9,8,20
1973-11-13,MIL,108,13,1,POR,100,7,4,20,5
1973-11-13,PHX,116,2,12,CHI,108,12,2,14,14
1973-11-13,GOS,128,7,5,CLE,115,3,9,10,14
1973-11-14,BOS,110,9,3,SEA,104,5,13,14,16
1973-11-14,DET,108,9,6,POR,111,7,5,16,11
1973-11-14,KCK,118,4,10,HOU,116,5,11,9,21
1973-11-15,NYK,97,9,6,BUF,86,6,9,15,15
1973-11-15,ATL,123,9,7,POR,114,8,5,17,12
1973-11-15,PHX,116,3,12,PHL,94,4,10,7,22
1973-11-16,BOS,105,10,3,MIL,90,14,1,24,4
1973-11-16,DET,125,9,7,KCK,98,5,10,14,17
1973-11-16,LAL,118,9,6,CHI,102,12,3,21,9
1973-11-16,SEA,117,5,14,CLE,93,3,10,8,24
1973-11-17,BUF,94,6,10,DET,98,10,7,16,17
1973-11-17,ATL,109,10,7,CAP,115,7,6,17,13
1973-11-17,HOU,87,5,12,POR,96,8,6,13,18
1973-11-17,KCK,110,5,11,BOS,123,11,3,16,14
1973-11-17,PHX,110,4,12,LAL,130,10,6,14,18
1973-11-17,GOS,106,8,5,PHL,109,4,11,12,16
1973-11-18,CAP,101,8,6,BUF,112,6,11,14,17
1973-11-18,LAL,102,11,6,CLE,100,3,11,14,17
1973-11-18,SEA,95,6,14,PHL,91,5,11,11,25
1973-11-18,DET,102,11,7,CHI,104,12,4,23,11
1973-11-20,BUF,127,7,11,PHX,100,4,13,11,24
1973-11-20,NYK,105,10,6,LAL,89,12,6,22,12
1973-11-20,CHI,106,13,4,POR,101,9,6,22,10
1973-11-20,MIL,105,14,2,GOS,108,8,6,22,8
1973-11-20,KCK,103,5,12,PHL,109,5,12,10,24
1973-11-21,CAP,97,8,7,LAL,106,12,7,20,14
1973-11-21,DET,107,11,8,PHX,104,4,14,15,22
1973-11-21,KCK,90,5,13,PHL,103,6,12,11,25
1973-11-22,ATL,99,10,8,GOS,101,9,6,19,14
1973-11-22,MIL,107,14,3,NYK,91,11,6,25,9
1973-11-22,POR,131,9,7,SEA,125,7,14,16,21
1973-11-22,HOU,96,5,13,CLE,104,3,12,8,25
1973-11-23,BOS,119,12,3,KCK,102,5,14,17,17
1973-11-23,PHL,106,7,12,GOS,111,10,6,17,18
1973-11-23,CAP,101,8,8,ATL,86,10,9,18,17
1973-11-23,HOU,83,5,14,CLE,85,4,12,9,26
1973-11-23,CHI,94,14,4,PHX,99,4,15,18,19
1973-11-23,SEA,127,7,15,POR,106,10,7,17,22
1973-11-24,BUF,143,8,11,KCK,131,5,15,13,26
1973-11-24,NYK,99,11,7,GOS,107,11,6,22,13
1973-11-24,ATL,92,10,10,MIL,112,15,3,25,13
1973-11-24,CHI,114,14,5,DET,112,12,8,26,13
1973-11-24,POR,108,10,8,LAL,113,13,7,23,15
1973-11-25,CAP,109,9,8,NYK,81,11,8,20,16
1973-11-25,KCK,99,5,16,SEA,104,8,15,13,31
1973-11-25,LAL,137,14,7,POR,109,10,9,24,16
1973-11-25,CLE,101,5,12,BOS,107,13,3,18,15
1973-11-25,MIL,105,16,3,PHL,96,7,13,23,16
1973-11-27,BUF,110,9,11,MIL,115,17,3,26,14
1973-11-27,CLE,120,5,13,SEA,118,9,15,14,28
1973-11-27,HOU,125,5,15,PHX,111,5,15,10,30
1973-11-27,CHI,123,15,5,GOS,117,12,6,27,11
1973-11-27,KCK,110,5,17,ATL,129,10,11,15,28
1973-11-28,BOS,111,14,3,CAP,104,10,8,24,11
1973-11-28,NYK,106,11,9,HOU,114,6,15,17,24
1973-11-28,PHL,101,7,14,CHI,96,16,5,23,19
1973-11-28,ATL,130,11,11,BUF,106,9,12,20,23
1973-11-28,DET,91,12,9,CLE,96,6,13,18,22
1973-11-28,MIL,127,18,3,SEA,93,9,16,27,19
1973-11-29,PHX,119,5,16,KCK,99,5,18,10,34
1973-11-29,GOS,119,12,7,POR,89,10,10,22,17
1973-11-30,BUF,113,9,13,CAP,121,10,9,19,22
1973-11-30,CLE,112,7,13,PHL,110,8,14,15,27
1973-11-30,HOU,110,7,15,DET,95,12,10,19,25
1973-11-30,CHI,115,16,6,NYK,97,11,10,27,16
1973-11-30,MIL,117,19,3,BOS,93,15,3,34,6
1973-11-30,LAL,123,15,7,KCK,107,5,19,20,26
1973-11-30,POR,99,10,11,PHX,107,6,16,16,27
1973-12-01,BOS,120,15,4,CHI,98,17,6,32,10
1973-12-01,NYK,119,11,11,CLE,99,8,13,19,24
1973-12-01,PHL,108,8,15,HOU,106,8,15,16,30
1973-12-01,ATL,120,12,11,SEA,110,9,17,21,28
1973-12-01,PHX,109,7,16,DET,121,12,11,19,27
1973-12-01,POR,134,10,12,LAL,115,16,7,26,19
1973-12-01,GOS,120,13,7,KCK,108,5,20,18,27
1973-12-02,CAP,98,11,9,SEA,96,9,18,20,27
1973-12-02,CLE,104,8,14,HOU,130,8,16,16,30
1973-12-02,LAL,108,16,8,DET,114,13,11,29,19
1973-12-04,CHI,130,17,7,SEA,107,9,19,26,26
1973-12-04,MIL,124,20,3,HOU,109,9,16,29,19
1973-12-04,GOS,93,14,7,DET,112,14,11,28,18
1973-12-04,LAL,120,16,9,PHX,103,7,17,23,26
1973-12-04,NYK,113,45,33,POR,100,27,52,72,85
1973-12-05,BOS,119,16,4,NYK,97,12,11,28,15
1973-12-05,PHL,75,9,15,CLE,89,8,15,17,30
1973-12-05,HOU,119,9,17,CAP,99,12,9,21,26
1973-12-05,KCK,117,5,21,ATL,105,13,11,18,32
1973-12-05,PHX,103,7,18,GOS,97,14,8,21,26
1973-12-05,BUF,114,9,14,POR,110,11,12,20,26
1973-12-06,SEA,108,9,20,DET,110,15,11,24,31
1973-12-06,CHI,103,18,7,PHL,98,9,16,27,23
1973-12-07,BOS,116,17,4,ATL,112,13,12,30,16
1973-12-07,BUF,108,10,14,NYK,113,12,12,22,26
1973-12-07,PHL,102,9,17,KCK,113,6,21,15,38
1973-12-07,CLE,91,9,15,CHI,96,19,7,28,22
1973-12-07,MIL,116,21,3,POR,86,11,13,32,16
1973-12-07,LAL,111,17,9,SEA,115,9,21,26,30
1973-12-07,PHX,114,8,18,CAP,92,12,10,20,28
1973-12-08,CHI,112,20,7,BOS,95,18,4,38,11
1973-12-08,DET,106,16,11,POR,91,11,14,27,25
1973-12-08,GOS,135,14,9,LAL,111,17,10,31,19
1973-12-08,PHL,92,9,18,MIL,105,22,3,31,21
1973-12-08,NYK,117,46,33,ATL,100,35,45,81,78
1973-12-09,CLE,106,9,16,PHX,117,9,18,18,34
1973-12-09,KCK,80,7,21,DET,86,17,11,24,32
1973-12-09,LAL,96,17,11,CAP,110,12,11,29,22
1973-12-09,SEA,107,10,21,HOU,110,10,17,20,38
1973-12-09,BOS,118,53,24,BUF,114,39,37,92,61
1973-12-11,NYK,105,13,12,PHX,97,10,18,23,30
1973-12-11,CLE,101,9,17,LAL,100,17,12,26,29
1973-12-11,CHI,105,21,7,KCK,104,7,22,28,29
1973-12-11,MIL,130,23,3,SEA,91,10,22,33,25
1973-12-11,POR,82,11,15,CAP,87,13,11,24,26
1973-12-11,GOS,114,15,9,HOU,107,11,17,26,26
1973-12-11,ATL,127,13,13,BUF,132,10,15,23,28
1973-12-12,BOS,126,18,5,BUF,119,11,15,29,20
1973-12-12,PHL,93,9,19,SEA,100,10,23,19,42
1973-12-12,DET,114,18,11,LAL,96,17,13,35,24
1973-12-13,MIL,94,24,3,CHI,97,22,7,46,10
1973-12-13,PHX,108,10,19,POR,119,11,16,21,35
1973-12-14,CLE,98,10,17,BUF,102,11,16,21,33
1973-12-14,HOU,106,11,18,BOS,114,19,5,30,23
1973-12-14,CHI,97,23,7,LAL,100,17,14,40,21
1973-12-14,DET,93,19,11,PHL,96,9,20,28,31
1973-12-14,POR,109,12,16,GOS,101,16,9,28,25
1973-12-14,SEA,93,11,23,CAP,88,14,11,25,34
1973-12-15,PHL,89,10,20,DET,99,19,12,29,32
1973-12-15,CHI,104,23,8,HOU,100,11,19,34,27
1973-12-15,MIL,116,24,4,ATL,82,13,14,37,18
1973-12-15,PHX,121,10,20,BOS,120,20,5,30,25
1973-12-15,GOS,93,16,10,CAP,106,14,12,30,22
1973-12-16,KCK,105,7,23,DET,104,20,12,27,35
1973-12-16,LAL,110,18,14,BOS,115,20,6,38,20
1973-12-16,POR,98,13,16,MIL,121,25,4,38,20
1973-12-16,SEA,109,12,23,PHX,113,11,20,23,43
1973-12-17,HOU,97,11,20,NYK,109,14,12,25,32
1973-12-18,BUF,100,12,16,CLE,93,10,18,22,34
1973-12-18,CAP,91,15,12,ATL,98,13,15,28,27
1973-12-18,CHI,92,24,8,SEA,93,12,24,36,32
1973-12-18,LAL,109,18,15,MIL,107,26,4,44,19
1973-12-18,POR,133,13,17,PHX,117,12,20,25,37
1973-12-18,GOS,106,16,11,BOS,125,21,6,37,17
1973-12-19,ATL,107,14,15,NYK,105,15,12,29,27
1973-12-19,HOU,118,11,21,SEA,124,13,24,24,45
1973-12-19,DET,89,20,13,CHI,87,24,9,44,22
1973-12-19,KCK,106,8,23,CLE,92,10,19,18,42
1973-12-19,PHX,98,12,21,PHL,101,10,21,22,42
1973-12-20,KCK,92,9,23,CAP,98,15,13,24,36
1973-12-21,BUF,117,13,16,NYK,115,15,13,28,29
1973-12-21,CLE,101,10,20,SEA,96,14,24,24,44
1973-12-21,HOU,110,11,22,ATL,124,15,15,26,37
1973-12-21,DET,107,21,13,GOS,104,16,12,37,25
1973-12-21,LAL,116,19,15,PHL,107,11,21,30,36
1973-12-21,POR,120,14,17,BOS,124,22,6,36,23
1973-12-22,NYK,99,15,14,DET,88,22,13,37,27
1973-12-22,ATL,98,16,15,CLE,108,11,20,27,35
1973-12-22,CAP,98,16,13,HOU,89,11,23,27,36
1973-12-22,CHI,110,24,10,GOS,86,16,13,40,23
1973-12-22,KCK,122,9,24,BUF,112,14,16,23,40
1973-12-22,PHX,121,12,22,MIL,112,26,5,38,27
1973-12-22,POR,110,14,18,PHL,105,11,22,25,40
1973-12-23,CLE,99,12,20,HOU,91,11,24,23,44
1973-12-23,SEA,95,14,25,BOS,96,23,6,37,31
1973-12-23,KCK,101,10,24,GOS,93,16,14,26,38
1973-12-23,CAP,110,46,35,BUF,85,39,38,85,73
1973-12-25,NYK,100,16,14,CAP,102,17,13,33,27
1973-12-25,PHX,135,13,22,LAL,100,20,15,33,37
1973-12-26,ATL,145,16,16,PHL,118,11,23,27,39
1973-12-26,CAP,82,18,13,CHI,81,25,10,43,23
1973-12-26,HOU,110,11,25,KCK,95,11,24,22,49
1973-12-26,DET,91,22,14,NYK,96,16,15,38,29
1973-12-26,MIL,123,26,6,CLE,110,13,20,39,26
1973-12-26,SEA,129,14,26,LAL,105,20,16,34,42
1973-12-26,BUF,123,14,17,BOS,125,24,6,38,23
1973-12-27,MIL,129,27,6,PHL,107,11,24,38,30
1973-12-27,GOS,117,16,15,POR,118,15,18,31,33
1973-12-27,PHX,111,14,22,SEA,100,15,26,29,48
1973-12-28,HOU,111,12,25,MIL,127,28,6,40,31
1973-12-28,CHI,118,25,11,ATL,94,17,16,42,27
1973-12-28,DET,102,22,15,CAP,93,19,13,41,28
1973-12-28,LAL,119,20,17,PHX,107,15,22,35,39
1973-12-28,SEA,110,15,27,POR,93,16,18,31,45
1973-12-29,NYK,112,17,15,PHL,92,11,25,28,40
1973-12-29,ATL,114,17,17,HOU,110,12,26,29,43
1973-12-29,CAP,102,19,14,KCK,106,11,25,30,39
1973-12-29,CHI,108,26,11,DET,103,23,15,49,26
1973-12-29,PHX,108,15,23,BUF,120,14,18,29,41
1973-12-29,GOS,102,16,16,LAL,100,21,17,37,33
1973-12-29,BOS,111,54,24,CLE,92,27,47,81,71
1973-12-30,CLE,94,13,21,ATL,99,18,17,31,38
1973-12-30,KCK,85,12,25,NYK,102,18,15,30,40
1973-12-30,MIL,91,29,6,DET,98,23,16,52,22
1973-12-30,LAL,108,21,18,BUF,105,15,18,36,36
1973-12-30,POR,99,16,19,CHI,92,27,11,43,30
1973-12-30,SEA,96,16,27,GOS,92,17,16,33,43
1973-12-31,BOS,106,25,6,PHL,97,11,26,36,32
1974-01-01,NYK,99,19,15,ATL,89,19,17,38,32
1974-01-01,POR,119,17,19,BUF,120,15,19,32,38
1974-01-01,GOS,80,17,17,CHI,91,27,12,44,29
1974-01-02,PHL,99,11,27,HOU,101,12,27,23,54
1974-01-02,ATL,113,19,18,PHX,116,15,24,34,42
1974-01-02,CAP,81,19,15,NYK,92,20,15,39,30
1974-01-02,DET,106,24,16,MIL,92,29,7,53,23
1974-01-02,KCK,109,12,26,BOS,97,26,6,38,32
1974-01-02,SEA,111,17,27,BUF,115,16,19,33,46
1974-01-03,MIL,120,29,8,KCK,105,13,26,42,34
1974-01-04,PHL,78,11,28,NYK,75,21,15,32,43
1974-01-04,CLE,91,13,22,CAP,94,19,16,32,38
1974-01-04,DET,106,25,16,BOS,101,26,7,51,23
1974-01-04,KCK,122,13,27,PHX,97,16,24,29,51
1974-01-04,LAL,114,22,18,GOS,111,17,18,39,36
1974-01-04,POR,113,17,20,HOU,119,13,27,30,47
1974-01-04,SEA,103,17,28,CHI,101,28,12,45,40
1974-01-05,NYK,110,21,16,BUF,111,17,19,38,35
1974-01-05,ATL,99,19,19,CLE,86,13,23,32,42
1974-01-05,CAP,93,20,16,DET,90,26,16,46,32
1974-01-05,MIL,118,30,8,PHX,109,16,25,46,33
1974-01-05,GOS,108,17,19,HOU,106,14,27,31,46
1974-01-05,BOS,108,55,24,PHL,102,25,56,80,80
1974-01-06,CAP,90,21,16,MIL,88,31,8,52,24
1974-01-06,CHI,120,28,13,PHX,116,16,26,44,39
1974-01-06,LAL,109,23,18,KCK,105,14,27,37,45
1974-01-06,POR,106,17,21,GOS,105,18,19,35,40
1974-01-06,SEA,91,18,28,HOU,90,14,28,32,56
1974-01-06,BUF,117,39,39,ATL,109,35,46,74,85
1974-01-08,BUF,100,18,19,ATL,96,20,19,38,38
1974-01-08,CAP,94,22,16,LAL,92,24,18,46,34
1974-01-08,CHI,80,29,13,NYK,108,21,17,50,30
1974-01-08,POR,129,18,21,KCK,110,14,28,32,49
1974-01-08,HOU,92,14,29,GOS,104,18,20,32,49
1974-01-09,BOS,106,26,8,CHI,89,29,14,55,22
1974-01-09,PHL,90,12,28,CLE,86,13,24,25,52
1974-01-09,DET,123,26,17,LAL,94,24,19,50,36
1974-01-09,PHX,105,16,27,HOU,101,14,30,30,57
1974-01-09,SEA,100,19,28,KCK,96,14,29,33,57
1974-01-10,ATL,104,20,20,CHI,116,29,15,49,35
1974-01-10,GOS,125,19,20,SEA,89,20,28,39,48
1974-01-11,BOS,103,27,8,LAL,111,24,20,51,28
1974-01-11,BUF,117,19,19,HOU,99,14,31,33,50
1974-01-11,PHL,121,13,28,ATL,100,20,21,33,49
1974-01-11,CLE,96,13,25,DET,106,27,17,40,42
1974-01-11,MIL,115,31,9,CAP,113,23,16,54,25
1974-01-11,PHX,100,17,27,KCK,117,14,30,31,57
1974-01-11,SEA,98,20,29,NYK,107,22,17,42,46
1974-01-12,PHL,101,14,28,LAL,108,25,20,39,48
1974-01-12,CAP,96,23,17,BUF,97,20,19,43,36
1974-01-12,CHI,82,30,15,MIL,101,32,9,62,24
1974-01-12,DET,112,28,17,CLE,117,13,26,41,43
1974-01-12,GOS,80,20,20,NYK,96,23,17,43,37
1974-01-13,CLE,96,14,26,PHL,94,14,29,28,55
1974-01-13,KCK,103,15,30,POR,99,19,21,34,51
1974-01-13,MIL,124,33,9,CHI,94,30,16,63,25
1974-01-13,ATL,105,20,22,BOS,128,27,9,47,31
1974-01-13,PHX,112,17,28,SEA,123,20,30,37,58
1974-01-13,HOU,121,31,50,BUF,112,40,39,71,89
1974-01-17,ATL,126,20,23,POR,99,19,22,39,45
1974-01-17,GOS,127,20,21,PHX,120,17,29,37,50
1974-01-17,CAP,101,23,18,CLE,86,15,26,38,44
1974-01-18,BOS,98,28,9,ATL,94,21,23,49,32
1974-01-18,BUF,98,21,19,CAP,94,24,18,45,37
1974-01-18,PHL,104,14,30,SEA,116,21,30,35,60
1974-01-18,HOU,96,14,32,NYK,90,24,17,38,49
1974-01-18,DET,113,28,18,CHI,95,30,17,58,35
1974-01-18,KCK,115,16,30,LAL,116,26,20,42,50
1974-01-19,ATL,127,21,24,SEA,109,22,30,43,54
1974-01-19,CAP,117,24,19,GOS,90,21,21,45,40
1974-01-19,KCK,111,16,31,CLE,108,15,27,31,58
1974-01-19,MIL,121,34,9,POR,106,19,23,53,32
1974-01-19,PHX,112,17,30,NYK,89,24,18,41,48
1974-01-20,BOS,102,29,9,GOS,123,21,22,50,31
1974-01-20,PHL,129,14,31,BUF,112,22,19,36,50
1974-01-20,CAP,111,25,19,HOU,105,15,32,40,51
1974-01-20,CHI,99,30,18,POR,97,19,24,49,42
1974-01-20,DET,105,29,18,KCK,79,17,31,46,49
1974-01-20,MIL,94,35,9,LAL,90,27,20,62,29
1974-01-22,BUF,119,22,20,PHL,109,15,31,37,51
1974-01-22,NYK,93,24,19,HOU,108,15,33,39,52
1974-01-22,CHI,102,31,18,ATL,89,22,24,53,42
1974-01-22,KCK,103,17,32,POR,96,19,25,36,57
1974-01-22,LAL,110,27,21,CLE,111,15,28,42,49
1974-01-22,GOS,99,22,22,CAP,97,26,19,48,41
1974-01-23,BOS,97,29,10,SEA,98,22,31,51,41
1974-01-23,DET,121,30,18,POR,95,19,26,49,44
1974-01-23,MIL,114,36,9,BUF,88,23,20,59,29
1974-01-23,PHX,110,18,30,CLE,103,16,28,34,58
1974-01-23,ATL,104,22,25,HOU,115,16,33,38,58
1974-01-25,BOS,112,29,11,PHL,97,15,32,44,43
1974-01-25,BUF,113,23,21,KCK,118,18,32,41,53
1974-01-25,CHI,104,32,18,SEA,99,23,31,55,49
1974-01-25,DET,93,31,18,HOU,89,17,33,48,51
1974-01-25,LAL,143,27,22,CAP,124,26,20,53,42
1974-01-25,PHX,108,19,30,MIL,112,37,9,56,39
1974-01-25,POR,84,27,53,CLE,87,27,48,54,101
1974-01-26,NYK,122,24,20,PHL,98,15,33,39,53
1974-01-26,ATL,132,22,26,BUF,122,23,22,45,48
1974-01-26,DET,94,32,18,SEA,83,23,32,55,50
1974-01-26,GOS,106,23,22,CLE,93,16,29,39,51
1974-01-27,BOS,119,30,11,KCK,98,19,32,49,43
1974-01-27,ATL,89,23,26,NYK,111,25,20,48,46
1974-01-27,HOU,108,17,34,BUF,122,23,23,40,57
1974-01-27,CHI,109,33,18,DET,91,33,18,66,36
1974-01-27,LAL,99,28,22,MIL,92,38,9,66,31
1974-01-27,PHX,127,19,31,CAP,107,26,21,45,52
1974-01-29,BUF,121,24,23,GOS,128,24,22,48,45
1974-01-29,NYK,104,26,20,BOS,83,31,11,57,31
1974-01-29,CLE,118,16,30,ATL,111,23,27,39,57
1974-01-29,HOU,107,17,35,SEA,115,23,33,40,68
1974-01-29,POR,106,19,27,MIL,126,38,10,57,37
1974-01-30,BOS,120,31,12,CLE,108,17,30,48,42
1974-01-30,ATL,122,23,28,GOS,129,25,22,48,50
1974-01-30,KCK,88,19,33,NYK,108,27,20,46,53
1974-01-30,DET,111,33,19,BUF,96,24,24,57,43
1974-01-30,CHI,103,34,18,CAP,94,26,22,60,40
1974-01-31,PHX,112,20,31,POR,100,19,28,39,59
1974-01-31,HOU,108,17,36,GOS,109,26,22,43,58
1974-02-01,PHL,105,15,34,BOS,106,32,12,47,46
1974-02-01,CLE,99,17,31,CAP,107,26,23,43,54
1974-02-01,SEA,110,24,33,MIL,85,39,10,63,43
1974-02-01,CHI,99,35,18,KCK,88,19,34,54,52
1974-02-01,DET,96,34,19,NYK,91,28,20,62,39
1974-02-01,LAL,121,29,22,PHX,110,21,31,50,53
1974-02-02,NYK,103,28,21,CLE,87,17,32,45,53
1974-02-02,PHL,89,15,35,CHI,105,36,18,51,53
1974-02-02,ATL,117,23,29,HOU,107,17,37,40,66
1974-02-02,PHX,119,21,32,LAL,112,30,22,51,54
1974-02-02,POR,102,19,29,SEA,97,25,33,44,62
1974-02-02,GOS,120,27,22,MIL,91,39,11,66,33
1974-02-03,BOS,99,33,12,CAP,112,27,23,60,35
1974-02-03,BUF,112,24,25,PHL,98,15,36,39,61
1974-02-03,CLE,94,17,33,CHI,108,37,18,54,51
1974-02-03,HOU,123,17,38,ATL,112,24,29,41,67
1974-02-03,LAL,124,30,23,POR,91,20,29,50,52
1974-02-03,SEA,100,25,34,DET,114,35,19,60,53
1974-02-05,NYK,106,29,21,PHX,90,22,32,51,53
1974-02-05,ATL,121,24,30,CAP,103,28,23,52,53
1974-02-05,CLE,87,17,34,MIL,102,39,12,56,46
1974-02-05,HOU,116,18,38,LAL,112,31,23,49,61
1974-02-05,CHI,100,38,18,BOS,98,33,13,71,31
1974-02-05,POR,102,20,30,DET,104,36,19,56,49
1974-02-05,GOS,129,28,22,SEA,113,25,35,53,57
1974-02-06,PHL,98,15,37,BUF,114,25,25,40,62
1974-02-06,ATL,107,25,30,LAL,103,31,24,56,54
1974-02-06,MIL,104,40,12,BOS,105,33,14,73,26
1974-02-06,CAP,109,28,24,PHX,101,22,33,50,57
1974-02-06,KCK,95,19,35,CHI,112,39,18,58,53
1974-02-06,SEA,107,25,36,POR,94,20,31,45,67
1974-02-07,GOS,86,29,22,DET,110,37,19,66,41
1974-02-08,BOS,125,34,14,NYK,97,30,21,64,35
1974-02-08,BUF,106,26,25,CHI,101,40,18,66,43
1974-02-08,PHL,104,15,38,ATL,84,26,30,41,68
1974-02-08,HOU,120,19,38,CLE,106,17,35,36,73
1974-02-08,MIL,105,40,13,CAP,96,29,24,69,37
1974-02-08,PHX,94,22,34,DET,99,38,19,60,53
1974-02-08,POR,99,20,32,KCK,104,19,36,39,68
1974-02-09,NYK,100,30,22,BUF,103,27,25,57,47
1974-02-09,ATL,99,26,31,CLE,90,17,36,43,67
1974-02-09,CAP,108,29,25,PHL,75,16,38,45,63
1974-02-09,GOS,120,29,23,KCK,121,20,36,49,59
1974-02-10,PHL,95,16,39,CAP,94,30,25,46,64
1974-02-10,CLE,125,17,37,BUF,121,28,25,45,62
1974-02-10,CHI,96,40,19,LAL,86,31,25,71,44
1974-02-10,PHX,105,22,35,GOS,121,29,24,51,59
1974-02-10,POR,106,20,33,HOU,112,20,38,40,71
1974-02-10,SEA,119,26,36,KCK,103,21,36,47,72
1974-02-10,MIL,95,57,22,BOS,86,56,24,113,46
1974-02-11,ATL,95,27,31,PHL,116,17,39,44,70
1974-02-12,BUF,93,28,26,NYK,100,30,23,58,49
1974-02-12,CHI,93,41,19,MIL,81,41,13,82,32
1974-02-12,DET,113,39,19,KCK,106,21,37,60,56
1974-02-12,LAL,119,31,26,HOU,129,21,38,52,64
1974-02-12,POR,113,20,34,PHX,104,22,36,42,70
1974-02-12,GOS,102,30,24,BOS,107,35,14,65,38
1974-02-12,CLE,99,18,37,CAP,107,30,26,48,63
1974-02-13,NYK,89,31,23,CHI,80,42,19,73,42
1974-02-13,PHL,106,18,39,BUF,129,28,27,46,66
1974-02-13,CAP,89,31,26,KCK,87,21,38,52,64
1974-02-13,SEA,118,27,36,BOS,100,36,14,63,50
1974-02-14,PHX,107,22,37,HOU,99,22,38,44,75
1974-02-14,GOS,121,30,25,ATL,105,27,32,57,57
1974-02-14,DET,99,40,19,MIL,102,41,14,81,33
1974-02-15,BUF,118,29,27,DET,116,40,20,69,47
1974-02-15,PHL,92,18,40,KCK,89,21,39,39,79
1974-02-15,MIL,90,42,14,CHI,92,42,20,84,34
1974-02-15,LAL,112,31,27,SEA,96,28,36,59,63
1974-02-15,POR,104,21,34,BOS,106,36,15,57,49
1974-02-16,NYK,117,32,23,GOS,107,31,25,63,48
1974-02-16,CAP,101,32,26,BUF,92,30,27,62,53
1974-02-16,PHX,124,23,37,ATL,123,27,33,50,70
1974-02-16,POR,101,21,35,CLE,106,18,38,39,73
1974-02-17,PHL,107,19,40,DET,118,40,21,59,61
1974-02-17,CAP,99,33,26,BOS,95,37,15,70,41
1974-02-17,HOU,118,22,39,BUF,135,30,28,52,67
1974-02-17,CHI,105,43,20,GOS,108,31,26,74,46
1974-02-17,MIL,97,42,15,NYK,86,33,23,75,38
1974-02-17,LAL,110,32,27,ATL,113,27,34,59,61
1974-02-17,PHX,112,24,37,POR,100,21,36,45,73
1974-02-17,SEA,106,28,37,CLE,97,19,38,47,75
1974-02-19,BOS,107,37,16,DET,97,41,21,78,37
1974-02-19,BUF,145,31,28,MIL,109,43,15,74,43
1974-02-19,NYK,119,33,24,POR,116,21,37,54,61
1974-02-19,CLE,98,19,39,GOS,104,32,26,51,65
1974-02-19,CHI,130,43,21,PHX,96,25,37,68,58
1974-02-19,KCK,92,21,40,LAL,86,32,28,53,68
1974-02-20,CAP,116,34,26,POR,101,21,38,55,64
1974-02-20,HOU,115,22,40,PHL,98,19,41,41,81
1974-02-20,DET,112,41,22,LAL,110,32,29,73,51
1974-02-20,KCK,116,22,40,GOS,97,33,26,55,66
1974-02-20,MIL,110,43,16,ATL,94,28,34,71,50
1974-02-21,BUF,119,32,28,NYK,97,34,24,66,52
1974-02-21,CLE,103,28,48,GOS,122,42,38,70,86
1974-02-22,BUF,109,33,28,BOS,116,38,16,71,44
1974-02-22,CLE,110,19,40,NYK,117,34,25,53,65
1974-02-22,HOU,113,23,40,MIL,122,44,16,67,56
1974-02-22,CHI,117,44,21,POR,100,21,39,65,60
1974-02-22,DET,84,42,22,CAP,83,35,26,77,48
1974-02-22,KCK,119,23,40,PHX,104,25,38,48,78
1974-02-22,LAL,104,32,30,PHL,103,19,42,51,72
1974-02-23,NYK,98,35,25,ATL,90,28,35,63,60
1974-02-23,CAP,101,35,27,CLE,104,19,41,54,68
1974-02-23,DET,119,43,22,PHX,107,25,39,68,61
1974-02-23,GOS,125,33,27,PHL,106,19,43,52,70
1974-02-23,SEA,116,29,37,LAL,118,33,30,62,67
1974-02-24,BOS,111,39,16,ATL,96,28,36,67,52
1974-02-24,CAP,94,35,28,DET,84,44,22,79,50
1974-02-24,CLE,101,20,41,PHX,97,25,40,45,81
1974-02-24,HOU,133,23,41,POR,115,21,40,44,81
1974-02-24,KCK,93,24,40,MIL,100,45,16,69,56
1974-02-24,LAL,100,34,30,CHI,90,45,21,79,51
1974-02-24,SEA,115,29,38,PHL,105,19,44,48,82
1974-02-26,BUF,112,33,29,LAL,119,35,30,68,59
1974-02-26,NYK,85,36,25,CAP,71,36,28,72,53
1974-02-26,DET,83,44,23,BOS,86,40,16,84,39
1974-02-26,POR,110,21,41,PHL,118,19,45,40,86
1974-02-26,GOS,120,34,27,PHX,100,25,41,59,68
1974-02-26,HOU,118,24,41,KCK,101,24,41,48,82
1974-02-27,ATL,76,28,37,KCK,85,24,42,52,79
1974-02-27,CAP,104,36,29,SEA,100,30,38,66,67
1974-02-27,MIL,108,46,16,LAL,110,36,30,82,46
1974-02-27,PHX,95,25,42,CHI,107,45,22,70,64
1974-02-27,BUF,122,40,40,BOS,104,56,25,96,65
1974-02-28,MIL,113,46,17,DET,90,44,24,90,41
1974-02-28,GOS,129,35,27,POR,109,21,42,56,69
1974-03-01,BUF,110,33,30,BOS,94,41,16,74,46
1974-03-01,ATL,105,28,38,MIL,89,47,17,75,55
1974-03-01,CAP,103,37,29,NYK,112,37,25,74,54
1974-03-01,DET,103,44,25,SEA,105,30,39,74,64
1974-03-01,LAL,107,37,30,KCK,100,25,42,62,72
1974-03-01,POR,95,21,43,CHI,91,46,22,67,65
1974-03-01,HOU,117,25,41,PHX,111,25,43,50,84
1974-03-01,PHL,93,20,45,CLE,110,21,41,41,86
1974-03-02,NYK,88,38,25,BOS,104,41,17,79,42
1974-03-02,PHL,99,20,46,BUF,103,34,30,54,76
1974-03-02,ATL,129,29,38,HOU,122,26,41,55,79
1974-03-02,MIL,116,47,18,SEA,99,31,39,78,57
1974-03-02,GOS,103,36,27,CHI,88,46,23,82,50
1974-03-03,BOS,102,42,17,NYK,108,38,26,80,43
1974-03-03,CAP,98,37,30,CLE,93,22,41,59,71
1974-03-03,MIL,112,48,18,HOU,106,26,42,74,60
1974-03-03,LAL,108,38,30,GOS,104,37,27,75,57
1974-03-03,PHX,113,25,44,KCK,100,25,43,50,87
1974-03-03,POR,95,22,43,DET,99,44,26,66,69
1974-03-04,MIL,109,49,18,KCK,103,25,44,74,62
1974-03-05,NYK,111,39,26,SEA,106,31,40,70,66
1974-03-05,CAP,103,38,30,ATL,89,30,38,68,68
1974-03-05,PHX,91,26,44,CHI,111,46,24,72,68
1974-03-05,POR,107,22,44,LAL,102,39,30,61,74
1974-03-05,GOS,93,37,28,DET,95,45,26,82,54
1974-03-06,PHL,112,20,47,CAP,99,39,30,59,77
1974-03-06,ATL,94,30,39,NYK,96,40,26,70,65
1974-03-06,HOU,93,26,43,CHI,105,47,24,73,67
1974-03-06,KCK,99,25,45,MIL,111,50,18,75,63
1974-03-06,LAL,116,39,31,BOS,111,42,18,81,49
1974-03-07,MIL,95,51,18,GOS,97,37,29,88,47
1974-03-07,PHX,97,26,45,BOS,99,42,19,68,64
1974-03-08,BUF,117,35,30,SEA,123,31,41,66,71
1974-03-08,PHL,96,21,47,GOS,106,38,29,59,76
1974-03-08,HOU,113,26,44,BOS,106,43,19,69,63
1974-03-08,LAL,129,40,31,DET,113,46,26,86,57
1974-03-09,NYK,88,41,26,MIL,75,51,19,92,45
1974-03-09,ATL,106,30,40,CHI,99,48,24,78,64
1974-03-09,CAP,106,39,31,POR,103,23,44,62,75
1974-03-09,KCK,106,25,46,SEA,96,32,41,57,87
1974-03-09,PHX,109,26,46,CLE,100,22,42,48,88
1974-03-10,BOS,94,43,20,LAL,82,41,31,84,51
1974-03-10,BUF,122,35,31,POR,112,23,45,58,76
1974-03-10,PHL,109,21,48,NYK,108,42,26,63,74
1974-03-10,ATL,111,31,40,DET,116,46,27,77,67
1974-03-10,CAP,117,40,31,GOS,107,39,29,79,60
1974-03-10,HOU,113,27,44,CLE,108,22,43,49,87
1974-03-11,MIL,105,51,20,PHX,92,27,46,78,66
1974-03-11,DET,108,52,29,GOS,120,43,38,95,67
1974-03-12,BUF,124,36,31,PHX,94,27,47,63,78
1974-03-12,NYK,102,42,27,LAL,109,41,32,83,59
1974-03-12,CLE,95,22,44,ATL,84,31,41,53,85
1974-03-12,CHI,91,48,25,KCK,93,26,46,74,71
1974-03-12,DET,113,47,27,GOS,108,39,30,86,57
1974-03-12,CAP,112,41,31,PHL,101,22,48,63,79
1974-03-12,BOS,110,44,20,POR,93,23,46,67,66
1974-03-13,BOS,104,45,20,PHX,97,27,48,72,68
1974-03-13,PHL,100,22,49,LAL,121,42,32,64,81
1974-03-13,HOU,117,28,44,CAP,93,42,31,70,75
1974-03-14,GOS,95,39,31,NYK,107,42,28,81,59
1974-03-15,PHL,108,22,50,PHX,101,27,49,49,99
1974-03-15,CLE,104,23,44,BOS,103,46,20,69,64
1974-03-15,HOU,114,29,44,CAP,105,42,32,71,76
1974-03-15,CHI,114,48,26,BUF,97,37,31,85,57
1974-03-15,DET,93,48,27,MIL,89,52,20,100,47
1974-03-15,LAL,107,43,32,GOS,112,39,32,82,64
1974-03-15,POR,107,23,47,NYK,105,43,28,66,75
1974-03-15,SEA,107,32,42,ATL,126,31,42,63,84
1974-03-16,BUF,114,37,32,CLE,105,24,44,61,76
1974-03-16,PHL,127,23,50,BOS,146,46,21,69,71
1974-03-16,POR,128,24,47,ATL,127,32,42,56,89
1974-03-16,GOS,135,40,32,LAL,105,43,33,83,65
1974-03-17,BOS,129,47,21,CAP,103,42,33,89,54
1974-03-17,CLE,115,24,45,PHL,99,23,51,47,96
1974-03-17,CHI,82,49,26,MIL,107,52,21,101,47
1974-03-17,DET,116,49,27,BUF,109,38,32,87,59
1974-03-17,KCK,125,27,46,HOU,114,30,44,57,90
1974-03-17,LAL,126,43,34,NYK,114,43,29,86,63
1974-03-17,SEA,108,32,43,PHX,133,27,50,59,93
1974-03-18,KCK,114,28,46,POR,105,25,47,53,93
1974-03-19,CLE,107,25,45,POR,103,25,48,50,93
1974-03-19,HOU,107,30,45,BOS,110,48,21,78,66
1974-03-19,CHI,103,49,27,PHL,94,23,52,72,79
1974-03-19,GOS,100,41,32,MIL,111,53,21,94,53
1974-03-20,PHL,106,23,53,POR,113,25,49,48,102
1974-03-20,ATL,99,32,43,BOS,89,49,21,81,64
1974-03-20,CAP,101,42,34,CLE,91,26,45,68,79
1974-03-20,DET,103,50,27,HOU,99,30,46,80,73
1974-03-20,KCK,86,29,46,CHI,87,50,27,79,73
1974-03-20,PHX,104,28,50,NYK,106,43,30,71,80
1974-03-20,SEA,110,32,44,GOS,107,41,33,73,77
1974-03-20,LAL,120,44,34,MIL,114,54,21,98,55
1974-03-21,GOS,102,41,34,BUF,115,38,33,79,67
1974-03-22,BOS,126,49,22,POR,118,26,49,75,71
1974-03-22,PHL,106,23,54,ATL,107,33,43,56,97
1974-03-22,CAP,109,43,34,HOU,95,30,47,73,81
1974-03-22,KCK,107,29,47,DET,105,51,27,80,74
1974-03-22,LAL,99,45,34,CHI,93,51,27,96,61
1974-03-22,PHX,126,28,51,BUF,119,39,33,67,84
1974-03-22,SEA,101,33,44,MIL,106,54,22,87,66
1974-03-23,BOS,108,50,22,HOU,105,30,48,80,70
1974-03-23,NYK,106,44,30,KCK,107,30,47,74,77
1974-03-23,ATL,119,34,43,CAP,108,44,34,78,77
1974-03-23,DET,89,51,28,PHL,97,23,55,74,83
1974-03-23,GOS,137,41,35,SEA,139,33,45,74,80
1974-03-24,BOS,109,51,22,HOU,106,30,49,81,71
1974-03-24,CAP,120,44,35,ATL,92,35,43,79,78
1974-03-24,CLE,114,26,46,NYK,92,44,31,70,77
1974-03-24,LAL,150,46,34,BUF,124,39,34,85,68
1974-03-24,PHX,134,29,51,GOS,121,41,36,70,87
1974-03-24,POR,110,26,50,MIL,120,55,22,81,72
1974-03-24,SEA,113,34,45,CHI,122,51,28,85,73
1974-03-26,NYK,117,44,32,PHL,90,24,55,68,87
1974-03-26,CAP,126,45,35,BOS,108,52,22,97,57
1974-03-26,HOU,119,30,50,BUF,96,39,35,69,85
1974-03-26,DET,109,51,29,ATL,108,35,44,86,73
1974-03-26,MIL,118,56,22,KCK,98,31,47,87,69
1974-03-26,CHI,104,52,28,CLE,98,27,46,79,74
1974-03-26,GOS,143,41,37,POR,120,26,51,67,88
1974-03-26,LAL,115,47,34,SEA,121,34,46,81,80
1974-03-27,SEA,127,35,46,PHX,123,30,51,65,97
1974-03-27,POR,132,26,52,GOS,122,42,37,68,89
1974-03-27,PHL,117,24,56,BOS,108,52,23,76,79
1974-10-17,PHX,114,0,0,SEA,97,0,0,0,0
1974-10-17,NYK,89,0,0,NOJ,74,0,0,0,0
1974-10-18,POR,131,0,0,CLE,129,0,0,0,0
1974-10-18,BOS,119,0,0,BUF,126,0,0,0,0
1974-10-18,CHI,120,0,0,ATL,115,0,0,0,0
1974-10-18,MIL,101,0,0,HOU,106,0,0,0,0
1974-10-18,PHL,112,0,0,NOJ,99,0,1,0,1
1974-10-18,SEA,95,0,1,DET,100,0,0,0,1
1974-10-18,LAL,105,0,0,GOS,90,0,0,0,0
1974-10-19,ATL,118,0,1,HOU,112,1,0,1,1
1974-10-19,GOS,113,0,1,CLE,110,0,1,0,2
1974-10-19,POR,99,1,0,DET,122,1,0,2,0
1974-10-19,BUF,95,1,0,BOS,113,0,1,1,1
1974-10-19,WAS,110,0,0,NOJ,92,0,2,0,2
1974-10-19,PHX,91,1,0,KCK,94,0,0,1,0
1974-10-19,NYK,86,1,0,PHL,99,1,0,2,0
1974-10-19,CHI,87,1,0,MIL,70,0,1,1,1
1974-10-20,LAL,95,1,0,KCK,105,1,0,2,0
1974-10-20,SEA,100,0,2,CLE,93,0,2,0,4
1974-10-22,KCK,121,2,0,WAS,123,1,0,3,0
1974-10-22,BUF,134,1,1,NOJ,118,0,3,1,4
1974-10-22,GOS,106,1,1,POR,107,1,1,2,2
1974-10-22,NYK,110,1,1,HOU,100,1,1,2,2
1974-10-22,ATL,125,1,1,PHL,92,2,0,3,1
1974-10-22,MIL,92,0,2,CHI,90,2,0,2,2
1974-10-23,BOS,107,1,1,CLE,108,0,3,1,4
1974-10-23,KCK,99,2,1,CHI,98,2,1,4,2
1974-10-23,SEA,107,1,2,POR,97,2,1,3,3
1974-10-23,WAS,99,2,0,HOU,95,1,2,3,2
1974-10-23,PHX,100,1,1,DET,90,2,0,3,1
1974-10-24,ATL,97,2,1,CLE,116,1,3,3,4
1974-10-24,BUF,111,2,1,NYK,91,2,1,4,2
1974-10-24,NOJ,89,0,4,PHL,102,2,1,2,5
1974-10-25,BOS,116,1,2,ATL,109,2,2,3,4
1974-10-25,LAL,107,1,1,DET,110,2,1,3,2
1974-10-25,POR,97,2,2,GOS,99,1,2,3,4
1974-10-25,SEA,106,2,2,PHX,97,2,1,4,3
1974-10-25,MIL,96,1,2,WAS,111,3,0,4,2
1974-10-25,CHI,91,2,2,KCK,112,3,1,5,3
1974-10-25,HOU,110,1,3,PHL,86,3,1,4,4
1974-10-26,GOS,105,2,2,DET,104,3,1,5,3
1974-10-26,BUF,105,3,1,CHI,104,2,3,5,4
1974-10-26,WAS,101,4,0,MIL,95,1,3,5,3
1974-10-26,NOJ,88,0,5,CLE,90,2,3,2,8
1974-10-26,NYK,97,2,2,BOS,86,2,2,4,4
1974-10-27,LAL,123,1,2,PHX,116,2,2,3,4
1974-10-27,POR,120,2,3,SEA,94,3,2,5,5
1974-10-29,POR,102,3,3,LAL,105,2,2,5,5
1974-10-29,GOS,130,3,2,BUF,101,4,1,7,3
1974-10-29,CLE,92,3,3,BOS,107,2,3,5,6
1974-10-29,CHI,80,2,4,WAS,96,5,0,7,4
1974-10-30,BOS,104,3,3,CHI,105,2,5,5,8
1974-10-30,NOJ,100,0,6,HOU,113,2,3,2,9
1974-10-30,PHL,99,3,2,PHX,104,2,3,5,5
1974-10-30,KCK,99,4,1,MIL,97,1,4,5,5
1974-10-30,SEA,117,3,3,LAL,97,3,2,6,5
1974-10-30,DET,96,3,2,ATL,104,2,3,5,5
1974-10-30,WAS,94,6,0,NYK,86,3,2,9,2
1974-10-31,HOU,95,3,3,WAS,92,7,0,10,3
1974-10-31,NYK,93,3,3,ATL,90,3,3,6,6
1974-11-01,POR,113,3,4,BUF,106,4,2,7,6
1974-11-01,BOS,114,3,4,PHL,98,3,3,6,7
1974-11-01,DET,103,3,3,NOJ,93,0,7,3,10
1974-11-01,SEA,88,4,3,GOS,99,4,2,8,5
1974-11-01,LAL,109,3,3,MIL,86,1,5,4,8
1974-11-02,ATL,125,3,4,BOS,126,4,4,7,8
1974-11-02,HOU,120,4,3,KCK,97,5,1,9,4
1974-11-02,PHL,94,3,4,DET,100,4,3,7,7
1974-11-02,WAS,108,7,1,PHX,94,3,3,10,4
1974-11-02,NYK,90,4,3,CHI,95,3,5,7,8
1974-11-02,GOS,99,5,2,MIL,90,1,6,6,8
1974-11-03,CLE,104,3,4,PHX,101,3,4,6,8
1974-11-03,LAL,101,4,3,BUF,124,4,3,8,6
1974-11-03,POR,100,4,4,GOS,109,6,2,10,6
1974-11-03,SEA,101,4,4,MIL,89,1,7,5,11
1974-11-03,KCK,79,5,2,CHI,86,4,5,9,7
1974-11-05,KCK,115,5,3,NOJ,97,0,8,5,11
1974-11-05,HOU,93,5,3,NYK,106,4,4,9,7
1974-11-06,BOS,128,5,4,POR,110,4,5,9,9
1974-11-06,DET,118,5,3,KCK,104,6,3,11,6
1974-11-06,WAS,99,8,1,CLE,107,4,4,12,5
1974-11-06,NOJ,98,0,9,BUF,110,5,3,5,12
1974-11-06,PHL,105,3,5,CHI,90,5,5,8,10
1974-11-07,ATL,109,3,5,PHX,108,3,5,6,10
1974-11-07,HOU,103,5,4,MIL,93,1,8,6,12
1974-11-07,GOS,93,7,2,SEA,104,5,4,12,6
1974-11-08,LAL,105,4,4,NYK,117,5,4,9,8
1974-11-08,BOS,104,6,4,DET,105,6,3,12,7
1974-11-08,NOJ,102,0,10,PHX,105,3,6,3,16
1974-11-08,PHL,105,4,5,POR,89,4,6,8,11
1974-11-09,ATL,115,4,5,POR,119,4,7,8,12
1974-11-09,BUF,109,6,3,DET,100,7,3,13,6
1974-11-09,HOU,96,6,4,PHX,101,4,6,10,10
1974-11-09,GOS,97,7,3,NYK,93,6,4,13,7
1974-11-09,WAS,96,8,2,CHI,89,5,6,13,8
1974-11-10,DET,117,7,4,BUF,124,7,3,14,7
1974-11-10,LAL,103,4,5,GOS,106,8,3,12,8
1974-11-10,NOJ,102,0,11,POR,101,5,7,5,18
1974-11-10,KCK,99,6,4,BOS,102,6,5,12,9
1974-11-10,SEA,109,6,4,PHL,95,5,5,11,9
1974-11-10,MIL,94,1,9,ATL,99,4,6,5,15
1974-11-12,GOS,128,9,3,ATL,111,5,6,14,9
1974-11-12,POR,105,5,8,NYK,103,6,5,11,13
1974-11-12,KCK,99,6,5,HOU,103,6,5,12,10
1974-11-12,BUF,112,8,3,CLE,94,5,4,13,7
1974-11-12,MIL,83,1,10,BOS,91,7,5,8,15
1974-11-12,NOJ,79,1,11,CHI,88,5,7,6,18
1974-11-13,SEA,108,7,4,LAL,103,4,6,11,10
1974-11-13,PHX,105,5,6,PHL,100,5,6,10,12
1974-11-13,DET,98,7,5,MIL,91,1,11,8,16
1974-11-13,WAS,118,9,2,KCK,81,6,6,15,8
1974-11-14,BOS,100,8,5,BUF,112,9,3,17,8
1974-11-14,HOU,105,7,5,CHI,96,6,7,13,12
1974-11-14,POR,104,6,8,ATL,92,5,7,11,15
1974-11-14,NYK,94,6,6,CLE,89,5,5,11,11
1974-11-15,BOS,109,8,6,KCK,110,6,7,14,13
1974-11-15,DET,117,8,5,SEA,103,8,4,16,9
1974-11-15,LAL,105,4,7,PHL,99,5,7,9,14
1974-11-15,PHX,95,6,6,CHI,102,6,8,12,14
1974-11-15,NOJ,95,1,12,WAS,104,10,2,11,14
1974-11-16,WAS,109,11,2,BOS,124,8,7,19,9
1974-11-16,ATL,130,5,8,NOJ,104,1,13,6,21
1974-11-16,GOS,102,10,3,PHL,106,5,8,15,11
1974-11-16,POR,112,7,8,LAL,99,5,7,12,15
1974-11-16,HOU,118,8,5,DET,98,9,5,17,10
1974-11-16,BUF,101,10,3,KCK,96,7,7,17,10
1974-11-16,NYK,104,7,6,SEA,94,8,5,15,11
1974-11-16,MIL,89,1,12,CLE,92,5,6,6,18
1974-11-17,PHX,105,6,7,GOS,106,10,4,16,11
1974-11-17,NOJ,85,1,14,DET,99,9,6,10,20
1974-11-17,LAL,76,5,8,CHI,96,7,8,12,16
1974-11-19,ATL,122,6,8,SEA,113,8,6,14,14
1974-11-19,MIL,122,1,13,PHX,108,6,8,7,21
1974-11-19,BUF,111,11,3,GOS,106,11,4,22,7
1974-11-19,POR,98,8,8,CHI,92,8,8,16,16
1974-11-19,KCK,97,7,8,DET,87,10,6,17,14
1974-11-19,NYK,86,8,6,WAS,85,11,3,19,9
1974-11-20,BOS,115,9,7,GOS,120,11,5,20,12
1974-11-20,DET,106,10,7,PHX,114,6,9,16,16
1974-11-20,WAS,104,11,4,BUF,115,12,3,23,7
1974-11-20,NOJ,95,1,15,SEA,99,8,7,9,22
1974-11-20,PHL,95,6,8,NYK,105,9,6,15,14
1974-11-21,KCK,96,8,8,MIL,106,2,13,10,21
1974-11-21,BUF,99,13,3,PHL,95,6,9,19,12
1974-11-21,ATL,95,7,8,NYK,101,10,6,17,14
1974-11-22,POR,99,9,8,WAS,117,11,5,20,13
1974-11-22,BOS,95,9,8,PHX,94,7,9,16,17
1974-11-22,SEA,89,9,7,CHI,93,8,9,17,16
1974-11-22,NOJ,90,1,16,ATL,86,7,9,8,25
1974-11-22,LAL,89,5,9,HOU,83,9,5,14,14
1974-11-23,POR,110,9,9,SEA,117,9,8,18,17
1974-11-23,BUF,117,14,3,PHX,104,7,10,21,13
1974-11-23,ATL,100,7,10,KCK,103,8,9,15,19
1974-11-23,DET,98,10,8,GOS,110,12,5,22,13
1974-11-23,PHL,98,6,10,BOS,96,10,8,16,18
1974-11-23,NYK,72,11,6,MIL,90,3,13,14,19
1974-11-24,SEA,109,10,8,HOU,124,9,6,19,14
1974-11-24,LAL,108,6,9,WAS,111,12,5,18,14
1974-11-24,KCK,109,9,9,CLE,94,6,6,15,15
1974-11-24,CHI,91,9,9,BUF,89,15,3,24,12
1974-11-26,GOS,144,13,5,HOU,124,10,6,23,11
1974-11-26,PHX,120,7,11,NOJ,110,2,16,9,27
1974-11-26,MIL,102,4,13,LAL,105,6,10,10,23
1974-11-26,ATL,119,7,11,WAS,102,13,5,20,16
1974-11-26,PHL,99,7,10,BUF,103,15,4,22,14
1974-11-26,CHI,90,10,9,KCK,93,10,9,20,18
1974-11-26,NYK,88,11,7,DET,99,10,9,21,16
1974-11-27,WAS,114,13,6,ATL,104,8,11,21,17
1974-11-27,BOS,104,10,9,SEA,99,10,9,20,18
1974-11-27,POR,111,9,10,HOU,97,10,7,19,17
1974-11-27,KCK,107,11,9,LAL,89,7,10,18,19
1974-11-28,PHX,85,8,11,POR,88,10,10,18,21
1974-11-29,LAL,127,7,11,NOJ,122,2,17,9,28
1974-11-29,PHL,119,7,11,SEA,121,10,10,17,21
1974-11-29,MIL,102,4,14,KCK,99,12,9,16,23
1974-11-29,BUF,93,16,4,WAS,96,14,6,30,10
1974-11-29,HOU,91,10,8,ATL,96,8,12,18,20
1974-11-29,BOS,86,11,9,NYK,96,11,8,22,17
1974-11-30,GOS,128,14,5,LAL,118,8,11,22,16
1974-11-30,NYK,118,12,8,BUF,111,16,5,28,13
1974-11-30,PHX,112,8,12,HOU,100,10,9,18,21
1974-11-30,MIL,101,5,14,CHI,99,10,10,15,24
1974-11-30,WAS,122,15,6,SEA,90,11,10,26,16
1974-11-30,POR,117,11,10,NOJ,85,2,18,13,28
1974-12-01,MIL,117,6,14,PHL,112,7,12,13,26
1974-12-01,LAL,111,8,12,PHX,105,9,12,17,24
1974-12-02,KCK,106,12,10,SEA,110,11,11,23,21
1974-12-03,BUF,101,16,6,MIL,110,7,14,23,20
1974-12-03,GOS,122,15,5,NOJ,101,2,19,17,24
1974-12-03,NYK,100,13,8,LAL,95,9,12,22,20
1974-12-03,CHI,96,10,11,POR,91,12,10,22,21
1974-12-03,CLE,97,6,7,HOU,91,10,10,16,17
1974-12-03,PHX,85,9,13,ATL,91,9,12,18,25
1974-12-04,PHL,109,7,13,KCK,105,12,11,19,24
1974-12-04,MIL,103,8,14,SEA,112,12,11,20,25
1974-12-04,BOS,101,11,10,LAL,90,9,13,20,23
1974-12-04,WAS,114,16,6,POR,87,12,11,28,17
1974-12-04,DET,86,11,9,HOU,69,10,11,21,20
1974-12-05,PHX,108,9,14,GOS,106,16,5,25,19
1974-12-06,HOU,114,10,12,BOS,120,12,10,22,22
1974-12-06,SEA,121,13,11,NOJ,108,2,20,15,31
1974-12-06,BUF,114,16,7,POR,105,12,12,28,19
1974-12-06,CHI,96,11,11,MIL,99,8,15,19,26
1974-12-06,DET,117,12,9,CLE,91,7,7,19,16
1974-12-06,PHL,88,8,13,NYK,96,14,8,22,21
1974-12-06,LAL,100,9,14,ATL,84,10,12,19,26
1974-12-07,PHL,116,8,14,BUF,112,17,7,25,21
1974-12-07,NYK,120,15,8,POR,112,12,13,27,21
1974-12-07,GOS,132,16,6,SEA,96,14,11,30,17
1974-12-07,WAS,94,17,6,DET,89,13,9,30,15
1974-12-07,PHX,92,10,14,LAL,88,10,14,20,28
1974-12-08,LAL,107,10,15,PHX,102,11,14,21,29
1974-12-08,NOJ,101,2,21,BOS,111,13,10,15,31
1974-12-08,SEA,95,14,12,ATL,102,10,13,24,25
1974-12-08,DET,92,13,10,KCK,96,12,12,25,22
1974-12-10,POR,103,12,14,ATL,107,11,13,23,27
1974-12-10,NYK,106,16,8,KCK,102,13,12,29,20
1974-12-10,HOU,111,10,13,GOS,97,17,6,27,19
1974-12-10,BUF,101,17,8,PHL,91,9,14,26,22
1974-12-10,CHI,89,11,12,BOS,107,14,10,25,22
1974-12-10,MIL,90,9,15,DET,82,13,11,22,26
1974-12-11,NOJ,106,2,22,GOS,103,17,7,19,29
1974-12-11,PHX,104,11,15,POR,100,12,15,23,30
1974-12-11,PHL,103,9,15,HOU,96,11,13,20,28
1974-12-11,SEA,95,14,13,CLE,97,7,8,21,21
1974-12-11,DET,103,13,12,WAS,89,18,6,31,18
1974-12-12,BUF,124,18,8,HOU,113,11,14,29,22
1974-12-12,ATL,109,12,13,GOS,129,17,8,29,21
1974-12-12,MIL,105,10,15,KCK,113,13,13,23,28
1974-12-13,BUF,108,19,8,NYK,104,17,8,36,16
1974-12-13,LAL,109,11,15,SEA,93,14,14,25,29
1974-12-13,PHL,93,10,15,MIL,89,10,16,20,31
1974-12-13,BOS,89,15,10,WAS,108,18,7,33,17
1974-12-13,PHX,85,12,15,CLE,84,8,8,20,23
1974-12-13,KCK,88,14,13,DET,84,14,12,28,25
1974-12-13,CHI,109,11,13,NOJ,76,3,22,14,35
1974-12-14,NYK,102,17,9,BUF,118,20,8,37,17
1974-12-14,DET,100,14,13,PHL,93,11,15,25,28
1974-12-14,WAS,99,19,7,GOS,91,18,8,37,15
1974-12-14,ATL,90,12,14,BOS,92,15,11,27,25
1974-12-14,HOU,123,11,15,KCK,84,15,13,26,28
1974-12-15,POR,100,12,16,LAL,97,12,15,24,31
1974-12-17,KCK,111,15,14,BUF,110,21,8,36,22
1974-12-17,BOS,109,16,11,PHL,113,11,16,27,27
1974-12-17,NYK,108,17,10,GOS,126,18,9,35,19
1974-12-17,LAL,106,12,16,CLE,119,8,9,20,25
1974-12-17,POR,119,13,16,MIL,103,10,17,23,33
1974-12-17,ATL,96,12,15,WAS,85,20,7,32,22
1974-12-17,CHI,87,12,13,SEA,84,14,15,26,28
1974-12-17,HOU,109,12,15,NOJ,83,3,23,15,38
1974-12-18,PHL,99,12,16,BOS,131,16,12,28,28
1974-12-18,DET,97,15,13,SEA,100,14,16,29,29
1974-12-18,WAS,113,20,8,NOJ,90,3,24,23,32
1974-12-19,KCK,113,16,14,NYK,117,17,11,33,25
1974-12-19,PHX,108,13,15,MIL,112,10,18,23,33
1974-12-19,ATL,80,13,15,CHI,88,13,13,26,28
1974-12-20,LAL,102,12,17,DET,103,15,14,27,31
1974-12-20,BUF,102,21,9,ATL,113,13,16,34,25
1974-12-20,PHL,93,12,17,GOS,94,19,9,31,26
1974-12-20,HOU,116,13,15,WAS,91,21,8,34,23
1974-12-20,CHI,96,14,13,KCK,73,16,15,30,28
1974-12-20,BOS,110,18,12,NOJ,106,3,26,21,38
1974-12-21,PHX,114,13,16,LAL,104,12,18,25,34
1974-12-21,WAS,117,21,9,PHL,101,12,18,33,27
1974-12-21,POR,108,14,16,DET,97,16,14,30,30
1974-12-21,ATL,96,14,16,HOU,101,14,15,28,31
1974-12-21,NYK,91,18,11,BOS,109,17,12,35,23
1974-12-21,KCK,107,16,16,GOS,84,20,9,36,25
1974-12-22,LAL,115,12,19,POR,102,15,16,27,35
1974-12-22,SEA,108,15,16,DET,90,16,15,31,31
1974-12-22,MIL,96,11,18,NOJ,76,3,25,14,43
1974-12-23,MIL,103,12,18,WAS,106,22,9,34,27
1974-12-23,GOS,111,20,10,PHX,94,14,16,34,26
1974-12-23,PHL,100,12,19,ATL,88,14,17,26,36
1974-12-23,KCK,97,17,16,CHI,87,15,13,32,29
1974-12-25,NYK,97,18,12,PHL,104,13,19,31,31
1974-12-25,PHX,110,14,17,BOS,96,19,12,33,29
1974-12-25,WAS,110,23,9,ATL,92,14,18,37,27
1974-12-26,GOS,112,21,10,POR,101,15,17,36,27
1974-12-26,CHI,92,15,14,PHL,91,14,19,29,33
1974-12-26,HOU,114,15,15,ATL,86,14,19,29,34
1974-12-26,DET,84,16,16,NYK,83,18,13,34,29
1974-12-27,SEA,98,16,16,KCK,108,18,16,34,32
1974-12-27,CHI,93,16,14,LAL,105,13,19,29,33
1974-12-27,PHX,92,15,17,BUF,108,21,10,36,27
1974-12-28,HOU,125,16,15,BUF,117,22,10,38,25
1974-12-28,GOS,105,22,10,BOS,115,19,13,41,23
1974-12-28,NYK,101,18,14,NOJ,94,3,27,21,41
1974-12-28,ATL,106,14,20,LAL,89,14,19,28,39
1974-12-28,DET,79,17,16,CHI,70,16,15,33,31
1974-12-29,SEA,101,16,17,BOS,121,20,13,36,30
1974-12-29,POR,99,15,18,KCK,103,19,16,34,34
1974-12-29,MIL,115,12,19,NYK,89,19,14,31,33
1974-12-30,HOU,120,17,15,LAL,107,14,20,31,35
1974-12-30,GOS,110,22,11,KCK,102,20,16,42,27
1974-12-30,MIL,106,13,19,BUF,91,22,11,35,30
1974-12-30,WAS,103,24,9,CLE,90,9,9,33,18
1974-12-30,CHI,81,16,16,DET,86,18,16,34,32
1975-01-01,SEA,123,16,18,WAS,118,25,9,41,27
1975-01-01,KCK,97,20,17,ATL,102,15,20,35,37
1975-01-01,POR,94,15,19,BOS,108,21,13,36,32
1975-01-02,NYK,117,19,15,PHX,113,15,18,34,33
1975-01-02,MIL,116,14,19,ATL,111,16,20,30,39
1975-01-02,DET,99,19,16,NOJ,95,3,28,22,44
1975-01-03,LAL,106,14,21,BOS,127,22,13,36,34
1975-01-03,CHI,126,16,17,PHX,99,15,19,31,36
1975-01-03,KCK,95,20,18,PHL,107,14,20,34,38
1975-01-03,POR,93,15,20,SEA,98,17,18,32,38
1975-01-03,BUF,92,22,12,DET,111,20,16,42,28
1975-01-04,ATL,108,16,21,BUF,121,22,13,38,34
1975-01-04,NYK,103,20,15,CLE,102,9,10,29,25
1975-01-04,GOS,104,23,11,WAS,96,25,10,48,21
1975-01-04,MIL,93,15,19,HOU,89,18,15,33,34
1975-01-04,SEA,111,18,18,NOJ,89,3,29,21,47
1975-01-04,CHI,100,17,17,KCK,88,20,19,37,36
1975-01-04,DET,89,21,16,PHL,82,15,20,36,36
1975-01-05,LAL,112,14,22,WAS,109,25,11,39,33
1975-01-05,KCK,106,20,20,HOU,115,18,16,38,36
1975-01-05,POR,111,15,21,NOJ,102,3,30,18,51
1975-01-05,MIL,96,16,19,CHI,95,18,17,34,36
1975-01-05,CLE,97,9,11,PHX,86,15,20,24,31
1975-01-06,PHL,101,15,21,BUF,95,23,13,38,34
1975-01-07,ATL,113,16,22,CLE,112,10,11,26,33
1975-01-07,BUF,115,23,14,LAL,107,15,22,38,36
1975-01-07,KCK,108,20,21,MIL,99,17,19,37,40
1975-01-07,CHI,106,18,18,HOU,97,19,16,37,34
1975-01-07,GOS,136,24,11,NOJ,94,3,31,27,42
1975-01-07,POR,106,16,21,NYK,92,21,15,37,36
1975-01-08,SEA,102,19,18,NYK,113,21,16,40,34
1975-01-08,PHL,98,16,21,LAL,106,15,23,31,44
1975-01-08,BOS,104,23,13,ATL,96,17,22,40,35
1975-01-08,PHX,95,15,21,WAS,102,25,12,40,33
1975-01-08,DET,92,22,16,MIL,102,17,20,39,36
1975-01-09,BUF,100,24,14,BOS,108,24,13,48,27
1975-01-09,GOS,132,25,11,NYK,96,22,16,47,27
1975-01-09,HOU,94,19,17,WAS,102,26,12,45,29
1975-01-10,CHI,116,19,18,ATL,113,17,23,36,41
1975-01-10,PHX,110,15,22,POR,113,17,21,32,43
1975-01-10,NOJ,111,3,32,HOU,108,19,18,22,50
1975-01-10,BUF,104,24,15,CLE,100,10,12,34,27
1975-01-10,BOS,103,25,13,LAL,97,16,23,41,36
1975-01-10,PHL,102,16,22,KCK,94,21,21,37,43
1975-01-10,SEA,94,19,19,GOS,119,26,11,45,30
1975-01-10,MIL,81,18,20,DET,89,22,17,40,37
1975-01-11,ATL,113,17,24,DET,118,23,17,40,41
1975-01-11,PHX,113,15,23,NYK,107,22,17,37,40
1975-01-11,GOS,105,27,11,CHI,114,20,18,47,29
1975-01-11,WAS,102,27,12,LAL,90,16,24,43,36
1975-01-11,CLE,81,10,13,MIL,91,18,21,28,34
1975-01-12,SEA,123,19,20,CHI,127,21,18,40,38
1975-01-12,BUF,114,25,15,BOS,101,26,13,51,28
1975-01-12,MIL,99,19,21,PHL,88,17,22,36,43
1975-01-16,HOU,125,19,19,SEA,127,19,21,38,40
1975-01-16,MIL,119,20,21,GOS,100,27,12,47,33
1975-01-16,ATL,108,17,25,WAS,85,28,12,45,37
1975-01-17,BUF,121,26,15,GOS,116,27,13,53,28
1975-01-17,NOJ,113,4,32,SEA,109,20,21,24,53
1975-01-17,HOU,106,19,20,POR,127,18,21,37,41
1975-01-17,CHI,105,22,18,PHX,115,16,23,38,41
1975-01-17,PHL,92,17,23,WAS,103,28,13,45,36
1975-01-17,BOS,96,26,14,DET,90,24,17,50,31
1975-01-17,KCK,107,21,22,NYK,90,22,18,43,40
1975-01-18,ATL,115,18,25,BUF,129,27,15,45,40
1975-01-18,PHL,106,17,24,CLE,108,10,14,27,38
1975-01-18,BOS,123,27,14,HOU,101,19,21,46,35
1975-01-18,WAS,125,29,13,GOS,101,27,14,56,27
1975-01-18,CHI,91,22,19,NYK,104,22,19,44,38
1975-01-18,DET,86,24,18,PHX,77,17,23,41,41
1975-01-19,NOJ,112,5,32,BUF,117,28,15,33,47
1975-01-19,ATL,117,18,26,SEA,109,20,22,38,48
1975-01-19,MIL,122,21,21,POR,108,19,21,40,42
1975-01-19,BOS,102,28,14,PHL,100,17,25,45,39
1975-01-19,DET,100,25,18,CLE,98,11,14,36,32
1975-01-19,KCK,97,22,22,PHX,109,17,24,39,46
1975-01-21,BUF,118,29,15,SEA,108,20,23,49,38
1975-01-21,GOS,138,27,15,LAL,108,16,25,43,40
1975-01-21,KCK,109,22,23,POR,106,19,22,41,45
1975-01-21,ATL,135,19,26,NOJ,103,5,33,24,59
1975-01-21,HOU,102,19,22,BOS,113,29,14,48,36
1975-01-21,PHX,95,18,24,PHL,101,17,26,35,50
1975-01-21,NYK,94,23,19,CHI,97,22,20,45,39
1975-01-22,NOJ,102,5,34,BOS,110,30,14,35,48
1975-01-22,DET,96,26,18,POR,94,19,23,45,41
1975-01-22,WAS,97,30,13,KCK,88,23,23,53,36
1975-01-23,GOS,108,28,15,PHL,100,18,26,46,41
1975-01-23,ATL,95,20,26,HOU,96,19,23,39,49
1975-01-24,LAL,110,16,26,NOJ,108,5,35,21,61
1975-01-24,DET,113,27,18,ATL,103,20,27,47,45
1975-01-24,BUF,105,30,15,NYK,99,23,20,53,35
1975-01-24,POR,119,19,24,PHL,97,18,27,37,51
1975-01-24,HOU,95,20,23,MIL,91,22,21,42,44
1975-01-24,BOS,96,31,14,KCK,87,23,24,54,38
1975-01-24,CHI,86,23,20,SEA,81,20,24,43,44
1975-01-25,GOS,114,29,15,POR,109,20,24,49,39
1975-01-25,NYK,103,23,21,KCK,112,23,25,46,46
1975-01-25,ATL,117,20,28,MIL,101,22,22,42,50
1975-01-25,CHI,116,24,20,DET,96,28,18,52,38
1975-01-25,WAS,94,31,13,CLE,92,11,15,42,28
1975-01-25,PHX,94,18,25,NOJ,90,5,36,23,61
1975-01-26,POR,128,20,25,GOS,113,30,15,50,40
1975-01-26,LAL,97,17,26,PHL,103,18,28,35,54
1975-01-26,DET,102,28,19,CHI,93,25,20,53,39
1975-01-26,BOS,107,32,14,BUF,93,31,15,63,29
1975-01-26,WAS,118,32,13,HOU,90,21,23,53,36
1975-01-27,NOJ,115,5,37,MIL,117,22,23,27,60
1975-01-28,NYK,115,23,22,ATL,111,21,28,44,50
1975-01-28,POR,115,21,25,PHX,107,19,25,40,50
1975-01-28,CHI,125,25,21,CLE,97,11,16,36,37
1975-01-28,HOU,104,21,24,LAL,89,17,27,38,51
1975-01-29,NOJ,108,5,38,LAL,112,17,28,22,66
1975-01-29,KCK,106,24,25,MIL,102,23,23,47,48
1975-01-29,PHL,98,19,28,NYK,92,24,22,43,50
1975-01-29,DET,93,29,19,GOS,90,30,16,59,35
1975-01-29,PHX,85,19,26,SEA,99,20,25,39,51
1975-01-30,ATL,115,21,29,NYK,117,24,23,45,52
1975-01-30,HOU,103,22,24,DET,88,30,19,52,43
1975-01-31,SEA,106,21,25,POR,103,22,25,43,50
1975-01-31,CHI,127,26,21,GOS,103,30,17,56,38
1975-01-31,PHX,105,19,27,LAL,101,18,28,37,55
1975-01-31,NOJ,101,5,39,WAS,106,33,13,38,52
1975-01-31,BUF,111,31,16,ATL,101,21,30,52,46
1975-01-31,BOS,121,33,14,CLE,99,11,17,44,31
1975-01-31,PHL,97,20,28,MIL,101,23,24,43,52
1975-02-01,DET,119,30,20,BUF,113,32,16,62,36
1975-02-01,NYK,93,25,23,HOU,95,23,24,48,47
1975-02-01,POR,91,22,26,SEA,93,22,25,44,51
1975-02-02,NOJ,118,5,40,NYK,114,25,24,30,64
1975-02-02,LAL,112,18,29,SEA,119,23,25,41,54
1975-02-02,BOS,120,34,14,MIL,102,24,24,58,38
1975-02-02,KCK,127,25,25,GOS,101,30,18,55,43
1975-02-02,CHI,97,27,21,WAS,80,34,13,61,34
1975-02-02,PHL,90,20,29,HOU,77,24,24,44,53
1975-02-03,DET,100,31,20,BOS,114,35,14,66,34
1975-02-03,KCK,100,26,25,PHL,87,21,29,47,54
1975-02-04,HOU,105,24,25,GOS,107,30,19,54,44
1975-02-04,BUF,105,32,17,PHL,111,21,30,53,47
1975-02-04,ATL,111,21,31,CLE,97,11,18,32,49
1975-02-04,NYK,109,25,25,LAL,94,18,30,43,55
1975-02-04,CHI,102,28,21,POR,90,22,27,50,48
1975-02-04,PHX,90,20,27,WAS,89,34,14,54,41
1975-02-05,PHL,110,22,30,LAL,113,18,31,40,61
1975-02-05,SEA,102,24,25,PHX,107,21,27,45,52
1975-02-05,NOJ,97,6,40,HOU,124,24,26,30,66
1975-02-05,MIL,90,24,25,BOS,92,36,14,60,39
1975-02-05,KCK,90,27,25,POR,82,22,28,49,53
1975-02-06,PHX,112,22,27,SEA,105,24,26,46,53
1975-02-06,ATL,111,22,31,DET,98,31,21,53,52
1975-02-06,GOS,97,31,19,WAS,98,34,15,65,34
1975-02-06,MIL,94,24,26,KCK,95,28,25,52,51
1975-02-07,BUF,108,32,18,LAL,98,19,31,51,49
1975-02-07,MIL,119,24,27,NOJ,98,6,41,30,68
1975-02-07,HOU,105,25,26,ATL,97,23,31,48,57
1975-02-07,BOS,95,37,14,PHL,98,22,31,59,45
1975-02-07,CHI,95,29,21,DET,83,31,22,60,43
1975-02-07,SEA,76,24,27,WAS,99,35,15,59,42
1975-02-08,ATL,102,23,32,NOJ,106,6,42,29,74
1975-02-08,NYK,102,26,25,BOS,128,37,15,63,40
1975-02-08,POR,100,22,29,WAS,96,36,15,58,44
1975-02-08,GOS,105,31,20,PHX,96,23,27,54,47
1975-02-09,PHL,109,23,31,CHI,97,30,21,53,52
1975-02-09,DET,97,31,23,LAL,96,19,32,50,55
1975-02-09,SEA,93,24,28,BUF,99,33,18,57,46
1975-02-09,POR,92,23,29,HOU,102,26,26,49,55
1975-02-09,BOS,105,38,15,NYK,88,26,26,64,41
1975-02-10,MIL,130,25,27,DET,109,32,23,57,50
1975-02-10,NOJ,96,7,42,ATL,89,23,33,30,75
1975-02-11,LAL,108,19,33,BUF,112,34,18,53,51
1975-02-11,GOS,108,32,20,HOU,112,27,26,59,46
1975-02-11,CHI,101,30,22,NYK,84,26,27,56,49
1975-02-12,WAS,112,36,16,MIL,108,26,27,62,43
1975-02-12,SEA,104,24,29,HOU,103,28,26,52,55
1975-02-12,KCK,103,29,25,BOS,102,39,15,68,40
1975-02-12,PHL,102,24,31,CLE,105,11,19,35,50
1975-02-12,PHX,108,23,28,BUF,96,35,18,58,46
1975-02-12,DET,93,32,24,CHI,103,31,22,63,46
1975-02-14,HOU,112,28,27,NOJ,124,8,42,36,69
1975-02-14,BUF,112,35,19,KCK,132,30,25,65,44
1975-02-14,PHX,106,24,28,BOS,112,39,16,63,44
1975-02-14,MIL,112,26,28,CLE,105,12,19,38,47
1975-02-14,PHL,103,24,32,DET,101,32,25,56,57
1975-02-14,LAL,108,19,34,ATL,100,23,34,42,68
1975-02-14,POR,90,23,30,SEA,88,25,29,48,59
1975-02-14,CHI,105,32,22,GOS,87,32,21,64,43
1975-02-15,PHX,107,24,29,ATL,111,23,35,47,64
1975-02-15,NYK,106,26,28,WAS,108,37,16,63,44
1975-02-15,PHL,101,25,32,GOS,108,32,22,57,54
1975-02-15,POR,100,24,30,BOS,102,40,16,64,46
1975-02-15,DET,81,32,26,KCK,93,31,25,63,51
1975-02-16,CHI,114,33,22,BUF,109,35,20,68,42
1975-02-16,WAS,125,38,16,NYK,104,26,29,64,45
1975-02-16,NOJ,103,9,42,MIL,101,27,28,36,70
1975-02-16,KCK,102,32,25,DET,99,32,27,64,52
1975-02-16,SEA,109,25,30,LAL,87,20,34,45,64
1975-02-18,BUF,124,35,21,PHX,109,24,30,59,51
1975-02-18,CHI,128,34,22,LAL,105,20,35,54,57
1975-02-18,NYK,99,26,30,GOS,98,33,22,59,52
1975-02-18,NOJ,103,10,42,PHL,85,25,33,35,75
1975-02-18,HOU,107,28,28,POR,83,24,31,52,59
1975-02-19,WAS,120,39,16,PHX,97,24,31,63,47
1975-02-19,SEA,121,26,30,BOS,95,41,16,67,46
1975-02-19,DET,94,32,28,NYK,109,27,30,59,58
1975-02-19,KCK,115,33,25,LAL,92,20,36,53,61
1975-02-20,GOS,108,33,23,ATL,102,24,35,57,58
1975-02-20,NOJ,114,11,42,POR,102,24,32,35,74
1975-02-21,SEA,110,27,30,ATL,108,24,36,51,66
1975-02-21,BUF,116,36,21,POR,106,24,33,60,54
1975-02-21,NOJ,98,12,42,PHX,96,24,32,36,74
1975-02-21,DET,96,32,29,WAS,121,40,16,72,45
1975-02-21,LAL,93,20,37,GOS,105,34,23,54,60
1975-02-21,CHI,96,35,22,MIL,85,27,29,62,51
1975-02-21,HOU,103,29,28,PHL,85,25,34,54,62
1975-02-22,GOS,114,35,23,BOS,108,41,17,76,40
1975-02-22,NYK,85,28,30,BUF,92,37,21,65,51
1975-02-23,LAL,115,20,38,BOS,119,41,18,61,56
1975-02-23,SEA,100,28,30,PHL,114,25,35,53,65
1975-02-23,NOJ,108,13,42,HOU,99,30,28,43,70
1975-02-23,WAS,113,41,16,POR,98,24,34,65,50
1975-02-23,MIL,97,27,30,PHX,106,24,33,51,63
1975-02-25,NOJ,105,14,42,CHI,120,36,22,50,64
1975-02-25,NYK,101,28,31,SEA,102,28,31,56,62
1975-02-25,GOS,97,36,23,PHX,111,25,33,61,56
1975-02-25,BUF,93,38,21,WAS,111,42,16,80,37
1975-02-25,KCK,93,34,25,MIL,90,27,31,61,56
1975-02-25,HOU,114,30,29,CLE,87,12,20,42,49
1975-02-25,POR,99,24,35,PHL,77,26,35,50,70
1975-02-26,LAL,116,20,39,POR,117,25,35,45,74
1975-02-26,BOS,121,42,18,NYK,103,28,32,70,50
1975-02-26,WAS,104,43,16,SEA,98,29,31,72,47
1975-02-26,PHX,108,26,33,CLE,96,12,21,38,54
1975-02-26,DET,104,32,30,MIL,84,27,32,59,62
1975-02-27,BUF,110,38,22,NOJ,100,14,43,52,65
1975-02-27,ATL,91,24,37,CHI,111,37,22,61,59
1975-02-28,PHL,112,26,36,SEA,111,29,32,55,68
1975-02-28,NOJ,114,14,44,KCK,107,35,25,49,69
1975-02-28,BOS,107,43,18,MIL,106,27,33,70,51
1975-02-28,BUF,106,39,22,NYK,114,28,33,67,55
1975-02-28,LAL,109,20,40,CLE,105,12,22,32,62
1975-02-28,PHX,102,27,33,GOS,96,36,24,63,57
1975-02-28,WAS,106,44,16,DET,95,33,30,77,46
1975-02-28,HOU,102,31,29,CHI,87,38,22,69,51
1975-03-01,HOU,121,32,29,NOJ,109,15,44,47,73
1975-03-01,MIL,104,27,34,BUF,100,39,23,66,57
1975-03-01,ATL,108,24,38,KCK,95,35,26,59,64
1975-03-01,GOS,110,36,25,CLE,95,12,23,48,48
1975-03-01,DET,95,33,31,CHI,94,38,23,71,54
1975-03-01,NYK,94,29,33,PHL,100,27,36,56,69
1975-03-02,KCK,122,35,27,DET,112,34,31,69,58
1975-03-02,HOU,110,33,29,PHX,104,28,33,61,62
1975-03-02,WAS,117,45,16,LAL,104,21,40,66,56
1975-03-02,BOS,97,44,18,SEA,104,29,33,73,51
1975-03-02,PHL,91,28,36,NYK,87,29,34,57,70
1975-03-02,POR,122,26,35,GOS,86,37,25,63,60
1975-03-04,NYK,111,29,35,BOS,126,44,19,73,54
1975-03-04,GOS,117,37,26,CHI,102,38,24,75,50
1975-03-04,KCK,103,36,27,PHX,99,28,34,64,61
1975-03-04,POR,117,27,35,CLE,98,12,24,39,59
1975-03-04,BUF,104,39,24,SEA,97,30,33,69,57
1975-03-04,ATL,109,25,38,LAL,97,21,41,46,79
1975-03-04,MIL,101,28,34,DET,83,34,32,62,66
1975-03-05,NOJ,123,15,45,LAL,117,21,42,36,87
1975-03-05,WAS,118,46,16,ATL,112,26,38,72,54
1975-03-05,PHL,107,29,36,BOS,116,45,19,74,55
1975-03-06,KCK,111,37,27,BUF,110,40,24,77,51
1975-03-06,ATL,110,26,39,GOS,106,38,26,64,65
1975-03-06,MIL,102,29,34,SEA,92,30,34,59,68
1975-03-06,PHX,88,28,35,CHI,65,38,25,66,60
1975-03-07,NOJ,110,16,45,GOS,107,38,27,54,72
1975-03-07,POR,120,28,35,PHX,98,29,35,57,70
1975-03-07,LAL,87,21,43,CHI,89,38,26,59,69
1975-03-07,HOU,93,34,29,CLE,86,12,25,46,54
1975-03-08,PHX,107,29,36,HOU,112,35,29,64,65
1975-03-08,ATL,113,27,39,NOJ,101,17,45,44,84
1975-03-08,NYK,118,29,36,DET,100,34,33,63,69
1975-03-08,KCK,99,38,27,SEA,103,30,35,68,62
1975-03-08,BUF,110,40,25,MIL,95,30,34,70,59
1975-03-08,PHL,92,29,37,WAS,113,47,16,76,53
1975-03-08,POR,88,29,35,CHI,82,39,26,68,61
1975-03-09,BOS,101,46,19,GOS,102,38,28,84,47
1975-03-09,WAS,100,48,16,PHL,113,29,38,77,54
1975-03-09,DET,106,34,34,KCK,99,38,28,72,62
1975-03-09,LAL,116,21,44,HOU,95,36,29,57,73
1975-03-09,NOJ,90,17,46,CLE,86,12,26,29,72
1975-03-10,MIL,103,30,35,KCK,96,38,29,68,64
1975-03-11,HOU,117,36,30,SEA,122,31,35,67,65
1975-03-11,CHI,115,39,27,BOS,121,46,20,85,47
1975-03-11,NYK,103,30,36,PHX,98,29,37,59,73
1975-03-11,DET,94,35,34,LAL,95,22,44,57,78
1975-03-11,MIL,90,31,35,GOS,107,39,28,70,63
1975-03-11,ATL,87,28,39,WAS,99,48,17,76,56
1975-03-12,PHL,91,30,38,POR,88,30,35,60,73
1975-03-12,WAS,117,49,17,HOU,88,36,31,85,48
1975-03-12,BOS,88,47,20,PHX,82,29,38,76,58
1975-03-13,ATL,104,28,40,MIL,120,31,36,59,76
1975-03-13,NYK,116,31,36,POR,103,30,36,61,72
1975-03-13,GOS,103,40,28,BUF,122,41,25,81,53
1975-03-14,SEA,125,32,35,BUF,105,42,25,74,60
1975-03-14,MIL,104,32,36,LAL,105,23,44,55,80
1975-03-14,KCK,103,38,30,WAS,102,50,17,88,47
1975-03-14,BOS,103,48,20,POR,98,30,37,78,57
1975-03-14,PHL,108,31,38,PHX,97,29,39,60,77
1975-03-14,CHI,97,39,28,DET,94,35,35,74,63
1975-03-14,HOU,94,36,32,NYK,103,32,36,68,68
1975-03-15,NOJ,140,18,46,ATL,123,28,41,46,87
1975-03-15,GOS,120,40,29,SEA,84,33,35,73,64
1975-03-16,ATL,117,28,42,PHX,114,29,40,57,82
1975-03-16,NOJ,111,19,46,CLE,113,12,27,31,73
1975-03-16,POR,102,30,38,BUF,95,42,26,72,64
1975-03-16,LAL,111,24,44,GOS,95,41,29,65,73
1975-03-16,SEA,97,33,36,NYK,94,33,36,66,72
1975-03-16,BOS,99,49,20,HOU,94,36,33,85,53
1975-03-16,CHI,90,40,28,MIL,103,32,37,72,65
1975-03-18,HOU,122,36,34,BUF,115,42,27,78,61
1975-03-18,GOS,133,41,30,PHX,103,29,41,70,71
1975-03-18,KCK,105,39,30,ATL,101,29,42,68,72
1975-03-18,LAL,100,25,44,NYK,109,33,37,58,81
1975-03-18,CLE,112,13,27,WAS,98,50,18,63,45
1975-03-18,CHI,111,40,29,PHL,96,32,38,72,67
1975-03-18,DET,90,35,36,BOS,116,50,20,85,56
1975-03-18,POR,95,31,38,MIL,89,33,37,64,75
1975-03-19,PHL,115,32,39,NOJ,126,19,47,51,86
1975-03-19,SEA,101,34,36,MIL,100,33,38,67,74
1975-03-19,PHX,96,29,42,NYK,101,34,37,63,79
1975-03-19,WAS,97,50,19,BOS,80,51,20,101,39
1975-03-20,GOS,97,42,30,POR,95,32,38,74,68
1975-03-20,KCK,101,40,30,NOJ,95,20,47,60,77
1975-03-21,DET,121,35,37,HOU,110,37,34,72,71
1975-03-21,LAL,112,25,45,SEA,109,35,36,60,81
1975-03-21,NOJ,109,20,48,WAS,122,51,19,71,67
1975-03-21,PHX,108,29,43,POR,112,32,39,61,82
1975-03-21,PHL,114,32,40,ATL,103,29,43,61,83
1975-03-21,BOS,109,51,21,BUF,101,42,28,93,49
1975-03-21,CHI,104,41,29,KCK,98,41,30,82,59
1975-03-22,GOS,133,43,30,MIL,117,33,39,76,69
1975-03-22,BUF,117,42,29,HOU,112,37,35,79,64
1975-03-22,ATL,104,29,44,PHL,100,33,40,62,84
1975-03-22,WAS,100,52,19,CLE,97,14,27,66,46
1975-03-22,POR,94,33,39,PHX,92,29,44,62,83
1975-03-22,NYK,81,35,37,BOS,90,52,21,87,58
1975-03-23,NOJ,114,20,49,DET,125,36,37,56,86
1975-03-23,KCK,103,41,31,CHI,101,42,29,83,60
1975-03-23,LAL,116,26,45,MIL,97,33,40,59,85
1975-03-23,SEA,96,35,37,PHX,102,29,45,64,82
1975-03-23,BOS,96,53,21,NYK,86,35,38,88,59
1975-03-25,GOS,139,44,30,LAL,122,27,45,71,75
1975-03-25,NOJ,112,20,50,KCK,110,42,31,62,81
1975-03-25,BUF,118,43,29,PHL,103,33,41,76,70
1975-03-25,CHI,112,42,30,HOU,94,37,36,79,66
1975-03-25,ATL,89,30,44,POR,105,34,39,64,83
1975-03-25,PHX,92,30,45,MIL,87,33,41,63,86
1975-03-26,DET,110,37,37,POR,107,35,39,72,76
1975-03-26,BOS,113,54,21,NOJ,100,21,50,75,71
1975-03-26,PHL,98,33,42,NYK,128,35,39,68,81
1975-03-26,WAS,91,53,19,BUF,94,44,29,97,48
1975-03-26,SEA,110,35,38,LAL,89,27,46,62,84
1975-03-27,GOS,111,45,30,KCK,103,42,32,87,62
1975-03-27,CHI,83,43,30,CLE,86,14,28,57,58
1975-03-27,PHX,79,31,45,DET,91,38,37,69,82
1975-03-28,HOU,112,37,37,CLE,105,15,28,52,65
1975-03-28,MIL,128,33,42,POR,105,35,40,68,82
1975-03-28,PHL,104,33,43,BUF,115,45,29,78,72
1975-03-28,LAL,114,27,47,KCK,103,42,33,69,80
1975-03-28,NOJ,111,21,51,NYK,102,36,39,57,90
1975-03-28,SEA,96,36,38,GOS,92,46,30,82,68
1975-03-28,BOS,97,55,21,CHI,92,43,31,98,52
1975-03-29,GOS,115,46,31,DET,112,39,37,85,68
1975-03-29,HOU,107,38,37,NOJ,105,22,51,60,88
1975-03-29,PHX,100,31,46,KCK,104,42,34,73,80
1975-03-29,ATL,103,30,45,CLE,97,15,29,45,74
1975-03-29,BUF,102,46,29,BOS,96,56,21,102,50
1975-03-30,NOJ,108,22,52,ATL,105,31,45,53,97
1975-03-30,NYK,111,36,40,MIL,99,34,42,70,82
1975-03-30,LAL,104,28,47,PHX,90,31,47,59,94
1975-03-30,SEA,98,37,38,POR,88,35,41,72,79
1975-03-30,WAS,94,53,20,CHI,82,43,32,96,52
1975-04-01,LAL,106,29,47,POR,124,35,42,64,89
1975-04-01,HOU,113,39,37,ATL,104,31,46,70,83
1975-04-01,NOJ,101,23,52,WAS,110,54,20,77,72
1975-04-01,NYK,99,37,40,PHL,95,33,44,70,84
1975-04-01,BUF,93,47,29,CHI,98,43,33,90,62
1975-04-01,MIL,98,34,43,DET,91,39,38,73,81
1975-04-02,PHX,108,31,48,LAL,106,29,48,60,96
1975-04-02,SEA,99,38,38,KCK,96,43,34,81,72
1975-04-02,BOS,95,56,22,BUF,92,47,30,103,52
1975-04-02,DET,97,39,39,CHI,89,44,33,83,72
1975-04-02,WAS,112,55,20,HOU,85,40,37,95,57
1975-04-03,CLE,100,15,30,NYK,95,38,40,53,70
1975-04-04,POR,116,36,42,KCK,110,43,35,79,77
1975-04-04,LAL,102,29,49,SEA,111,39,38,68,87
1975-04-04,MIL,109,35,43,NYK,101,38,41,73,84
1975-04-04,PHX,99,32,48,GOS,128,47,31,79,79
1975-04-04,BUF,108,47,31,PHL,97,33,45,80,76
1975-04-04,BOS,95,57,22,WAS,94,56,20,113,42
1975-04-04,CHI,111,44,34,NOJ,87,23,53,67,87
1975-04-05,WAS,123,56,21,ATL,115,31,47,87,68
1975-04-05,GOS,108,48,31,SEA,109,40,38,88,69
1975-04-05,DET,106,40,39,MIL,119,36,43,76,82
1975-04-05,PHL,97,33,46,BOS,111,58,22,91,68
1975-04-06,SEA,114,41,38,PHX,111,32,49,73,87
1975-04-06,WAS,119,57,21,NOJ,103,23,54,80,75
1975-04-06,MIL,100,37,43,CHI,112,45,34,82,77
1975-04-06,POR,126,37,42,LAL,97,29,50,66,92
1975-04-06,KCK,95,43,36,CLE,94,16,30,59,66
1975-04-06,NYK,105,38,42,BUF,93,48,31,86,73
1975-10-23,CLE,83,0,0,GOS,89,0,0,0,0
1975-10-23,WAS,107,0,0,KCK,95,0,0,0,0
1975-10-23,NYK,101,0,0,LAL,104,0,0,0,0
1975-10-23,ATL,109,0,0,NOJ,91,0,0,0,0
1975-10-24,NOJ,114,0,1,DET,106,0,0,0,1
1975-10-24,BOS,109,0,0,HOU,94,0,0,0,0
1975-10-24,CHI,103,0,0,PHL,110,0,0,0,0
1975-10-24,SEA,105,0,0,POR,97,0,0,0,0
1975-10-25,MIL,87,0,0,CHI,91,0,1,0,1
1975-10-25,NYK,100,0,1,CLE,91,0,1,0,2
1975-10-25,ATL,102,1,0,DET,108,0,1,1,1
1975-10-25,POR,88,0,1,PHX,89,0,0,0,1
1975-10-25,BUF,104,0,0,GOS,92,1,0,1,0
1975-10-26,NOJ,125,1,1,NYK,114,1,1,2,2
1975-10-26,SEA,113,1,0,PHX,99,1,0,2,0
1975-10-27,PHL,117,1,0,LAL,104,1,0,2,0
1975-10-28,NYK,94,1,2,GOS,111,1,1,2,3
1975-10-28,BUF,124,1,0,HOU,108,0,1,1,1
1975-10-28,MIL,92,0,1,LAL,99,1,1,1,2
1975-10-28,NOJ,99,2,1,POR,90,0,2,2,3
1975-10-28,CHI,101,1,1,SEA,90,2,0,3,1
1975-10-29,BOS,115,1,0,GOS,106,2,1,3,1
1975-10-29,DET,112,1,1,LAL,99,2,1,3,2
1975-10-29,KCK,91,0,1,SEA,92,2,1,2,2
1975-10-30,NYK,117,1,4,KCK,113,0,2,1,6
1975-10-31,PHL,87,2,0,BUF,92,2,0,4,0
1975-10-31,DET,131,2,1,HOU,127,0,2,2,3
1975-10-31,NOJ,100,3,1,MIL,85,0,2,3,3
1975-10-31,BOS,112,2,0,POR,94,0,3,2,3
1975-10-31,LAL,120,2,2,SEA,104,3,1,5,3
1975-11-01,CHI,84,2,1,BOS,82,3,0,5,1
1975-11-01,BUF,97,3,0,DET,93,3,1,6,1
1975-11-01,CLE,91,0,2,NOJ,103,4,1,4,3
1975-11-01,NYK,110,2,4,PHL,98,2,1,4,5
1975-11-01,KCK,106,0,3,PHX,100,2,1,2,4
1975-11-01,MIL,97,0,3,POR,113,0,4,0,7
1975-11-01,GOS,100,2,2,WAS,89,1,0,3,2
1975-11-02,LAL,116,3,2,ATL,113,1,1,4,3
1975-11-02,HOU,104,0,3,MIL,89,0,4,0,7
1975-11-02,SEA,85,3,2,WAS,94,1,1,4,3
1975-11-04,POR,97,1,4,ATL,98,1,2,2,6
1975-11-04,WAS,113,2,1,CLE,96,0,3,2,4
1975-11-04,MIL,103,0,5,DET,101,3,2,3,7
1975-11-04,KCK,116,1,3,LAL,98,4,2,5,5
1975-11-04,HOU,119,1,3,NYK,106,3,4,4,7
1975-11-04,BUF,114,4,0,PHL,121,2,2,6,2
1975-11-04,CHI,80,3,1,PHX,96,2,2,5,3
1975-11-05,BOS,105,3,1,BUF,95,4,1,7,2
1975-11-05,PHL,115,3,2,CHI,82,3,2,6,4
1975-11-05,NOJ,113,5,1,LAL,110,4,3,9,4
1975-11-05,DET,124,3,3,SEA,107,3,3,6,6
1975-11-06,ATL,108,2,2,CLE,113,0,4,2,6
1975-11-06,GOS,111,3,2,NYK,96,3,5,6,7
1975-11-06,WAS,110,3,1,SEA,100,3,4,6,5
1975-11-07,MIL,104,1,5,BOS,101,4,1,5,6
1975-11-07,NOJ,90,6,1,CLE,94,1,4,7,5
1975-11-07,CHI,122,3,3,DET,124,4,3,7,6
1975-11-07,POR,92,1,5,KCK,88,2,3,3,8
1975-11-07,LAL,105,4,4,NYK,97,3,6,7,10
1975-11-07,PHL,103,4,2,PHX,99,3,2,7,4
1975-11-08,DET,104,5,3,BOS,118,4,2,9,5
1975-11-08,HOU,116,2,3,CLE,112,2,4,4,7
1975-11-08,GOS,114,4,2,LAL,106,5,4,9,6
1975-11-08,WAS,95,4,1,MIL,99,2,5,6,6
1975-11-08,BUF,110,4,2,PHX,105,3,3,7,5
1975-11-08,ATL,107,2,3,SEA,94,3,5,5,8
1975-11-09,LAL,125,5,5,KCK,112,2,4,7,9
1975-11-09,POR,115,2,5,NYK,96,3,7,5,12
1975-11-09,NOJ,97,6,2,SEA,111,3,6,9,8
1975-11-11,PHX,112,1,1,NYK,81,1,3,2,4
1975-11-11,BOS,91,5,2,ATL,100,3,3,8,5
1975-11-11,GOS,103,5,2,CLE,98,2,5,7,7
1975-11-11,POR,106,3,5,NOJ,104,6,3,9,8
1975-11-11,MIL,108,3,5,PHL,81,5,2,8,7
1975-11-11,BUF,90,5,2,WAS,105,4,2,9,4
1975-11-12,DET,106,5,4,ATL,109,4,3,9,7
1975-11-12,HOU,80,3,3,BUF,93,5,3,8,6
1975-11-12,SEA,92,4,6,KCK,107,2,5,6,11
1975-11-12,PHL,84,5,3,MIL,107,4,5,9,8
1975-11-12,LAL,116,6,5,NOJ,100,6,4,12,9
1975-11-13,WAS,110,5,2,BOS,107,5,3,10,5
1975-11-13,GOS,98,6,2,CHI,87,3,4,9,6
1975-11-13,NYK,108,3,8,HOU,102,3,4,6,12
1975-11-13,PHX,106,3,4,SEA,103,4,7,7,11
1975-11-14,MIL,98,5,5,BUF,112,6,3,11,8
1975-11-14,POR,93,4,5,CHI,89,3,5,7,10
1975-11-14,SEA,100,4,8,CLE,97,2,6,6,14
1975-11-14,BOS,109,5,4,PHL,119,5,4,10,8
1975-11-14,LAL,114,7,5,PHX,107,4,4,11,9
1975-11-14,ATL,97,5,3,WAS,88,6,2,11,5
1975-11-15,NYK,92,4,8,ATL,86,6,3,10,11
1975-11-15,BUF,110,7,3,BOS,112,5,5,12,8
1975-11-15,POR,95,5,5,CLE,99,2,7,7,12
1975-11-15,GOS,123,7,2,KCK,92,3,5,10,7
1975-11-15,DET,101,5,5,MIL,89,5,6,10,11
1975-11-15,HOU,103,3,5,NOJ,101,6,5,9,10
1975-11-15,PHL,110,6,4,WAS,109,6,3,12,7
1975-11-16,LAL,110,8,5,CHI,93,3,6,11,11
1975-11-16,SEA,102,5,8,GOS,98,8,2,13,10
1975-11-16,ATL,97,6,4,NYK,96,5,8,11,12
1975-11-18,NOJ,104,6,6,GOS,112,8,3,14,9
1975-11-18,BUF,120,7,4,LAL,106,9,5,16,9
1975-11-18,NYK,101,5,9,POR,92,5,6,10,15
1975-11-19,SEA,97,6,8,CHI,87,3,8,9,16
1975-11-19,ATL,104,7,4,GOS,98,9,3,16,7
1975-11-19,PHL,113,7,4,KCK,103,4,6,11,10
1975-11-19,HOU,110,4,5,LAL,118,9,6,13,11
1975-11-19,PHX,94,4,5,MIL,96,5,7,9,12
1975-11-19,DET,120,6,5,POR,114,5,7,11,12
1975-11-20,WAS,105,6,4,ATL,96,8,4,14,8
1975-11-21,KCK,107,3,6,CHI,98,3,7,6,13
1975-11-21,DET,104,7,5,BUF,94,8,4,15,9
1975-11-21,PHX,107,4,6,HOU,92,4,6,8,12
1975-11-21,LAL,116,10,7,MIL,104,6,7,16,14
1975-11-21,BOS,110,6,5,NYK,101,6,9,12,14
1975-11-21,PHL,131,8,4,POR,111,6,8,14,12
1975-11-22,NYK,94,6,10,CLE,95,3,7,9,17
1975-11-22,WAS,71,7,4,GOS,111,9,4,16,8
1975-11-22,ATL,85,8,5,NOJ,89,6,7,14,12
1975-11-22,BUF,104,8,5,POR,109,6,9,14,14
1975-11-23,LAL,110,11,7,HOU,99,4,7,15,14
1975-11-23,SEA,112,7,8,MIL,104,6,8,13,16
1975-11-23,ATL,115,8,6,PHL,111,9,4,17,10
1975-11-25,CHI,94,3,9,CLE,98,4,7,7,16
1975-11-25,PHL,109,9,5,GOS,108,10,4,19,9
1975-11-25,WAS,89,7,5,HOU,100,4,8,11,13
1975-11-25,NYK,127,6,11,SEA,128,8,8,14,19
1975-11-26,LAL,101,10,6,POR,118,5,8,15,14
1975-11-26,NOJ,108,7,7,ATL,113,9,6,16,13
1975-11-26,PHX,107,5,6,BUF,106,8,6,13,12
1975-11-26,DET,120,9,5,KCK,104,4,8,13,13
1975-11-26,BOS,109,7,5,SEA,110,9,8,16,13
1975-11-26,HOU,97,5,8,WAS,85,7,6,12,14
1975-11-27,MIL,105,6,9,GOS,106,10,5,16,14
1975-11-27,WAS,90,7,7,NYK,96,6,12,13,19
1975-11-28,BOS,114,7,6,ATL,107,10,6,17,12
1975-11-28,LAL,126,12,7,BUF,105,8,7,20,14
1975-11-28,CHI,89,3,10,MIL,69,6,10,9,20
1975-11-28,KCK,98,4,10,NOJ,97,7,8,11,18
1975-11-28,PHX,110,6,6,POR,101,8,9,14,15
1975-11-28,PHL,113,10,5,SEA,94,10,8,20,13
1975-11-29,POR,130,8,10,BUF,115,8,8,16,18
1975-11-29,MIL,88,6,11,CHI,85,4,10,10,21
1975-11-29,NYK,110,7,12,DET,115,10,5,17,17
1975-11-29,HOU,99,6,8,PHL,98,11,5,17,13
1975-11-29,GOS,112,11,5,PHX,100,7,6,18,11
1975-11-30,KCK,110,6,10,NYK,98,7,13,13,23
1975-11-30,NOJ,96,7,9,PHL,113,11,6,18,15
1975-11-30,LAL,116,13,7,POR,109,9,10,22,17
1975-12-02,NYK,100,7,14,BOS,103,8,6,15,20
1975-12-02,PHX,115,7,7,GOS,98,12,6,19,13
1975-12-02,CHI,77,4,11,HOU,91,7,8,11,19
1975-12-02,WAS,107,7,8,LAL,104,14,7,21,15
1975-12-02,BUF,96,8,9,NOJ,108,7,10,15,19
1975-12-02,KCK,90,7,10,SEA,101,10,9,17,19
1975-12-03,BOS,106,9,6,CHI,109,4,12,13,18
1975-12-03,DET,110,11,5,LAL,118,14,8,25,13
1975-12-03,PHL,102,12,6,NOJ,94,8,10,20,16
1975-12-03,MIL,114,7,11,POR,92,9,11,16,22
1975-12-03,HOU,107,9,8,SEA,101,11,9,20,17
1975-12-04,KCK,105,7,11,CLE,101,5,7,12,18
1975-12-04,ATL,94,10,7,POR,87,9,12,19,19
1975-12-05,BUF,125,8,11,CLE,88,5,8,13,19
1975-12-05,DET,102,11,6,HOU,91,10,8,21,14
1975-12-05,MIL,103,8,11,KCK,95,8,11,16,22
1975-12-05,BOS,104,9,7,NOJ,93,8,11,17,18
1975-12-05,PHL,99,13,6,NYK,97,7,15,20,21
1975-12-05,PHX,87,8,7,WAS,92,8,8,16,15
1975-12-06,ATL,104,11,7,BOS,111,10,7,21,14
1975-12-06,NYK,108,7,16,BUF,98,9,11,16,27
1975-12-06,HOU,105,10,9,DET,96,12,6,22,15
1975-12-06,KCK,84,8,12,PHL,98,14,6,22,18
1975-12-06,CHI,77,5,12,POR,90,9,13,14,25
1975-12-06,GOS,104,12,7,SEA,94,11,10,23,17
1975-12-07,PHX,114,8,8,CHI,97,5,13,13,21
1975-12-07,SEA,106,11,11,GOS,115,13,7,24,18
1975-12-07,LAL,114,15,8,WAS,106,9,8,24,16
1975-12-09,PHL,100,15,6,CLE,85,5,9,20,15
1975-12-09,GOS,129,14,7,DET,124,12,7,26,14
1975-12-09,BUF,126,9,12,KCK,107,8,13,17,25
1975-12-09,NYK,100,8,16,MIL,109,9,11,17,27
1975-12-09,NOJ,89,8,12,PHX,104,9,8,17,20
1975-12-09,POR,95,10,13,WAS,116,9,9,19,22
1975-12-10,KCK,100,8,14,ATL,94,11,8,19,22
1975-12-10,SEA,99,11,12,CHI,79,5,14,16,26
1975-12-10,BOS,111,11,7,MIL,98,10,11,21,18
1975-12-10,HOU,91,11,9,PHX,105,10,8,21,17
1975-12-11,ATL,122,11,9,BUF,99,10,12,21,21
1975-12-11,WAS,117,10,9,NOJ,109,8,13,18,22
1975-12-11,PHX,106,11,8,PHL,110,16,6,27,14
1975-12-11,GOS,101,15,7,POR,89,10,14,25,21
1975-12-12,KCK,109,9,15,CHI,99,5,15,14,30
1975-12-12,MIL,91,11,12,CLE,109,5,10,16,22
1975-12-12,SEA,97,12,12,DET,95,12,8,24,20
1975-12-12,BUF,123,10,13,NYK,110,8,17,18,30
1975-12-12,LAL,114,16,8,PHL,102,17,6,33,14
1975-12-12,BOS,130,12,7,WAS,108,11,9,23,16
1975-12-13,HOU,120,11,10,BOS,137,13,7,24,17
1975-12-13,CHI,101,5,16,BUF,103,11,13,16,29
1975-12-13,POR,101,10,15,DET,91,12,9,22,24
1975-12-13,ATL,115,12,9,KCK,101,10,15,22,24
1975-12-13,PHX,116,11,9,LAL,108,17,8,28,17
1975-12-13,NYK,126,8,18,WAS,107,11,10,19,28
1975-12-14,NOJ,93,8,14,BOS,102,14,7,22,21
1975-12-14,LAL,110,17,9,DET,100,12,10,29,19
1975-12-14,KCK,105,11,16,GOS,115,16,7,27,23
1975-12-14,SEA,114,13,12,PHL,105,17,7,30,19
1975-12-14,POR,96,11,15,PHX,105,12,9,23,24
1975-12-16,NYK,97,9,18,ATL,96,13,9,22,27
1975-12-16,WAS,100,11,11,BUF,94,12,13,23,24
1975-12-16,LAL,103,18,9,CLE,123,6,11,24,20
1975-12-16,CHI,87,5,17,GOS,91,17,7,22,24
1975-12-16,KCK,100,11,17,HOU,111,11,11,22,28
1975-12-16,POR,98,11,16,PHL,105,17,8,28,24
1975-12-17,SEA,101,14,12,CLE,115,7,11,21,23
1975-12-17,DET,102,12,11,GOS,113,18,7,30,18
1975-12-17,BUF,88,12,14,HOU,85,12,11,24,25
1975-12-17,BOS,118,15,7,KCK,104,11,18,26,25
1975-12-17,PHX,116,13,9,MIL,111,11,13,24,22
1975-12-17,NOJ,105,8,15,WAS,88,12,11,20,26
1975-12-18,ATL,114,13,10,LAL,98,18,10,31,20
1975-12-19,HOU,113,12,12,ATL,107,14,10,26,22
1975-12-19,PHX,124,14,9,CLE,128,8,11,22,20
1975-12-19,CHI,104,5,18,LAL,91,18,11,23,29
1975-12-19,SEA,113,14,13,NOJ,102,9,15,23,28
1975-12-19,BOS,120,16,7,NYK,112,10,18,26,25
1975-12-19,DET,114,12,12,PHL,115,18,8,30,20
1975-12-19,BUF,104,13,14,WAS,88,12,12,25,26
1975-12-20,PHL,97,19,8,BOS,111,17,7,36,15
1975-12-20,KCK,110,11,19,BUF,117,14,14,25,33
1975-12-20,NYK,96,10,19,CHI,89,6,18,16,37
1975-12-20,WAS,98,12,13,DET,86,12,13,24,26
1975-12-20,ATL,123,14,11,HOU,108,13,12,27,23
1975-12-20,GOS,124,19,7,MIL,87,11,14,30,21
1975-12-20,POR,97,11,17,NOJ,105,9,16,20,33
1975-12-21,ATL,90,15,11,CHI,97,6,19,21,30
1975-12-21,POR,102,11,18,GOS,108,20,7,31,25
1975-12-21,SEA,101,15,13,MIL,103,11,15,26,28
1975-12-21,PHX,107,14,10,NOJ,120,10,16,24,26
1975-12-23,BUF,101,15,14,BOS,92,18,7,33,21
1975-12-23,HOU,103,13,13,CHI,94,7,19,20,32
1975-12-23,LAL,111,18,12,KCK,97,11,20,29,32
1975-12-23,GOS,105,21,7,NOJ,97,11,16,32,23
1975-12-23,MIL,108,12,15,NYK,110,11,19,23,34
1975-12-23,POR,125,11,19,SEA,100,15,14,26,33
1975-12-23,DET,102,12,14,WAS,120,14,13,26,27
1975-12-25,WAS,99,15,13,ATL,94,15,13,30,26
1975-12-25,NOJ,101,11,17,HOU,99,14,13,25,30
1975-12-25,PHX,122,14,11,KCK,111,11,21,25,32
1975-12-25,NYK,111,12,19,PHL,103,19,9,31,28
1975-12-26,PHX,106,15,11,BOS,112,18,8,33,19
1975-12-26,PHL,96,19,10,BUF,95,16,14,35,24
1975-12-26,DET,101,12,15,CHI,87,7,20,19,35
1975-12-26,SEA,90,15,15,KCK,87,11,22,26,37
1975-12-26,LAL,104,19,12,POR,95,12,19,31,31
1975-12-26,MIL,85,12,16,WAS,81,16,13,28,29
1975-12-27,WAS,100,16,14,CLE,106,9,11,25,25
1975-12-27,CHI,112,7,21,DET,99,13,15,20,36
1975-12-27,GOS,110,22,7,HOU,113,14,14,36,21
1975-12-27,SEA,100,16,15,LAL,109,20,12,36,27
1975-12-27,ATL,87,15,14,MIL,82,13,16,28,30
1975-12-27,NYK,108,13,19,NOJ,101,12,17,25,36
1975-12-27,BUF,130,16,15,PHL,105,20,10,36,25
1975-12-28,KCK,87,4,7,DET,103,8,5,12,12
1975-12-28,LAL,113,21,12,BOS,123,19,8,40,20
1975-12-28,POR,96,12,20,GOS,92,22,8,34,28
1975-12-28,SEA,116,16,16,HOU,106,16,14,32,30
1975-12-28,MIL,88,13,17,PHX,85,15,12,28,29
1975-12-29,CHI,93,8,21,NYK,94,14,19,22,40
1975-12-30,GOS,133,22,9,BOS,101,20,8,42,17
1975-12-30,WAS,96,16,15,CHI,81,8,22,24,37
1975-12-30,PHL,114,20,11,DET,108,13,16,33,27
1975-12-30,CLE,110,10,11,KCK,106,11,23,21,34
1975-12-30,BUF,118,17,15,MIL,106,14,17,31,32
1975-12-30,NYK,114,15,19,PHX,88,15,13,30,32
1975-12-30,LAL,100,21,13,SEA,112,17,16,38,29
1976-01-01,POR,107,13,20,HOU,110,16,15,29,35
1976-01-01,WAS,114,17,15,PHX,103,15,14,32,29
1976-01-02,NOJ,111,12,18,ATL,95,16,15,28,33
1976-01-02,SEA,98,18,16,BOS,102,20,9,38,25
1976-01-02,PHL,112,21,11,CLE,101,11,11,32,22
1976-01-02,LAL,105,21,14,GOS,113,23,9,44,23
1976-01-02,DET,83,13,17,MIL,98,14,18,27,35
1976-01-02,BUF,106,18,15,NYK,105,16,19,34,34
1976-01-02,CHI,99,8,23,WAS,107,18,15,26,38
1976-01-03,POR,125,13,21,BOS,97,21,9,34,30
1976-01-03,NYK,107,16,20,BUF,106,19,15,35,35
1976-01-03,CLE,100,11,12,DET,104,13,18,24,30
1976-01-03,MIL,126,15,18,HOU,101,17,15,32,33
1976-01-03,NOJ,120,13,18,KCK,95,11,24,24,42
1976-01-03,GOS,130,24,9,LAL,99,21,15,45,24
1976-01-03,WAS,119,19,15,PHL,104,22,11,41,26
1976-01-03,ATL,89,16,16,PHX,100,15,15,31,31
1976-01-04,SEA,97,18,17,GOS,85,25,9,43,26
1976-01-04,KCK,98,11,25,PHX,86,16,15,27,40
1976-01-04,LAL,110,21,16,POR,101,14,21,35,37
1976-01-05,CHI,98,8,24,HOU,97,17,16,25,40
1976-01-06,MIL,87,16,18,ATL,91,16,17,32,35
1976-01-06,CHI,98,9,24,NOJ,104,14,18,23,42
1976-01-06,BUF,114,19,16,LAL,113,22,16,41,32
1976-01-06,POR,97,14,22,NYK,112,17,20,31,42
1976-01-06,KCK,98,12,25,WAS,103,20,15,32,40
1976-01-07,DET,119,14,18,CLE,118,11,13,25,31
1976-01-07,PHX,110,16,16,GOS,114,25,10,41,26
1976-01-07,HOU,106,17,17,KCK,108,12,26,29,43
1976-01-07,BOS,109,21,10,LAL,103,22,17,43,27
1976-01-07,PHL,112,22,12,MIL,102,16,19,38,31
1976-01-07,SEA,91,19,17,NYK,89,18,20,37,37
1976-01-08,ATL,106,17,17,HOU,115,17,18,34,35
1976-01-08,KCK,97,13,26,NOJ,107,15,18,28,44
1976-01-08,GOS,129,26,10,PHX,113,16,17,42,27
1976-01-09,BUF,100,20,16,CHI,107,9,25,29,41
1976-01-09,MIL,102,16,20,DET,95,15,18,31,38
1976-01-09,PHL,109,23,12,LAL,106,22,18,45,30
1976-01-09,PHX,110,16,18,SEA,112,20,17,36,35
1976-01-09,BOS,118,22,10,WAS,113,21,15,43,25
1976-01-10,ATL,100,17,18,CLE,106,11,14,28,32
1976-01-10,CHI,111,10,25,KCK,84,13,27,23,52
1976-01-10,WAS,107,21,16,MIL,87,17,20,38,36
1976-01-10,DET,99,15,19,NOJ,104,16,18,31,37
1976-01-10,GOS,117,27,10,NYK,87,18,21,45,31
1976-01-10,HOU,105,18,18,POR,94,14,23,32,41
1976-01-11,PHL,118,24,12,BOS,107,23,10,47,22
1976-01-11,SEA,104,21,17,BUF,125,20,17,41,34
1976-01-11,KCK,105,13,28,DET,99,15,20,28,48
1976-01-11,MIL,95,17,21,LAL,89,22,19,39,40
1976-01-11,PHX,98,16,19,NYK,99,18,22,34,41
1976-01-11,ATL,109,17,19,POR,116,14,24,31,43
1976-01-13,GOS,127,28,10,BUF,101,21,17,49,27
1976-01-13,CHI,102,11,25,LAL,104,22,20,33,45
1976-01-13,BOS,106,23,11,POR,94,15,24,38,35
1976-01-13,MIL,114,18,21,SEA,108,21,18,39,39
1976-01-14,KCK,106,14,28,BOS,101,24,11,38,39
1976-01-14,WAS,92,22,16,CLE,88,12,14,34,30
1976-01-14,PHL,100,25,12,NOJ,95,17,18,42,30
1976-01-14,HOU,103,19,18,NYK,107,19,22,38,40
1976-01-14,ATL,110,17,20,SEA,112,21,19,38,39
1976-01-15,PHX,119,16,20,BUF,126,21,18,37,38
1976-01-16,CHI,104,11,26,BUF,110,22,18,33,44
1976-01-16,HOU,103,19,19,GOS,128,29,10,48,29
1976-01-16,MIL,92,19,21,NOJ,94,17,19,36,40
1976-01-16,KCK,90,15,28,NYK,102,20,22,35,50
1976-01-16,BOS,118,24,12,PHL,110,26,12,50,24
1976-01-16,DET,104,15,21,POR,111,15,25,30,46
1976-01-16,WAS,100,23,16,SEA,85,22,19,45,35
1976-01-17,KCK,94,4,9,POR,102,7,9,11,18
1976-01-17,CHI,92,11,27,BOS,94,25,12,36,39
1976-01-17,ATL,97,17,21,GOS,91,30,10,47,31
1976-01-17,HOU,97,19,20,NOJ,103,18,19,37,39
1976-01-17,WAS,105,24,16,PHL,103,26,13,50,29
1976-01-17,CLE,105,12,15,PHX,85,16,21,28,36
1976-01-17,BUF,110,23,18,SEA,101,22,20,45,38
1976-01-18,MIL,94,19,22,BOS,97,26,12,45,34
1976-01-18,DET,118,15,22,PHX,122,16,22,31,44
1976-01-19,HOU,115,19,21,WAS,96,25,16,44,37
1976-01-20,CHI,86,11,28,ATL,100,18,21,29,49
1976-01-20,WAS,107,25,17,DET,114,15,23,40,40
1976-01-20,KCK,103,15,29,GOS,116,30,11,45,40
1976-01-20,MIL,108,19,23,PHL,111,26,14,45,37
1976-01-20,BUF,112,24,18,PHX,103,17,22,41,40
1976-01-20,NYK,107,21,22,POR,104,16,25,37,47
1976-01-21,ATL,94,19,21,BUF,102,25,18,44,39
1976-01-21,NOJ,93,19,19,CHI,102,11,29,30,48
1976-01-21,BOS,114,27,12,PHX,100,17,23,44,35
1976-01-21,DET,111,16,23,SEA,104,22,21,38,44
1976-01-22,GOS,129,31,11,LAL,105,23,20,54,31
1976-01-22,WAS,109,25,18,NOJ,86,19,20,44,38
1976-01-23,BUF,119,26,18,ATL,104,19,22,45,40
1976-01-23,BOS,108,28,12,DET,91,17,23,45,35
1976-01-23,PHX,124,17,24,HOU,115,20,21,37,45
1976-01-23,MIL,113,19,24,KCK,97,15,30,34,54
1976-01-23,POR,119,16,26,LAL,96,23,21,39,47
1976-01-23,NYK,104,22,22,PHL,92,27,14,49,36
1976-01-24,PHL,130,27,15,ATL,116,19,23,46,38
1976-01-24,DET,100,17,24,NYK,117,23,22,40,46
1976-01-24,GOS,123,32,11,POR,125,17,26,49,37
1976-01-24,HOU,110,20,22,SEA,103,22,22,42,44
1976-01-24,PHX,84,18,24,WAS,100,26,18,44,42
1976-01-25,BOS,135,29,12,BUF,107,27,18,56,30
1976-01-25,KCK,118,15,31,CHI,110,12,29,27,60
1976-01-25,ATL,109,19,24,PHL,112,28,15,47,39
1976-01-25,LAL,101,23,22,WAS,105,27,18,50,40
1976-01-26,MIL,104,20,24,GOS,115,32,12,52,36
1976-01-27,NYK,113,24,22,ATL,114,19,25,43,47
1976-01-27,CHI,110,12,30,GOS,103,33,12,45,42
1976-01-27,KCK,107,16,31,MIL,89,20,25,36,56
1976-01-27,BUF,129,27,19,NOJ,105,19,21,46,40
1976-01-27,HOU,127,21,22,PHL,116,29,15,50,37
1976-01-27,POR,118,18,26,WAS,105,28,18,46,44
1976-01-28,BOS,110,30,12,ATL,99,20,25,50,37
1976-01-28,NOJ,112,19,22,BUF,126,28,19,47,41
1976-01-28,DET,84,17,25,CHI,87,13,30,30,55
1976-01-28,HOU,108,22,22,CLE,93,13,15,35,37
1976-01-28,LAL,121,23,23,PHX,118,18,25,41,48
1976-01-28,POR,124,19,26,SEA,104,22,23,41,49
1976-01-29,KCK,119,17,31,HOU,86,23,22,40,53
1976-01-29,PHX,96,18,26,MIL,105,20,26,38,52
1976-01-29,ATL,112,20,26,NYK,109,24,23,44,49
1976-01-29,GOS,123,33,13,PHL,114,29,16,62,29
1976-01-30,CHI,89,14,30,CLE,91,13,16,27,46
1976-01-30,DET,101,17,26,KCK,94,18,31,35,57
1976-01-30,NOJ,119,19,23,NYK,97,24,24,43,47
1976-01-30,LAL,113,24,23,POR,121,20,26,44,49
1976-01-30,SEA,123,22,24,WAS,100,28,19,50,43
1976-01-31,BUF,100,29,19,BOS,109,31,12,60,31
1976-01-31,NYK,114,24,25,HOU,130,23,23,47,48
1976-01-31,CHI,96,14,31,KCK,104,18,32,32,63
1976-01-31,GOS,90,34,13,MIL,88,21,26,55,39
1976-01-31,ATL,95,21,26,NOJ,108,20,23,41,49
1976-01-31,PHX,119,18,27,PHL,105,29,17,47,44
1976-02-01,DET,109,18,26,BOS,114,32,12,50,38
1976-02-01,ATL,84,21,27,CHI,80,14,32,35,59
1976-02-01,NOJ,96,21,23,CLE,95,14,16,35,39
1976-02-01,POR,107,21,26,MIL,97,21,27,42,53
1976-02-01,LAL,103,24,24,PHL,82,29,18,53,42
1976-02-01,GOS,99,35,13,WAS,101,28,20,63,33
1976-02-05,ATL,108,22,27,DET,111,18,27,40,54
1976-02-05,KCK,117,19,32,LAL,109,25,24,44,56
1976-02-05,HOU,111,24,23,NOJ,114,22,23,46,46
1976-02-06,PHL,87,29,19,CLE,92,14,17,43,36
1976-02-06,PHX,118,19,27,GOS,111,35,14,54,41
1976-02-06,NOJ,108,23,23,KCK,101,20,32,43,55
1976-02-06,CHI,112,14,33,LAL,106,25,25,39,58
1976-02-06,BUF,109,29,20,MIL,104,21,28,50,48
1976-02-06,SEA,100,23,24,POR,109,22,26,45,50
1976-02-07,NYK,98,24,26,BOS,106,33,12,57,38
1976-02-07,HOU,89,24,24,CHI,87,15,33,39,57
1976-02-07,DET,106,19,27,MIL,114,21,29,40,56
1976-02-07,GOS,127,35,15,SEA,100,23,25,58,40
1976-02-07,ATL,90,22,28,WAS,103,29,20,51,48
1976-02-08,PHL,100,29,20,BUF,97,30,20,59,40
1976-02-08,NOJ,92,24,23,CHI,96,15,34,39,57
1976-02-08,KCK,93,20,33,DET,94,19,28,39,61
1976-02-08,POR,105,23,26,GOS,109,36,15,59,41
1976-02-08,ATL,89,22,29,LAL,97,25,26,47,55
1976-02-08,BOS,89,34,12,NYK,97,24,27,58,39
1976-02-08,SEA,101,23,26,PHX,107,20,27,43,53
1976-02-09,HOU,105,25,24,KCK,86,20,34,45,58
1976-02-10,LAL,106,26,26,DET,88,20,28,46,54
1976-02-10,ATL,111,22,30,KCK,89,20,35,42,65
1976-02-10,GOS,124,37,15,NOJ,130,24,24,61,39
1976-02-10,MIL,97,22,29,NYK,104,25,27,47,56
1976-02-10,CHI,84,16,34,PHL,85,30,20,46,54
1976-02-10,BUF,115,30,21,WAS,105,30,20,60,41
1976-02-11,HOU,115,26,24,BOS,103,34,13,60,37
1976-02-11,PHX,123,21,27,DET,94,20,29,41,56
1976-02-11,NYK,95,26,27,MIL,109,22,30,48,57
1976-02-11,SEA,93,23,27,NOJ,90,25,24,48,51
1976-02-11,PHL,118,31,20,POR,106,23,27,54,47
1976-02-12,GOS,113,37,16,ATL,104,23,30,60,46
1976-02-12,WAS,92,30,21,POR,81,23,28,53,49
1976-02-13,SEA,119,24,27,ATL,102,23,31,47,58
1976-02-13,PHX,108,22,27,BOS,109,34,14,56,41
1976-02-13,KCK,96,20,36,BUF,101,31,21,51,57
1976-02-13,MIL,96,23,30,CLE,101,15,17,38,47
1976-02-13,PHL,134,32,20,HOU,109,27,24,59,44
1976-02-13,LAL,126,27,26,NOJ,112,25,25,52,51
1976-02-14,BUF,111,32,21,CLE,114,16,17,48,38
1976-02-14,GOS,106,38,16,DET,105,20,30,58,46
1976-02-14,WAS,108,31,21,HOU,89,27,25,58,46
1976-02-14,CHI,89,16,35,MIL,95,23,31,39,66
1976-02-14,PHX,112,22,28,NOJ,93,25,26,47,54
1976-02-14,NYK,101,26,28,PHL,97,33,20,59,48
1976-02-14,POR,108,23,29,SEA,122,25,27,48,56
1976-02-15,POR,109,23,30,BOS,105,35,14,58,44
1976-02-15,ATL,112,23,32,BUF,104,32,22,55,54
1976-02-15,SEA,109,26,27,DET,107,20,31,46,58
1976-02-15,MIL,113,24,31,HOU,105,27,26,51,57
1976-02-15,WAS,101,32,21,LAL,88,28,26,60,47
1976-02-15,PHL,82,33,21,NYK,88,27,28,60,49
1976-02-17,NYK,96,28,28,GOS,104,39,16,67,44
1976-02-17,NOJ,101,25,27,LAL,115,28,27,53,54
1976-02-17,KCK,125,20,37,PHL,107,33,22,53,59
1976-02-17,CHI,114,16,36,PHX,111,23,28,39,64
1976-02-17,BUF,116,32,23,POR,113,24,30,56,53
1976-02-17,MIL,112,25,31,WAS,113,33,21,58,52
1976-02-18,KCK,103,5,10,GOS,91,12,5,17,15
1976-02-18,SEA,124,27,27,BOS,99,35,15,62,42
1976-02-18,HOU,114,27,27,LAL,98,29,27,56,54
1976-02-18,DET,105,20,32,PHX,94,23,29,43,61
1976-02-20,LAL,113,29,28,BOS,125,35,16,64,44
1976-02-20,HOU,110,28,27,MIL,108,25,32,53,59
1976-02-20,SEA,111,28,27,PHL,92,33,23,61,50
1976-02-20,NOJ,102,25,28,PHX,103,23,30,48,58
1976-02-20,CHI,130,17,36,POR,74,24,31,41,67
1976-02-20,DET,102,21,32,WAS,87,34,21,55,53
1976-02-21,WAS,103,34,22,ATL,95,24,32,58,54
1976-02-21,GOS,100,40,16,BOS,94,36,16,76,32
1976-02-21,BUF,112,33,23,DET,114,22,32,55,55
1976-02-21,NYK,102,28,29,NOJ,98,25,29,53,58
1976-02-21,HOU,108,29,27,PHX,110,24,30,53,57
1976-02-21,KCK,97,21,37,POR,116,24,32,45,69
1976-02-22,NOJ,102,25,30,ATL,94,24,33,49,63
1976-02-22,MIL,115,25,33,CHI,112,18,36,43,69
1976-02-22,SEA,97,29,27,LAL,91,29,29,58,56
1976-02-22,GOS,94,41,16,PHL,93,33,24,74,40
1976-02-23,HOU,117,29,28,CLE,114,17,17,46,45
1976-02-24,NYK,103,29,29,BUF,109,33,24,62,53
1976-02-24,PHX,117,25,30,KCK,120,21,38,46,68
1976-02-24,POR,102,25,32,PHL,106,33,25,58,57
1976-02-24,CHI,83,18,37,WAS,92,35,22,53,59
1976-02-25,DET,101,23,32,CLE,108,17,18,40,50
1976-02-25,BOS,103,36,17,HOU,102,30,28,66,45
1976-02-25,BUF,94,34,24,SEA,126,30,27,64,51
1976-02-25,NOJ,105,26,30,WAS,104,36,22,62,52
1976-02-26,PHX,115,25,31,ATL,97,24,34,49,65
1976-02-26,WAS,118,36,23,NOJ,108,27,30,63,53
1976-02-27,PHL,114,34,25,GOS,121,42,16,76,41
1976-02-27,BUF,107,34,25,HOU,113,30,29,64,54
1976-02-27,LAL,97,29,30,KCK,90,22,38,51,68
1976-02-27,DET,97,23,33,NYK,93,29,30,52,63
1976-02-27,BOS,122,37,17,SEA,118,31,27,68,44
1976-02-28,NYK,93,29,31,CHI,85,18,38,47,69
1976-02-28,POR,119,25,33,KCK,105,22,39,47,72
1976-02-28,NOJ,99,27,31,MIL,112,26,33,53,64
1976-02-28,WAS,92,37,23,PHX,89,26,31,63,54
1976-02-29,POR,102,26,33,ATL,98,24,35,50,68
1976-02-29,WAS,110,38,23,HOU,108,31,29,69,52
1976-02-29,DET,98,24,33,PHX,109,26,32,50,65
1976-02-29,PHL,130,34,26,SEA,115,31,28,65,54
1976-02-29,LAL,108,30,30,CLE,97,18,18,48,48
1976-02-29,BOS,119,38,17,GOS,101,43,16,81,33
1976-03-02,POR,116,27,33,CHI,105,18,39,45,72
1976-03-02,KCK,127,22,40,DET,113,24,34,46,74
1976-03-02,BUF,93,34,26,GOS,100,43,17,77,43
1976-03-02,MIL,111,27,33,NOJ,109,27,32,54,65
1976-03-02,WAS,128,39,23,PHL,111,35,26,74,49
1976-03-02,NYK,105,30,31,SEA,109,31,29,61,60
1976-03-03,PHL,123,35,27,BOS,110,39,17,74,44
1976-03-03,PHX,108,27,32,CLE,92,18,19,45,51
1976-03-03,NOJ,105,27,33,HOU,113,31,30,58,63
1976-03-03,DET,114,24,35,SEA,110,32,29,56,64
1976-03-04,ATL,103,24,36,BOS,98,39,18,63,54
1976-03-04,GOS,124,44,17,CHI,110,18,40,62,57
1976-03-04,MIL,99,28,33,KCK,95,23,40,51,73
1976-03-04,HOU,106,32,30,WAS,113,40,23,72,53
1976-03-05,NOJ,93,27,34,BOS,98,39,19,66,53
1976-03-05,PHX,99,28,32,CHI,97,18,41,46,73
1976-03-05,POR,100,28,33,CLE,113,18,20,46,53
1976-03-05,PHL,123,36,27,DET,112,25,35,61,62
1976-03-05,LAL,106,31,30,GOS,99,45,17,76,47
1976-03-05,KCK,111,23,41,SEA,93,32,30,55,71
1976-03-06,HOU,101,32,31,ATL,97,25,36,57,67
1976-03-06,GOS,117,45,18,CLE,106,19,20,64,38
1976-03-06,BUF,105,34,27,PHL,99,37,27,71,54
1976-03-06,POR,118,28,34,PHX,99,29,32,57,66
1976-03-06,NYK,116,30,32,WAS,107,41,23,71,55
1976-03-07,LAL,88,32,30,CHI,91,18,42,50,72
1976-03-07,BOS,88,40,19,DET,87,25,36,65,55
1976-03-07,ATL,123,25,37,HOU,106,33,31,58,68
1976-03-07,KCK,113,24,41,MIL,97,29,33,53,74
1976-03-07,WAS,92,41,24,NYK,81,31,32,72,56
1976-03-07,PHX,106,29,33,POR,84,29,34,58,67
1976-03-07,NOJ,124,27,35,SEA,106,32,31,59,66
1976-03-09,DET,108,25,37,GOS,112,46,18,71,55
1976-03-09,NYK,101,31,33,LAL,96,32,31,63,64
1976-03-09,BOS,99,41,19,NOJ,117,28,35,69,54
1976-03-09,CHI,102,19,42,SEA,101,32,32,51,74
1976-03-10,NOJ,105,29,35,BUF,120,35,27,64,62
1976-03-10,BOS,92,41,20,LAL,89,32,32,73,52
1976-03-10,PHL,125,37,28,PHX,108,30,33,67,61
1976-03-10,HOU,113,33,32,POR,110,29,35,62,67
1976-03-10,MIL,105,29,34,SEA,110,32,33,61,67
1976-03-11,ATL,99,26,37,PHX,104,30,34,56,71
1976-03-12,BUF,100,8,10,HOU,113,8,8,16,18
1976-03-12,PHL,109,38,28,ATL,107,26,38,64,66
1976-03-12,MIL,101,29,35,DET,117,25,38,54,73
1976-03-12,CHI,73,20,42,KCK,95,25,41,45,83
1976-03-12,LAL,113,32,33,NYK,95,32,33,64,66
1976-03-12,NOJ,110,29,36,POR,101,29,36,58,72
1976-03-13,KCK,118,9,14,MIL,121,10,12,19,26
1976-03-13,HOU,97,34,32,GOS,111,47,18,81,50
1976-03-13,CHI,111,20,43,NOJ,117,30,36,50,79
1976-03-13,CLE,99,19,21,PHX,77,31,34,50,55
1976-03-14,KCK,114,26,41,ATL,113,26,39,52,80
1976-03-14,LAL,137,33,33,BUF,109,36,27,69,60
1976-03-14,POR,114,29,37,DET,103,26,38,55,75
1976-03-14,NOJ,118,31,36,GOS,103,48,18,79,54
1976-03-14,SEA,113,33,33,NYK,103,32,34,65,67
1976-03-14,MIL,106,29,36,PHX,108,31,35,60,71
1976-03-14,BOS,89,42,20,WAS,102,42,24,84,44
1976-03-16,POR,95,30,37,BUF,112,36,28,66,65
1976-03-16,GOS,110,48,19,DET,101,26,39,74,58
1976-03-16,HOU,116,34,33,NYK,111,32,35,66,68
1976-03-16,CHI,120,20,44,PHX,87,32,35,52,79
1976-03-17,HOU,124,35,33,ATL,112,26,40,61,73
1976-03-17,SEA,122,34,33,BUF,111,37,28,71,61
1976-03-17,PHL,108,39,28,CHI,101,21,44,60,72
1976-03-17,MIL,109,29,37,LAL,96,34,33,63,70
1976-03-17,NOJ,107,32,36,NYK,112,32,36,64,72
1976-03-18,GOS,110,49,19,BUF,109,37,29,86,48
1976-03-18,PHX,106,32,36,DET,100,26,40,58,76
1976-03-18,WAS,110,43,24,KCK,102,27,41,70,65
1976-03-19,CHI,108,21,45,ATL,101,26,41,47,86
1976-03-19,NOJ,103,32,37,CLE,81,20,21,52,58
1976-03-19,LAL,122,34,34,DET,107,26,41,60,75
1976-03-19,POR,111,30,38,HOU,105,36,33,66,71
1976-03-19,BOS,120,42,21,KCK,117,27,42,69,63
1976-03-20,PHL,96,40,28,BOS,103,43,21,83,49
1976-03-20,ATL,99,26,42,CLE,107,20,22,46,64
1976-03-20,PHX,106,33,36,LAL,93,35,34,68,70
1976-03-20,GOS,120,50,19,MIL,106,30,37,80,56
1976-03-20,BUF,115,37,30,NOJ,101,33,37,70,67
1976-03-20,WAS,109,44,24,NYK,104,33,36,77,60
1976-03-21,DET,118,26,42,BUF,112,38,30,64,72
1976-03-21,KCK,112,27,43,CHI,101,22,45,49,88
1976-03-21,SEA,117,35,33,HOU,107,36,34,71,67
1976-03-21,LAL,111,35,35,MIL,130,30,38,65,73
1976-03-21,BOS,108,44,21,PHL,100,40,29,84,50
1976-03-23,GOS,118,51,19,ATL,100,26,43,77,62
1976-03-23,NOJ,97,33,38,BOS,101,45,21,78,59
1976-03-23,BUF,122,38,31,CHI,109,22,46,60,77
1976-03-23,NYK,116,33,37,DET,122,27,42,60,79
1976-03-23,LAL,125,35,36,HOU,106,36,35,71,71
1976-03-23,POR,100,31,38,MIL,97,31,38,62,76
1976-03-23,PHX,104,34,36,SEA,97,36,33,70,69
1976-03-23,KCK,106,28,43,WAS,101,45,24,73,67
1976-03-24,BOS,94,46,21,CHI,87,22,47,68,68
1976-03-24,DET,130,28,42,KCK,117,29,43,57,85
1976-03-24,SEA,135,36,34,MIL,110,31,39,67,73
1976-03-24,PHL,118,40,30,NYK,100,33,38,73,68
1976-03-25,PHX,107,35,36,ATL,98,26,44,61,80
1976-03-25,GOS,104,52,19,HOU,123,36,36,88,55
1976-03-25,WAS,105,45,25,POR,108,32,38,77,63
1976-03-26,LAL,107,36,36,ATL,85,26,45,62,81
1976-03-26,MIL,123,31,40,BUF,92,39,31,70,71
1976-03-26,BOS,95,47,21,CLE,93,21,22,68,43
1976-03-26,CHI,77,22,48,DET,85,29,42,51,90
1976-03-26,NOJ,131,33,39,WAS,126,45,26,78,65
1976-03-27,NYK,105,33,39,BOS,103,48,21,81,60
1976-03-27,WAS,99,45,27,CHI,84,22,49,67,76
1976-03-27,PHX,117,36,36,KCK,100,29,44,65,80
1976-03-27,GOS,113,52,20,LAL,97,37,36,89,56
1976-03-27,HOU,109,37,36,PHL,95,41,30,78,66
1976-03-27,DET,112,30,42,POR,94,33,38,63,80
1976-03-28,SEA,127,37,34,ATL,112,26,46,63,80
1976-03-28,WAS,113,46,27,BUF,90,39,32,85,59
1976-03-28,GOS,134,53,20,KCK,117,29,45,82,65
1976-03-28,BOS,100,48,22,NYK,94,34,39,82,61
1976-03-28,NOJ,110,34,39,PHL,107,41,31,75,70
1976-03-28,LAL,97,37,37,PHX,100,37,36,74,73
1976-03-28,MIL,115,32,40,POR,100,33,39,65,79
1976-03-30,MIL,130,33,40,ATL,126,26,47,59,87
1976-03-30,BUF,93,39,33,BOS,83,49,22,88,55
1976-03-30,CHI,84,22,50,GOS,94,54,20,76,70
1976-03-30,POR,114,33,40,KCK,113,29,46,62,86
1976-03-30,NYK,97,34,40,PHX,113,38,36,72,76
1976-03-31,PHL,107,41,32,BUF,103,40,33,81,65
1976-03-31,DET,102,31,42,CHI,96,22,51,53,93
1976-03-31,NOJ,101,35,39,CLE,110,21,23,56,62
1976-03-31,WAS,88,47,27,GOS,95,55,20,102,47
1976-03-31,SEA,120,38,34,LAL,109,37,38,75,72
1976-03-31,BOS,122,49,23,PHX,102,39,36,88,59
1976-04-02,BUF,101,40,34,ATL,93,26,48,66,82
1976-04-02,BOS,119,50,23,HOU,115,38,36,88,59
1976-04-02,MIL,120,34,40,KCK,107,29,47,63,87
1976-04-02,DET,116,32,42,NOJ,102,35,40,67,82
1976-04-02,CHI,95,22,52,NYK,110,34,41,56,93
1976-04-02,PHX,106,39,37,POR,103,34,40,73,77
1976-04-02,LAL,113,37,39,SEA,105,39,34,76,73
1976-04-02,PHL,96,42,32,WAS,94,47,28,89,60
1976-04-03,KCK,104,10,16,CLE,101,6,10,16,26
1976-04-03,CHI,97,22,53,DET,93,33,42,55,95
1976-04-03,ATL,106,26,49,MIL,115,35,40,61,89
1976-04-03,POR,112,34,41,PHX,97,40,37,74,78
1976-04-03,GOS,130,56,20,SEA,115,39,35,95,55
1976-04-04,BOS,114,51,23,BUF,117,41,34,92,57
1976-04-04,LAL,118,38,39,GOS,111,57,20,95,59
1976-04-04,NYK,115,35,41,KCK,95,29,48,64,89
1976-04-04,WAS,125,47,29,NOJ,129,35,41,82,70
1976-04-04,DET,101,33,43,PHL,97,43,32,76,75
1976-04-04,SEA,117,39,36,PHX,89,40,38,79,74
1976-04-05,ATL,105,15,12,WAS,133,13,13,28,25
1976-04-05,PHL,130,43,33,HOU,129,38,37,81,70
1976-04-05,CHI,97,23,53,MIL,102,36,40,59,93
1976-04-06,BOS,92,51,24,CLE,101,22,23,73,47
1976-04-06,POR,106,35,41,LAL,104,39,39,74,80
1976-04-06,BUF,102,42,34,NYK,106,36,41,78,75
1976-04-06,GOS,111,57,21,PHX,106,40,39,97,60
1976-04-07,SEA,115,40,36,CHI,114,23,54,63,90
1976-04-07,DET,106,34,43,MIL,96,37,40,71,83
1976-04-07,PHL,102,44,33,NOJ,99,36,41,80,74
1976-04-07,HOU,105,38,38,WAS,115,47,30,85,68
1976-04-08,KCK,131,29,49,BOS,104,51,25,80,74
1976-04-08,NYK,98,37,41,BUF,105,42,35,79,76
1976-04-08,PHX,113,40,40,LAL,98,39,40,79,80
1976-04-08,GOS,121,58,21,POR,106,36,41,94,62
1976-04-09,DET,116,35,43,ATL,108,26,50,61,93
1976-04-09,POR,100,36,42,CHI,88,23,55,59,97
1976-04-09,SEA,119,41,36,GOS,103,59,21,100,57
1976-04-09,NOJ,99,36,42,HOU,88,38,39,74,81
1976-04-09,PHL,112,45,33,KCK,108,30,49,75,82
1976-04-09,BOS,100,51,26,MIL,106,37,41,88,67
1976-04-10,HOU,110,38,40,DET,99,36,43,74,83
1976-04-10,ATL,123,26,51,PHL,109,46,33,72,84
1976-04-10,PHX,121,41,40,SEA,95,42,36,83,76
1976-04-11,ATL,111,16,14,HOU,122,15,14,31,28
1976-04-11,WAS,99,48,30,BOS,103,51,27,99,57
1976-04-11,MIL,77,38,41,CHI,111,23,56,61,97
1976-04-11,NYK,103,37,42,CLE,78,23,23,60,65
1976-04-11,NOJ,112,37,42,DET,105,36,44,73,86
1976-04-11,BUF,99,43,35,KCK,98,30,50,73,85
1976-04-11,SEA,132,42,37,POR,131,37,42,79,79
1976-10-21,IND,122,0,0,BOS,129,0,0,0,0
1976-10-21,MIL,112,0,0,BUF,133,0,0,0,0
1976-10-21,ATL,104,0,0,HOU,120,0,0,0,0
1976-10-21,NYK,102,0,0,LAL,97,0,0,0,0
1976-10-22,PHL,118,0,0,SAN,121,0,0,0,0
1976-10-22,IND,110,0,1,DEN,123,0,0,0,1
1976-10-22,GOS,103,0,0,NYN,104,0,0,0,0
1976-10-22,NOJ,111,0,0,PHX,98,0,0,0,0
1976-10-22,KCK,96,0,0,DET,99,0,0,0,0
1976-10-22,CLE,106,0,0,CHI,95,0,0,0,0
1976-10-22,WAS,84,0,0,LAL,103,0,1,0,1
1976-10-23,HOU,129,1,0,PHX,126,0,1,1,1
1976-10-23,MIL,107,0,1,BOS,111,1,0,1,1
1976-10-23,BUF,108,1,0,PHL,105,0,1,1,1
1976-10-23,POR,114,0,0,NYN,104,1,0,1,0
1976-10-23,DEN,120,1,0,KCK,99,0,1,1,1
1976-10-23,DET,97,1,0,WAS,98,0,1,1,1
1976-10-23,CHI,102,0,1,IND,97,0,2,0,3
1976-10-24,SEA,104,0,0,NYN,93,1,1,1,1
1976-10-24,ATL,115,0,1,MIL,91,0,2,0,3
1976-10-26,KCK,117,0,2,LAL,115,1,1,1,3
1976-10-26,ATL,122,1,1,SAN,114,1,0,2,1
1976-10-26,NYK,118,1,0,BUF,104,2,0,3,0
1976-10-26,NOJ,101,1,0,PHL,111,0,2,1,2
1976-10-26,POR,110,1,0,GOS,96,0,1,1,1
1976-10-26,IND,120,0,3,SEA,90,1,0,1,3
1976-10-26,CHI,90,1,1,MIL,88,0,3,1,4
1976-10-27,SAN,115,1,1,PHX,106,0,2,1,3
1976-10-27,HOU,94,2,0,PHL,116,1,2,3,2
1976-10-27,NYN,96,1,2,WAS,93,1,1,2,3
1976-10-27,DET,106,1,1,SEA,92,1,1,2,2
1976-10-28,BOS,112,2,0,BUF,105,2,1,4,1
1976-10-28,DEN,119,2,0,MIL,100,0,4,2,4
1976-10-28,GOS,112,0,2,POR,92,2,0,2,2
1976-10-28,CLE,114,1,0,NYK,90,2,0,3,0
1976-10-29,SEA,106,1,2,DET,103,2,1,3,3
1976-10-29,KCK,130,1,2,SAN,102,2,1,3,3
1976-10-29,LAL,118,1,2,ATL,101,2,1,3,3
1976-10-29,NOJ,111,1,1,WAS,93,1,2,2,3
1976-10-29,NYN,89,2,2,IND,90,1,3,3,5
1976-10-29,CHI,82,2,1,PHX,95,0,3,2,4
1976-10-30,SAN,117,2,2,BOS,126,3,0,5,2
1976-10-30,NYK,112,2,1,NOJ,115,2,1,4,2
1976-10-30,DEN,113,3,0,PHX,107,1,3,4,3
1976-10-30,GOS,114,1,2,ATL,106,2,2,3,4
1976-10-30,BUF,105,2,2,CLE,109,2,0,4,2
1976-10-30,IND,112,2,3,KCK,102,2,2,4,5
1976-10-30,POR,131,2,1,DET,97,2,2,4,3
1976-10-30,HOU,105,2,1,WAS,92,1,3,3,4
1976-10-30,PHL,104,2,2,NYN,80,2,3,4,5
1976-10-30,MIL,102,0,5,CHI,74,2,2,2,7
1976-10-31,SEA,126,2,2,ATL,112,2,3,4,5
1976-10-31,LAL,121,2,2,DET,101,2,3,4,5
1976-10-31,CLE,106,3,0,NOJ,92,3,1,6,1
1976-11-01,KCK,105,2,3,NYK,101,2,2,4,5
1976-11-01,NYN,75,2,4,CLE,82,4,0,6,4
1976-11-02,POR,129,3,1,ATL,116,2,4,5,5
1976-11-02,MIL,125,1,5,SEA,113,3,2,4,7
1976-11-02,GOS,111,2,2,DET,98,2,4,4,6
1976-11-02,NOJ,115,3,2,BOS,97,4,0,7,2
1976-11-03,HOU,117,3,1,BOS,111,4,1,7,2
1976-11-03,DEN,119,4,0,NYK,110,2,3,6,3
1976-11-03,KCK,126,3,3,SEA,106,3,3,6,6
1976-11-03,WAS,117,1,4,MIL,105,2,5,3,9
1976-11-03,IND,113,3,3,SAN,97,2,3,5,6
1976-11-03,NYN,100,2,5,BUF,96,2,3,4,8
1976-11-04,GOS,96,3,2,PHL,101,3,2,6,4
1976-11-04,ATL,97,2,5,CHI,87,2,3,4,8
1976-11-05,LAL,121,3,2,NYK,126,2,4,5,6
1976-11-05,NOJ,127,4,2,SAN,119,2,4,6,6
1976-11-05,DET,108,2,5,BUF,122,2,4,4,9
1976-11-05,BOS,104,4,2,WAS,107,2,4,6,6
1976-11-05,POR,146,4,1,PHL,104,4,2,8,3
1976-11-05,KCK,112,4,3,IND,103,4,3,8,6
1976-11-05,NYN,95,3,5,HOU,91,4,1,7,6
1976-11-05,CHI,85,2,4,DEN,99,5,0,7,4
1976-11-05,SEA,88,3,4,PHX,84,1,4,4,8
1976-11-06,GOS,111,3,3,NYK,112,3,4,6,7
1976-11-06,ATL,105,3,5,DET,110,2,6,5,11
1976-11-06,MIL,103,2,6,DEN,105,6,0,8,6
1976-11-06,WAS,109,3,4,BOS,103,4,3,7,7
1976-11-06,BUF,117,3,4,HOU,102,4,2,7,6
1976-11-06,SAN,113,2,5,IND,94,4,4,6,9
1976-11-07,NOJ,107,5,2,DET,115,3,6,8,8
1976-11-07,ATL,107,3,6,CLE,97,5,0,8,6
1976-11-07,LAL,107,3,3,KCK,96,5,3,8,6
1976-11-07,POR,119,5,1,NYK,93,4,4,9,5
1976-11-07,SEA,98,4,4,PHL,91,4,3,8,7
1976-11-09,DEN,123,7,0,GOS,117,3,4,10,4
1976-11-09,BUF,121,4,4,LAL,116,4,3,8,7
1976-11-09,SAN,138,3,5,SEA,114,5,4,8,9
1976-11-09,POR,119,6,1,KCK,102,5,4,11,5
1976-11-09,NOJ,110,5,3,NYN,99,4,5,9,8
1976-11-09,NYK,106,4,5,WAS,97,4,4,8,9
1976-11-09,CHI,92,2,5,HOU,111,4,3,6,8
1976-11-10,BOS,117,4,4,LAL,112,4,4,8,8
1976-11-10,DET,123,4,6,CLE,112,5,1,9,7
1976-11-10,WAS,116,4,5,NOJ,103,6,3,10,8
1976-11-10,HOU,99,5,3,SEA,97,5,5,10,8
1976-11-10,PHL,103,4,5,CHI,88,2,6,6,11
1976-11-11,ATL,107,4,6,POR,105,7,1,11,7
1976-11-11,SAN,108,4,5,NYN,104,4,6,8,11
1976-11-11,PHX,108,1,5,IND,98,4,5,5,10
1976-11-11,BUF,105,5,4,DEN,94,8,0,13,4
1976-11-11,GOS,86,3,5,KCK,94,5,5,8,10
1976-11-12,BOS,117,5,4,NOJ,110,6,4,11,8
1976-11-12,LAL,117,4,5,IND,106,4,6,8,11
1976-11-12,PHL,143,5,5,WAS,104,5,5,10,10
1976-11-12,MIL,111,3,7,HOU,99,6,3,9,10
1976-11-12,SEA,102,5,6,KCK,97,6,5,11,11
1976-11-12,DET,111,5,6,NYK,97,5,5,10,11
1976-11-13,GOS,120,3,6,IND,112,4,7,7,13
1976-11-13,HOU,110,6,4,NYN,114,4,7,10,11
1976-11-13,WAS,109,5,6,PHL,114,6,5,11,11
1976-11-13,BUF,118,6,4,BOS,107,6,4,12,8
1976-11-13,CHI,103,2,7,DET,106,6,6,8,13
1976-11-13,SAN,113,5,5,POR,101,7,2,12,7
1976-11-13,NYK,110,5,6,MIL,97,4,7,9,13
1976-11-13,DEN,128,8,1,KCK,96,6,6,14,7
1976-11-13,PHX,90,2,5,CLE,103,5,2,7,7
1976-11-13,ATL,86,5,6,NOJ,115,6,5,11,11
1976-11-14,SEA,121,6,6,IND,118,4,8,10,14
1976-11-14,LAL,95,5,5,CLE,97,6,2,11,7
1976-11-14,MIL,83,4,8,DET,104,7,6,11,14
1976-11-16,SAN,114,6,5,BUF,112,7,4,13,9
1976-11-16,GOS,110,4,6,SEA,102,7,6,11,12
1976-11-16,NOJ,100,7,5,POR,98,7,3,14,8
1976-11-16,NYK,100,6,6,ATL,97,5,7,11,13
1976-11-16,KCK,100,6,7,MIL,91,4,9,10,16
1976-11-17,PHL,117,7,5,IND,123,4,9,11,14
1976-11-17,HOU,120,6,5,BUF,114,7,5,13,10
1976-11-17,WAS,111,5,7,NYK,97,7,6,12,13
1976-11-17,PHX,103,2,6,MIL,95,4,10,6,16
1976-11-17,DET,118,8,6,NOJ,95,8,5,16,11
1976-11-17,BOS,104,6,5,ATL,91,5,8,11,13
1976-11-17,SEA,92,7,7,CLE,78,7,2,14,9
1976-11-17,DEN,112,9,1,NYN,78,5,7,14,8
1976-11-18,GOS,131,5,6,PHX,111,3,6,8,12
1976-11-18,SAN,129,7,5,KCK,104,7,7,14,12
1976-11-18,IND,104,5,9,DET,99,9,6,14,15
1976-11-19,POR,124,7,4,MIL,111,4,11,11,15
1976-11-19,BOS,112,7,5,DEN,108,10,1,17,6
1976-11-19,SEA,130,8,7,BUF,101,7,6,15,13
1976-11-19,LAL,121,5,6,GOS,99,6,6,11,12
1976-11-19,PHL,100,7,6,NOJ,95,8,6,15,12
1976-11-19,PHX,88,3,7,NYN,90,5,8,8,15
1976-11-20,HOU,127,7,5,KCK,126,7,8,14,13
1976-11-20,NYK,120,7,7,DEN,115,10,2,17,9
1976-11-20,DET,116,9,7,BOS,110,8,5,17,12
1976-11-20,ATL,106,5,9,PHL,123,8,6,13,15
1976-11-20,WAS,109,6,7,SAN,103,8,5,14,12
1976-11-20,GOS,130,6,7,BUF,93,7,7,13,14
1976-11-21,SEA,115,9,7,MIL,106,4,12,13,19
1976-11-21,POR,121,8,4,BUF,98,7,8,15,12
1976-11-21,PHX,101,3,8,CHI,96,2,8,5,16
1976-11-21,NOJ,97,8,7,CLE,92,7,3,15,10
1976-11-21,LAL,96,6,6,NYN,91,6,8,12,14
1976-11-21,ATL,83,5,10,KCK,106,7,9,12,19
1976-11-23,BUF,115,7,9,SAN,122,8,6,15,15
1976-11-23,MIL,114,4,13,LAL,117,7,6,11,19
1976-11-23,PHL,116,9,6,BOS,102,8,6,17,12
1976-11-23,NYK,98,8,7,KCK,100,8,9,16,16
1976-11-23,DEN,117,10,3,WAS,96,7,7,17,10
1976-11-23,NOJ,117,9,7,GOS,94,7,7,16,14
1976-11-24,DET,118,10,7,PHL,117,10,6,20,13
1976-11-24,POR,117,9,4,CHI,115,2,9,11,13
1976-11-24,DEN,122,11,3,LAL,112,8,6,19,9
1976-11-24,BOS,133,8,7,KCK,111,9,9,17,16
1976-11-24,HOU,113,8,5,GOS,107,7,8,15,13
1976-11-24,IND,115,6,9,ATL,93,5,11,11,20
1976-11-24,NYN,99,6,9,SAN,91,9,6,15,15
1976-11-25,NOJ,99,10,7,HOU,105,9,5,19,12
1976-11-25,PHX,104,4,8,WAS,98,7,8,11,16
1976-11-26,SAN,123,9,7,GOS,121,7,9,16,16
1976-11-26,BUF,124,7,10,DET,119,11,7,18,17
1976-11-26,KCK,120,9,10,DEN,110,12,3,21,13
1976-11-26,NYN,105,7,9,ATL,109,5,12,12,21
1976-11-26,PHL,114,10,7,NYK,103,8,8,18,15
1976-11-26,IND,109,7,9,MIL,98,4,14,11,23
1976-11-26,SEA,101,10,7,CHI,97,2,10,12,17
1976-11-26,LAL,99,8,7,POR,96,10,4,18,11
1976-11-27,HOU,125,10,5,SAN,116,10,7,20,12
1976-11-27,DEN,122,12,4,IND,113,8,9,20,13
1976-11-27,NYK,109,8,9,BOS,123,9,7,17,16
1976-11-27,PHX,119,5,8,SEA,107,11,7,16,15
1976-11-27,POR,103,10,5,WAS,95,7,9,17,14
1976-11-27,ATL,101,6,12,BUF,94,8,10,14,22
1976-11-27,MIL,91,4,15,NYN,96,7,10,11,25
1976-11-28,NOJ,127,10,8,BUF,118,8,11,18,19
1976-11-28,SEA,117,11,8,WAS,116,7,10,18,18
1976-11-28,POR,145,11,5,IND,115,8,10,19,15
1976-11-28,ATL,98,7,12,GOS,132,7,10,14,22
1976-11-28,KCK,101,10,10,PHL,89,11,7,21,17
1976-11-28,LAL,103,9,7,CHI,84,2,11,11,18
1976-11-30,SAN,130,10,8,DET,129,11,8,21,16
1976-11-30,CHI,120,2,12,GOS,125,8,10,10,22
1976-11-30,BUF,119,8,12,SEA,114,12,8,20,20
1976-11-30,MIL,115,4,16,POR,106,12,5,16,21
1976-11-30,NYK,103,8,10,NYN,104,8,10,16,20
1976-11-30,LAL,109,10,7,WAS,102,7,11,17,18
1976-11-30,IND,103,8,11,PHX,97,6,8,14,19
1976-12-01,NOJ,126,11,8,MIL,105,5,16,16,24
1976-12-01,HOU,110,11,5,DET,104,11,9,22,14
1976-12-01,BOS,107,10,7,SEA,103,12,9,22,16
1976-12-01,PHL,114,11,8,DEN,102,13,4,24,12
1976-12-01,IND,100,9,11,POR,101,12,6,21,17
1976-12-01,NYN,96,9,10,PHX,106,6,9,15,19
1976-12-01,KCK,91,11,10,CLE,98,7,4,18,14
1976-12-02,GOS,124,9,10,SAN,116,11,8,20,18
1976-12-02,HOU,137,12,5,MIL,110,5,17,17,22
1976-12-02,ATL,90,7,13,WAS,102,7,12,14,25
1976-12-03,NYN,124,9,11,DEN,126,13,5,22,16
1976-12-03,DET,124,11,10,KCK,115,11,11,22,21
1976-12-03,PHL,112,12,8,SEA,121,12,10,24,18
1976-12-03,BUF,135,9,12,NYK,112,8,11,17,23
1976-12-03,IND,112,9,12,CLE,109,8,4,17,16
1976-12-03,BOS,115,11,7,CHI,109,2,13,13,20
1976-12-03,LAL,114,11,7,SAN,105,11,9,22,16
1976-12-03,NOJ,121,12,8,ATL,105,7,14,19,22
1976-12-03,PHX,99,7,9,POR,113,13,6,20,15
1976-12-04,GOS,116,10,10,LAL,114,12,7,22,17
1976-12-04,POR,112,14,6,MIL,108,5,18,19,24
1976-12-04,HOU,120,13,5,IND,108,10,12,23,17
1976-12-04,ATL,105,7,15,NYN,107,9,12,16,27
1976-12-04,CHI,107,2,14,NOJ,99,13,8,15,22
1976-12-04,NYK,103,8,12,SEA,96,13,10,21,22
1976-12-04,WAS,100,8,12,DEN,95,14,5,22,17
1976-12-05,NOJ,105,13,9,DEN,117,14,6,27,15
1976-12-05,PHX,103,7,10,SAN,98,11,10,18,20
1976-12-05,KCK,102,11,12,BOS,96,12,7,23,19
1976-12-05,POR,93,15,6,CLE,89,8,5,23,11
1976-12-07,DEN,122,15,6,MIL,115,5,19,20,25
1976-12-07,GOS,120,11,10,CLE,104,8,6,19,16
1976-12-07,BUF,103,10,12,IND,107,10,13,20,25
1976-12-07,NOJ,110,13,10,SEA,98,13,11,26,21
1976-12-07,NYK,94,9,12,POR,111,16,6,25,18
1976-12-07,CHI,89,3,14,LAL,81,12,8,15,22
1976-12-08,SAN,106,11,11,ATL,117,7,16,18,27
1976-12-08,PHL,123,12,9,BUF,102,10,13,22,22
1976-12-08,DET,107,12,10,CHI,100,4,14,16,24
1976-12-08,WAS,99,9,12,SEA,109,13,12,22,24
1976-12-08,IND,111,11,13,LAL,98,12,9,23,22
1976-12-08,BOS,104,12,8,POR,95,17,6,29,14
1976-12-08,NYN,95,10,12,NYK,105,9,13,19,25
1976-12-08,PHX,116,8,10,HOU,95,14,5,22,15
1976-12-09,KCK,100,12,12,ATL,102,8,16,20,28
1976-12-09,DEN,104,16,6,CLE,94,8,7,24,13
1976-12-10,MIL,120,5,20,SAN,136,11,12,16,32
1976-12-10,NYN,104,10,13,DET,106,13,10,23,23
1976-12-10,BOS,103,13,8,PHX,107,9,10,22,18
1976-12-10,BUF,102,10,14,POR,103,17,7,27,21
1976-12-10,LAL,109,12,10,HOU,99,14,6,26,16
1976-12-10,SEA,99,14,12,GOS,93,12,10,26,22
1976-12-10,WAS,98,9,13,IND,88,12,13,21,26
1976-12-10,NOJ,78,14,10,CHI,92,4,15,18,25
1976-12-11,GOS,124,12,11,HOU,112,14,7,26,18
1976-12-11,PHL,108,13,9,POR,107,18,7,31,16
1976-12-11,SAN,121,12,12,NOJ,106,14,11,26,23
1976-12-11,IND,109,12,14,BUF,101,10,15,22,29
1976-12-11,NYK,112,10,13,PHX,96,10,10,20,23
1976-12-11,DET,88,14,10,NYN,115,10,14,24,24
1976-12-11,CHI,84,5,15,BOS,76,13,9,18,24
1976-12-12,KCK,104,12,13,DET,110,14,11,26,24
1976-12-12,MIL,102,5,21,PHL,107,14,9,19,30
1976-12-12,SEA,92,15,12,HOU,96,14,8,29,20
1976-12-12,ATL,91,9,16,PHX,106,10,11,19,27
1976-12-12,LAL,112,13,10,DEN,83,17,6,30,16
1976-12-14,NOJ,120,14,12,KCK,117,12,14,26,26
1976-12-14,ATL,106,9,17,LAL,104,14,10,23,27
1976-12-14,BUF,108,10,16,PHX,99,11,11,21,27
1976-12-14,SAN,111,13,12,NYK,98,11,13,24,25
1976-12-14,CHI,101,6,15,PHL,88,15,9,21,24
1976-12-14,POR,104,18,8,HOU,84,15,8,33,16
1976-12-15,BOS,129,13,10,MIL,125,5,22,18,32
1976-12-15,DET,136,15,11,GOS,116,13,11,28,22
1976-12-15,NOJ,105,15,12,LAL,115,14,11,29,23
1976-12-15,SEA,103,15,13,DEN,117,17,7,32,20
1976-12-15,IND,116,13,14,SAN,102,14,12,27,26
1976-12-15,WAS,104,10,13,KCK,100,12,15,22,28
1976-12-15,PHL,97,15,10,PHX,87,11,12,26,22
1976-12-16,HOU,118,15,9,ATL,107,10,17,25,26
1976-12-16,KCK,100,12,16,NYN,90,11,14,23,30
1976-12-17,PHL,114,16,10,GOS,117,13,12,29,22
1976-12-17,NYN,110,11,15,MIL,126,5,23,16,38
1976-12-17,NOJ,109,15,13,ATL,113,10,18,25,31
1976-12-17,BOS,109,14,10,NYK,123,11,14,25,24
1976-12-17,LAL,118,15,11,PHX,105,11,13,26,24
1976-12-17,POR,127,19,8,DEN,105,18,7,37,15
1976-12-17,DET,113,16,11,IND,104,14,14,30,25
1976-12-17,CHI,103,7,15,SAN,101,14,13,21,28
1976-12-17,BUF,88,11,16,WAS,99,11,13,22,29
1976-12-18,NYK,115,12,14,CLE,113,8,8,20,22
1976-12-18,POR,111,20,8,LAL,115,16,11,36,19
1976-12-18,WAS,110,12,13,GOS,115,14,12,26,25
1976-12-18,ATL,110,11,18,BOS,117,14,11,25,29
1976-12-18,HOU,106,16,9,NOJ,110,15,14,31,23
1976-12-18,DEN,111,18,8,CHI,106,8,15,26,23
1976-12-18,IND,93,14,15,PHL,97,16,11,30,26
1976-12-18,PHX,89,11,14,KCK,90,13,16,24,30
1976-12-19,NOJ,110,16,14,DET,125,17,11,33,25
1976-12-19,MIL,126,6,23,ATL,109,11,19,17,42
1976-12-19,SEA,98,15,14,BUF,99,11,17,26,31
1976-12-19,LAL,103,17,11,KCK,92,14,16,31,27
1976-12-19,NYN,87,11,16,BOS,94,15,11,26,27
1976-12-21,SAN,123,14,14,GOS,120,15,12,29,26
1976-12-21,NOJ,123,16,15,IND,113,14,16,30,31
1976-12-21,NYK,133,13,14,DET,103,18,11,31,25
1976-12-21,CHI,103,8,16,SEA,101,15,15,23,31
1976-12-21,CLE,108,8,9,BOS,101,16,11,24,20
1976-12-21,POR,99,20,9,KCK,94,14,17,34,26
1976-12-21,DEN,108,19,8,PHL,94,17,11,36,19
1976-12-21,LAL,97,18,11,BUF,89,12,17,30,28
1976-12-22,DET,107,18,12,ATL,94,11,20,29,32
1976-12-22,NYN,127,11,17,NOJ,93,17,15,28,32
1976-12-22,HOU,111,16,10,WAS,90,12,14,28,24
1976-12-23,SAN,118,15,14,WAS,116,12,15,27,29
1976-12-23,MIL,112,7,23,GOS,103,15,13,22,36
1976-12-23,CHI,101,9,16,ATL,95,11,21,20,37
1976-12-23,DEN,123,20,8,SEA,95,15,16,35,24
1976-12-23,IND,96,14,17,NYN,94,12,17,26,34
1976-12-23,PHX,107,11,15,BUF,92,12,18,23,33
1976-12-25,BUF,115,12,19,DET,106,19,12,31,31
1976-12-25,NYK,104,14,14,PHL,105,17,12,31,26
1976-12-25,WAS,117,12,16,CLE,99,9,9,21,25
1976-12-25,PHX,113,12,15,LAL,96,19,11,31,26
1976-12-25,POR,110,21,9,SEA,95,15,17,36,26
1976-12-25,KCK,91,14,18,CHI,96,10,16,24,34
1976-12-26,KCK,105,14,19,SAN,110,16,14,30,33
1976-12-26,DEN,101,21,8,BOS,103,16,12,37,20
1976-12-26,NOJ,109,17,16,WAS,100,13,16,30,32
1976-12-26,LAL,107,19,12,MIL,99,8,23,27,35
1976-12-26,ATL,98,11,22,NYK,103,14,15,25,37
1976-12-26,SEA,89,15,18,POR,87,22,9,37,27
1976-12-26,IND,79,15,17,HOU,93,17,10,32,27
1976-12-28,ATL,119,11,23,SEA,120,16,18,27,41
1976-12-28,SAN,127,17,14,PHL,116,18,12,35,26
1976-12-28,IND,111,15,18,WAS,117,13,17,28,35
1976-12-28,LAL,134,20,12,BOS,105,17,12,37,24
1976-12-28,DEN,110,21,9,PHX,102,13,15,34,24
1976-12-28,GOS,102,15,14,MIL,113,8,24,23,38
1976-12-28,NYK,111,15,15,HOU,99,18,10,33,25
1976-12-28,CHI,79,11,16,POR,84,22,10,33,26
1976-12-29,DET,120,19,13,POR,111,23,10,42,23
1976-12-29,BUF,103,13,19,KCK,113,14,20,27,39
1976-12-29,NYN,96,12,18,SEA,102,17,18,29,36
1976-12-29,WAS,96,14,17,ATL,92,11,24,25,41
1976-12-29,HOU,93,18,11,PHL,91,18,13,36,24
1976-12-29,PHX,97,13,16,BOS,87,17,13,30,29
1976-12-30,MIL,127,9,24,POR,107,23,11,32,35
1976-12-30,DEN,123,22,9,DET,106,20,13,42,22
1976-12-30,GOS,124,15,15,CHI,106,11,17,26,32
1976-12-30,IND,104,15,19,NOJ,97,18,16,33,35
1977-01-01,NYK,121,16,15,CLE,110,9,10,25,25
1977-01-01,WAS,104,15,17,HOU,89,19,11,34,28
1977-01-01,BUF,102,13,20,NYN,87,12,19,25,39
1977-01-01,POR,89,23,12,CHI,82,11,18,34,30
1977-01-02,DEN,145,23,9,SAN,120,18,14,41,23
1977-01-02,NYN,110,12,20,PHL,139,18,14,30,34
1977-01-02,MIL,109,10,24,IND,116,16,19,26,43
1977-01-02,LAL,104,21,12,POR,99,24,12,45,24
1977-01-02,GOS,105,16,15,BOS,98,17,14,33,29
1977-01-02,KCK,89,15,20,PHX,88,14,16,29,36
1977-01-02,ATL,88,11,25,NOJ,93,18,17,29,42
1977-01-02,SEA,83,18,18,CHI,79,11,19,29,37
1977-01-03,SAN,142,18,15,BUF,109,14,20,32,35
1977-01-04,MIL,139,10,25,PHX,111,14,17,24,42
1977-01-04,NYK,110,17,15,GOS,120,17,15,34,30
1977-01-04,ATL,113,11,26,DEN,109,24,9,35,35
1977-01-04,POR,128,24,13,BOS,84,17,15,41,28
1977-01-04,CHI,88,11,20,NYN,80,12,21,23,41
1977-01-05,SAN,137,19,15,DEN,133,24,10,43,25
1977-01-05,DET,118,20,14,PHX,115,14,18,34,32
1977-01-05,BUF,109,14,21,GOS,118,18,15,32,36
1977-01-05,HOU,108,19,12,NYK,107,17,16,36,28
1977-01-05,IND,109,17,19,CHI,94,12,20,29,39
1977-01-05,PHL,117,19,14,LAL,94,22,12,41,26
1977-01-05,SEA,94,19,18,BOS,93,17,16,36,34
1977-01-05,WAS,107,16,17,NYN,92,12,22,28,39
1977-01-06,MIL,119,11,25,BUF,111,14,22,25,47
1977-01-06,ATL,95,12,26,IND,103,18,19,30,45
1977-01-07,DET,140,21,14,MIL,132,12,25,33,39
1977-01-07,SEA,131,20,18,SAN,124,20,15,40,33
1977-01-07,POR,130,25,13,NOJ,118,19,17,44,30
1977-01-07,HOU,107,20,12,DEN,117,24,11,44,23
1977-01-07,PHL,116,20,14,CLE,96,9,11,29,25
1977-01-07,WAS,99,17,17,PHX,89,14,19,31,36
1977-01-07,CHI,108,12,21,NYK,88,17,17,29,38
1977-01-07,NYN,82,12,23,LAL,85,22,13,34,36
1977-01-08,MIL,111,2,7,PHL,106,4,4,6,11
1977-01-08,GOS,114,19,15,NOJ,107,19,18,38,33
1977-01-08,BUF,106,14,23,BOS,109,17,17,31,40
1977-01-08,DEN,119,25,11,CHI,99,13,21,38,32
1977-01-08,NYK,102,17,18,PHX,95,14,20,31,38
1977-01-08,KCK,106,16,20,HOU,94,20,13,36,33
1977-01-08,IND,80,19,19,NYN,73,12,24,31,43
1977-01-09,POR,150,26,13,SAN,113,20,16,46,29
1977-01-09,SEA,92,21,18,NOJ,76,19,19,40,37
1977-01-09,DET,118,23,15,LAL,124,24,13,47,28
1977-01-10,ATL,92,12,27,PHX,93,14,21,26,48
1977-01-11,GOS,121,20,15,DET,129,22,14,42,29
1977-01-11,KCK,115,17,20,PHL,117,21,14,38,34
1977-01-11,POR,131,27,13,NYK,111,18,18,45,31
1977-01-11,MIL,109,12,26,WAS,120,18,17,30,43
1977-01-11,BOS,105,18,17,HOU,101,20,14,38,31
1977-01-11,CLE,99,9,12,LAL,101,23,13,32,25
1977-01-11,CHI,93,13,22,PHX,90,15,21,28,43
1977-01-12,SAN,121,20,17,MIL,127,12,27,32,44
1977-01-12,BUF,118,14,24,ATL,124,12,28,26,52
1977-01-12,BOS,101,19,17,IND,112,20,19,39,36
1977-01-12,DEN,110,26,11,NOJ,99,19,20,45,31
1977-01-12,SEA,121,22,18,DET,99,23,14,45,32
1977-01-12,PHL,102,22,14,HOU,97,20,15,42,29
1977-01-12,WAS,85,19,17,CHI,99,14,22,33,39
1977-01-13,KCK,116,17,21,GOS,114,20,16,37,37
1977-01-13,PHX,131,15,22,DET,101,23,16,38,38
1977-01-14,IND,109,21,19,GOS,113,20,17,41,36
1977-01-14,SEA,127,23,18,NYK,107,18,19,41,37
1977-01-14,SAN,106,20,18,LAL,109,25,13,45,31
1977-01-14,PHL,111,23,14,KCK,106,18,21,41,35
1977-01-14,BUF,131,14,25,NOJ,103,19,21,33,46
1977-01-14,NYN,101,12,25,ATL,120,13,28,25,53
1977-01-14,DEN,116,27,11,CLE,96,9,13,36,24
1977-01-14,BOS,92,19,18,POR,107,28,13,47,31
1977-01-14,CHI,89,15,22,WAS,94,19,18,34,40
1977-01-14,MIL,84,13,27,HOU,111,20,16,33,43
1977-01-15,HOU,122,21,16,LAL,116,26,13,47,29
1977-01-15,WAS,113,20,18,POR,107,29,13,49,31
1977-01-15,DET,121,23,17,BUF,105,15,25,38,42
1977-01-15,CHI,96,15,23,MIL,93,13,28,28,51
1977-01-15,ATL,90,14,28,KCK,115,18,22,32,50
1977-01-15,PHX,94,16,22,CLE,79,9,14,25,36
1977-01-16,ATL,125,14,29,POR,120,29,14,43,43
1977-01-16,SAN,122,20,19,IND,115,21,20,41,39
1977-01-16,SEA,101,24,18,DEN,109,28,11,52,29
1977-01-16,GOS,97,21,17,NYK,111,18,20,39,37
1977-01-16,BOS,106,19,19,NYN,91,12,26,31,45
1977-01-16,MIL,83,13,29,CHI,102,16,23,29,52
1977-01-16,PHL,97,24,14,NOJ,76,19,22,43,36
1977-01-18,KCK,111,19,22,LAL,113,26,14,45,36
1977-01-18,GOS,107,21,18,DEN,101,29,11,50,29
1977-01-18,MIL,93,13,30,CLE,101,9,15,22,45
1977-01-18,NOJ,99,19,23,BOS,89,20,19,39,42
1977-01-18,HOU,103,22,16,CHI,85,17,23,39,39
1977-01-19,SAN,115,21,19,CHI,107,17,24,38,43
1977-01-19,SEA,109,24,19,IND,102,21,21,45,40
1977-01-19,HOU,102,23,16,BOS,112,20,20,43,36
1977-01-19,NYN,94,12,27,POR,109,29,15,41,42
1977-01-19,PHL,114,25,14,ATL,94,15,29,40,43
1977-01-19,PHX,97,17,22,NYK,90,19,20,36,42
1977-01-19,WAS,91,21,18,BUF,87,15,26,36,44
1977-01-20,GOS,107,22,18,PHX,103,18,22,40,40
1977-01-20,KCK,123,19,23,NYN,92,12,28,31,51
1977-01-21,DEN,120,29,12,SEA,106,25,19,54,31
1977-01-21,ATL,121,15,30,MIL,101,13,31,28,61
1977-01-21,PHX,125,18,23,IND,96,21,22,39,45
1977-01-21,LAL,108,27,14,NYK,94,19,21,46,35
1977-01-21,BOS,103,21,20,SAN,90,22,19,43,39
1977-01-21,CHI,110,17,25,BUF,89,15,27,32,52
1977-01-21,NYN,88,12,29,WAS,99,22,18,34,47
1977-01-21,DET,109,24,17,HOU,86,23,17,47,34
1977-01-22,HOU,110,23,18,POR,107,30,15,53,33
1977-01-22,KCK,132,20,23,BUF,104,15,28,35,51
1977-01-22,NOJ,118,20,23,GOS,100,23,18,43,41
1977-01-22,PHL,109,26,14,BOS,94,22,20,48,34
1977-01-23,SAN,123,22,20,POR,118,30,16,52,36
1977-01-23,MIL,119,13,32,KCK,111,21,23,34,55
1977-01-23,WAS,119,23,18,DET,108,25,17,48,35
1977-01-23,LAL,121,28,14,IND,104,21,23,49,37
1977-01-23,NOJ,111,21,23,NYK,102,19,22,40,45
1977-01-23,ATL,97,16,30,GOS,104,23,19,39,49
1977-01-23,PHX,98,19,23,SEA,88,25,20,44,43
1977-01-23,NYN,95,12,30,CHI,86,18,25,30,55
1977-01-23,BOS,83,22,21,PHL,91,27,14,49,35
1977-01-24,DEN,127,30,12,BUF,102,15,29,45,41
1977-01-25,LAL,120,29,14,SEA,109,25,21,54,35
1977-01-25,PHX,108,20,23,SAN,116,23,20,43,43
1977-01-25,NYK,108,19,23,CHI,91,18,26,37,49
1977-01-25,BOS,89,22,22,DET,91,25,18,47,40
1977-01-26,BUF,114,15,30,MIL,109,14,32,29,62
1977-01-26,SEA,118,25,22,LAL,103,30,14,55,36
1977-01-26,DEN,102,31,12,POR,107,30,17,61,29
1977-01-26,DET,103,26,18,NYN,101,13,30,39,48
1977-01-26,IND,121,21,24,BOS,101,22,23,43,47
1977-01-26,KCK,101,21,24,NOJ,95,22,23,43,47
1977-01-26,WAS,106,24,18,GOS,95,24,19,48,37
1977-01-26,CHI,106,18,27,CLE,93,10,15,28,42
1977-01-27,HOU,114,24,18,DET,107,27,18,51,36
1977-01-27,POR,112,31,17,SAN,104,24,20,55,37
1977-01-27,PHX,111,20,24,PHL,94,28,14,48,38
1977-01-28,BOS,119,22,24,MIL,113,14,33,36,57
1977-01-28,LAL,117,30,15,PHL,104,28,15,58,30
1977-01-28,HOU,118,25,18,ATL,104,16,31,41,49
1977-01-28,DEN,108,31,13,NOJ,96,22,24,53,37
1977-01-28,KCK,105,22,24,CHI,94,19,27,41,51
1977-01-28,NYN,84,13,31,GOS,106,24,20,37,51
1977-01-29,IND,107,22,24,WAS,108,25,18,47,42
1977-01-29,NYK,105,20,23,KCK,112,23,24,43,47
1977-01-29,PHX,118,21,24,NOJ,102,22,25,43,49
1977-01-29,CHI,109,19,28,DET,101,27,19,46,47
1977-01-29,ATL,101,16,32,HOU,97,26,18,42,50
1977-01-30,DET,127,27,20,IND,120,22,25,49,45
1977-01-30,SEA,118,26,22,SAN,126,24,21,50,43
1977-01-30,DEN,101,32,13,PHL,107,28,16,60,29
1977-01-30,LAL,101,31,15,NOJ,99,22,26,53,41
1977-01-30,WAS,112,26,18,KCK,98,24,24,50,42
1977-01-30,NYN,92,13,32,MIL,100,14,34,27,66
1977-01-30,BOS,92,23,24,GOS,109,25,20,48,44
1977-01-30,POR,97,32,17,PHX,91,22,24,54,41
1977-02-01,LAL,136,32,15,MIL,115,15,34,47,49
1977-02-01,IND,110,22,26,PHL,109,29,16,51,42
1977-02-01,NYK,108,20,24,GOS,107,26,20,46,44
1977-02-01,ATL,92,17,32,DET,95,28,20,45,52
1977-02-01,SAN,92,25,21,CLE,87,10,16,35,37
1977-02-01,CHI,86,20,28,KCK,97,24,25,44,53
1977-02-02,PHL,138,29,17,DET,116,29,20,58,37
1977-02-02,PHX,130,22,25,MIL,113,15,35,37,60
1977-02-02,KCK,119,25,25,POR,107,33,17,58,42
1977-02-02,DEN,119,32,14,WAS,105,27,18,59,32
1977-02-02,SEA,120,26,23,NOJ,95,22,27,48,50
1977-02-02,NYN,99,13,33,BOS,89,23,25,36,58
1977-02-03,GOS,99,26,21,NOJ,105,22,28,48,49
1977-02-03,ATL,100,17,33,BUF,98,16,30,33,63
1977-02-03,SAN,98,26,21,CHI,107,20,29,46,50
1977-02-03,IND,98,23,26,POR,107,33,18,56,44
1977-02-03,NYK,108,21,24,HOU,90,26,19,47,43
1977-02-04,PHL,112,30,17,NYN,113,14,33,44,50
1977-02-04,DET,124,29,21,DEN,111,33,14,62,35
1977-02-04,SEA,106,27,23,WAS,109,27,19,54,42
1977-02-04,PHX,106,23,25,GOS,109,26,22,49,47
1977-02-04,KCK,101,26,25,CLE,102,10,17,36,42
1977-02-04,BOS,99,23,26,LAL,98,33,15,56,41
1977-02-05,GOS,138,27,22,MIL,116,15,36,42,58
1977-02-05,POR,104,34,18,WAS,116,28,19,62,37
1977-02-05,HOU,105,26,20,NYK,103,22,24,48,44
1977-02-05,ATL,99,18,33,CHI,96,21,29,39,62
1977-02-06,DET,130,30,21,KCK,111,26,26,56,47
1977-02-06,PHX,115,23,26,DEN,104,33,15,56,41
1977-02-06,SEA,107,27,24,MIL,99,15,37,42,61
1977-02-06,IND,111,23,27,CHI,99,21,30,44,57
1977-02-06,PHL,102,30,18,LAL,97,33,16,63,34
1977-02-06,BOS,113,24,26,BUF,97,16,31,40,57
1977-02-06,SAN,119,26,22,NYK,96,22,25,48,47
1977-02-06,NOJ,99,23,28,HOU,90,27,20,50,48
1977-02-08,POR,111,34,19,DEN,119,33,16,67,35
1977-02-08,NYK,125,22,26,LAL,107,33,17,55,43
1977-02-08,PHX,117,24,26,ATL,104,19,33,43,59
1977-02-08,GOS,128,28,22,WAS,104,29,19,57,41
1977-02-08,MIL,100,15,38,NYN,97,15,33,30,71
1977-02-08,BUF,99,16,32,PHL,89,31,18,47,50
1977-02-08,CHI,111,21,31,SAN,89,27,22,48,53
1977-02-08,HOU,97,27,21,CLE,81,11,17,38,38
1977-02-09,DET,129,31,21,SAN,135,27,23,58,44
1977-02-09,IND,110,24,27,NYK,109,23,26,47,53
1977-02-09,PHL,107,31,19,MIL,104,16,38,47,57
1977-02-09,HOU,108,28,21,CHI,103,22,31,50,52
1977-02-09,SEA,98,28,24,ATL,99,19,34,47,58
1977-02-09,BUF,90,17,32,LAL,105,33,18,50,50
1977-02-09,NYN,93,15,34,NOJ,89,24,28,39,62
1977-02-10,PHX,103,25,26,WAS,109,29,20,54,46
1977-02-10,MIL,112,16,39,KCK,102,26,27,42,66
1977-02-10,GOS,114,29,22,DEN,101,34,16,63,38
1977-02-11,BOS,119,25,26,NYK,111,23,27,48,53
1977-02-11,LAL,117,34,18,DEN,109,34,17,68,35
1977-02-11,PHL,118,32,19,IND,109,25,27,57,46
1977-02-11,POR,108,34,20,ATL,121,20,34,54,54
1977-02-11,SEA,114,28,25,GOS,107,30,22,58,47
1977-02-11,KCK,120,26,28,WAS,106,30,20,56,48
1977-02-11,HOU,104,29,21,SAN,107,28,23,57,44
1977-02-11,NYN,94,16,34,BUF,96,17,33,33,67
1977-02-11,DET,101,31,22,CLE,94,11,18,42,40
1977-02-11,CHI,110,22,32,NOJ,92,24,29,46,61
1977-02-15,BUF,114,18,33,WAS,126,30,21,48,54
1977-02-15,GOS,117,30,23,ATL,111,21,34,51,57
1977-02-15,SAN,109,29,23,SEA,106,29,25,58,48
1977-02-15,CHI,114,23,32,NYN,106,16,35,39,67
1977-02-15,MIL,117,17,39,NOJ,106,24,30,41,69
1977-02-15,KCK,102,27,28,PHX,96,25,27,52,55
1977-02-15,BOS,109,27,27,DET,99,34,22,61,49
1977-02-16,DET,125,32,22,POR,118,34,21,66,43
1977-02-16,PHL,117,33,19,BUF,113,18,34,51,53
1977-02-16,NYK,123,23,28,CHI,103,24,32,47,60
1977-02-16,DEN,116,34,18,NYN,102,16,36,50,54
1977-02-16,HOU,124,29,22,SEA,95,29,26,58,48
1977-02-16,IND,111,25,28,PHX,93,25,28,50,56
1977-02-16,WAS,111,31,21,BOS,92,26,26,57,47
1977-02-17,KCK,125,28,28,BOS,126,26,27,54,55
1977-02-17,BUF,112,18,35,CLE,103,11,19,29,54
1977-02-17,SAN,99,30,23,HOU,113,30,22,60,45
1977-02-17,MIL,99,18,39,GOS,97,31,23,49,62
1977-02-18,MIL,124,19,39,NYK,123,24,28,43,67
1977-02-18,IND,111,26,28,GOS,116,31,24,57,52
1977-02-18,LAL,101,35,18,ATL,111,21,35,56,53
1977-02-18,DET,107,33,22,WAS,97,32,21,65,43
1977-02-18,PHL,96,34,19,PHX,102,25,29,59,48
1977-02-18,NYN,88,16,37,SEA,93,29,27,45,64
1977-02-18,CHI,87,24,33,POR,90,34,22,58,55
1977-02-19,DEN,133,35,18,POR,124,35,22,70,40
1977-02-19,KCK,115,28,29,HOU,109,31,22,59,51
1977-02-19,BUF,103,19,35,SEA,100,30,27,49,62
1977-02-19,WAS,105,32,22,DET,95,34,23,66,45
1977-02-19,NYK,85,24,29,NYN,86,16,38,40,67
1977-02-20,IND,135,26,29,SEA,115,30,28,56,57
1977-02-20,GOS,112,32,24,BOS,114,28,27,60,51
1977-02-20,PHL,112,34,20,CLE,111,11,20,45,40
1977-02-20,SAN,129,30,24,NOJ,109,24,31,54,55
1977-02-20,DET,109,34,24,PHX,107,26,29,60,53
1977-02-20,WAS,101,33,22,LAL,108,35,19,68,41
1977-02-20,DEN,111,36,18,ATL,95,22,35,58,53
1977-02-20,NYN,80,17,38,NYK,100,24,30,41,68
1977-02-21,BUF,117,20,35,IND,106,27,29,47,64
1977-02-22,BUF,115,21,35,PHX,114,26,30,47,65
1977-02-22,POR,113,35,23,BOS,111,29,27,64,50
1977-02-22,DEN,118,37,18,HOU,106,31,23,68,41
1977-02-22,SAN,135,31,24,LAL,103,36,19,67,43
1977-02-22,CHI,118,24,34,GOS,102,32,25,56,59
1977-02-22,NYK,119,25,30,NOJ,102,24,32,49,62
1977-02-23,DET,102,35,24,LAL,101,36,20,71,44
1977-02-23,WAS,109,33,23,IND,101,27,30,60,53
1977-02-23,NOJ,106,24,33,MIL,96,20,39,44,72
1977-02-23,KCK,93,29,29,SEA,94,30,29,59,58
1977-02-23,NYN,91,17,39,DEN,88,38,18,55,57
1977-02-24,SAN,121,32,24,MIL,131,20,40,52,64
1977-02-24,PHX,106,26,31,HOU,109,31,24,57,55
1977-02-24,ATL,101,22,36,NYK,98,26,30,48,66
1977-02-25,KCK,128,29,30,DEN,130,38,19,67,49
1977-02-25,NYN,106,18,39,DET,112,36,24,54,63
1977-02-25,POR,106,36,23,HOU,123,32,24,68,47
1977-02-25,LAL,104,36,21,PHL,102,35,20,71,41
1977-02-25,BUF,97,22,35,GOS,104,32,26,54,61
1977-02-25,SEA,92,31,29,BOS,102,29,28,60,57
1977-02-25,CHI,96,25,34,ATL,87,23,36,48,70
1977-02-25,NOJ,124,25,35,NYK,107,27,32,52,67
1977-02-26,NYK,129,26,31,IND,115,27,31,53,62
1977-02-26,ATL,119,23,37,SAN,111,32,25,55,62
1977-02-26,PHX,104,26,32,BOS,108,30,28,56,60
1977-02-26,WAS,105,34,23,MIL,102,21,40,55,63
1977-02-27,NOJ,118,25,33,SAN,135,32,26,57,59
1977-02-27,WAS,117,35,23,BUF,105,22,36,57,59
1977-02-27,LAL,106,37,21,HOU,101,33,24,70,45
1977-02-27,DEN,121,39,19,BOS,100,31,28,70,47
1977-02-27,NYN,98,18,40,GOS,106,33,26,51,66
1977-02-27,SEA,85,31,30,PHL,93,35,21,66,51
1977-03-01,NYK,127,27,31,SAN,132,33,26,60,57
1977-03-01,POR,108,36,24,PHL,107,36,21,72,45
1977-03-01,KCK,126,29,31,NOJ,104,25,34,54,65
1977-03-01,BUF,95,22,37,NYN,104,18,41,40,78
1977-03-01,BOS,94,31,29,GOS,101,34,26,65,55
1977-03-01,DET,94,37,24,DEN,110,40,19,77,43
1977-03-01,ATL,90,24,37,LAL,92,38,21,62,58
1977-03-01,CHI,102,26,34,IND,85,27,32,53,66
1977-03-02,WAS,115,36,23,DEN,113,41,19,77,42
1977-03-02,HOU,120,33,25,LAL,113,39,21,72,46
1977-03-02,IND,116,27,33,BUF,108,22,38,49,71
1977-03-02,PHX,104,26,33,CHI,108,27,34,53,67
1977-03-02,NYN,100,19,41,KCK,112,30,31,49,72
1977-03-02,SEA,85,31,31,CLE,105,11,21,42,52
1977-03-03,GOS,121,35,26,PHL,119,36,22,71,48
1977-03-04,NYN,121,19,42,SAN,135,34,26,53,68
1977-03-04,POR,101,37,24,CLE,113,12,21,49,45
1977-03-04,ATL,100,24,38,WAS,99,37,23,61,61
1977-03-04,LAL,99,39,22,CHI,114,28,34,67,56
1977-03-04,DET,92,37,25,BOS,94,31,30,68,55
1977-03-04,NOJ,91,26,35,BUF,95,22,39,48,74
1977-03-04,PHX,87,26,34,GOS,101,36,26,62,60
1977-03-05,NYK,114,27,33,PHL,117,36,23,63,56
1977-03-05,BUF,109,23,39,SAN,120,35,26,58,65
1977-03-05,HOU,119,34,25,MIL,106,21,41,55,66
1977-03-05,WAS,117,37,24,NOJ,105,26,36,63,60
1977-03-05,POR,134,37,25,SEA,104,31,32,68,57
1977-03-05,IND,118,28,33,DET,96,37,26,65,59
1977-03-06,BOS,112,32,30,DEN,110,41,20,73,50
1977-03-06,WAS,118,38,24,PHX,110,26,35,64,59
1977-03-06,KCK,109,31,31,MIL,108,21,42,52,73
1977-03-06,NOJ,106,26,37,IND,110,29,33,55,70
1977-03-06,DET,115,37,27,ATL,105,25,38,62,65
1977-03-06,PHL,102,37,23,NYK,110,27,34,64,57
1977-03-06,LAL,104,39,23,CLE,99,13,21,52,44
1977-03-06,NYN,91,19,43,HOU,99,35,25,54,68
1977-03-06,GOS,86,37,26,CHI,94,29,34,66,60
1977-03-07,BUF,107,23,40,HOU,128,36,25,59,65
1977-03-08,SAN,122,36,26,PHX,115,26,36,62,62
1977-03-08,NYK,108,28,34,DEN,114,41,21,69,55
1977-03-08,DET,109,38,27,MIL,107,21,43,59,70
1977-03-08,GOS,112,37,27,CLE,102,13,22,50,49
1977-03-08,ATL,99,25,39,PHL,98,37,24,62,63
1977-03-08,BUF,102,23,41,POR,95,38,25,61,66
1977-03-08,NOJ,91,26,38,SEA,96,31,33,57,71
1977-03-09,PHL,129,37,25,DEN,125,42,21,79,46
1977-03-09,MIL,109,21,44,WAS,107,39,24,60,68
1977-03-09,HOU,105,37,25,PHX,100,26,37,63,62
1977-03-09,BOS,86,33,30,SEA,114,32,33,65,63
1977-03-10,NYK,108,28,35,POR,104,38,26,66,61
1977-03-10,SAN,106,37,26,CLE,100,13,23,50,49
1977-03-11,PHL,126,38,25,SEA,122,33,33,71,58
1977-03-11,KCK,114,32,31,POR,112,38,27,70,58
1977-03-11,IND,109,30,33,HOU,124,38,25,68,58
1977-03-11,ATL,100,26,39,DEN,95,42,22,68,61
1977-03-11,LAL,94,40,23,WAS,91,39,25,79,48
1977-03-11,BUF,95,24,41,CHI,90,30,34,54,75
1977-03-11,NYN,82,19,44,PHX,73,26,38,45,82
1977-03-12,MIL,108,22,44,IND,106,30,34,52,78
1977-03-12,HOU,120,39,25,NOJ,104,26,39,65,64
1977-03-12,NYK,88,29,35,SEA,91,33,34,62,69
1977-03-13,GOS,122,38,27,WAS,119,39,26,77,53
1977-03-13,ATL,113,27,39,CLE,115,13,24,40,63
1977-03-13,BOS,124,33,31,PHX,107,26,39,59,70
1977-03-13,PHL,102,39,25,CHI,106,30,35,69,60
1977-03-13,IND,98,30,35,KCK,103,33,31,63,66
1977-03-13,SAN,97,38,26,DET,102,39,27,77,53
1977-03-13,BUF,102,25,41,DEN,95,42,23,67,64
1977-03-13,NYN,81,20,44,LAL,84,41,23,61,67
1977-03-14,MIL,110,23,44,LAL,106,42,23,65,67
1977-03-15,SAN,118,38,27,NYN,108,20,45,58,72
1977-03-15,POR,131,38,28,NOJ,104,26,40,64,68
1977-03-15,CLE,102,14,24,PHL,133,39,26,53,50
1977-03-15,KCK,101,34,31,WAS,99,39,27,73,58
1977-03-15,CHI,107,31,35,BOS,96,34,31,65,66
1977-03-15,DEN,107,42,24,LAL,95,42,24,84,48
1977-03-16,PHL,109,40,26,ATL,100,27,40,67,66
1977-03-16,IND,109,30,36,DEN,98,43,24,73,60
1977-03-16,DET,97,40,27,CHI,104,32,35,72,62
1977-03-16,WAS,96,39,28,SEA,100,34,34,73,62
1977-03-16,PHX,124,26,40,NYK,91,29,36,55,76
1977-03-16,HOU,100,40,25,NYN,86,20,46,60,71
1977-03-17,DEN,107,43,25,NYK,115,29,37,72,62
1977-03-17,GOS,106,39,27,POR,115,39,28,78,55
1977-03-17,KCK,125,35,31,BUF,104,26,41,61,72
1977-03-17,MIL,100,24,44,BOS,91,34,32,58,76
1977-03-18,CHI,114,33,35,KCK,112,36,31,69,66
1977-03-18,POR,134,40,28,IND,110,31,36,71,64
1977-03-18,DET,104,40,28,SEA,105,35,34,75,62
1977-03-18,PHL,124,41,26,HOU,104,41,25,82,51
1977-03-18,PHX,100,27,40,NOJ,104,26,41,53,81
1977-03-18,BOS,98,34,33,ATL,96,27,41,61,74
1977-03-18,NYN,88,20,47,CLE,101,14,25,34,72
1977-03-18,LAL,98,42,25,GOS,85,39,28,81,53
1977-03-19,HOU,110,41,26,BUF,104,26,42,67,68
1977-03-19,NYK,107,30,37,ATL,101,27,42,57,79
1977-03-19,CHI,104,34,35,SEA,92,36,34,70,69
1977-03-19,GOS,150,39,29,IND,91,31,37,70,66
1977-03-20,WAS,135,39,29,SAN,116,39,27,78,56
1977-03-20,BOS,118,35,33,KCK,110,36,32,71,65
1977-03-20,MIL,107,25,44,SEA,110,36,35,61,79
1977-03-20,PHX,126,27,41,POR,106,41,28,68,69
1977-03-20,NYN,104,20,48,PHL,111,42,26,62,74
1977-03-20,DEN,133,43,26,DET,104,40,29,83,55
1977-03-20,LAL,100,43,25,NOJ,95,27,41,70,66
1977-03-22,NYK,125,31,37,MIL,115,25,45,56,82
1977-03-22,KCK,126,36,33,GOS,113,40,29,76,62
1977-03-22,SAN,104,39,28,BOS,108,36,33,75,61
1977-03-22,HOU,106,42,26,IND,99,31,38,73,64
1977-03-22,NOJ,106,27,42,POR,95,41,29,68,71
1977-03-22,CHI,102,35,35,LAL,86,44,25,79,60
1977-03-22,BUF,84,26,43,ATL,86,27,43,53,86
1977-03-23,DEN,120,44,26,SAN,122,39,29,83,55
1977-03-23,PHL,120,43,26,GOS,128,40,30,83,56
1977-03-23,HOU,109,43,26,POR,104,41,30,84,56
1977-03-23,IND,97,31,39,LAL,105,44,26,75,65
1977-03-23,ATL,96,28,43,BOS,103,37,33,65,76
1977-03-23,NYN,96,20,49,KCK,107,37,33,57,82
1977-03-23,WAS,95,40,29,CLE,90,15,25,55,54
1977-03-23,DET,89,40,30,NOJ,95,28,42,68,72
1977-03-24,SAN,118,40,29,HOU,112,44,26,84,55
1977-03-24,PHX,102,28,41,BUF,107,26,44,54,85
1977-03-24,CLE,87,15,26,NOJ,92,29,42,44,68
1977-03-25,PHL,113,43,27,SAN,110,41,29,84,56
1977-03-25,MIL,112,25,46,DEN,108,44,27,69,73
1977-03-25,NYN,103,20,50,POR,131,41,31,61,81
1977-03-25,BOS,97,38,33,WAS,122,41,29,79,62
1977-03-25,IND,103,31,40,ATL,95,28,44,59,84
1977-03-25,NOJ,100,30,42,KCK,94,38,33,68,75
1977-03-25,DET,107,40,31,GOS,94,41,30,81,61
1977-03-25,LAL,118,45,26,PHX,93,28,42,73,68
1977-03-25,CHI,105,36,35,NYK,87,32,37,68,72
1977-03-26,MIL,128,26,46,DET,108,41,31,67,77
1977-03-26,PHX,102,28,43,LAL,109,46,26,74,69
1977-03-26,HOU,107,44,27,KCK,97,38,34,82,61
1977-03-26,NYK,92,32,38,WAS,98,42,29,74,67
1977-03-27,SAN,139,41,30,KCK,129,38,35,79,65
1977-03-27,IND,118,32,40,NOJ,119,31,42,63,82
1977-03-27,PHL,128,44,27,POR,116,42,31,86,58
1977-03-27,BOS,114,38,34,NYN,109,20,51,58,85
1977-03-27,DEN,115,44,28,GOS,109,41,31,85,59
1977-03-27,DET,115,41,32,HOU,100,45,27,86,59
1977-03-27,SEA,100,37,35,PHX,121,28,44,65,79
1977-03-27,WAS,95,43,29,NYK,109,32,39,75,68
1977-03-27,LAL,92,47,26,BUF,89,27,44,74,70
1977-03-29,KCK,132,38,36,NYK,126,33,39,71,75
1977-03-29,SAN,122,42,30,WAS,116,43,30,85,60
1977-03-29,CHI,113,37,35,PHL,119,45,27,82,62
1977-03-29,MIL,110,27,46,PHX,122,29,44,56,90
1977-03-29,DEN,119,45,28,IND,105,32,41,77,69
1977-03-29,POR,127,42,32,BUF,101,27,45,69,77
1977-03-29,LAL,100,48,26,SEA,97,37,36,85,62
1977-03-29,GOS,109,41,32,HOU,92,45,28,86,60
1977-03-29,NOJ,94,32,42,NYN,85,20,52,52,94
1977-03-29,CLE,110,15,27,BOS,82,39,34,54,61
1977-03-30,PHL,115,46,27,DET,112,42,32,88,59
1977-03-30,SEA,111,37,37,HOU,105,45,29,82,66
1977-03-30,WAS,110,43,31,ATL,103,28,45,71,76
1977-03-30,NOJ,112,33,42,PHX,100,30,44,63,86
1977-03-30,BOS,90,39,35,CHI,88,37,36,76,71
1977-03-31,IND,131,32,42,NYK,135,33,40,65,82
1977-03-31,GOS,125,42,32,SAN,116,43,30,85,62
1977-03-31,DEN,110,46,28,BUF,95,27,46,73,74
1977-03-31,ATL,95,28,46,NYN,81,20,53,48,99
1977-04-01,PHX,133,30,45,DET,116,42,33,72,78
1977-04-01,MIL,109,27,47,NYK,116,34,40,61,87
1977-04-01,NOJ,106,34,42,CLE,115,16,27,50,69
1977-04-01,PHL,111,47,27,KCK,105,39,36,86,63
1977-04-01,LAL,107,49,26,SAN,102,43,31,92,57
1977-04-01,POR,109,43,32,GOS,98,43,32,86,64
1977-04-01,CHI,107,37,37,DEN,97,47,28,84,65
1977-04-01,NYN,88,20,54,IND,89,32,43,52,97
1977-04-01,WAS,85,44,31,HOU,91,45,30,89,61
1977-04-02,GOS,102,43,33,SEA,109,38,37,81,70
1977-04-02,ATL,99,29,46,IND,106,33,43,62,89
1977-04-02,BUF,94,27,47,MIL,93,27,48,54,95
1977-04-02,HOU,106,46,30,CLE,93,17,27,63,57
1977-04-03,IND,112,34,43,MIL,120,27,49,61,92
1977-04-03,NYK,130,35,40,BUF,111,28,47,63,87
1977-04-03,PHX,109,31,45,DEN,124,47,29,78,74
1977-04-03,LAL,115,50,26,DET,107,42,34,92,60
1977-04-03,SEA,104,39,37,POR,119,44,32,83,69
1977-04-03,SAN,103,43,32,ATL,111,29,47,72,79
1977-04-03,WAS,115,44,32,NYN,97,20,55,64,87
1977-04-03,BOS,96,40,35,PHL,90,48,27,88,62
1977-04-03,NOJ,82,34,43,CHI,101,38,37,72,80
1977-04-05,NYK,121,36,40,BOS,113,41,35,77,75
1977-04-05,NOJ,109,34,44,PHL,119,48,28,82,72
1977-04-05,POR,110,45,32,DET,105,42,35,87,67
1977-04-05,GOS,132,43,34,LAL,103,51,26,94,60
1977-04-05,PHX,108,31,46,ATL,102,30,47,61,93
1977-04-05,CHI,91,39,37,BUF,89,28,48,67,85
1977-04-05,SEA,86,39,38,NYN,88,20,56,59,94
1977-04-05,KCK,82,39,37,IND,87,34,44,73,81
1977-04-06,SAN,131,43,33,PHL,109,49,28,92,61
1977-04-06,BUF,107,28,49,NOJ,102,34,45,62,94
1977-04-06,WAS,97,45,32,CHI,96,40,37,85,69
1977-04-06,DEN,110,48,29,ATL,95,30,48,78,77
1977-04-06,BOS,93,41,36,HOU,104,47,30,88,66
1977-04-07,PHX,121,32,46,KCK,110,39,38,71,84
1977-04-07,NYK,100,37,40,IND,114,35,44,72,84
1977-04-07,GOS,124,44,34,NYN,86,21,56,65,90
1977-04-08,DET,116,42,36,PHL,112,49,29,91,65
1977-04-08,POR,122,46,32,PHX,111,33,46,79,78
1977-04-08,CHI,113,40,38,HOU,109,48,30,88,68
1977-04-08,BOS,120,41,37,NOJ,109,34,46,75,83
1977-04-08,MIL,118,28,49,ATL,107,30,49,58,98
1977-04-08,SEA,112,39,39,KCK,105,39,39,78,78
1977-04-08,BUF,102,29,49,NYK,104,37,41,66,90
1977-04-08,LAL,124,51,27,NYN,100,21,57,72,84
1977-04-09,POR,145,47,32,LAL,116,52,27,99,59
1977-04-09,HOU,110,48,31,DEN,118,49,29,97,60
1977-04-09,BOS,120,42,37,SAN,105,44,33,86,70
1977-04-09,GOS,118,45,34,KCK,102,39,40,84,74
1977-04-09,PHL,125,49,30,WAS,93,46,32,95,62
1977-04-10,DET,126,43,36,NYK,144,38,41,81,77
1977-04-10,MIL,133,29,49,SAN,125,44,34,73,83
1977-04-10,NOJ,139,34,47,DEN,125,50,29,84,76
1977-04-10,WAS,131,46,33,PHL,121,50,30,96,63
1977-04-10,BOS,115,43,37,CLE,105,17,28,60,65
1977-04-10,SEA,104,40,39,LAL,113,52,28,92,67
1977-04-10,PHX,128,33,47,NYN,104,21,58,54,105
1977-04-10,BUF,99,29,50,CHI,120,41,38,70,88
1977-10-18,PHX,100,0,0,GOS,83,0,0,0,0
1977-10-18,DET,110,0,0,NJN,93,0,0,0,0
1977-10-18,CLE,88,0,0,CHI,91,0,0,0,0
1977-10-18,MIL,117,0,0,LAL,112,0,0,0,0
1977-10-18,NYK,120,0,0,KCK,113,0,0,0,0
1977-10-19,DEN,133,0,0,MIL,115,1,0,1,0
1977-10-19,BUF,112,0,0,KCK,108,0,1,0,1
1977-10-19,SAN,114,0,0,BOS,109,0,0,0,0
1977-10-19,GOS,116,0,1,SEA,84,0,0,0,1
1977-10-19,HOU,103,0,0,CHI,107,1,0,1,0
1977-10-19,PHL,113,0,0,DET,96,1,0,1,0
1977-10-19,IND,120,0,0,LAL,133,0,1,0,1
1977-10-20,NOJ,104,0,0,CLE,107,0,1,0,1
1977-10-21,NJN,103,0,1,NOJ,111,0,1,0,2
1977-10-21,SEA,99,0,1,POR,106,0,0,0,1
1977-10-21,DEN,106,1,0,LAL,101,1,1,2,1
1977-10-21,CHI,122,2,0,IND,119,0,1,2,1
1977-10-21,WAS,117,0,0,DET,109,1,1,1,1
1977-10-21,KCK,95,0,2,HOU,94,0,1,0,3
1977-10-21,GOS,122,1,1,SAN,117,1,0,2,1
1977-10-22,IND,106,0,2,KCK,101,1,2,1,4
1977-10-22,MIL,113,1,1,CHI,95,3,0,4,1
1977-10-22,PHL,103,1,0,NOJ,104,1,1,2,1
1977-10-22,HOU,110,0,2,BOS,98,0,1,0,3
1977-10-22,NYK,141,1,0,WAS,115,1,0,2,0
1977-10-22,ATL,107,0,0,CLE,101,1,1,1,1
1977-10-22,POR,130,1,0,SAN,115,1,1,2,1
1977-10-22,DET,126,1,2,DEN,106,2,0,3,2
1977-10-22,BUF,101,1,0,NJN,96,0,2,1,2
1977-10-23,SEA,94,0,2,SAN,112,1,2,1,4
1977-10-23,LAL,101,1,2,PHX,104,1,0,2,2
1977-10-24,DET,100,2,2,BOS,85,0,2,2,4
1977-10-25,NYK,112,2,0,CLE,117,1,2,3,2
1977-10-25,CHI,98,3,1,GOS,105,2,1,5,2
1977-10-25,IND,129,1,2,DEN,104,2,1,3,3
1977-10-25,POR,107,2,0,BUF,85,2,0,4,0
1977-10-25,LAL,109,1,3,SAN,107,2,2,3,5
1977-10-25,PHX,93,2,0,SEA,86,0,3,2,3
1977-10-25,PHL,112,1,1,KCK,104,1,3,2,4
1977-10-25,BOS,110,0,3,ATL,103,1,0,1,3
1977-10-26,NJN,110,0,3,ATL,113,1,1,1,4
1977-10-26,DET,123,3,2,GOS,107,3,1,6,3
1977-10-26,DEN,111,2,2,POR,108,3,0,5,2
1977-10-26,NOJ,123,2,1,NYK,106,2,1,4,2
1977-10-26,SEA,97,0,4,BUF,92,2,1,2,5
1977-10-27,HOU,133,1,2,MIL,110,2,1,3,3
1977-10-27,CLE,104,2,2,KCK,119,1,4,3,6
1977-10-28,NOJ,114,3,1,PHX,107,3,0,6,1
1977-10-28,POR,98,3,1,PHL,94,2,1,5,2
1977-10-28,GOS,104,3,2,BUF,97,2,2,5,4
1977-10-28,ATL,102,2,1,LAL,95,2,3,4,4
1977-10-28,IND,136,2,2,WAS,127,1,1,3,3
1977-10-28,NJN,116,0,4,BOS,109,1,3,1,7
1977-10-29,NYK,124,2,2,DET,117,4,2,6,4
1977-10-29,HOU,125,2,2,PHX,112,3,1,5,3
1977-10-29,KCK,120,2,4,WAS,106,1,2,3,6
1977-10-29,CHI,101,3,2,SEA,97,1,4,4,6
1977-10-29,DEN,127,3,2,BUF,111,2,3,5,5
1977-10-29,GOS,113,4,2,PHL,110,2,2,6,4
1977-10-29,SAN,129,2,3,LAL,118,2,4,4,7
1977-10-29,CLE,103,2,3,BOS,98,1,4,3,7
1977-10-30,MIL,108,2,2,SEA,95,1,5,3,7
1977-10-31,PHX,143,3,2,SAN,145,3,3,6,5
1977-11-01,NOJ,99,4,1,CHI,88,4,2,8,3
1977-11-01,MIL,115,3,2,KCK,95,3,4,6,6
1977-11-01,SAN,97,4,3,GOS,108,5,2,9,5
1977-11-01,POR,113,4,1,NYK,104,3,2,7,3
1977-11-01,ATL,102,3,1,SEA,99,1,6,4,7
1977-11-01,CLE,110,3,3,DEN,93,4,2,7,5
1977-11-02,BUF,104,2,4,DEN,100,4,3,6,7
1977-11-02,KCK,104,3,5,NOJ,102,5,1,8,6
1977-11-02,BOS,101,1,5,CLE,104,4,3,5,8
1977-11-02,PHL,102,2,3,CHI,103,4,3,6,6
1977-11-02,IND,104,3,2,SEA,106,1,7,4,9
1977-11-02,NJN,102,1,4,LAL,107,2,5,3,9
1977-11-02,DET,89,4,3,ATL,102,4,1,8,4
1977-11-03,HOU,113,3,2,GOS,111,6,2,9,4
1977-11-03,SAN,89,4,4,PHX,110,3,3,7,7
1977-11-03,CLE,100,5,3,MIL,91,4,2,9,5
1977-11-04,NJN,104,1,5,PHL,107,2,4,3,9
1977-11-04,SEA,92,2,7,NYK,95,3,3,5,10
1977-11-04,KCK,110,4,5,ATL,111,5,1,9,6
1977-11-04,MIL,110,4,3,HOU,108,4,2,8,5
1977-11-04,WAS,113,1,3,PHX,96,4,3,5,6
1977-11-04,BOS,107,1,6,DEN,109,4,4,5,10
1977-11-04,CHI,92,5,3,BUF,100,3,4,8,7
1977-11-04,LAL,111,3,5,IND,99,3,3,6,8
1977-11-04,NOJ,105,5,2,GOS,102,6,3,11,5
1977-11-05,HOU,116,4,3,WAS,105,2,3,6,6
1977-11-05,ATL,100,6,1,GOS,94,6,4,12,5
1977-11-05,BUF,101,4,4,SAN,111,4,5,8,9
1977-11-05,CLE,105,6,3,NJN,93,1,6,7,9
1977-11-05,PHL,132,3,4,DEN,101,5,4,8,8
1977-11-05,CHI,111,5,4,PHX,94,4,4,9,8
1977-11-05,POR,116,5,1,SEA,94,2,8,7,9
1977-11-06,LAL,102,4,5,NYK,106,4,3,8,8
1977-11-06,POR,108,6,1,IND,106,3,4,9,5
1977-11-06,SEA,83,2,9,KCK,99,4,6,6,15
1977-11-06,NOJ,97,6,2,WAS,108,2,4,8,6
1977-11-08,MIL,101,5,3,DEN,111,5,5,10,8
1977-11-08,NYK,123,5,3,SAN,117,5,5,10,8
1977-11-08,POR,130,7,1,KCK,104,5,6,12,7
1977-11-08,CHI,117,6,4,HOU,104,5,3,11,7
1977-11-09,BOS,114,1,7,SAN,129,5,6,6,13
1977-11-09,DEN,115,6,5,NOJ,112,6,3,12,8
1977-11-09,PHL,130,4,4,NJN,107,1,7,5,11
1977-11-09,BUF,124,4,5,NYK,113,6,3,10,8
1977-11-09,GOS,132,6,5,IND,129,3,5,9,10
1977-11-09,DET,127,4,4,HOU,107,5,4,9,8
1977-11-10,HOU,101,5,5,ATL,132,7,1,12,6
1977-11-10,WAS,103,3,4,MIL,106,5,4,8,8
1977-11-10,PHX,127,4,5,NOJ,111,6,4,10,9
1977-11-11,DET,104,5,4,SAN,107,6,6,11,10
1977-11-11,LAL,123,4,6,NOJ,107,6,5,10,11
1977-11-11,BOS,109,1,8,BUF,103,5,5,6,13
1977-11-11,GOS,105,7,5,KCK,106,5,7,12,12
1977-11-11,SEA,117,2,10,IND,111,3,6,5,16
1977-11-11,MIL,82,6,4,CLE,88,7,3,13,7
1977-11-11,PHL,127,5,4,NYK,119,6,4,11,8
1977-11-11,NJN,91,1,8,CHI,89,7,4,8,12
1977-11-11,ATL,92,8,1,POR,132,8,1,16,2
1977-11-12,BUF,106,5,6,CHI,103,7,5,12,11
1977-11-12,DEN,119,7,5,KCK,114,6,7,13,12
1977-11-12,SAN,116,7,6,ATL,99,8,2,15,8
1977-11-12,WAS,116,3,5,PHL,98,6,4,9,9
1977-11-12,HOU,104,5,6,POR,102,9,1,14,7
1977-11-12,NYK,101,6,5,NJN,90,2,8,8,13
1977-11-13,LAL,97,5,6,GOS,95,7,6,12,12
1977-11-13,DET,104,5,5,WAS,102,4,5,9,10
1977-11-13,PHX,116,5,5,IND,107,3,7,8,12
1977-11-13,MIL,119,6,5,BOS,127,2,8,8,13
1977-11-13,SEA,117,3,10,NOJ,83,6,6,9,16
1977-11-15,SAN,113,8,6,KCK,107,6,8,14,14
1977-11-15,DEN,123,8,5,DET,113,6,5,14,10
1977-11-15,NYK,108,7,5,NOJ,105,6,7,13,12
1977-11-15,BUF,94,6,6,IND,100,3,8,9,14
1977-11-15,WAS,111,4,6,SEA,109,4,10,8,16
1977-11-15,LAL,95,6,6,CLE,102,8,3,14,9
1977-11-15,ATL,93,8,3,PHL,114,6,5,14,8
1977-11-15,MIL,106,6,6,POR,109,9,2,15,8
1977-11-16,BOS,131,3,8,ATL,105,8,4,11,12
1977-11-16,IND,111,4,8,POR,104,10,2,14,10
1977-11-16,NJN,106,2,9,MIL,116,6,7,8,16
1977-11-16,HOU,97,6,6,BUF,101,6,7,12,13
1977-11-16,PHL,101,7,5,SEA,96,4,11,11,16
1977-11-17,NOJ,127,6,8,SEA,116,4,12,10,20
1977-11-17,SAN,111,9,6,BUF,108,7,7,16,13
1977-11-18,WAS,123,5,6,NYK,103,8,5,13,11
1977-11-18,DEN,105,9,5,SAN,94,10,6,19,11
1977-11-18,LAL,116,6,7,DET,83,6,6,12,13
1977-11-18,NJN,116,2,10,IND,124,5,8,7,18
1977-11-18,GOS,108,7,7,CLE,104,9,3,16,10
1977-11-18,BOS,112,4,8,PHL,121,8,5,12,13
1977-11-18,PHX,103,6,5,CHI,101,7,6,13,11
1977-11-19,GOS,128,8,7,DET,96,6,7,14,14
1977-11-19,PHL,111,9,5,MIL,100,7,7,16,12
1977-11-19,NYK,129,8,6,IND,127,6,8,14,14
1977-11-19,KCK,125,6,9,WAS,131,6,6,12,15
1977-11-19,ATL,129,8,5,NJN,114,2,11,10,16
1977-11-19,HOU,101,6,7,NOJ,103,7,8,13,15
1977-11-19,POR,109,10,3,CLE,67,9,4,19,7
1977-11-19,BUF,102,7,8,BOS,98,4,9,11,17
1977-11-20,NJN,118,2,12,DEN,125,10,5,12,17
1977-11-20,POR,118,11,3,DET,101,6,8,17,11
1977-11-20,LAL,80,7,7,CHI,102,7,7,14,14
1977-11-20,SEA,108,4,13,CLE,115,9,5,13,18
1977-11-20,PHX,134,7,5,SAN,112,10,7,17,12
1977-11-21,BUF,97,8,8,WAS,114,7,6,15,14
1977-11-22,MIL,109,7,8,GOS,88,9,7,16,15
1977-11-22,NYK,101,9,6,BUF,102,8,9,17,15
1977-11-22,PHL,105,10,5,HOU,99,6,8,16,13
1977-11-22,WAS,114,8,6,DEN,119,11,5,19,11
1977-11-22,NOJ,123,8,8,IND,108,6,9,14,17
1977-11-22,PHX,118,8,5,LAL,107,7,8,15,13
1977-11-23,IND,126,6,10,GOS,116,9,8,15,18
1977-11-23,SAN,132,10,8,NJN,119,2,13,12,21
1977-11-23,BOS,109,4,10,HOU,100,6,9,10,19
1977-11-23,KCK,116,6,10,MIL,122,8,8,14,18
1977-11-23,SEA,113,4,14,LAL,89,7,9,11,23
1977-11-23,POR,116,12,3,CHI,111,8,7,20,10
1977-11-23,ATL,105,9,5,DEN,104,12,5,21,10
1977-11-23,DET,105,6,9,PHL,106,11,5,17,14
1977-11-24,NOJ,131,9,8,DEN,129,12,6,21,14
1977-11-24,CLE,97,10,5,PHX,82,9,5,19,10
1977-11-25,LAL,129,7,10,NJN,117,2,14,9,24
1977-11-25,ATL,115,10,5,MIL,117,9,8,19,13
1977-11-25,PHL,125,12,5,GOS,119,9,9,21,14
1977-11-25,BOS,121,5,10,NYK,119,9,7,14,17
1977-11-25,IND,110,7,10,PHX,118,9,6,16,16
1977-11-25,SEA,89,5,14,CHI,106,8,8,13,22
1977-11-26,KCK,110,6,11,BOS,108,6,10,12,21
1977-11-26,SAN,129,11,8,MIL,107,10,8,21,16
1977-11-26,POR,114,13,3,NJN,102,2,15,15,18
1977-11-26,DET,87,6,10,CLE,105,11,5,17,15
1977-11-26,BUF,107,9,9,PHL,112,13,5,22,14
1977-11-26,NYK,112,9,8,GOS,106,9,10,18,18
1977-11-26,WAS,93,8,7,HOU,91,6,10,14,17
1977-11-26,DEN,136,12,7,IND,123,7,11,19,18
1977-11-27,SEA,96,5,15,NJN,99,2,16,7,31
1977-11-27,LAL,93,8,10,POR,100,14,3,22,13
1977-11-27,PHX,115,10,6,DEN,97,13,7,23,13
1977-11-27,NOJ,115,10,8,KCK,106,7,11,17,19
1977-11-28,NYK,104,10,8,HOU,86,6,11,16,19
1977-11-29,CHI,95,9,8,NOJ,87,11,8,20,16
1977-11-29,ATL,108,10,6,BOS,101,6,11,16,17
1977-11-29,HOU,120,6,12,NYK,103,11,8,17,20
1977-11-29,DEN,115,13,8,SEA,99,5,16,18,24
1977-11-29,CLE,118,12,5,LAL,101,8,11,20,16
1977-11-29,POR,108,15,3,PHX,96,11,6,26,9
1977-11-29,SAN,117,12,8,PHL,129,14,5,26,13
1977-11-29,GOS,110,9,11,NJN,101,3,16,12,27
1977-11-29,MIL,99,10,9,DET,100,6,11,16,20
1977-11-30,IND,113,7,12,MIL,120,10,10,17,22
1977-11-30,NOJ,114,11,9,PHL,117,15,5,26,14
1977-11-30,BUF,105,9,10,ATL,93,11,6,20,16
1977-11-30,BOS,98,6,12,CHI,92,10,8,16,20
1977-11-30,WAS,116,9,7,SAN,105,12,9,21,16
1977-11-30,KCK,84,7,12,SEA,86,5,17,12,29
1977-11-30,DET,104,7,11,LAL,98,8,12,15,23
1977-12-01,CLE,92,13,5,HOU,105,7,12,20,17
1977-12-01,SAN,120,12,10,NYK,116,11,9,23,19
1977-12-02,PHX,103,11,7,POR,106,16,3,27,10
1977-12-02,IND,102,7,13,CHI,107,10,9,17,22
1977-12-02,MIL,95,11,10,WAS,108,10,7,21,17
1977-12-02,BOS,89,7,12,SEA,111,6,17,13,29
1977-12-02,KCK,108,7,13,DET,97,8,11,15,24
1977-12-02,DEN,126,14,8,NJN,92,3,17,17,25
1977-12-03,HOU,120,8,12,PHL,116,16,5,24,17
1977-12-03,WAS,103,11,7,BOS,93,7,13,18,20
1977-12-03,GOS,118,10,11,ATL,101,11,7,21,18
1977-12-03,CHI,111,11,9,CLE,97,13,6,24,15
1977-12-03,NYK,108,11,10,MIL,115,11,11,22,21
1977-12-03,SAN,133,13,10,NOJ,118,11,10,24,20
1977-12-03,DET,89,8,12,IND,103,7,14,15,26
1977-12-03,KCK,118,8,13,NJN,115,3,18,11,31
1977-12-03,BUF,95,10,10,SEA,102,7,17,17,27
1977-12-04,CLE,94,13,7,WAS,100,12,7,25,14
1977-12-04,PHX,89,11,8,ATL,96,11,8,22,16
1977-12-04,LAL,109,8,13,DEN,111,15,8,23,21
1977-12-04,MIL,134,12,11,NJN,118,3,19,15,30
1977-12-05,SEA,99,8,17,ATL,88,12,8,20,25
1977-12-06,GOS,107,11,11,HOU,105,9,12,20,23
1977-12-06,KCK,92,9,13,PHX,103,11,9,20,22
1977-12-06,BUF,113,10,11,NOJ,90,11,11,21,22
1977-12-06,NYK,122,11,11,BOS,119,7,14,18,25
1977-12-06,CLE,94,13,8,POR,116,17,3,30,11
1977-12-06,LAL,109,8,14,MIL,108,13,11,21,25
1977-12-06,CHI,116,12,9,WAS,108,13,7,25,16
1977-12-07,WAS,96,13,8,CLE,95,13,9,26,17
1977-12-07,BOS,113,7,15,KCK,109,9,14,16,29
1977-12-07,DET,107,8,13,PHX,113,12,9,20,22
1977-12-07,DEN,123,16,8,ATL,116,12,9,28,17
1977-12-07,IND,118,8,14,NOJ,103,11,12,19,26
1977-12-07,NJN,122,3,20,SAN,125,14,10,17,30
1977-12-07,PHL,122,16,6,POR,100,18,3,34,9
1977-12-08,CHI,104,13,9,NJN,78,3,21,16,30
1977-12-08,GOS,116,12,11,MIL,117,13,12,25,23
1977-12-09,SEA,136,9,17,MIL,123,14,12,23,29
1977-12-09,PHL,120,17,6,SAN,116,15,10,32,16
1977-12-09,WAS,101,14,8,NOJ,97,11,13,25,21
1977-12-09,NJN,122,3,22,KCK,114,9,15,12,37
1977-12-09,ATL,84,12,10,NYK,103,12,11,24,21
1977-12-09,LAL,105,9,14,HOU,116,9,13,18,27
1977-12-09,BOS,87,8,15,POR,118,18,4,26,19
1977-12-10,CHI,121,14,9,SAN,119,15,11,29,20
1977-12-10,CLE,102,13,10,ATL,87,12,11,25,21
1977-12-10,DEN,118,17,8,MIL,111,14,13,31,21
1977-12-10,NYK,106,13,11,POR,107,19,4,32,15
1977-12-10,PHX,110,13,9,HOU,93,10,13,23,22
1977-12-10,DET,104,8,14,NOJ,86,11,14,19,28
1977-12-10,KCK,92,9,16,GOS,97,12,12,21,28
1977-12-10,IND,114,9,14,PHL,108,18,6,27,20
1977-12-11,LAL,124,9,15,BUF,119,11,11,20,26
1977-12-11,SEA,116,10,17,HOU,84,10,14,20,31
1977-12-11,WAS,95,15,8,NJN,106,4,22,19,30
1977-12-13,CHI,99,15,9,DEN,96,18,8,33,17
1977-12-13,MIL,129,14,14,PHL,117,18,7,32,21
1977-12-13,WAS,102,15,9,GOS,96,13,12,28,21
1977-12-13,CLE,116,14,10,SEA,104,11,17,25,27
1977-12-13,NOJ,117,11,15,LAL,94,10,15,21,30
1977-12-13,BOS,122,8,16,NJN,108,5,22,13,38
1977-12-13,NYK,107,13,12,ATL,106,12,12,25,24
1977-12-13,POR,111,20,4,BUF,108,11,12,31,16
1977-12-14,HOU,91,10,15,LAL,113,10,16,20,31
1977-12-14,IND,98,10,14,NYK,101,14,12,24,26
1977-12-14,NJN,108,5,23,GOS,104,13,13,18,36
1977-12-14,PHL,99,18,8,ATL,108,12,13,30,21
1977-12-14,DET,92,9,14,SEA,102,11,18,20,32
1977-12-14,PHX,113,14,9,BUF,103,11,13,25,22
1977-12-14,KCK,124,9,17,DEN,98,18,9,27,26
1977-12-14,SAN,116,15,12,CHI,108,16,9,31,21
1977-12-16,ATL,115,13,13,SAN,99,16,12,29,25
1977-12-16,NJN,116,6,23,CLE,106,15,10,21,33
1977-12-16,DEN,112,18,10,WAS,117,16,9,34,19
1977-12-16,LAL,90,11,16,SEA,98,12,18,23,34
1977-12-16,CHI,115,16,10,PHL,110,18,9,34,19
1977-12-16,MIL,152,15,14,NYK,150,15,12,30,26
1977-12-16,IND,114,10,15,DET,106,9,15,19,30
1977-12-16,BOS,118,9,16,GOS,113,13,14,22,30
1977-12-16,NOJ,113,12,15,PHX,126,15,9,27,24
1977-12-17,NYK,112,15,13,CHI,103,17,10,32,23
1977-12-17,KCK,115,10,17,NOJ,93,12,16,22,33
1977-12-17,DET,122,9,16,BUF,126,11,14,20,30
1977-12-17,PHL,129,18,10,CLE,116,15,11,33,21
1977-12-17,HOU,97,10,16,PHX,101,16,9,26,25
1977-12-17,POR,117,21,4,WAS,104,17,9,38,13
1977-12-18,LAL,104,11,17,BOS,97,10,16,21,33
1977-12-18,KCK,115,11,17,IND,114,11,15,22,32
1977-12-18,SEA,111,13,18,WAS,109,17,10,30,28
1977-12-18,MIL,111,16,14,BUF,100,12,14,28,28
1977-12-18,NOJ,108,12,17,DET,117,9,17,21,34
1977-12-18,ATL,134,14,13,PHX,129,17,9,31,22
1977-12-18,CLE,101,15,12,GOS,95,13,15,28,27
1977-12-20,SEA,93,14,18,DEN,88,18,11,32,29
1977-12-20,BUF,110,12,15,HOU,104,10,17,22,32
1977-12-20,SAN,117,16,13,DET,118,10,17,26,30
1977-12-20,POR,104,22,4,BOS,99,10,17,32,21
1977-12-20,CHI,94,17,11,ATL,86,15,13,32,24
1977-12-20,LAL,120,12,17,WAS,115,17,11,29,28
1977-12-20,NYK,99,16,13,PHX,110,17,10,33,23
1977-12-21,MIL,116,17,14,SAN,92,16,14,33,28
1977-12-21,IND,109,11,16,ATL,98,15,14,26,30
1977-12-21,PHL,125,19,10,PHX,119,18,10,37,20
1977-12-21,GOS,111,13,16,BOS,106,10,18,23,34
1977-12-21,NJN,93,7,23,HOU,103,10,18,17,41
1977-12-22,SEA,132,15,18,BOS,99,10,19,25,37
1977-12-22,DET,118,11,17,MIL,102,18,14,29,31
1977-12-22,NOJ,131,12,18,NJN,110,7,24,19,42
1977-12-22,CLE,112,16,12,NYK,100,16,14,32,26
1977-12-22,KCK,113,12,17,CHI,110,18,11,30,28
1977-12-23,MIL,93,18,15,ATL,109,15,15,33,30
1977-12-23,NJN,103,7,25,BUF,102,13,15,20,40
1977-12-23,POR,108,23,4,LAL,98,13,17,36,21
1977-12-23,SAN,107,16,15,HOU,101,11,18,27,33
1977-12-23,PHX,129,18,11,BOS,110,10,20,28,31
1977-12-23,CHI,107,18,12,DET,108,12,17,30,29
1977-12-23,GOS,98,14,16,DEN,93,18,12,32,28
1977-12-25,SEA,96,16,18,LAL,111,13,18,29,36
1977-12-25,CLE,111,17,12,BUF,105,13,16,30,28
1977-12-25,KCK,122,13,17,MIL,131,18,16,31,33
1977-12-25,POR,109,24,4,GOS,97,15,16,39,20
1977-12-25,WAS,100,17,12,ATL,93,16,15,33,27
1977-12-25,NOJ,105,13,18,SAN,115,17,15,30,33
1977-12-25,NYK,113,16,15,PHL,110,20,10,36,25
1977-12-26,ATL,106,16,16,WAS,113,18,12,34,28
1977-12-26,HOU,113,11,19,KCK,99,13,18,24,37
1977-12-26,DEN,127,18,13,PHX,108,19,11,37,24
1977-12-26,DET,122,13,17,BOS,100,10,21,23,38
1977-12-27,CLE,102,18,12,NOJ,113,13,19,31,31
1977-12-27,PHX,131,19,12,SEA,105,16,19,35,31
1977-12-27,BUF,105,13,17,MIL,108,19,16,32,33
1977-12-27,SAN,89,18,15,IND,96,12,16,30,31
1977-12-27,CHI,115,18,13,POR,106,25,4,43,17
1977-12-27,GOS,82,15,17,LAL,123,14,18,29,35
1977-12-28,PHL,129,20,11,CHI,125,19,13,39,24
1977-12-28,DET,106,14,17,POR,111,25,5,39,22
1977-12-28,DEN,130,19,13,GOS,108,15,18,34,31
1977-12-28,WAS,106,19,12,BUF,87,13,18,32,30
1977-12-28,ATL,99,16,17,IND,92,13,16,29,33
1977-12-29,HOU,104,12,19,CLE,99,18,13,30,32
1977-12-29,PHX,110,20,12,KCK,104,13,19,33,31
1977-12-29,NJN,101,8,25,NYK,109,17,15,25,40
1977-12-29,MIL,115,20,16,BOS,124,10,22,30,38
1977-12-30,ATL,104,17,17,DEN,106,20,13,37,30
1977-12-30,GOS,99,15,19,POR,108,26,5,41,24
1977-12-30,CHI,102,19,14,BOS,97,11,22,30,36
1977-12-30,BUF,87,13,19,DET,103,14,18,27,37
1977-12-30,NYK,118,18,15,NOJ,116,14,19,32,34
1977-12-30,PHL,126,21,11,WAS,119,20,12,41,23
1977-12-30,LAL,119,15,18,KCK,109,13,20,28,38
1977-12-30,SEA,121,16,20,PHX,110,21,12,37,32
1977-12-30,IND,99,13,17,HOU,98,13,19,26,36
1977-12-30,SAN,122,18,16,CLE,101,18,14,36,30
1978-01-01,POR,107,27,5,KCK,102,13,21,40,26
1978-01-01,SEA,114,17,20,CHI,96,20,14,37,34
1978-01-01,NYK,96,19,15,CLE,87,18,15,37,30
1978-01-03,NYK,117,20,15,LAL,120,16,18,36,33
1978-01-03,WAS,100,20,13,DEN,101,21,13,41,26
1978-01-03,POR,92,28,5,CHI,90,20,15,48,20
1978-01-03,NOJ,103,14,20,IND,104,14,17,28,37
1978-01-03,MIL,103,20,17,PHX,125,21,13,41,30
1978-01-03,ATL,103,17,18,DET,106,15,18,32,36
1978-01-04,NJN,115,8,26,PHX,83,22,13,30,39
1978-01-04,SEA,116,18,20,KCK,110,13,22,31,42
1978-01-04,SAN,114,19,16,DEN,119,22,13,41,29
1978-01-04,PHL,108,22,11,CLE,93,18,16,40,27
1978-01-04,GOS,115,15,20,CHI,94,20,16,35,36
1978-01-04,DET,111,16,18,ATL,97,17,19,33,37
1978-01-04,HOU,104,13,20,IND,96,15,17,28,37
1978-01-04,BUF,94,13,20,LAL,93,17,18,30,38
1978-01-05,MIL,109,20,18,NOJ,116,14,21,34,39
1978-01-05,CLE,110,18,17,NJN,94,9,26,27,43
1978-01-05,BOS,111,11,23,PHX,121,22,14,33,37
1978-01-06,WAS,146,20,14,IND,114,15,18,35,32
1978-01-06,NOJ,96,15,21,ATL,94,17,20,32,41
1978-01-06,HOU,101,14,20,MIL,103,20,19,34,39
1978-01-06,NJN,105,9,27,SAN,110,19,17,28,44
1978-01-06,PHL,123,23,11,LAL,110,17,19,40,30
1978-01-06,CHI,97,20,17,NYK,99,20,16,40,33
1978-01-06,GOS,107,16,20,DET,106,17,18,33,38
1978-01-07,CLE,107,19,17,SAN,109,20,17,39,34
1978-01-07,POR,109,29,5,DET,105,17,19,46,24
1978-01-07,KCK,93,13,23,NYK,100,21,16,34,39
1978-01-07,BUF,97,14,20,PHX,107,23,14,37,34
1978-01-07,ATL,106,17,21,HOU,83,14,21,31,42
1978-01-08,IND,104,15,19,LAL,103,17,20,32,39
1978-01-08,SEA,99,19,20,GOS,91,17,20,36,40
1978-01-08,DEN,109,23,13,CHI,104,20,18,43,31
1978-01-08,PHL,94,24,11,BOS,91,11,24,35,35
1978-01-08,MIL,133,21,19,KCK,123,13,24,34,43
1978-01-08,NJN,98,9,28,WAS,99,21,14,30,42
1978-01-08,POR,122,30,5,NOJ,100,16,21,46,26
1978-01-10,PHL,95,25,11,HOU,80,14,22,39,33
1978-01-10,DEN,115,24,13,NOJ,110,16,22,40,35
1978-01-10,MIL,125,22,19,IND,103,16,19,38,38
1978-01-10,WAS,123,22,14,KCK,115,13,25,35,39
1978-01-10,POR,126,31,5,NYK,113,22,16,53,21
1978-01-10,CHI,110,20,19,LAL,106,17,21,37,40
1978-01-11,KCK,102,13,26,LAL,94,17,22,30,48
1978-01-11,ATL,100,18,21,WAS,95,23,14,41,35
1978-01-11,NJN,92,9,29,GOS,103,17,21,26,50
1978-01-11,SAN,130,21,17,MIL,106,23,19,44,36
1978-01-11,PHX,142,24,14,NOJ,99,16,23,40,37
1978-01-11,BOS,91,11,25,HOU,88,14,23,25,48
1978-01-11,SEA,106,20,20,DET,100,17,20,37,40
1978-01-12,BUF,111,14,21,IND,92,16,20,30,41
1978-01-12,HOU,106,14,24,DEN,109,25,13,39,37
1978-01-13,PHL,118,26,11,BUF,93,15,21,41,32
1978-01-13,IND,108,16,21,KCK,106,14,26,30,47
1978-01-13,GOS,109,18,21,NYK,96,22,17,40,38
1978-01-13,BOS,114,12,25,NJN,111,9,30,21,55
1978-01-13,WAS,102,23,15,POR,93,32,5,55,20
1978-01-13,CHI,128,21,19,MIL,111,23,20,44,39
1978-01-13,PHX,111,25,14,DET,100,17,21,42,35
1978-01-13,ATL,92,19,21,SAN,98,22,17,41,38
1978-01-13,SEA,104,21,20,CLE,98,19,18,40,38
1978-01-14,GOS,111,19,21,NOJ,118,16,24,35,45
1978-01-14,HOU,104,14,25,SAN,93,23,17,37,42
1978-01-14,KCK,110,14,27,ATL,101,19,22,33,49
1978-01-14,DEN,123,26,13,LAL,112,17,23,43,36
1978-01-14,NJN,120,9,31,PHL,136,27,11,36,42
1978-01-14,BUF,130,15,22,WAS,93,24,15,39,37
1978-01-15,SEA,108,22,20,NYK,102,22,18,44,38
1978-01-15,DET,101,17,22,CHI,107,22,19,39,41
1978-01-15,BOS,103,13,25,POR,107,32,6,45,31
1978-01-15,PHX,113,26,14,CLE,104,19,19,45,33
1978-01-16,IND,120,17,21,NJN,112,9,32,26,53
1978-01-17,LAL,121,17,24,NYK,108,22,19,39,43
1978-01-17,BUF,94,16,22,POR,96,33,6,49,28
1978-01-17,NOJ,99,17,24,HOU,95,15,25,32,49
1978-01-17,CHI,105,23,19,IND,104,18,21,41,40
1978-01-17,DEN,104,27,13,CLE,89,19,20,46,33
1978-01-17,SAN,119,23,18,SEA,113,23,20,46,38
1978-01-17,ATL,111,19,23,KCK,90,15,27,34,50
1978-01-17,MIL,119,23,21,NJN,109,9,33,32,54
1978-01-18,HOU,104,15,26,SEA,106,23,21,38,47
1978-01-18,GOS,113,19,22,WAS,106,24,16,43,38
1978-01-18,DET,113,17,23,BUF,100,16,23,33,46
1978-01-18,KCK,106,15,28,PHL,126,28,11,43,39
1978-01-18,IND,96,18,22,SAN,109,24,18,42,40
1978-01-18,ATL,106,20,23,NOJ,108,18,24,38,47
1978-01-18,NJN,101,9,34,POR,127,34,6,43,40
1978-01-18,BOS,130,13,26,MIL,116,24,21,37,47
1978-01-19,PHX,134,27,14,NYK,114,22,20,49,34
1978-01-19,MIL,114,24,22,DEN,109,28,13,52,35
1978-01-19,CLE,117,19,21,PHL,109,29,11,48,32
1978-01-19,ATL,95,20,24,CHI,105,24,19,44,43
1978-01-20,HOU,118,15,27,DET,108,18,23,33,50
1978-01-20,NOJ,101,19,24,POR,100,35,6,54,30
1978-01-20,LAL,121,18,24,WAS,99,24,17,42,41
1978-01-20,SAN,112,25,18,IND,82,18,23,43,41
1978-01-20,GOS,119,20,22,PHX,104,28,14,48,36
1978-01-21,ATL,111,20,25,IND,100,18,24,38,49
1978-01-22,CLE,93,20,21,ATL,89,21,25,41,46
1978-01-22,IND,99,18,25,BUF,90,16,24,34,49
1978-01-22,DEN,141,28,14,NYK,143,22,21,50,35
1978-01-22,BOS,92,14,26,SEA,103,24,21,38,47
1978-01-22,MIL,112,25,22,CHI,90,25,19,50,41
1978-01-22,LAL,106,19,24,HOU,101,16,27,35,51
1978-01-22,NJN,97,9,35,KCK,105,15,29,24,64
1978-01-22,PHL,99,29,12,GOS,87,21,22,50,34
1978-01-22,NOJ,100,20,24,DET,97,18,24,38,48
1978-01-22,PHX,114,28,15,WAS,101,24,18,52,33
1978-01-22,SAN,106,26,18,POR,95,35,7,61,25
1978-01-24,NYK,99,23,21,GOS,97,21,23,44,44
1978-01-24,WAS,101,24,19,DET,104,18,25,42,44
1978-01-24,KCK,97,16,29,POR,120,35,8,51,37
1978-01-24,IND,92,19,25,CLE,96,21,21,40,46
1978-01-24,NOJ,96,21,24,BOS,91,14,27,35,51
1978-01-24,CHI,131,25,20,DEN,114,28,15,53,35
1978-01-24,LAL,117,20,24,PHL,102,30,12,50,36
1978-01-25,DEN,121,28,16,BUF,119,16,25,44,41
1978-01-25,PHX,118,29,15,HOU,96,16,28,45,43
1978-01-25,SEA,125,25,21,PHL,128,30,13,55,34
1978-01-25,SAN,113,27,18,BOS,103,14,28,41,46
1978-01-25,DET,99,19,25,GOS,95,21,24,40,49
1978-01-26,POR,112,36,8,NJN,77,9,36,45,44
1978-01-26,NYK,112,24,21,KCK,105,16,30,40,51
1978-01-26,WAS,135,24,20,CHI,107,26,20,50,40
1978-01-27,DEN,105,29,16,HOU,100,16,29,45,45
1978-01-27,NOJ,134,22,24,KCK,117,16,31,38,55
1978-01-27,ATL,105,21,26,NYK,96,25,21,46,47
1978-01-27,BUF,94,16,26,GOS,101,21,25,37,51
1978-01-27,PHX,110,30,15,PHL,101,31,13,61,28
1978-01-27,SEA,95,25,22,NJN,90,9,37,34,59
1978-01-27,LAL,131,21,24,MIL,114,26,22,47,46
1978-01-28,NYK,108,25,22,CHI,96,26,21,51,43
1978-01-28,CLE,105,22,21,DET,115,20,25,42,46
1978-01-29,SEA,103,26,22,MIL,101,26,23,52,45
1978-01-29,POR,123,37,8,HOU,88,16,30,53,38
1978-01-29,KCK,113,16,32,SAN,127,28,18,44,50
1978-01-29,PHX,131,31,15,NJN,100,9,38,40,53
1978-01-29,DET,120,21,25,CLE,116,22,22,43,47
1978-01-29,BOS,88,14,29,GOS,99,22,25,36,54
1978-01-29,DEN,117,30,16,PHL,118,31,14,61,30
1978-01-29,WAS,119,25,20,LAL,112,22,24,47,44
1978-01-29,ATL,107,22,26,BUF,102,16,27,38,53
1978-01-29,IND,91,19,26,NOJ,107,23,24,42,50
1978-01-31,NYK,115,26,22,DEN,119,30,17,56,39
1978-01-31,POR,136,38,8,MIL,116,26,24,64,32
1978-01-31,CHI,106,26,22,ATL,103,23,26,49,48
1978-01-31,NOJ,114,24,24,BUF,95,16,28,40,52
1978-01-31,CLE,107,22,23,LAL,116,22,25,44,48
1978-01-31,GOS,103,23,25,NJN,92,9,39,32,64
1978-01-31,KCK,102,16,33,PHX,112,32,15,48,48
1978-01-31,BOS,104,14,30,IND,94,19,27,33,57
1978-01-31,SAN,129,29,18,WAS,109,26,20,55,38
1978-02-01,HOU,124,16,31,NJN,103,9,40,25,71
1978-02-01,NOJ,117,25,24,CHI,111,27,22,52,46
1978-02-01,PHL,104,32,14,DEN,101,31,17,63,31
1978-02-01,BOS,103,15,30,LAL,100,23,25,38,55
1978-02-01,DET,127,22,25,PHX,120,33,15,55,40
1978-02-02,CLE,110,22,24,WAS,93,26,21,48,45
1978-02-02,IND,105,19,28,ATL,107,23,27,42,55
1978-02-02,KCK,113,16,34,DET,101,23,25,39,59
1978-02-02,SAN,123,30,18,NYK,113,26,23,56,41
1978-02-02,GOS,105,24,25,MIL,102,26,25,50,50
1978-02-03,CHI,110,27,23,SAN,107,31,18,58,41
1978-02-03,PHL,116,33,14,IND,104,19,29,52,43
1978-02-03,POR,112,39,8,GOS,92,25,25,64,33
1978-02-03,BOS,116,16,30,WAS,94,26,22,42,52
1978-02-03,PHX,115,33,16,MIL,105,26,26,59,42
1978-02-03,BUF,101,16,29,CLE,104,23,24,39,53
1978-02-03,HOU,112,17,31,NYK,102,26,24,43,55
1978-02-03,NJN,99,9,41,LAL,105,23,26,32,67
1978-02-03,DEN,115,31,18,DET,102,23,26,54,44
1978-02-07,IND,89,19,30,BOS,92,17,30,36,60
1978-02-07,CHI,108,28,23,PHL,106,34,14,62,37
1978-02-07,BUF,105,16,30,LAL,132,24,26,40,56
1978-02-07,CLE,122,24,24,NOJ,99,26,24,50,48
1978-02-07,GOS,105,25,26,WAS,102,26,23,51,49
1978-02-08,PHL,117,34,15,NOJ,104,26,25,60,40
1978-02-08,SEA,100,27,22,WAS,106,26,24,53,46
1978-02-08,DET,95,23,27,LAL,105,25,26,48,53
1978-02-08,KCK,104,17,34,BOS,100,18,30,35,64
1978-02-08,MIL,104,26,27,BUF,103,16,31,42,58
1978-02-08,DEN,114,32,18,ATL,109,24,27,56,45
1978-02-08,NJN,140,9,42,IND,138,19,31,28,73
1978-02-08,HOU,105,18,31,CHI,101,29,23,47,54
1978-02-09,SAN,104,31,19,HOU,94,19,31,50,50
1978-02-09,NYK,126,26,25,IND,117,19,32,45,57
1978-02-09,CLE,88,25,24,POR,94,40,8,65,32
1978-02-09,GOS,119,26,26,DEN,108,33,18,59,44
1978-02-09,PHX,125,34,16,ATL,98,24,28,58,44
1978-02-10,MIL,108,27,27,CLE,98,25,25,52,52
1978-02-10,IND,108,19,33,POR,112,41,8,60,41
1978-02-10,KCK,106,18,34,CHI,93,29,24,47,58
1978-02-10,HOU,114,19,32,SAN,125,32,19,51,51
1978-02-10,BUF,116,16,32,PHL,110,35,15,51,47
1978-02-10,SEA,126,27,23,DEN,123,33,19,60,42
1978-02-10,LAL,135,26,26,GOS,107,27,26,53,52
1978-02-10,NJN,117,10,42,DET,112,23,28,33,70
1978-02-11,CHI,90,29,25,KCK,95,19,34,48,59
1978-02-11,DET,106,23,29,NOJ,96,26,26,49,55
1978-02-11,GOS,122,27,27,SAN,131,33,19,60,46
1978-02-11,NYK,133,27,25,MIL,122,28,27,55,52
1978-02-12,NOJ,112,26,27,HOU,119,19,33,45,60
1978-02-12,POR,101,42,8,DEN,103,33,20,75,28
1978-02-12,KCK,101,20,34,CLE,88,25,26,45,60
1978-02-12,PHL,109,35,16,SEA,99,28,23,63,39
1978-02-12,PHX,121,35,16,WAS,109,27,24,62,40
1978-02-12,NJN,112,11,42,NYK,110,28,25,39,67
1978-02-12,IND,111,19,34,CHI,94,29,26,48,60
1978-02-12,LAL,103,27,26,ATL,116,24,29,51,55
1978-02-13,DET,125,24,29,NJN,115,12,42,36,71
1978-02-14,CHI,102,29,27,NOJ,95,26,28,55,55
1978-02-14,GOS,75,27,28,BOS,98,18,31,45,59
1978-02-14,BUF,101,17,32,SEA,100,28,24,45,56
1978-02-14,DEN,103,34,20,WAS,98,27,25,61,45
1978-02-14,KCK,125,21,34,HOU,102,20,33,41,67
1978-02-14,LAL,128,27,27,SAN,114,34,19,61,46
1978-02-14,CLE,136,25,27,NYK,127,28,26,53,53
1978-02-14,POR,113,42,9,PHX,100,36,16,78,25
1978-02-14,IND,116,20,34,PHL,119,36,16,56,50
1978-02-15,HOU,126,20,34,IND,122,20,35,40,69
1978-02-15,POR,102,43,9,ATL,99,25,29,68,38
1978-02-15,DET,113,25,29,PHL,116,37,16,62,45
1978-02-15,MIL,112,28,28,NOJ,99,26,29,54,57
1978-02-16,NJN,101,12,43,SEA,92,28,25,40,68
1978-02-16,PHX,95,36,17,BOS,98,19,31,55,48
1978-02-16,CLE,119,26,27,DEN,87,35,20,61,47
1978-02-16,WAS,123,27,26,BUF,109,18,32,45,58
1978-02-17,CHI,98,30,27,SEA,106,28,26,58,53
1978-02-17,NOJ,102,26,30,ATL,111,25,30,51,60
1978-02-17,LAL,114,28,27,BOS,106,20,31,48,58
1978-02-17,BUF,100,18,33,KCK,108,22,34,40,67
1978-02-17,GOS,111,27,29,PHX,92,36,18,63,47
1978-02-17,PHL,125,38,16,SAN,116,34,20,72,36
1978-02-17,DEN,112,35,21,POR,105,44,9,79,30
1978-02-17,IND,123,20,36,WAS,111,28,26,48,62
1978-02-17,MIL,115,29,28,HOU,98,21,34,50,62
1978-02-17,DET,108,25,30,NYK,128,28,27,53,57
1978-02-17,NJN,96,13,43,CLE,99,27,27,40,70
1978-02-18,SAN,124,34,21,CHI,103,30,28,64,49
1978-02-18,PHX,114,36,19,IND,101,21,36,57,55
1978-02-18,NYK,112,29,27,BUF,122,18,34,47,61
1978-02-18,HOU,121,21,35,ATL,112,26,30,47,65
1978-02-18,CLE,105,28,27,KCK,101,23,34,51,61
1978-02-19,POR,127,44,10,IND,104,21,37,65,47
1978-02-19,WAS,130,28,27,NOJ,111,26,31,54,58
1978-02-19,DET,110,25,31,KCK,107,23,35,48,66
1978-02-19,MIL,103,30,28,SEA,108,29,26,59,54
1978-02-19,DEN,118,36,21,BOS,115,20,32,56,53
1978-02-19,PHL,120,39,16,NJN,110,13,44,52,60
1978-02-19,GOS,93,28,29,LAL,115,29,27,57,56
1978-02-20,CHI,106,30,29,CLE,95,29,27,59,56
1978-02-21,BUF,111,19,34,PHX,114,37,19,56,53
1978-02-21,CHI,104,31,29,LAL,106,30,27,61,56
1978-02-21,NYK,122,29,28,SEA,120,30,26,59,54
1978-02-21,SAN,114,35,21,POR,118,45,10,80,31
1978-02-21,HOU,111,22,35,BOS,96,20,33,42,68
1978-02-21,CLE,114,29,28,PHL,127,40,16,69,44
1978-02-22,NJN,83,13,45,SEA,94,30,27,43,72
1978-02-22,KCK,127,23,36,LAL,122,31,27,54,63
1978-02-22,WAS,97,29,27,POR,105,46,10,75,37
1978-02-22,DEN,96,37,21,IND,99,21,38,58,59
1978-02-22,DET,119,26,31,HOU,108,23,35,49,66
1978-02-22,ATL,107,26,31,PHX,95,38,19,64,50
1978-02-22,NOJ,116,26,32,GOS,91,28,30,54,62
1978-02-23,SAN,118,35,22,ATL,105,27,31,62,53
1978-02-24,CHI,109,31,30,MIL,112,30,29,61,59
1978-02-24,NJN,126,13,46,HOU,112,23,36,36,82
1978-02-24,WAS,121,29,28,PHX,120,38,20,67,48
1978-02-24,BUF,99,19,35,BOS,106,20,34,39,69
1978-02-24,LAL,109,31,28,DEN,99,37,22,68,50
1978-02-24,KCK,96,24,36,POR,107,47,10,71,46
1978-02-24,ATL,96,27,32,GOS,97,28,31,55,63
1978-02-24,NOJ,101,27,32,CLE,98,29,29,56,61
1978-02-25,SAN,112,36,22,CLE,108,29,30,65,52
1978-02-25,BUF,106,19,36,HOU,110,23,37,42,73
1978-02-25,SEA,118,31,27,DET,104,27,31,58,58
1978-02-25,DEN,124,37,23,PHL,115,41,16,78,39
1978-02-25,NYK,122,30,28,PHX,115,38,21,68,49
1978-02-26,ATL,119,27,33,BUF,117,19,37,46,70
1978-02-26,NJN,92,14,46,BOS,94,21,34,35,80
1978-02-26,NOJ,120,28,32,MIL,122,31,29,59,61
1978-02-26,CHI,99,31,31,POR,100,48,10,79,41
1978-02-26,WAS,121,30,28,GOS,110,29,31,59,59
1978-02-26,SEA,99,32,27,PHL,97,41,17,73,44
1978-02-26,LAL,124,32,28,DET,127,27,32,59,60
1978-02-27,HOU,97,24,37,CLE,110,29,31,53,68
1978-02-28,IND,106,22,38,DEN,122,38,23,60,61
1978-02-28,ATL,117,28,33,BOS,85,22,34,50,67
1978-02-28,MIL,136,32,29,WAS,135,31,28,63,57
1978-02-28,NYK,138,31,28,SAN,123,37,22,68,50
1978-02-28,NOJ,125,28,33,BUF,108,19,38,47,71
1978-02-28,KCK,107,24,37,SEA,114,33,27,57,64
1978-02-28,CHI,126,31,32,PHX,115,38,22,69,54
1978-02-28,POR,113,49,10,PHL,92,41,18,90,28
1978-03-01,PHX,102,38,23,DET,115,28,32,66,55
1978-03-01,WAS,125,31,29,SAN,110,37,23,68,52
1978-03-01,HOU,104,24,38,BUF,114,19,39,43,77
1978-03-01,DEN,104,39,23,CLE,110,30,31,69,54
1978-03-01,NOJ,101,29,33,BOS,100,22,35,51,68
1978-03-01,GOS,119,29,32,PHL,125,41,19,70,51
1978-03-01,NJN,97,14,47,ATL,95,29,33,43,80
1978-03-02,NYK,128,32,28,POR,117,50,10,82,38
1978-03-02,SAN,128,37,24,BUF,107,20,39,57,63
1978-03-03,BOS,116,22,36,NOJ,113,30,33,52,69
1978-03-03,IND,115,22,39,SEA,111,34,27,56,66
1978-03-03,LAL,96,32,29,PHL,95,42,19,74,48
1978-03-03,PHX,132,38,24,MIL,126,33,29,71,53
1978-03-03,DET,108,29,32,WAS,124,32,29,61,61
1978-03-03,ATL,133,29,34,HOU,110,24,39,53,73
1978-03-04,DEN,123,39,24,KCK,114,24,38,63,62
1978-03-04,BUF,111,20,40,NJN,107,15,47,35,87
1978-03-04,NOJ,113,30,34,SEA,104,34,28,64,62
1978-03-04,NYK,99,33,28,BOS,91,23,36,56,64
1978-03-04,POR,105,50,11,CLE,100,31,31,81,42
1978-03-05,PHX,92,39,24,PHL,104,42,20,81,44
1978-03-05,SAN,98,38,24,NOJ,97,31,34,69,58
1978-03-05,NJN,109,15,48,BUF,103,21,40,36,88
1978-03-05,DET,122,29,33,IND,110,23,39,52,72
1978-03-05,GOS,95,29,33,CHI,96,32,32,61,65
1978-03-05,LAL,128,33,29,CLE,117,31,32,64,61
1978-03-05,WAS,106,33,29,HOU,88,24,40,57,69
1978-03-05,ATL,101,30,34,SEA,94,34,29,64,63
1978-03-05,BOS,112,23,37,NYK,94,34,28,57,65
1978-03-05,POR,126,51,11,MIL,88,33,30,84,41
1978-03-06,KCK,98,24,39,IND,88,23,40,47,79
1978-03-07,NYK,112,34,29,HOU,101,24,41,58,70
1978-03-07,NOJ,84,31,35,POR,82,52,11,83,46
1978-03-07,SAN,129,39,24,NJN,98,16,48,55,72
1978-03-07,DEN,112,40,24,PHX,126,39,25,79,49
1978-03-07,ATL,123,31,34,DET,109,30,33,61,67
1978-03-08,KCK,121,25,39,NJN,123,16,49,41,88
1978-03-08,MIL,127,33,31,NYK,125,35,29,68,60
1978-03-08,HOU,94,24,42,POR,97,52,12,76,54
1978-03-08,BUF,120,21,41,NOJ,108,32,35,53,76
1978-03-08,SAN,94,40,24,SEA,95,34,30,74,54
1978-03-08,GOS,118,29,34,CLE,108,31,33,60,67
1978-03-08,PHL,108,43,20,ATL,97,32,34,75,54
1978-03-09,IND,112,23,41,DET,105,30,34,53,75
1978-03-09,PHX,112,40,25,CHI,103,33,32,73,57
1978-03-10,HOU,114,24,43,WAS,117,34,29,58,72
1978-03-10,BUF,118,22,41,CLE,117,31,34,53,75
1978-03-10,LAL,115,34,29,CHI,109,33,33,67,62
1978-03-10,MIL,102,34,31,GOS,124,30,34,64,65
1978-03-10,KCK,126,25,40,DEN,120,40,25,65,65
1978-03-10,NJN,99,17,49,NOJ,105,32,36,49,85
1978-03-10,PHL,120,44,20,BOS,109,24,37,68,57
1978-03-10,IND,122,24,41,NYK,115,35,30,59,71
1978-03-10,ATL,114,32,35,POR,105,53,12,85,47
1978-03-11,NYK,126,35,31,NJN,117,17,50,52,81
1978-03-11,PHX,120,41,25,LAL,114,35,29,76,54
1978-03-11,SAN,116,40,25,WAS,101,35,29,75,54
1978-03-11,HOU,91,24,44,SEA,93,35,30,59,74
1978-03-12,IND,90,25,41,CLE,95,31,35,56,76
1978-03-12,DEN,98,40,26,CHI,95,33,34,73,60
1978-03-12,NJN,125,17,51,DET,130,30,35,47,86
1978-03-12,LAL,128,35,30,PHX,112,42,25,77,55
1978-03-12,ATL,98,33,35,MIL,93,34,32,67,67
1978-03-12,KCK,106,26,40,GOS,113,31,34,57,74
1978-03-12,BOS,103,24,38,PHL,105,45,20,69,58
1978-03-12,BUF,96,23,41,POR,90,53,13,76,54
1978-03-14,CHI,96,33,35,GOS,103,32,34,65,69
1978-03-14,CLE,119,32,35,HOU,98,24,45,56,80
1978-03-14,BOS,105,24,39,DET,98,31,35,55,74
1978-03-14,BUF,123,24,41,SAN,115,41,25,65,66
1978-03-14,MIL,121,34,33,PHX,106,42,26,76,59
1978-03-14,NYK,117,36,31,LAL,135,36,30,72,61
1978-03-14,WAS,120,35,30,SEA,115,36,30,71,60
1978-03-14,POR,103,53,14,NOJ,109,33,36,86,50
1978-03-15,PHL,113,46,20,LAL,93,37,30,83,50
1978-03-15,DET,106,31,36,SAN,135,41,26,72,62
1978-03-15,NJN,117,17,52,PHX,98,42,27,59,79
1978-03-15,IND,111,25,42,BUF,106,25,41,50,83
1978-03-15,DEN,123,41,26,GOS,111,33,34,74,60
1978-03-16,CLE,112,33,35,BOS,102,25,39,58,74
1978-03-16,CHI,111,33,36,WAS,107,36,30,69,66
1978-03-16,SEA,123,36,31,NOJ,98,34,36,70,67
1978-03-16,GOS,104,33,35,ATL,98,34,35,67,70
1978-03-16,HOU,98,24,46,DET,106,31,37,55,83
1978-03-17,CHI,129,34,36,NYK,117,36,32,70,68
1978-03-17,BUF,136,25,42,MIL,127,35,33,60,75
1978-03-17,PHL,123,47,20,KCK,112,26,41,73,61
1978-03-17,NJN,111,18,52,DEN,109,42,26,60,78
1978-03-17,WAS,99,36,31,IND,105,26,42,62,73
1978-03-17,LAL,98,37,31,SEA,105,37,31,74,62
1978-03-17,BOS,115,25,40,PHX,108,42,28,67,68
1978-03-17,POR,99,53,15,SAN,118,42,26,95,41
1978-03-18,GOS,88,34,35,NOJ,96,34,37,68,72
1978-03-18,POR,105,53,16,ATL,86,34,36,87,52
1978-03-18,NYK,127,36,33,PHL,141,48,20,84,53
1978-03-18,BOS,117,26,40,KCK,110,26,42,52,82
1978-03-18,IND,104,27,42,MIL,113,35,34,62,76
1978-03-18,HOU,104,24,47,NJN,106,19,52,43,99
1978-03-19,WAS,106,36,32,MIL,117,36,34,72,66
1978-03-19,LAL,101,37,32,ATL,87,34,37,71,69
1978-03-19,CLE,112,34,35,PHX,123,42,29,76,64
1978-03-19,SEA,116,38,31,SAN,98,43,26,81,57
1978-03-19,PHL,125,49,20,NYK,118,36,34,85,54
1978-03-19,DET,112,32,37,CHI,92,35,36,67,73
1978-03-19,KCK,122,26,43,BUF,108,26,42,52,85
1978-03-19,BOS,122,27,40,DEN,95,42,27,69,67
1978-03-20,CLE,104,34,36,IND,127,27,43,61,79
1978-03-21,IND,119,28,43,PHX,115,43,29,71,72
1978-03-21,NOJ,117,35,37,NJN,114,20,52,55,89
1978-03-21,DET,111,33,37,KCK,116,27,43,60,80
1978-03-21,POR,102,54,16,SEA,96,39,31,93,47
1978-03-21,CHI,101,35,37,HOU,99,24,48,59,85
1978-03-21,MIL,100,37,34,ATL,86,34,38,71,72
1978-03-21,WAS,119,36,33,BOS,107,28,40,64,73
1978-03-21,SAN,109,43,27,LAL,105,38,32,81,59
1978-03-21,DEN,114,42,28,NYK,115,36,35,78,63
1978-03-21,GOS,111,34,36,BUF,104,26,43,60,79
1978-03-22,HOU,106,24,49,LAL,124,38,33,62,82
1978-03-22,NOJ,109,36,37,WAS,124,37,33,73,70
1978-03-22,SEA,97,39,32,BUF,92,26,44,65,76
1978-03-22,NJN,105,20,53,CHI,99,36,37,56,90
1978-03-22,BOS,105,28,41,CLE,99,34,37,62,78
1978-03-22,KCK,120,28,43,PHL,108,50,20,78,63
1978-03-23,PHX,120,43,30,NYK,108,37,35,80,65
1978-03-23,SAN,123,44,27,DEN,106,42,29,86,56
1978-03-23,MIL,116,38,34,POR,109,55,16,93,50
1978-03-23,GOS,119,35,36,IND,115,29,43,64,79
1978-03-24,LAL,120,39,33,BUF,115,26,45,65,78
1978-03-24,SEA,104,40,32,IND,102,29,44,69,76
1978-03-24,ATL,96,34,39,NOJ,94,36,38,70,77
1978-03-24,PHL,131,50,21,MIL,122,39,34,89,55
1978-03-24,DET,107,33,38,POR,95,55,17,88,55
1978-03-24,NJN,104,21,53,WAS,107,38,33,59,86
1978-03-24,BOS,96,29,41,CHI,97,36,38,65,79
1978-03-24,HOU,107,24,50,KCK,103,29,43,53,93
1978-03-25,WAS,98,39,33,ATL,95,35,39,74,72
1978-03-25,KCK,130,29,44,SAN,132,45,27,74,71
1978-03-25,GOS,133,36,36,NYK,123,37,36,73,72
1978-03-25,PHX,112,44,30,BUF,106,26,46,70,76
1978-03-26,PHL,116,51,21,POR,100,55,18,106,39
1978-03-26,MIL,110,39,35,DET,109,34,38,73,73
1978-03-26,CLE,95,34,38,CHI,78,37,38,71,76
1978-03-26,SEA,112,41,32,BOS,101,29,42,70,74
1978-03-26,NOJ,100,36,39,DEN,109,42,30,78,69
1978-03-26,WAS,104,40,33,NJN,118,21,54,61,87
1978-03-26,LAL,110,40,33,IND,99,29,45,69,78
1978-03-27,CLE,98,35,38,GOS,88,37,36,72,74
1978-03-28,SAN,94,46,27,GOS,108,37,37,83,64
1978-03-28,CLE,112,36,38,SEA,100,42,32,78,70
1978-03-28,ATL,105,35,40,LAL,104,41,33,76,73
1978-03-28,POR,92,55,19,BOS,104,29,43,84,62
1978-03-28,BUF,118,26,47,DET,123,34,39,60,86
1978-03-28,CHI,105,37,39,KCK,128,29,45,66,84
1978-03-28,NYK,106,37,37,DEN,103,43,30,80,67
1978-03-29,HOU,89,25,50,GOS,112,38,37,63,87
1978-03-29,DEN,109,43,31,BOS,106,30,43,73,74
1978-03-29,DET,121,35,39,SEA,116,42,33,77,72
1978-03-29,IND,91,29,46,SAN,106,46,28,75,74
1978-03-29,PHX,127,45,30,POR,94,55,20,100,50
1978-03-29,WAS,105,40,34,KCK,108,30,45,70,79
1978-03-29,NOJ,103,36,40,LAL,108,41,34,77,74
1978-03-29,PHL,149,52,21,BUF,118,26,48,78,69
1978-03-30,CLE,95,37,38,SAN,99,47,28,84,66
1978-03-30,NYK,108,38,37,WAS,123,40,35,78,72
1978-03-30,MIL,105,40,35,IND,100,29,47,69,82
1978-03-31,DEN,109,44,31,SEA,111,42,34,86,65
1978-03-31,WAS,101,41,35,CLE,102,37,39,78,74
1978-03-31,LAL,101,42,34,POR,103,55,21,97,55
1978-03-31,IND,103,29,48,GOS,111,39,37,68,85
1978-03-31,CHI,117,37,40,DET,107,36,39,73,79
1978-03-31,NOJ,116,36,41,NYK,117,38,38,74,79
1978-03-31,NJN,122,22,54,MIL,114,41,35,63,89
1978-03-31,ATL,111,36,40,PHL,110,53,21,89,61
1978-03-31,BOS,117,30,44,SAN,120,48,28,78,72
1978-03-31,PHX,136,46,30,KCK,112,31,45,77,75
1978-04-01,BOS,119,30,45,NOJ,108,36,42,66,87
1978-04-01,CLE,113,38,39,DET,99,36,40,74,79
1978-04-01,HOU,116,25,51,PHL,112,53,22,78,73
1978-04-01,BUF,102,26,49,CHI,110,38,40,64,89
1978-04-02,ATL,124,37,40,NJN,113,23,54,60,94
1978-04-02,BOS,120,31,45,IND,123,29,49,60,94
1978-04-02,WAS,109,41,36,NYK,114,39,38,80,74
1978-04-02,LAL,133,42,35,KCK,127,31,46,73,81
1978-04-02,PHX,105,47,30,GOS,99,40,37,87,67
1978-04-02,SEA,101,43,34,POR,86,56,21,99,55
1978-04-02,SAN,111,49,28,PHL,107,53,23,102,51
1978-04-02,DEN,109,44,32,HOU,100,26,51,70,83
1978-04-02,DET,121,36,41,MIL,129,41,36,77,77
1978-04-03,BUF,95,26,50,DEN,104,45,32,71,82
1978-04-04,SAN,125,50,28,PHX,119,48,30,98,58
1978-04-04,IND,121,30,49,NJN,129,23,55,53,104
1978-04-04,POR,89,56,22,HOU,101,26,52,82,74
1978-04-04,MIL,102,42,36,LAL,103,43,35,85,71
1978-04-04,GOS,130,40,38,KCK,119,31,47,71,85
1978-04-04,NYK,101,40,38,ATL,105,38,40,78,78
1978-04-04,CLE,116,39,39,BUF,105,26,51,65,90
1978-04-04,CHI,116,39,40,BOS,104,31,46,70,86
1978-04-04,NOJ,120,36,43,PHL,119,53,24,89,67
1978-04-05,DEN,129,46,32,NJN,121,24,55,70,87
1978-04-05,BUF,74,26,52,ATL,87,39,40,65,92
1978-04-05,SEA,113,44,34,HOU,100,27,52,71,86
1978-04-05,PHL,126,53,25,DET,115,36,42,89,67
1978-04-05,WAS,125,41,37,LAL,119,44,35,85,72
1978-04-06,PHX,105,48,31,DEN,111,47,32,95,63
1978-04-06,NYK,129,40,39,DET,125,36,43,76,82
1978-04-06,SAN,123,51,28,KCK,116,31,48,82,76
1978-04-06,GOS,115,41,38,POR,96,56,23,97,61
1978-04-06,BOS,103,31,47,WAS,112,42,37,73,84
1978-04-06,CLE,117,40,39,MIL,105,42,37,82,76
1978-04-07,CHI,103,40,40,BUF,113,26,53,66,93
1978-04-07,MIL,108,42,38,SAN,102,52,28,94,66
1978-04-07,SEA,95,45,34,PHX,83,48,32,93,66
1978-04-07,POR,97,56,24,DEN,93,48,32,104,56
1978-04-07,ATL,109,40,40,CLE,111,41,39,81,79
1978-04-07,HOU,114,27,53,NOJ,117,37,43,64,96
1978-04-07,PHL,118,54,25,IND,127,30,50,84,75
1978-04-07,KCK,112,31,49,NYK,125,41,39,72,88
1978-04-07,LAL,114,44,36,NJN,106,24,56,68,92
1978-04-07,BOS,109,31,48,DET,111,36,44,67,92
1978-04-08,PHX,120,48,33,NJN,109,24,57,72,90
1978-04-08,GOS,102,42,38,SEA,87,46,34,88,72
1978-04-08,IND,111,31,50,HOU,112,27,54,58,104
1978-04-08,PHL,131,54,26,WAS,114,43,37,97,63
1978-04-08,BOS,111,31,49,MIL,123,43,38,74,87
1978-04-08,BUF,107,27,53,NYK,118,42,39,69,92
1978-04-09,NOJ,153,38,43,SAN,132,52,29,90,72
1978-04-09,SEA,111,46,35,GOS,105,43,38,89,73
1978-04-09,BOS,131,31,50,BUF,114,27,54,58,104
1978-04-09,DET,139,37,44,DEN,137,48,33,85,77
1978-04-09,WAS,123,43,38,PHL,113,55,26,98,64
1978-04-09,POR,114,57,24,LAL,99,45,36,102,60
1978-04-09,KCK,117,31,50,CLE,120,42,39,73,89
1978-04-09,ATL,99,40,41,CHI,85,40,41,80,82
1978-10-13,NYK,107,0,0,HOU,111,0,0,0,0
1978-10-13,BOS,101,0,0,CLE,115,0,0,0,0
1978-10-13,PHL,110,0,0,LAL,102,0,0,0,0
1978-10-13,PHX,128,0,0,SDC,114,0,0,0,0
1978-10-13,DET,105,0,0,NJN,107,0,0,0,0
1978-10-13,SEA,104,0,0,CHI,86,0,0,0,0
1978-10-13,IND,117,0,0,ATL,104,0,0,0,0
1978-10-13,WAS,117,0,0,NOJ,101,0,0,0,0
1978-10-13,DEN,118,0,0,SAN,117,0,0,0,0
1978-10-14,SAN,153,0,1,MIL,111,0,0,0,1
1978-10-14,NJN,102,1,0,LAL,100,0,1,1,1
1978-10-14,ATL,122,0,1,DET,114,0,1,0,2
1978-10-14,GOS,117,0,0,SDC,89,0,1,0,1
1978-10-14,BOS,108,0,1,HOU,114,1,0,1,1
1978-10-15,SDC,94,0,2,DEN,98,1,0,1,2
1978-10-15,NOJ,112,0,1,MIL,123,0,1,0,2
1978-10-15,SEA,115,1,0,KCK,105,0,0,1,0
1978-10-15,POR,97,0,0,CHI,108,0,1,0,1
1978-10-15,PHX,129,1,0,GOS,110,1,0,2,0
1978-10-17,WAS,113,1,0,NJN,109,2,0,3,0
1978-10-17,NYK,109,0,1,SEA,120,2,0,2,1
1978-10-17,PHX,107,2,0,SAN,110,1,1,3,1
1978-10-17,NOJ,114,0,2,DET,109,0,2,0,4
1978-10-17,CLE,113,1,0,LAL,111,0,2,1,2
1978-10-17,POR,115,0,1,KCK,112,0,1,0,2
1978-10-17,SDC,99,0,3,CHI,94,1,1,1,4
1978-10-18,SDC,125,1,3,SAN,127,2,1,3,4
1978-10-18,PHL,111,1,0,WAS,121,2,0,3,0
1978-10-18,HOU,139,2,0,NJN,87,2,1,4,1
1978-10-18,DEN,125,2,0,POR,113,1,1,3,1
1978-10-18,IND,92,1,0,SEA,99,3,0,4,0
1978-10-18,ATL,99,1,1,BOS,116,0,2,1,3
1978-10-18,GOS,112,1,1,PHX,122,2,1,3,2
1978-10-19,NOJ,120,1,2,BOS,115,1,2,2,4
1978-10-19,KCK,108,0,2,HOU,103,3,0,3,2
1978-10-20,GOS,111,1,2,POR,108,1,2,2,4
1978-10-20,SEA,133,4,0,SAN,117,3,1,7,1
1978-10-20,DET,117,0,3,PHL,126,1,1,1,4
1978-10-20,CHI,94,1,2,SDC,110,1,4,2,6
1978-10-20,MIL,105,1,1,NYK,115,0,2,1,3
1978-10-20,NJN,117,2,2,DEN,126,3,0,5,2
1978-10-21,KCK,99,1,2,MIL,103,1,2,2,4
1978-10-21,PHL,130,2,1,NOJ,111,2,2,4,3
1978-10-21,CLE,113,2,0,CHI,104,1,3,3,3
1978-10-21,HOU,118,3,1,BOS,101,1,3,4,4
1978-10-21,NYK,109,1,2,NJN,108,2,3,3,5
1978-10-21,ATL,130,1,2,DEN,125,4,0,5,2
1978-10-21,IND,125,1,1,SDC,119,2,4,3,5
1978-10-21,WAS,119,3,0,DET,99,0,4,3,4
1978-10-22,LAL,134,0,3,SAN,121,3,2,3,5
1978-10-22,POR,116,1,3,PHX,124,3,1,4,4
1978-10-22,MIL,109,2,2,GOS,107,2,2,4,4
1978-10-24,NYK,113,2,2,ATL,109,2,2,4,4
1978-10-24,SDC,124,2,5,LAL,123,1,3,3,8
1978-10-24,IND,95,2,1,NJN,97,2,4,4,5
1978-10-24,CHI,117,1,4,KCK,123,1,3,2,7
1978-10-24,CLE,122,3,0,NOJ,104,2,3,5,3
1978-10-24,PHX,124,4,1,MIL,116,3,2,7,3
1978-10-24,SAN,132,3,3,BOS,109,1,4,4,7
1978-10-24,POR,104,1,4,WAS,102,4,0,5,4
1978-10-25,KCK,114,2,3,NOJ,109,2,4,4,7
1978-10-25,PHL,118,3,1,ATL,117,2,3,5,4
1978-10-25,SDC,125,3,5,MIL,116,3,3,6,8
1978-10-25,DET,110,0,5,CLE,105,4,0,4,5
1978-10-25,NJN,121,3,4,GOS,118,2,3,5,7
1978-10-25,DEN,108,4,1,PHX,104,5,1,9,2
1978-10-25,SEA,121,5,0,WAS,92,4,1,9,1
1978-10-25,HOU,106,4,1,NYK,101,3,2,7,3
1978-10-26,NOJ,123,2,5,NYK,111,3,3,5,8
1978-10-27,GOS,102,2,4,WAS,83,4,2,6,6
1978-10-27,NJN,123,4,4,CLE,108,4,1,8,5
1978-10-27,CHI,110,1,5,PHX,115,5,2,6,7
1978-10-27,DET,107,1,5,KCK,102,3,3,4,8
1978-10-27,IND,112,2,2,DEN,99,5,1,7,3
1978-10-27,LAL,113,1,4,SDC,101,4,5,5,9
1978-10-27,SEA,80,6,0,MIL,79,3,4,9,4
1978-10-28,NYK,111,3,4,IND,106,3,2,6,6
1978-10-28,SAN,150,4,3,DET,126,2,5,6,8
1978-10-28,NJN,111,5,4,BOS,109,1,5,6,9
1978-10-28,ATL,116,2,4,CHI,92,1,6,3,10
1978-10-28,HOU,99,5,1,PHL,101,4,1,9,2
1978-10-28,POR,106,2,4,MIL,95,3,5,5,9
1978-10-28,KCK,112,3,4,PHX,102,6,2,9,6
1978-10-29,LAL,109,2,4,WAS,93,4,3,6,7
1978-10-29,CLE,94,4,2,GOS,99,3,4,7,6
1978-10-29,SDC,103,4,6,SEA,100,7,0,11,6
1978-10-29,DEN,134,5,2,HOU,121,5,2,10,4
1978-10-31,NOJ,97,3,5,CHI,92,1,7,4,12
1978-10-31,POR,112,3,4,DET,96,2,6,5,10
1978-10-31,CLE,114,4,3,IND,119,3,3,7,6
1978-10-31,MIL,114,3,6,KCK,112,4,4,7,10
1978-10-31,PHX,120,6,3,NYK,108,4,4,10,7
1978-10-31,WAS,108,4,4,ATL,110,3,4,7,8
1978-10-31,LAL,134,3,4,DEN,107,6,2,9,6
1978-10-31,SAN,138,5,3,GOS,139,4,4,9,7
1978-11-01,BOS,118,1,6,CHI,112,1,8,2,14
1978-11-01,KCK,122,4,5,CLE,107,4,4,8,9
1978-11-01,HOU,105,5,3,GOS,112,5,4,10,7
1978-11-01,IND,113,4,3,WAS,124,4,5,8,8
1978-11-01,PHL,116,5,1,SAN,115,5,4,10,5
1978-11-01,NJN,131,6,4,MIL,110,4,6,10,10
1978-11-02,SDC,122,5,6,NYK,127,4,5,9,11
1978-11-02,DET,94,2,7,SEA,95,7,1,9,8
1978-11-02,NOJ,99,4,5,PHX,106,7,3,11,8
1978-11-02,ATL,106,4,4,GOS,113,6,4,10,8
1978-11-03,PHL,118,6,1,MIL,103,4,7,10,8
1978-11-03,LAL,147,4,4,NYK,124,5,5,9,9
1978-11-03,IND,115,4,4,KCK,108,5,5,9,9
1978-11-03,POR,119,4,4,SDC,98,5,7,9,11
1978-11-03,DEN,110,6,3,CLE,93,4,5,10,8
1978-11-03,CHI,93,1,9,DET,99,2,8,3,17
1978-11-03,NJN,81,7,4,SEA,102,8,1,15,5
1978-11-03,BOS,103,2,6,SAN,110,5,5,7,11
1978-11-04,MIL,108,4,8,NOJ,116,4,6,8,14
1978-11-04,HOU,110,5,4,PHX,103,8,3,13,7
1978-11-04,CHI,97,1,10,IND,84,5,4,6,14
1978-11-04,DET,95,3,8,GOS,103,7,4,10,12
1978-11-04,WAS,124,5,5,SAN,119,6,5,11,10
1978-11-04,KCK,109,5,6,DEN,107,7,3,12,9
1978-11-04,ATL,117,4,5,NJN,118,7,5,11,10
1978-11-04,SDC,106,5,8,CLE,112,4,6,9,14
1978-11-05,POR,111,5,4,NYK,96,5,6,10,10
1978-11-05,LAL,117,5,4,CLE,107,5,6,10,10
1978-11-07,MIL,125,4,9,BOS,108,2,7,6,16
1978-11-07,WAS,143,6,5,POR,103,6,4,12,9
1978-11-07,NOJ,115,5,6,SDC,121,5,9,10,15
1978-11-07,CHI,111,2,10,LAL,112,6,4,8,14
1978-11-08,SAN,163,6,6,SDC,125,6,9,12,15
1978-11-08,PHX,118,8,4,CLE,96,5,7,13,11
1978-11-08,PHL,123,7,1,NJN,117,8,5,15,6
1978-11-08,GOS,97,8,4,KCK,105,6,6,14,10
1978-11-08,DET,117,3,9,MIL,106,5,9,8,18
1978-11-08,BOS,109,2,8,POR,112,6,5,8,13
1978-11-08,SEA,100,9,1,NYK,104,5,7,14,8
1978-11-08,IND,111,5,5,LAL,113,7,4,12,9
1978-11-09,DEN,116,7,4,NYK,109,6,7,13,11
1978-11-09,ATL,125,4,6,SDC,101,6,10,10,16
1978-11-10,LAL,136,8,4,KCK,127,7,6,15,10
1978-11-10,GOS,116,8,5,IND,111,5,6,13,11
1978-11-10,DET,115,4,9,CHI,101,2,11,6,20
1978-11-10,NJN,91,8,6,POR,86,7,5,15,11
1978-11-10,NOJ,113,5,7,SAN,102,7,6,12,13
1978-11-10,SEA,109,9,2,CLE,95,5,8,14,10
1978-11-10,WAS,122,7,5,PHL,123,8,1,15,6
1978-11-10,PHX,132,9,4,DEN,150,8,4,17,8
1978-11-10,MIL,131,5,10,HOU,126,6,4,11,14
1978-11-10,BOS,103,2,9,ATL,115,5,6,7,15
1978-11-11,DEN,113,9,4,KCK,117,7,7,16,11
1978-11-11,NYK,111,6,8,BOS,98,2,10,8,18
1978-11-11,HOU,136,6,5,SDC,123,6,11,12,16
1978-11-11,ATL,102,6,6,MIL,95,6,10,12,16
1978-11-11,SAN,143,7,7,WAS,124,7,6,14,13
1978-11-11,PHL,135,9,1,DET,112,5,9,14,10
1978-11-11,CHI,112,2,12,NJN,125,9,6,11,18
1978-11-12,PHX,128,9,5,NOJ,122,6,7,15,12
1978-11-12,LAL,134,9,4,IND,106,5,7,14,11
1978-11-12,BOS,123,2,11,DET,128,5,10,7,21
1978-11-12,POR,98,7,6,CLE,91,5,9,12,15
1978-11-14,NJN,124,10,6,PHL,108,10,1,20,7
1978-11-14,SDC,109,6,12,IND,106,5,8,11,20
1978-11-14,POR,123,8,6,NOJ,103,6,8,14,14
1978-11-14,MIL,119,6,11,LAL,137,10,4,16,15
1978-11-14,CLE,106,5,10,WAS,122,7,7,12,17
1978-11-14,NYK,106,7,8,DEN,100,9,5,16,13
1978-11-15,DET,126,6,10,LAL,133,11,4,17,14
1978-11-15,SEA,135,10,2,NOJ,118,6,9,16,11
1978-11-15,SAN,119,8,7,PHX,125,10,5,18,12
1978-11-15,KCK,109,8,7,ATL,100,7,6,15,13
1978-11-15,WAS,138,8,7,MIL,111,6,12,14,19
1978-11-15,PHL,109,10,2,DEN,103,9,6,19,8
1978-11-15,HOU,103,7,5,CHI,117,2,13,9,18
1978-11-16,SDC,112,7,12,GOS,109,9,5,16,17
1978-11-16,CLE,93,5,11,NYK,97,8,8,13,19
1978-11-17,PHL,95,11,2,PHX,94,11,5,22,7
1978-11-17,SEA,126,11,2,IND,115,5,9,16,11
1978-11-17,NJN,94,11,6,WAS,143,9,7,20,13
1978-11-17,BOS,120,2,12,DEN,118,9,7,11,19
1978-11-17,GOS,89,9,6,CHI,100,3,13,12,19
1978-11-17,LAL,121,12,4,NOJ,109,6,10,18,14
1978-11-18,WAS,119,10,7,DEN,114,9,8,19,15
1978-11-18,POR,123,9,6,IND,111,5,10,14,16
1978-11-18,CLE,90,5,12,BOS,92,3,12,8,24
1978-11-18,DET,105,6,11,PHX,119,11,6,17,17
1978-11-18,SDC,114,8,12,NOJ,111,6,11,14,23
1978-11-18,GOS,112,9,7,SEA,104,12,2,21,9
1978-11-18,ATL,124,7,7,PHL,116,12,2,19,9
1978-11-18,NYK,102,9,8,MIL,100,6,13,15,21
1978-11-18,HOU,126,7,6,SAN,120,8,8,15,14
1978-11-18,KCK,114,9,7,NJN,100,11,7,20,14
1978-11-19,SEA,88,12,3,POR,85,10,6,22,9
1978-11-19,LAL,104,13,4,CHI,95,4,13,17,17
1978-11-21,MIL,123,6,14,POR,93,10,7,16,21
1978-11-21,CLE,108,5,13,PHX,110,12,6,17,19
1978-11-21,NYK,96,10,8,DET,79,6,12,16,20
1978-11-21,PHL,105,12,3,GOS,115,10,7,22,10
1978-11-21,SDC,107,9,12,ATL,113,8,7,17,19
1978-11-21,SAN,103,8,9,IND,108,5,11,13,20
1978-11-21,NOJ,140,6,12,NJN,118,11,8,17,20
1978-11-22,HOU,114,8,6,LAL,121,14,4,22,10
1978-11-22,IND,110,6,11,PHX,115,13,6,19,17
1978-11-22,DEN,111,9,9,ATL,113,9,7,18,16
1978-11-22,KCK,115,10,7,POR,96,10,8,20,15
1978-11-22,BOS,103,4,12,WAS,119,11,7,15,19
1978-11-22,SEA,98,13,3,CHI,96,4,14,17,17
1978-11-22,NJN,100,11,9,GOS,92,11,7,22,16
1978-11-23,MIL,114,7,14,SAN,116,8,10,15,24
1978-11-23,NOJ,106,7,12,GOS,98,11,8,18,20
1978-11-24,POR,99,10,9,CHI,100,4,15,14,24
1978-11-24,IND,98,6,12,CLE,104,5,14,11,26
1978-11-24,WAS,113,12,7,LAL,103,15,4,27,11
1978-11-24,PHX,120,14,6,HOU,113,8,7,22,13
1978-11-24,PHL,134,12,4,SDC,120,9,13,21,17
1978-11-24,SEA,100,14,3,DEN,103,9,10,23,13
1978-11-24,DET,119,6,13,ATL,117,10,7,16,20
1978-11-24,NJN,103,12,9,NOJ,100,8,12,20,21
1978-11-24,BOS,109,27,53,NYK,98,31,49,58,102
1978-11-25,KCK,86,11,7,SDC,87,9,14,20,21
1978-11-25,SAN,151,9,10,NJN,110,13,9,22,19
1978-11-25,ATL,109,10,8,LAL,103,15,5,25,13
1978-11-25,MIL,127,7,15,PHL,126,13,4,20,19
1978-11-25,NYK,103,11,8,NOJ,96,8,13,19,21
1978-11-25,POR,127,10,10,HOU,105,8,8,18,18
1978-11-25,DEN,104,10,10,SEA,110,14,4,24,14
1978-11-26,PHX,125,15,6,CHI,109,5,15,20,21
1978-11-26,SEA,103,15,4,HOU,108,8,9,23,13
1978-11-26,SDC,105,10,14,BOS,103,4,13,14,27
1978-11-26,IND,114,6,13,MIL,112,8,15,14,28
1978-11-26,WAS,110,13,7,GOS,102,11,9,24,16
1978-11-28,CHI,124,5,16,PHX,112,16,6,21,22
1978-11-28,MIL,117,8,16,DEN,100,10,11,18,27
1978-11-28,CLE,112,6,14,ATL,98,11,8,17,22
1978-11-28,LAL,103,15,6,DET,105,7,13,22,19
1978-11-28,NYK,106,12,8,WAS,133,14,7,26,15
1978-11-28,NOJ,107,8,14,PHL,103,13,5,21,19
1978-11-28,POR,102,11,10,BOS,97,4,14,15,24
1978-11-29,SEA,125,15,5,NJN,111,13,10,28,15
1978-11-29,GOS,109,11,10,HOU,94,9,9,20,19
1978-11-29,SAN,114,10,10,PHL,120,13,6,23,16
1978-11-29,IND,101,7,13,NYK,99,12,9,19,22
1978-11-30,KCK,108,11,8,BOS,94,4,15,15,23
1978-11-30,ATL,102,11,9,NYK,96,12,10,23,19
1978-11-30,NOJ,111,9,14,DEN,105,10,12,19,26
1978-11-30,PHX,119,16,7,DET,109,8,13,24,20
1978-11-30,CLE,97,7,14,POR,98,12,10,19,24
1978-11-30,SDC,104,11,14,HOU,113,9,10,20,24
1978-12-01,LAL,130,15,7,PHX,122,17,7,32,14
1978-12-01,GOS,110,12,10,NJN,120,13,11,25,21
1978-12-01,DEN,125,10,13,DET,120,8,14,18,27
1978-12-01,NOJ,115,10,14,WAS,117,15,7,25,21
1978-12-01,MIL,111,9,16,IND,107,8,13,17,29
1978-12-01,BOS,87,28,53,SEA,80,51,29,79,82
1978-12-02,CLE,100,7,15,MIL,106,10,16,17,31
1978-12-02,WAS,109,16,7,KCK,110,12,8,28,15
1978-12-02,PHL,97,14,6,SEA,100,16,5,30,11
1978-12-02,IND,110,8,14,BOS,117,4,16,12,30
1978-12-02,SAN,93,10,11,DEN,104,11,13,21,24
1978-12-02,CHI,105,6,16,HOU,91,10,10,16,26
1978-12-02,PHX,108,17,8,GOS,116,12,11,29,19
1978-12-02,SDC,113,11,15,DET,120,8,15,19,30
1978-12-02,NYK,111,12,11,POR,77,13,10,25,21
1978-12-02,ATL,128,12,9,NOJ,94,10,15,22,24
1978-12-03,LAL,105,16,7,NJN,107,14,11,30,18
1978-12-05,NOJ,102,10,16,LAL,114,16,8,26,24
1978-12-05,DET,112,9,15,BOS,114,5,16,14,31
1978-12-05,NYK,92,13,11,KCK,105,13,8,26,19
1978-12-05,WAS,117,16,8,CLE,102,7,16,23,24
1978-12-05,CHI,96,7,16,PHL,91,14,7,21,23
1978-12-06,HOU,96,10,11,WAS,101,17,8,27,19
1978-12-06,GOS,118,13,11,MIL,111,11,16,24,27
1978-12-06,PHX,136,17,9,ATL,109,13,9,30,18
1978-12-06,SAN,112,10,12,LAL,111,17,8,27,20
1978-12-06,KCK,106,14,8,PHL,114,14,8,28,16
1978-12-06,IND,115,8,15,POR,109,13,11,21,26
1978-12-06,BOS,117,6,16,SDC,111,11,16,17,32
1978-12-06,DEN,92,12,13,NJN,83,15,11,27,24
1978-12-07,DET,121,9,16,CLE,105,7,17,16,33
1978-12-08,LAL,101,17,9,MIL,85,11,17,28,26
1978-12-08,WAS,100,18,8,NJN,108,15,12,33,20
1978-12-08,CHI,100,8,16,POR,99,13,12,21,28
1978-12-08,SEA,107,17,5,ATL,106,13,10,30,15
1978-12-08,IND,114,9,15,DET,107,10,16,19,31
1978-12-08,BOS,104,7,16,PHX,124,18,9,25,25
1978-12-08,GOS,105,14,11,SAN,123,11,12,25,23
1978-12-08,NOJ,106,10,17,HOU,110,10,12,20,29
1978-12-09,WAS,101,18,9,PHX,98,19,9,37,18
1978-12-09,DEN,113,13,13,MIL,103,11,18,24,31
1978-12-09,NYK,96,13,12,CHI,101,9,16,22,28
1978-12-09,GOS,94,14,12,ATL,84,13,11,27,23
1978-12-09,CLE,115,7,18,PHL,107,15,8,22,26
1978-12-09,NJN,125,16,12,SDC,120,11,17,27,29
1978-12-09,KCK,132,14,9,DET,108,10,17,24,26
1978-12-09,HOU,116,11,12,POR,110,13,13,24,25
1978-12-10,LAL,88,18,9,ATL,86,13,12,31,21
1978-12-10,MIL,106,11,19,SDC,107,11,18,22,37
1978-12-10,SEA,112,18,5,SAN,99,12,12,30,17
1978-12-12,NYK,103,13,13,SDC,105,12,18,25,31
1978-12-12,CHI,99,10,16,GOS,94,15,12,25,28
1978-12-12,HOU,112,12,12,BOS,105,7,17,19,29
1978-12-12,CLE,127,8,18,DET,110,10,18,18,36
1978-12-12,POR,117,13,14,LAL,115,19,9,32,23
1978-12-12,MIL,120,11,20,PHX,114,19,10,30,30
1978-12-12,NOJ,109,10,18,IND,103,10,15,20,33
1978-12-12,DEN,107,14,13,SAN,103,12,13,26,26
1978-12-13,BOS,102,7,18,NOJ,96,11,18,18,36
1978-12-13,SEA,117,19,5,LAL,107,19,10,38,15
1978-12-13,PHL,120,15,9,KCK,100,15,9,30,18
1978-12-13,SAN,139,12,14,NYK,109,13,14,25,28
1978-12-13,WAS,134,19,9,SDC,117,13,18,32,27
1978-12-13,ATL,117,13,13,IND,101,10,16,23,29
1978-12-14,HOU,126,13,12,GOS,123,15,13,28,25
1978-12-15,NJN,104,17,12,ATL,121,14,13,31,25
1978-12-15,LAL,100,19,11,SEA,98,20,5,39,16
1978-12-15,MIL,106,12,20,CLE,110,9,18,21,38
1978-12-15,BOS,101,8,18,KCK,105,15,10,23,28
1978-12-15,DET,114,10,19,WAS,116,20,9,30,28
1978-12-15,DEN,113,15,13,POR,116,14,14,29,27
1978-12-15,IND,113,10,17,SAN,125,13,14,23,31
1978-12-15,CHI,94,11,16,NYK,118,13,15,24,31
1978-12-15,PHL,91,16,9,HOU,84,14,12,30,21
1978-12-16,KCK,128,16,10,NOJ,100,11,19,27,29
1978-12-16,PHX,119,19,11,LAL,100,20,11,39,22
1978-12-16,SAN,104,14,14,GOS,96,15,14,29,28
1978-12-16,CHI,108,11,17,CLE,100,10,18,21,35
1978-12-16,WAS,125,21,9,BOS,117,8,19,29,28
1978-12-17,NOJ,96,11,20,GOS,104,15,15,26,35
1978-12-17,LAL,96,20,12,PHL,103,17,9,37,21
1978-12-17,NYK,111,14,15,ATL,105,15,13,29,28
1978-12-17,MIL,117,12,21,CHI,101,12,17,24,38
1978-12-17,SDC,116,13,19,PHX,110,20,11,33,30
1978-12-17,POR,123,15,14,DEN,110,15,14,30,28
1978-12-17,CLE,101,10,19,SEA,91,20,6,30,25
1978-12-19,CLE,106,11,19,SAN,113,15,14,26,33
1978-12-19,CHI,101,12,18,ATL,95,15,14,27,32
1978-12-19,SDC,113,14,19,PHL,124,18,9,32,28
1978-12-19,NYK,130,15,15,IND,102,10,18,25,33
1978-12-19,MIL,128,13,21,SEA,99,20,7,33,28
1978-12-20,NJN,105,17,13,HOU,108,14,13,31,26
1978-12-20,PHX,129,20,12,WAS,137,22,9,42,21
1978-12-20,DEN,121,15,15,NOJ,112,11,21,26,36
1978-12-20,SAN,131,16,14,CHI,102,13,18,29,32
1978-12-20,GOS,85,16,15,PHL,81,19,9,35,24
1978-12-20,KCK,114,17,10,SEA,95,20,8,37,18
1978-12-20,BOS,121,8,20,IND,105,10,19,18,39
1978-12-20,ATL,121,15,15,NYK,112,16,15,31,30
1978-12-21,CLE,101,11,20,HOU,90,15,13,26,33
1978-12-21,DET,121,10,20,IND,108,10,20,20,40
1978-12-22,PHX,123,20,13,KCK,103,18,10,38,23
1978-12-22,CHI,92,13,19,SAN,103,17,14,30,33
1978-12-22,SEA,95,20,9,PHL,103,19,10,39,19
1978-12-22,GOS,103,17,15,DEN,107,16,15,33,30
1978-12-22,BOS,124,9,20,ATL,105,16,15,25,35
1978-12-22,LAL,127,20,13,WAS,115,23,9,43,22
1978-12-23,MIL,117,14,21,KCK,122,18,11,32,32
1978-12-23,ATL,109,16,16,CLE,91,12,20,28,36
1978-12-23,DET,126,11,20,SAN,130,18,14,29,34
1978-12-23,IND,127,10,21,NOJ,103,11,22,21,43
1978-12-23,HOU,129,15,14,NYK,107,16,16,31,30
1978-12-23,POR,114,16,14,WAS,109,23,10,39,24
1978-12-25,SEA,118,20,10,SDC,123,14,20,34,30
1978-12-25,NYK,94,16,17,PHL,109,20,10,36,27
1978-12-25,POR,115,17,14,GOS,102,17,16,34,30
1978-12-26,KCK,102,19,11,HOU,109,16,14,35,25
1978-12-26,LAL,123,21,13,NOJ,125,11,23,32,36
1978-12-26,SDC,115,15,20,CHI,109,13,20,28,40
1978-12-26,MIL,143,14,22,DET,84,11,21,25,43
1978-12-26,SAN,124,19,14,ATL,111,17,16,36,30
1978-12-26,WAS,108,23,11,IND,104,11,21,34,32
1978-12-26,DEN,102,17,15,PHX,106,21,13,38,28
1978-12-27,PHL,122,21,10,IND,110,11,22,32,32
1978-12-27,SEA,122,20,11,NOJ,103,12,23,32,34
1978-12-27,DET,131,11,22,HOU,119,17,14,28,36
1978-12-27,NJN,104,17,14,NYK,115,16,18,33,32
1978-12-27,GOS,104,17,17,LAL,106,21,14,38,31
1978-12-27,ATL,115,17,17,SAN,107,20,14,37,31
1978-12-27,KCK,103,19,12,BOS,112,10,20,29,32
1978-12-28,NYK,109,17,18,WAS,99,24,11,41,29
1978-12-28,DEN,107,17,16,CHI,111,13,21,30,37
1978-12-28,CLE,116,12,21,SDC,114,16,20,28,41
1978-12-28,SAN,112,20,15,MIL,103,15,22,35,37
1978-12-28,PHX,129,22,13,POR,127,18,14,40,27
1978-12-29,SEA,119,21,11,PHX,92,23,13,44,24
1978-12-29,NJN,126,17,15,KCK,137,19,13,36,28
1978-12-29,GOS,118,17,18,NOJ,106,12,24,29,42
1978-12-29,PHL,113,22,10,ATL,107,18,17,40,27
1978-12-29,LAL,118,22,14,POR,95,18,15,40,29
1978-12-29,HOU,106,17,15,MIL,103,15,23,32,38
1978-12-29,CHI,123,14,21,DEN,117,17,17,31,38
1978-12-29,DET,107,12,22,SDC,111,16,21,28,43
1978-12-30,PHL,94,23,10,SAN,100,21,15,44,25
1978-12-30,HOU,112,18,15,DET,101,12,23,30,38
1978-12-30,ATL,113,18,18,DEN,87,17,18,35,36
1978-12-30,PHX,112,23,14,BOS,109,11,20,34,34
1978-12-30,IND,111,11,23,SDC,114,17,21,28,44
1978-12-30,NYK,112,18,18,KCK,108,20,13,38,31
1978-12-30,CLE,104,13,21,NJN,94,17,16,30,37
1979-01-01,SEA,97,22,11,GOS,110,18,18,40,29
1979-01-02,KCK,97,20,14,DEN,99,17,19,37,33
1979-01-02,WAS,109,24,12,CHI,86,15,22,39,34
1979-01-02,POR,108,18,16,SEA,109,22,12,40,28
1979-01-02,NOJ,109,12,25,LAL,105,23,14,35,39
1979-01-02,NYK,102,19,18,PHX,114,24,14,43,32
1979-01-02,CLE,113,14,21,MIL,116,15,24,29,45
1979-01-02,SDC,137,18,21,DET,119,12,24,30,45
1979-01-03,GOS,96,19,18,DET,81,12,25,31,43
1979-01-03,ATL,96,19,18,LAL,99,23,15,42,33
1979-01-03,HOU,127,19,15,NJN,122,17,17,36,32
1979-01-03,DEN,101,18,19,KCK,108,20,15,38,34
1979-01-03,MIL,102,16,24,IND,108,11,24,27,48
1979-01-03,PHL,111,24,11,CHI,98,15,23,39,34
1979-01-03,SEA,123,23,12,BOS,116,11,21,34,33
1979-01-03,SAN,123,22,15,NOJ,97,13,25,35,40
1979-01-04,KCK,108,21,15,SDC,99,19,21,40,36
1979-01-04,CLE,117,14,22,NYK,103,19,19,33,41
1979-01-04,NOJ,112,13,26,NJN,125,17,18,30,44
1979-01-05,IND,123,12,24,PHL,96,25,11,37,35
1979-01-05,HOU,106,20,15,ATL,109,19,19,39,34
1979-01-05,SEA,92,24,12,DEN,95,18,20,42,32
1979-01-05,WAS,104,25,12,PHX,94,25,14,50,26
1979-01-05,CHI,124,15,24,MIL,119,16,25,31,49
1979-01-05,GOS,113,20,18,BOS,98,11,22,31,40
1979-01-05,NJN,104,18,18,SAN,110,23,15,41,33
1979-01-05,POR,98,18,17,DET,96,12,26,30,43
1979-01-06,MIL,104,16,26,SDC,93,19,22,35,48
1979-01-06,KCK,120,22,15,IND,99,13,24,35,39
1979-01-06,ATL,102,20,19,WAS,106,26,12,46,31
1979-01-06,DEN,127,19,20,BOS,98,11,23,30,43
1979-01-06,PHL,139,25,12,PHX,143,25,15,50,27
1979-01-06,HOU,115,20,16,LAL,112,24,15,44,31
1979-01-06,NYK,108,19,20,SAN,105,24,15,43,35
1979-01-06,NOJ,94,13,27,CLE,105,15,22,28,49
1979-01-07,NJN,117,18,19,PHX,112,26,15,44,34
1979-01-07,CLE,112,16,22,GOS,108,21,18,37,40
1979-01-07,IND,112,13,25,ATL,97,20,20,33,45
1979-01-08,MIL,116,17,26,HOU,104,21,16,38,42
1979-01-09,NOJ,107,13,28,SDC,114,19,23,32,51
1979-01-09,POR,104,19,17,IND,112,14,25,33,42
1979-01-09,HOU,126,21,17,KCK,110,23,15,44,32
1979-01-09,NYK,94,20,20,LAL,106,24,16,44,36
1979-01-09,CHI,101,16,24,GOS,103,21,19,37,43
1979-01-09,DEN,121,20,20,WAS,90,27,12,47,32
1979-01-09,SAN,116,24,16,DET,114,12,27,36,43
1979-01-10,BOS,89,11,24,LAL,99,25,16,36,40
1979-01-10,MIL,113,18,26,ATL,117,20,21,38,47
1979-01-10,SEA,118,24,13,IND,98,15,25,39,38
1979-01-10,PHL,123,25,13,NOJ,112,13,29,38,42
1979-01-10,NJN,116,19,19,CHI,120,16,25,35,44
1979-01-11,SAN,140,25,16,SDC,111,20,23,45,39
1979-01-11,KCK,94,23,16,GOS,89,22,19,45,35
1979-01-11,PHX,106,26,16,SEA,109,25,13,51,29
1979-01-11,DET,104,12,28,POR,101,19,18,31,46
1979-01-12,BOS,128,11,25,POR,125,19,19,30,44
1979-01-12,CHI,93,17,25,ATL,100,21,21,38,46
1979-01-12,DEN,126,21,20,NYK,119,20,21,41,41
1979-01-12,HOU,107,22,17,CLE,96,17,22,39,39
1979-01-12,NOJ,100,13,30,PHL,89,26,13,39,43
1979-01-12,NJN,116,19,20,LAL,117,26,16,45,36
1979-01-12,MIL,101,18,27,GOS,94,22,20,40,47
1979-01-13,DET,114,13,28,GOS,109,22,21,35,49
1979-01-13,HOU,117,23,17,NOJ,106,14,30,37,47
1979-01-13,SAN,117,26,16,CLE,103,17,23,43,39
1979-01-13,ATL,124,22,21,SDC,119,20,24,42,45
1979-01-13,PHX,99,26,17,IND,102,15,26,41,43
1979-01-14,ATL,115,23,21,HOU,105,24,17,47,38
1979-01-14,BOS,100,12,25,NJN,110,19,21,31,46
1979-01-14,KCK,124,24,16,NYK,104,20,22,44,38
1979-01-14,DEN,111,22,20,IND,109,16,26,38,46
1979-01-14,MIL,104,19,27,CHI,99,17,26,36,53
1979-01-14,PHL,112,26,14,POR,106,19,20,45,34
1979-01-14,WAS,125,27,13,SDC,91,20,25,47,38
1979-01-14,SEA,99,26,13,LAL,108,27,16,53,29
1979-01-16,NYK,111,20,23,DET,110,14,28,34,51
1979-01-16,NOJ,100,14,31,DEN,104,23,20,37,51
1979-01-17,NJN,106,20,21,DET,99,14,29,34,50
1979-01-17,BOS,99,12,26,KCK,120,25,16,37,42
1979-01-17,WAS,112,28,13,NOJ,102,14,32,42,45
1979-01-17,SDC,119,20,26,LAL,117,28,16,48,42
1979-01-17,IND,102,16,27,SEA,112,26,14,42,41
1979-01-17,MIL,123,20,27,PHX,118,26,18,46,45
1979-01-17,PHL,107,27,14,CLE,94,17,24,44,38
1979-01-17,ATL,111,24,21,POR,110,19,21,43,42
1979-01-17,SAN,119,27,16,DEN,101,24,20,51,36
1979-01-17,GOS,103,22,22,HOU,104,24,18,46,40
1979-01-18,DET,87,14,30,PHX,97,26,19,40,49
1979-01-19,LAL,121,28,17,HOU,122,25,18,53,35
1979-01-19,KCK,115,26,16,SAN,113,28,16,54,32
1979-01-19,IND,98,16,28,DEN,101,24,21,40,49
1979-01-19,NOJ,107,14,33,POR,101,19,22,33,55
1979-01-19,NYK,105,21,23,CLE,101,17,25,38,48
1979-01-19,BOS,103,12,27,MIL,102,21,27,33,54
1979-01-19,CHI,102,17,27,WAS,113,29,13,46,40
1979-01-20,DET,122,14,31,KCK,110,27,16,41,47
1979-01-20,CHI,101,17,28,SEA,107,27,14,44,42
1979-01-20,WAS,109,30,13,IND,104,16,29,46,42
1979-01-20,PHX,116,27,19,HOU,97,26,18,53,37
1979-01-20,SAN,113,28,17,POR,118,19,23,47,40
1979-01-20,PHL,102,28,14,BOS,108,13,27,41,41
1979-01-20,DEN,109,25,21,GOS,106,22,23,47,44
1979-01-20,NOJ,94,16,33,ATL,118,25,22,41,55
1979-01-21,ATL,87,25,21,NOJ,108,15,33,40,54
1979-01-21,BOS,87,14,27,PHL,91,28,15,42,42
1979-01-21,CLE,94,17,26,CHI,93,17,29,34,55
1979-01-21,MIL,138,21,28,NYK,114,22,23,43,51
1979-01-21,LAL,113,28,18,GOS,107,22,24,50,42
1979-01-22,DEN,117,26,21,DET,121,15,31,41,52
1979-01-23,NOJ,118,16,34,KCK,116,27,17,43,51
1979-01-23,LAL,148,29,18,NYK,124,22,24,51,42
1979-01-23,CLE,108,18,26,DEN,107,26,22,44,48
1979-01-23,ATL,107,26,22,IND,110,16,30,42,52
1979-01-23,CHI,100,17,30,BOS,90,14,28,31,58
1979-01-23,WAS,100,31,13,SEA,103,28,14,59,27
1979-01-24,HOU,117,26,19,DEN,116,26,23,52,42
1979-01-24,PHX,101,28,19,PHL,94,29,15,57,34
1979-01-24,NJN,114,21,21,CLE,123,19,26,40,47
1979-01-24,SDC,122,21,26,POR,121,20,23,41,49
1979-01-24,SAN,124,28,18,KCK,95,27,18,55,36
1979-01-24,GOS,126,22,25,NYK,123,22,25,44,50
1979-01-24,BOS,106,14,29,WAS,128,31,14,45,43
1979-01-25,DET,135,16,31,LAL,100,30,18,46,49
1979-01-25,ATL,98,26,23,SEA,100,29,14,55,37
1979-01-25,POR,108,20,24,GOS,103,23,25,43,49
1979-01-26,GOS,96,23,26,PHL,105,29,16,52,42
1979-01-26,DEN,119,26,24,LAL,107,30,19,56,43
1979-01-26,NJN,110,21,22,NOJ,104,17,34,38,56
1979-01-26,KCK,142,27,19,WAS,128,32,14,59,33
1979-01-26,PHX,108,29,19,NYK,107,22,26,51,45
1979-01-26,IND,119,17,30,BOS,106,14,30,31,60
1979-01-26,SAN,125,29,18,SEA,108,30,14,59,32
1979-01-26,CHI,91,18,30,SDC,107,22,26,40,56
1979-01-27,ATL,120,26,24,SAN,113,30,18,56,42
1979-01-27,HOU,94,27,19,SEA,99,30,15,57,34
1979-01-27,CLE,110,20,26,SDC,111,23,26,43,52
1979-01-28,PHX,114,30,19,NJN,117,22,22,52,41
1979-01-28,BOS,103,14,31,GOS,102,23,27,37,58
1979-01-28,WAS,122,32,15,NYK,105,22,27,54,42
1979-01-28,POR,116,21,24,PHL,94,30,16,51,40
1979-01-28,LAL,111,30,20,MIL,109,22,28,52,48
1979-01-28,DEN,98,27,24,CHI,87,18,31,45,55
1979-01-28,DET,128,17,31,SDC,118,24,26,41,57
1979-01-28,IND,123,18,30,SAN,110,30,19,48,49
1979-01-28,KCK,137,28,19,CLE,109,20,27,48,46
1979-01-29,NYK,104,22,28,GOS,107,23,28,45,56
1979-01-30,CHI,108,18,32,SAN,112,30,20,48,52
1979-01-30,WAS,109,33,15,ATL,105,27,24,60,39
1979-01-30,IND,112,19,30,HOU,106,27,20,46,50
1979-01-30,LAL,127,31,20,NJN,108,23,22,54,42
1979-01-30,POR,82,22,24,DEN,76,28,24,50,48
1979-01-30,SDC,117,24,27,MIL,113,22,29,46,56
1979-01-31,SEA,115,31,15,POR,112,23,24,54,39
1979-01-31,PHL,106,30,17,GOS,108,24,28,54,45
1979-01-31,ATL,130,27,25,KCK,118,29,19,56,44
1979-01-31,BOS,119,15,31,HOU,102,27,21,42,52
1979-01-31,DET,86,18,31,NYK,108,22,29,40,60
1979-01-31,PHX,123,30,20,MIL,118,22,30,52,50
1979-01-31,SDC,112,25,27,NJN,104,23,23,48,50
1979-02-01,CHI,105,15,21,PHL,128,23,11,38,32
1979-02-01,CLE,116,20,28,DET,120,18,32,38,60
1979-02-01,SEA,107,32,15,NJN,102,23,24,55,39
1979-02-01,SAN,122,31,20,WAS,123,34,15,65,35
1979-02-02,IND,87,20,30,GOS,84,25,28,45,58
1979-02-02,SEA,104,33,15,MIL,102,22,31,55,46
1979-02-02,CHI,116,18,33,NOJ,110,17,35,35,68
1979-02-02,PHX,133,31,20,SAN,108,31,21,62,41
1979-02-02,PHL,101,30,18,NYK,105,23,29,53,47
1979-02-02,BOS,112,16,31,CLE,98,20,29,36,60
1979-02-02,SDC,124,26,27,DEN,100,28,25,54,52
1979-02-02,HOU,106,27,22,WAS,120,35,15,62,37
1979-02-02,KCK,130,29,20,DET,114,19,32,48,52
1979-02-02,POR,117,23,25,NJN,100,23,25,46,50
1979-02-06,HOU,113,27,23,DET,108,19,33,46,56
1979-02-06,ATL,104,28,25,BOS,101,17,31,45,56
1979-02-06,LAL,119,32,20,SAN,111,31,22,63,42
1979-02-06,POR,110,24,25,PHX,93,32,20,56,45
1979-02-06,CHI,110,19,33,IND,107,21,30,40,63
1979-02-06,CLE,119,20,30,NJN,100,23,26,43,56
1979-02-06,NYK,108,24,29,SEA,99,34,15,58,44
1979-02-07,KCK,124,30,20,ATL,108,29,25,59,45
1979-02-07,BOS,107,17,32,SEA,100,34,16,51,48
1979-02-07,DEN,120,28,26,CLE,105,21,30,49,56
1979-02-07,IND,84,21,31,NJN,90,23,27,44,58
1979-02-07,PHL,114,30,19,DET,103,19,34,49,53
1979-02-07,MIL,90,22,32,WAS,96,36,15,58,47
1979-02-07,SDC,113,27,27,SAN,126,31,23,58,50
1979-02-07,NOJ,125,17,36,NYK,123,25,29,42,65
1979-02-07,GOS,104,25,29,LAL,106,33,20,58,49
1979-02-08,HOU,134,28,23,MIL,129,22,33,50,56
1979-02-08,DET,105,19,35,NJN,106,24,27,43,62
1979-02-09,PHL,117,31,19,SDC,106,27,28,58,47
1979-02-09,PHX,102,32,21,ATL,105,29,26,61,47
1979-02-09,CHI,114,20,33,KCK,124,31,20,51,53
1979-02-09,GOS,104,25,30,DEN,106,29,26,54,56
1979-02-09,POR,125,25,25,SAN,106,32,23,57,48
1979-02-09,MIL,118,22,34,SEA,116,34,17,56,51
1979-02-09,BOS,112,18,32,IND,101,21,32,39,64
1979-02-09,LAL,106,34,20,CLE,103,21,31,55,51
1979-02-09,NOJ,99,18,36,HOU,106,29,23,47,59
1979-02-10,NYK,102,25,30,BOS,106,19,32,44,62
1979-02-10,DET,105,19,36,NOJ,107,18,37,37,73
1979-02-10,HOU,113,30,23,SEA,101,34,18,64,41
1979-02-11,PHX,136,32,22,CLE,101,21,32,53,54
1979-02-11,GOS,107,25,31,SAN,125,32,24,57,55
1979-02-11,KCK,104,32,20,LAL,103,35,20,67,40
1979-02-11,PHL,107,32,19,WAS,99,37,15,69,34
1979-02-11,BOS,107,20,32,NYK,102,25,31,45,63
1979-02-11,POR,91,26,25,ATL,87,30,26,56,51
1979-02-11,IND,110,21,33,CHI,108,20,34,41,67
1979-02-11,MIL,126,23,34,DEN,87,30,26,53,60
1979-02-11,NJN,104,25,27,SDC,98,27,29,52,56
1979-02-13,CLE,117,21,33,LAL,111,35,21,56,54
1979-02-13,SDC,136,27,30,WAS,138,37,16,64,46
1979-02-13,POR,120,27,25,NOJ,101,19,37,46,62
1979-02-13,NJN,111,26,27,KCK,102,33,20,59,47
1979-02-13,CHI,94,20,35,DEN,104,30,27,50,62
1979-02-13,HOU,120,31,23,IND,124,22,33,53,56
1979-02-14,SAN,149,33,24,BOS,119,21,32,54,56
1979-02-14,GOS,113,25,32,NOJ,101,19,38,44,70
1979-02-14,DET,111,19,37,DEN,107,31,27,50,64
1979-02-14,MIL,115,24,34,NJN,94,27,27,51,61
1979-02-14,SEA,116,34,19,ATL,104,30,27,64,46
1979-02-14,PHL,106,33,19,KCK,108,33,21,66,40
1979-02-14,IND,106,23,33,NYK,97,25,32,48,65
1979-02-15,PHX,119,33,22,WAS,108,38,16,71,38
1979-02-15,HOU,119,31,24,POR,116,28,25,59,49
1979-02-15,CLE,113,22,33,PHL,100,33,20,55,53
1979-02-15,SDC,122,27,31,NOJ,112,19,39,46,70
1979-02-16,CHI,107,20,36,NYK,104,25,33,45,69
1979-02-16,DEN,104,31,28,SDC,118,28,31,59,59
1979-02-16,NJN,100,27,28,IND,105,24,33,51,61
1979-02-16,DET,110,20,37,HOU,96,32,24,52,61
1979-02-16,SAN,121,34,24,POR,120,28,26,62,50
1979-02-16,GOS,109,26,32,WAS,103,38,17,64,49
1979-02-16,SEA,119,35,19,PHX,104,34,22,69,41
1979-02-16,KCK,119,34,21,PHL,104,33,21,67,42
1979-02-16,MIL,99,25,34,LAL,98,35,22,60,56
1979-02-17,NYK,117,25,34,CLE,127,23,33,48,67
1979-02-17,PHX,136,34,23,NOJ,112,19,40,53,63
1979-02-18,POR,111,28,27,BOS,104,21,33,49,60
1979-02-18,DEN,115,31,29,NOJ,112,19,41,50,70
1979-02-18,SDC,116,29,31,ATL,101,30,28,59,59
1979-02-18,DET,124,21,37,SAN,104,35,24,56,61
1979-02-18,PHL,110,33,22,MIL,107,26,34,59,56
1979-02-18,IND,111,25,33,LAL,122,35,23,60,56
1979-02-18,NJN,126,27,29,HOU,124,32,25,59,54
1979-02-18,KCK,130,35,21,CHI,107,21,36,56,57
1979-02-18,SEA,94,36,19,WAS,105,38,18,74,37
1979-02-20,NYK,107,25,35,PHX,117,35,23,60,58
1979-02-20,CLE,109,24,33,ATL,119,30,29,54,62
1979-02-20,SAN,118,35,25,SEA,102,36,20,71,45
1979-02-20,CHI,99,21,37,POR,97,29,27,50,64
1979-02-20,LAL,91,36,23,GOS,102,27,32,63,55
1979-02-21,DEN,114,32,29,IND,109,25,34,57,63
1979-02-21,ATL,106,31,29,POR,83,29,28,60,57
1979-02-21,DET,106,22,37,PHL,99,34,22,56,59
1979-02-21,KCK,133,36,21,MIL,117,26,35,62,56
1979-02-21,NOJ,94,19,42,SEA,96,36,21,55,63
1979-02-21,NJN,123,28,29,PHX,112,36,23,64,52
1979-02-21,GOS,97,28,32,BOS,101,21,34,49,66
1979-02-22,WAS,110,39,18,HOU,120,32,26,71,44
1979-02-22,CLE,111,24,34,KCK,107,37,21,61,55
1979-02-23,NJN,110,29,29,POR,99,29,29,58,58
1979-02-23,WAS,132,39,19,SEA,110,37,21,76,40
1979-02-23,NOJ,111,19,43,CHI,102,22,37,41,80
1979-02-23,SDC,117,30,31,PHL,116,34,23,64,54
1979-02-23,KCK,121,37,22,PHX,112,36,24,73,46
1979-02-23,GOS,94,28,33,IND,96,25,35,53,68
1979-02-23,LAL,113,36,24,BOS,104,22,34,58,58
1979-02-24,ATL,110,32,29,PHX,85,36,25,68,54
1979-02-24,DEN,132,33,29,MIL,117,26,36,59,65
1979-02-24,NYK,111,25,36,NJN,107,30,29,55,65
1979-02-25,SDC,131,31,31,BOS,116,22,35,53,66
1979-02-25,LAL,118,37,24,IND,108,26,35,63,59
1979-02-25,DEN,111,34,29,PHL,119,34,24,68,53
1979-02-25,CHI,108,22,38,CLE,117,25,34,47,72
1979-02-25,NJN,116,30,30,NYK,102,26,36,56,66
1979-02-25,DET,119,23,37,POR,126,29,30,52,67
1979-02-25,KCK,114,38,22,SEA,106,37,22,75,44
1979-02-25,SAN,127,36,25,HOU,107,33,26,69,51
1979-02-25,WAS,99,40,19,GOS,89,28,34,68,53
1979-02-27,POR,118,30,30,PHL,115,35,24,65,54
1979-02-27,LAL,122,38,24,KCK,114,39,22,77,46
1979-02-27,NYK,101,26,37,GOS,99,28,35,54,72
1979-02-27,CHI,124,22,39,DET,117,23,38,45,77
1979-02-27,ATL,125,33,29,HOU,111,33,27,66,56
1979-02-27,DEN,121,34,30,SEA,106,37,23,71,53
1979-02-27,SDC,124,32,31,IND,107,26,36,58,67
1979-02-28,SDC,122,33,31,KCK,120,39,23,72,54
1979-02-28,PHX,103,36,26,IND,102,26,37,62,63
1979-02-28,BOS,122,22,36,NOJ,112,20,43,42,79
1979-02-28,SEA,97,37,24,PHL,93,35,25,72,49
1979-02-28,SAN,135,37,25,NYK,112,27,37,64,62
1979-02-28,HOU,122,33,28,DEN,97,35,30,68,58
1979-02-28,MIL,139,26,37,CLE,117,26,34,52,71
1979-02-28,WAS,124,41,19,CHI,113,23,39,64,58
1979-03-01,ATL,104,34,29,GOS,86,28,36,62,65
1979-03-02,NJN,99,31,30,MIL,91,27,37,58,67
1979-03-02,POR,98,31,30,HOU,118,34,28,65,58
1979-03-02,IND,98,26,38,GOS,105,28,37,54,75
1979-03-02,SAN,129,38,25,KCK,125,39,24,77,49
1979-03-02,SEA,109,38,24,CLE,111,26,35,64,59
1979-03-02,PHX,105,37,26,DEN,119,35,31,72,57
1979-03-02,BOS,99,23,36,SDC,106,34,31,57,67
1979-03-02,LAL,126,39,24,PHL,111,35,26,74,50
1979-03-03,DET,110,23,39,NOJ,101,20,44,43,83
1979-03-03,ATL,119,35,29,CHI,101,23,40,58,69
1979-03-03,NYK,111,27,38,SDC,108,35,31,62,69
1979-03-04,SEA,119,38,25,HOU,109,35,28,73,53
1979-03-04,WAS,129,42,19,SAN,128,39,25,81,44
1979-03-04,PHX,119,37,27,PHL,94,35,27,72,54
1979-03-04,BOS,122,23,37,MIL,135,27,38,50,75
1979-03-04,LAL,99,40,24,DEN,113,36,31,76,55
1979-03-04,POR,106,31,31,CLE,102,27,35,58,66
1979-03-04,KCK,110,40,25,GOS,111,29,37,69,62
1979-03-06,NJN,99,32,30,SAN,103,39,26,71,56
1979-03-06,DEN,118,37,31,HOU,119,35,29,72,60
1979-03-06,ATL,94,36,29,PHL,91,35,28,71,57
1979-03-06,NYK,110,28,38,POR,118,32,31,60,69
1979-03-07,SDC,138,35,32,HOU,115,36,29,71,61
1979-03-07,PHL,114,35,29,BOS,107,23,38,58,67
1979-03-07,ATL,122,37,29,KCK,120,41,26,78,55
1979-03-07,MIL,133,28,38,NJN,98,32,32,60,70
1979-03-07,NOJ,102,20,45,POR,103,33,31,53,76
1979-03-07,GOS,101,30,37,CLE,103,27,36,57,73
1979-03-07,IND,109,26,39,WAS,105,43,19,69,58
1979-03-07,DET,93,29,51,SEA,99,51,30,80,81
1979-03-08,PHX,132,38,27,CHI,117,23,41,61,68
1979-03-09,KCK,121,41,27,WAS,116,43,20,84,47
1979-03-09,LAL,92,40,26,CHI,102,23,42,63,68
1979-03-09,DET,160,24,39,BOS,117,23,39,47,78
1979-03-09,NJN,100,32,33,SEA,108,39,25,71,58
1979-03-09,MIL,119,29,38,PHL,113,36,29,65,67
1979-03-09,IND,125,27,39,POR,116,34,31,61,70
1979-03-10,HOU,124,36,30,NOJ,109,20,46,56,76
1979-03-10,SDC,121,36,32,CLE,115,28,36,64,68
1979-03-10,NYK,110,28,39,SAN,111,40,26,68,65
1979-03-11,NJN,104,32,34,PHL,103,36,30,68,64
1979-03-11,DEN,98,37,32,WAS,119,43,21,80,53
1979-03-11,BOS,108,23,40,LAL,106,40,27,63,67
1979-03-11,IND,112,28,39,PHX,111,39,27,67,66
1979-03-11,GOS,107,30,38,CHI,109,24,42,54,80
1979-03-11,KCK,100,42,27,POR,115,34,32,76,59
1979-03-11,MIL,115,30,38,DET,125,25,39,55,77
1979-03-11,ATL,113,38,29,SEA,111,40,25,78,54
1979-03-13,POR,103,35,32,ATL,82,39,29,74,61
1979-03-13,IND,122,29,39,DET,120,26,39,55,78
1979-03-13,WAS,120,44,21,LAL,111,40,28,84,49
1979-03-13,CHI,105,25,42,NJN,102,33,34,58,76
1979-03-13,CLE,120,28,37,PHX,124,39,28,67,65
1979-03-13,NYK,104,28,40,NOJ,91,20,47,48,87
1979-03-14,SDC,110,37,32,POR,105,36,32,73,64
1979-03-14,GOS,113,30,39,ATL,98,39,30,69,69
1979-03-14,MIL,158,30,39,NOJ,102,20,48,50,87
1979-03-14,PHL,96,36,31,SEA,99,40,26,76,57
1979-03-14,DEN,120,37,33,NJN,100,33,35,70,68
1979-03-14,BOS,117,24,40,PHX,126,40,28,64,68
1979-03-14,HOU,129,37,30,KCK,107,42,28,79,58
1979-03-14,SAN,125,41,26,LAL,112,40,29,81,55
1979-03-15,CLE,98,28,38,SEA,104,41,26,69,64
1979-03-15,NOJ,124,20,49,SAN,122,42,26,62,75
1979-03-15,DET,88,29,52,NYK,83,31,50,60,102
1979-03-16,HOU,124,38,30,CHI,118,26,42,64,72
1979-03-16,GOS,117,31,39,NJN,102,33,36,64,75
1979-03-16,NOJ,112,21,49,KCK,120,42,29,63,78
1979-03-16,PHL,114,36,32,IND,106,30,39,66,71
1979-03-16,WAS,126,45,21,MIL,134,31,39,76,60
1979-03-16,BOS,99,24,41,DET,98,26,40,50,81
1979-03-16,LAL,111,40,30,ATL,110,39,31,79,61
1979-03-16,SAN,122,42,27,PHX,128,41,28,83,55
1979-03-17,CHI,88,26,43,SEA,106,42,26,68,69
1979-03-17,DEN,118,38,33,ATL,111,39,32,77,65
1979-03-17,POR,124,36,33,NJN,113,33,37,69,70
1979-03-17,NYK,103,29,40,PHL,101,37,32,66,72
1979-03-17,SDC,107,38,32,GOS,102,32,39,70,71
1979-03-17,CLE,114,28,39,WAS,117,45,22,73,61
1979-03-17,HOU,134,39,30,PHX,122,42,28,81,58
1979-03-17,DET,105,26,41,IND,98,30,40,56,81
1979-03-18,MIL,147,32,39,SAN,127,42,28,74,67
1979-03-18,WAS,126,46,22,CLE,112,28,40,74,62
1979-03-18,KCK,114,43,29,CHI,103,26,44,69,73
1979-03-18,NOJ,121,21,50,PHX,117,42,29,63,79
1979-03-18,PHL,106,37,33,NYK,90,30,40,67,73
1979-03-18,SDC,110,39,32,NJN,98,33,38,72,70
1979-03-18,LAL,122,41,30,BOS,111,25,41,66,71
1979-03-20,DEN,113,39,33,GOS,102,32,40,71,73
1979-03-20,ATL,115,39,33,CLE,109,28,41,67,74
1979-03-20,SAN,120,42,29,PHL,124,38,33,80,62
1979-03-20,NYK,118,30,41,MIL,110,33,39,63,80
1979-03-20,POR,115,37,33,SDC,109,40,32,77,65
1979-03-20,NOJ,107,22,50,WAS,126,47,22,69,72
1979-03-20,NJN,117,33,39,DET,110,27,41,60,80
1979-03-21,GOS,103,32,41,SDC,106,40,33,72,74
1979-03-21,ATL,111,40,33,DET,104,27,42,67,75
1979-03-21,PHX,134,42,30,BOS,113,25,42,67,72
1979-03-21,IND,114,30,41,CHI,105,26,45,56,86
1979-03-21,WAS,119,48,22,NYK,106,31,41,79,63
1979-03-21,HOU,108,40,30,PHL,114,39,33,79,63
1979-03-21,KCK,116,44,29,SAN,123,42,30,86,59
1979-03-21,LAL,110,42,30,POR,114,38,33,80,63
1979-03-22,CLE,106,28,42,IND,108,31,41,59,83
1979-03-22,SEA,112,43,26,BOS,110,25,43,68,69
1979-03-23,GOS,116,32,42,MIL,113,33,40,65,82
1979-03-23,LAL,156,42,31,SDC,119,41,33,83,64
1979-03-23,IND,141,32,41,HOU,134,40,31,72,72
1979-03-23,PHL,110,40,33,NJN,98,34,39,74,72
1979-03-23,CHI,116,26,46,NOJ,99,22,51,48,97
1979-03-23,SAN,108,43,30,ATL,115,41,33,84,63
1979-03-23,DET,124,27,43,WAS,114,49,22,76,65
1979-03-23,PHX,126,43,30,KCK,107,44,30,87,60
1979-03-23,DEN,137,40,33,BOS,113,25,44,65,77
1979-03-24,NYK,143,31,42,CHI,148,27,46,58,88
1979-03-24,HOU,120,40,32,ATL,116,42,33,82,65
1979-03-24,NOJ,139,22,52,CLE,117,28,43,50,95
1979-03-25,WAS,116,49,23,DET,107,28,43,77,66
1979-03-25,NJN,99,34,40,CHI,88,28,46,62,86
1979-03-25,DEN,123,41,33,LAL,113,43,31,84,64
1979-03-25,SAN,113,43,31,IND,121,33,41,76,72
1979-03-25,SEA,111,44,26,KCK,101,44,31,88,57
1979-03-25,POR,110,39,33,MIL,122,33,41,72,74
1979-03-25,GOS,95,33,42,PHX,111,44,30,77,72
1979-03-25,BOS,103,25,45,PHL,94,41,33,66,78
1979-03-27,CHI,116,28,47,HOU,122,41,32,69,79
1979-03-27,WAS,97,50,23,PHL,100,41,34,91,57
1979-03-27,SEA,115,45,26,SDC,109,41,34,86,60
1979-03-27,CLE,111,28,44,BOS,109,26,45,54,89
1979-03-27,NOJ,101,23,52,IND,104,34,41,57,93
1979-03-27,POR,123,39,34,NYK,112,31,43,70,77
1979-03-28,GOS,132,33,43,KCK,122,44,32,77,75
1979-03-28,NJN,108,35,40,WAS,127,50,24,85,64
1979-03-28,SAN,122,43,32,NOJ,94,23,53,66,85
1979-03-28,DET,110,28,44,DEN,115,42,33,70,77
1979-03-28,PHX,112,45,30,LAL,106,43,32,88,62
1979-03-28,MIL,135,34,41,BOS,117,26,46,60,87
1979-03-28,SEA,111,46,26,NYK,105,31,44,77,70
1979-03-28,HOU,124,42,32,IND,125,35,41,77,73
1979-03-28,PHL,112,42,34,CHI,96,28,48,70,82
1979-03-29,SDC,111,41,35,KCK,116,44,33,85,68
1979-03-29,CLE,103,29,44,POR,120,40,34,69,78
1979-03-30,BOS,105,26,47,CHI,121,28,49,54,96
1979-03-30,IND,99,36,41,MIL,101,35,41,71,82
1979-03-30,WAS,104,51,24,POR,132,41,34,92,58
1979-03-30,LAL,124,43,33,DET,113,28,45,71,78
1979-03-30,SAN,116,44,32,HOU,117,42,33,86,65
1979-03-30,NJN,117,35,41,ATL,106,42,34,77,75
1979-03-30,GOS,114,34,43,NYK,98,31,45,65,88
1979-03-30,PHX,113,46,30,SEA,111,47,26,93,56
1979-03-30,DEN,130,43,33,SDC,121,41,36,84,69
1979-03-30,PHL,129,43,34,CLE,93,29,45,72,79
1979-03-31,KCK,126,45,33,IND,101,36,42,81,75
1979-03-31,SEA,123,47,27,DET,102,28,46,75,73
1979-03-31,NOJ,109,23,54,ATL,107,42,35,65,89
1979-03-31,CHI,99,29,49,MIL,108,36,41,65,90
1979-04-01,BOS,110,26,48,SAN,112,44,33,70,81
1979-04-01,PHX,116,47,30,DET,105,28,47,75,77
1979-04-01,MIL,107,37,41,POR,109,42,34,79,75
1979-04-01,CLE,114,29,46,HOU,105,43,33,72,79
1979-04-01,SDC,126,41,37,NYK,116,31,46,72,83
1979-04-01,ATL,109,42,36,NJN,98,36,41,78,77
1979-04-01,SEA,102,48,27,GOS,97,35,43,83,70
1979-04-01,PHL,112,44,34,LAL,111,44,33,88,67
1979-04-01,WAS,105,51,25,DEN,89,44,33,95,58
1979-04-03,NJN,97,36,42,DEN,110,44,34,80,76
1979-04-03,GOS,104,35,44,DET,100,28,48,63,92
1979-04-03,NYK,115,31,47,HOU,116,43,34,74,81
1979-04-03,NOJ,141,24,54,BOS,125,26,49,50,103
1979-04-03,CHI,95,29,50,LAL,97,44,34,73,84
1979-04-03,POR,106,43,34,SEA,102,49,27,92,61
1979-04-03,CLE,112,30,46,SAN,116,45,33,75,79
1979-04-03,MIL,108,37,42,WAS,112,52,25,89,67
1979-04-04,KCK,115,39,25,LAL,111,40,25,79,50
1979-04-04,WAS,145,53,25,BOS,119,26,50,79,75
1979-04-04,SDC,107,42,37,SEA,115,49,28,91,65
1979-04-04,IND,102,36,43,CLE,95,30,47,66,90
1979-04-04,SAN,110,46,33,NJN,103,36,43,82,76
1979-04-04,PHL,121,45,34,HOU,120,44,34,89,68
1979-04-04,PHX,106,48,30,POR,95,44,34,92,64
1979-04-04,ATL,118,43,36,MIL,109,37,43,80,79
1979-04-05,NOJ,104,25,54,DET,120,28,49,53,103
1979-04-05,NYK,107,31,48,DEN,114,45,34,76,82
1979-04-06,KCK,117,40,26,NJN,114,32,31,72,57
1979-04-06,LAL,93,45,34,SEA,113,50,28,95,62
1979-04-06,BOS,101,26,51,DEN,107,46,34,72,85
1979-04-06,NOJ,131,25,55,MIL,140,37,44,62,99
1979-04-06,CHI,128,29,51,WAS,114,54,25,83,76
1979-04-06,DET,96,29,49,ATL,112,44,36,73,85
1979-04-06,GOS,91,36,44,POR,87,44,35,80,79
1979-04-06,HOU,112,44,35,CLE,110,30,48,74,83
1979-04-06,IND,136,37,43,PHL,118,46,34,83,77
1979-04-06,PHX,118,49,30,SDC,117,42,38,91,68
1979-04-07,SDC,120,42,39,PHX,116,50,30,92,69
1979-04-07,HOU,123,45,35,SAN,106,47,33,92,68
1979-04-07,ATL,103,45,36,WAS,102,54,26,99,62
1979-04-07,POR,98,44,36,LAL,99,45,35,89,71
1979-04-07,NJN,126,36,44,BOS,112,26,52,62,96
1979-04-08,SAN,117,47,34,CLE,101,30,49,77,83
1979-04-08,PHL,112,46,35,DEN,111,47,34,93,69
1979-04-08,LAL,111,46,35,PHX,103,50,31,96,66
1979-04-08,IND,101,38,43,KCK,107,46,33,84,76
1979-04-08,GOS,89,37,44,SEA,86,51,28,88,72
1979-04-08,DET,107,29,50,CHI,117,30,51,59,101
1979-04-08,BOS,127,26,53,NJN,101,37,44,63,97
1979-04-08,WAS,102,54,27,HOU,112,46,35,100,62
1979-10-12,WAS,92,0,0,PHL,93,0,0,0,0
1979-10-12,NJN,102,0,0,CLE,95,0,0,0,0
1979-10-12,KCK,105,0,0,MIL,103,0,0,0,0
1979-10-12,PHX,97,0,0,GOS,89,0,0,0,0
1979-10-12,POR,101,0,0,UTH,85,0,0,0,0
1979-10-12,ATL,121,0,0,NYK,104,0,0,0,0
1979-10-12,DET,114,0,0,IND,105,0,0,0,0
1979-10-12,SDC,102,0,0,LAL,103,0,0,0,0
1979-10-12,BOS,114,0,0,HOU,106,0,0,0,0
1979-10-13,SAN,110,0,0,DET,112,1,0,1,0
1979-10-13,DEN,96,0,0,MIL,125,0,1,0,1
1979-10-13,IND,115,0,1,ATL,101,1,0,1,1
1979-10-13,PHL,113,1,0,HOU,105,0,1,1,1
1979-10-13,NYK,125,0,1,WAS,118,0,1,0,2
1979-10-13,CLE,117,0,1,BOS,139,1,0,1,1
1979-10-13,GOS,96,0,1,CHI,102,0,0,0,1
1979-10-14,PHX,112,1,0,CHI,102,1,0,2,0
1979-10-14,POR,109,1,0,DEN,93,0,1,1,1
1979-10-14,SDC,98,0,1,SEA,93,0,0,0,1
1979-10-15,UTH,107,0,1,MIL,131,1,1,1,2
1979-10-16,IND,113,1,1,NJN,100,1,0,2,1
1979-10-16,POR,88,2,0,SDC,81,1,1,3,1
1979-10-16,NYK,126,1,1,HOU,121,0,2,1,3
1979-10-16,ATL,116,1,1,SAN,118,0,1,1,2
1979-10-16,CLE,137,0,2,DET,117,2,0,2,2
1979-10-16,DEN,106,0,2,GOS,108,0,2,0,4
1979-10-16,PHX,102,2,0,SEA,86,0,1,2,1
1979-10-16,LAL,105,1,0,CHI,96,1,1,2,1
1979-10-17,MIL,125,2,1,DEN,97,0,3,2,4
1979-10-17,WAS,100,0,2,ATL,97,1,2,1,4
1979-10-17,HOU,116,0,3,IND,112,2,1,2,4
1979-10-17,BOS,127,2,0,CLE,108,1,2,3,2
1979-10-17,SEA,112,0,2,LAL,110,2,0,2,2
1979-10-17,KCK,94,1,0,GOS,107,1,2,2,2
1979-10-17,NJN,88,1,1,PHL,113,2,0,3,1
1979-10-18,SDC,111,1,2,CHI,107,1,2,2,4
1979-10-18,CLE,141,1,3,SAN,134,1,1,2,4
1979-10-18,DET,129,2,1,NYK,115,2,1,4,2
1979-10-18,UTH,92,0,2,POR,107,3,0,3,2
1979-10-18,ATL,115,1,3,IND,85,2,2,3,5
1979-10-19,NJN,106,1,2,NYK,111,2,2,3,4
1979-10-19,LAL,82,2,1,POR,99,4,0,6,1
1979-10-19,DEN,84,0,4,KCK,107,1,1,1,5
1979-10-19,MIL,95,3,1,PHX,94,3,0,6,1
1979-10-19,BOS,130,3,0,WAS,93,1,2,4,2
1979-10-19,SEA,106,1,2,SDC,98,2,2,3,4
1979-10-19,PHL,112,3,0,DET,104,3,1,6,1
1979-10-20,HOU,107,1,3,ATL,102,2,3,3,6
1979-10-20,CHI,116,1,3,PHX,104,3,1,4,4
1979-10-20,GOS,101,2,2,UTH,96,0,3,2,5
1979-10-20,SAN,129,1,2,CLE,127,2,3,3,5
1979-10-20,IND,131,2,3,BOS,128,4,0,6,3
1979-10-20,NYK,111,3,2,PHL,136,4,0,7,2
1979-10-20,WAS,117,1,3,DET,106,3,2,4,5
1979-10-21,KCK,122,2,1,PHX,85,3,2,5,3
1979-10-21,MIL,113,4,1,CHI,111,2,3,6,4
1979-10-21,POR,91,5,0,GOS,74,3,2,8,2
1979-10-21,LAL,106,2,2,SEA,97,2,2,4,4
1979-10-22,UTH,110,0,4,SDC,109,2,3,2,7
1979-10-23,POR,90,6,0,KCK,88,3,1,9,1
1979-10-23,SDC,132,2,4,DEN,127,0,5,2,9
1979-10-23,CLE,111,2,4,ATL,121,2,4,4,8
1979-10-23,PHX,108,3,3,MIL,114,5,1,8,4
1979-10-23,NYK,136,3,3,IND,112,3,3,6,6
1979-10-23,SAN,129,2,2,BOS,120,4,1,6,3
1979-10-23,LAL,102,3,2,UTH,87,1,4,4,6
1979-10-23,CHI,108,2,4,NJN,103,1,3,3,7
1979-10-24,ATL,128,3,4,CLE,118,2,5,5,9
1979-10-24,DET,104,3,3,WAS,103,2,3,5,6
1979-10-24,GOS,108,3,3,PHX,110,3,4,6,7
1979-10-24,DEN,87,0,6,POR,88,7,0,7,6
1979-10-24,HOU,99,2,3,BOS,100,4,2,6,5
1979-10-24,PHL,132,5,0,IND,110,3,4,8,4
1979-10-24,SEA,105,2,3,KCK,92,3,2,5,5
1979-10-25,SDC,115,3,4,MIL,118,6,1,9,5
1979-10-25,UTH,113,1,5,CHI,105,3,4,4,9
1979-10-26,NJN,90,1,4,ATL,94,4,4,5,8
1979-10-26,SEA,86,3,3,PHX,92,4,4,7,7
1979-10-26,PHL,127,6,0,NYK,116,4,3,10,3
1979-10-26,POR,95,8,0,CHI,93,3,5,11,5
1979-10-26,DET,113,4,3,SAN,129,3,2,7,5
1979-10-26,IND,118,3,5,WAS,108,2,4,5,9
1979-10-26,LAL,116,4,2,KCK,104,3,3,7,5
1979-10-27,DEN,116,0,7,UTH,96,2,5,2,12
1979-10-27,MIL,132,7,1,DET,118,4,4,11,5
1979-10-27,NYK,94,4,4,NJN,92,1,5,5,9
1979-10-27,ATL,95,5,4,BOS,100,5,2,10,6
1979-10-27,SDC,110,3,5,SEA,105,3,4,6,9
1979-10-27,SAN,128,4,2,IND,121,4,5,8,7
1979-10-27,GOS,101,3,4,KCK,95,3,4,6,8
1979-10-27,CLE,106,2,6,PHL,112,7,0,9,6
1979-10-28,SDC,101,4,5,KCK,106,3,5,7,10
1979-10-28,LAL,97,5,2,GOS,90,4,4,9,6
1979-10-28,NJN,120,1,6,HOU,115,2,4,3,10
1979-10-28,SEA,108,3,5,CHI,97,3,6,6,11
1979-10-28,POR,88,9,0,PHX,89,5,4,14,4
1979-10-30,PHX,142,6,4,SAN,109,5,2,11,6
1979-10-30,CHI,105,3,7,LAL,111,6,2,9,9
1979-10-30,DEN,121,1,7,NYK,112,5,4,6,11
1979-10-30,CLE,124,2,7,HOU,112,2,5,4,12
1979-10-31,IND,133,4,6,HOU,129,2,6,6,12
1979-10-31,MIL,110,8,1,LAL,106,7,2,15,3
1979-10-31,ATL,102,5,5,PHL,97,8,0,13,5
1979-10-31,KCK,125,4,5,UTH,108,2,6,6,11
1979-10-31,SEA,97,4,5,DEN,89,2,7,6,12
1979-10-31,WAS,114,2,5,CLE,105,3,7,5,12
1979-10-31,NJN,79,2,6,BOS,116,6,2,8,8
1979-10-31,GOS,111,4,5,POR,106,9,1,13,6
1979-10-31,SDC,123,4,6,SAN,130,5,3,9,9
1979-11-01,DET,125,4,5,CLE,127,3,8,7,13
1979-11-01,UTH,118,2,7,NYK,134,5,5,7,12
1979-11-02,NJN,115,2,7,IND,93,5,6,7,13
1979-11-02,SEA,117,5,5,SAN,107,6,3,11,8
1979-11-02,PHL,81,8,1,ATL,85,6,5,14,6
1979-11-02,KCK,111,5,5,NYK,112,6,5,11,10
1979-11-02,SDC,102,4,7,POR,123,9,2,13,9
1979-11-02,DEN,113,2,8,CHI,99,3,8,5,16
1979-11-02,LAL,112,7,3,PHX,110,7,4,14,7
1979-11-03,CHI,134,3,9,MIL,136,9,1,12,10
1979-11-03,IND,114,5,7,PHL,120,8,2,13,9
1979-11-03,GOS,130,5,5,DEN,103,3,8,8,13
1979-11-03,WAS,97,3,5,BOS,118,7,2,10,7
1979-11-03,DET,111,4,6,HOU,114,2,7,6,13
1979-11-03,SDC,126,4,8,UTH,109,2,8,6,16
1979-11-03,ATL,110,7,5,NJN,107,3,7,10,12
1979-11-04,MIL,101,10,1,SEA,114,6,5,16,6
1979-11-04,NJN,101,3,8,KCK,98,5,6,8,14
1979-11-04,POR,127,10,2,SAN,124,6,4,16,6
1979-11-06,CHI,97,3,10,SEA,114,7,5,10,15
1979-11-06,CLE,134,4,8,IND,117,5,8,9,16
1979-11-06,NYK,96,7,5,ATL,98,8,5,15,10
1979-11-06,UTH,107,2,9,PHX,120,7,5,9,14
1979-11-06,LAL,127,8,3,SDC,112,5,8,13,11
1979-11-06,SAN,108,6,5,NJN,95,4,8,10,13
1979-11-06,MIL,117,10,2,PHL,118,9,2,19,4
1979-11-07,PHL,110,10,2,KCK,102,5,7,15,9
1979-11-07,DET,107,4,7,ATL,115,9,5,13,12
1979-11-07,BOS,117,8,2,SAN,105,7,5,15,7
1979-11-07,HOU,106,3,7,NJN,101,4,9,7,16
1979-11-07,PHX,102,8,5,SDC,114,5,9,13,14
1979-11-07,DEN,113,3,9,SEA,92,8,5,11,14
1979-11-07,GOS,126,6,5,LAL,109,9,3,15,8
1979-11-07,IND,97,5,9,POR,90,11,2,16,11
1979-11-08,UTH,92,2,10,DEN,96,4,9,6,19
1979-11-08,MIL,98,10,3,POR,89,11,3,21,6
1979-11-09,LAL,126,9,4,DEN,122,5,9,14,13
1979-11-09,WAS,125,3,6,SAN,116,7,6,10,12
1979-11-09,BOS,127,9,2,KCK,119,5,8,14,10
1979-11-09,DET,106,4,8,PHL,98,11,2,15,10
1979-11-09,CHI,107,3,11,SDC,92,6,9,9,20
1979-11-09,PHX,110,8,6,CLE,106,5,8,13,14
1979-11-10,ATL,109,10,5,WAS,105,4,6,14,11
1979-11-10,NYK,119,7,6,SAN,123,7,7,14,13
1979-11-10,HOU,112,4,7,DET,104,5,8,9,15
1979-11-10,GOS,101,7,5,IND,104,6,9,13,14
1979-11-10,MIL,133,11,3,SDC,104,6,10,17,13
1979-11-10,UTH,87,2,11,SEA,88,8,6,10,17
1979-11-10,PHL,95,11,3,BOS,94,10,2,21,5
1979-11-10,CHI,90,4,11,POR,94,11,4,15,15
1979-11-11,LAL,140,10,4,CLE,126,5,9,15,13
1979-11-11,PHX,116,9,6,DEN,91,5,10,14,16
1979-11-11,KCK,109,5,9,POR,112,12,4,17,13
1979-11-12,UTH,105,2,12,IND,113,7,9,9,21
1979-11-13,NYK,107,7,7,WAS,111,4,7,11,14
1979-11-13,SAN,131,8,7,GOS,127,7,6,15,13
1979-11-13,NJN,101,4,10,ATL,82,11,5,15,15
1979-11-13,POR,92,13,4,MIL,101,12,3,25,7
1979-11-13,KCK,110,5,10,PHL,103,12,3,17,13
1979-11-13,CHI,127,4,12,HOU,128,5,7,9,19
1979-11-13,DEN,116,5,11,CLE,110,5,10,10,21
1979-11-13,SDC,91,6,11,LAL,137,11,4,17,15
1979-11-14,WAS,118,5,7,CHI,105,4,13,9,20
1979-11-14,SEA,136,9,6,MIL,117,13,3,22,9
1979-11-14,BOS,115,10,3,DET,111,5,9,15,12
1979-11-14,PHX,104,10,6,IND,100,8,9,18,15
1979-11-14,HOU,133,6,7,GOS,92,7,7,13,14
1979-11-14,ATL,108,11,6,UTH,97,2,13,13,19
1979-11-15,SAN,136,9,7,NYK,132,7,8,16,15
1979-11-15,KCK,114,6,10,LAL,108,12,4,18,14
1979-11-15,GOS,120,7,8,DEN,102,6,11,13,19
1979-11-16,PHX,98,11,6,POR,97,13,5,24,11
1979-11-16,NJN,91,5,10,WAS,92,6,7,11,17
1979-11-16,SDC,105,6,12,IND,97,8,10,14,22
1979-11-16,PHL,105,12,4,SAN,106,10,7,22,11
1979-11-16,BOS,113,11,3,UTH,97,2,14,13,17
1979-11-16,DEN,128,6,12,LAL,135,12,5,18,17
1979-11-16,KCK,103,7,10,CHI,97,4,14,11,24
1979-11-16,HOU,133,7,7,NYK,130,7,9,14,16
1979-11-16,SEA,108,10,6,CLE,100,5,11,15,17
1979-11-17,WAS,111,7,7,UTH,103,2,15,9,22
1979-11-17,POR,103,13,6,CLE,96,5,12,18,18
1979-11-17,CHI,106,4,15,PHL,103,12,5,16,20
1979-11-17,GOS,103,8,8,SEA,108,11,6,19,14
1979-11-17,NYK,113,7,10,BOS,109,12,3,19,13
1979-11-17,DET,93,5,10,NJN,98,5,11,10,21
1979-11-17,ATL,100,12,6,HOU,102,8,7,20,13
1979-11-18,POR,100,14,6,SEA,95,12,6,26,12
1979-11-18,LAL,127,13,5,IND,104,8,11,21,16
1979-11-18,SDC,112,7,12,MIL,96,13,4,20,16
1979-11-18,NJN,107,6,11,SAN,105,11,7,17,18
1979-11-18,PHX,95,12,6,GOS,99,8,9,20,15
1979-11-18,DEN,92,6,13,KCK,109,8,10,14,23
1979-11-20,NYK,130,8,10,HOU,125,9,7,17,17
1979-11-20,POR,114,15,6,LAL,99,14,5,29,11
1979-11-20,SDC,117,8,12,PHX,110,12,7,20,19
1979-11-20,SAN,114,11,8,PHL,118,12,6,23,14
1979-11-20,ATL,109,12,7,DET,105,5,11,17,18
1979-11-20,CHI,91,5,15,DEN,124,6,14,11,29
1979-11-20,CLE,119,5,13,UTH,107,2,16,7,29
1979-11-20,KCK,112,9,10,GOS,109,9,9,18,19
1979-11-21,DET,98,5,12,UTH,93,2,17,7,29
1979-11-21,MIL,96,13,5,ATL,93,13,7,26,12
1979-11-21,IND,119,8,12,NYK,108,9,10,17,22
1979-11-21,SEA,119,12,7,LAL,110,14,6,26,13
1979-11-21,BOS,111,12,4,NJN,103,7,11,19,15
1979-11-21,HOU,97,9,8,PHL,94,13,6,22,14
1979-11-21,PHX,128,12,8,KCK,120,10,10,22,18
1979-11-21,WAS,103,8,7,CLE,122,6,13,14,20
1979-11-21,DEN,105,7,14,SDC,84,9,12,16,26
1979-11-22,CLE,120,7,13,GOS,93,9,10,16,23
1979-11-22,NJN,109,7,12,MIL,117,14,5,21,17
1979-11-23,PHL,113,13,7,HOU,102,10,8,23,15
1979-11-23,BOS,118,13,4,IND,103,9,12,22,16
1979-11-23,PHX,126,13,8,LAL,112,14,7,27,15
1979-11-23,DET,119,6,12,MIL,100,15,5,21,17
1979-11-23,CHI,103,5,16,ATL,98,13,8,18,24
1979-11-23,SAN,128,11,9,WAS,108,8,8,19,17
1979-11-23,SEA,94,13,7,POR,90,16,6,29,13
1979-11-23,SDC,91,9,13,KCK,107,10,11,19,24
1979-11-24,ATL,101,13,9,BOS,106,14,4,27,13
1979-11-24,PHL,91,14,7,NJN,82,7,13,21,20
1979-11-24,CHI,101,6,16,GOS,106,9,11,15,27
1979-11-24,IND,115,9,13,DET,97,7,12,16,25
1979-11-24,NYK,133,9,11,CLE,113,8,13,17,24
1979-11-24,HOU,103,10,9,WAS,105,8,9,18,18
1979-11-24,DEN,101,8,14,PHX,115,14,8,22,22
1979-11-25,CLE,112,8,14,NJN,103,7,14,15,28
1979-11-25,MIL,114,15,6,GOS,90,10,11,25,17
1979-11-25,LAL,111,14,8,KCK,110,11,11,25,19
1979-11-25,POR,86,16,7,PHX,87,15,8,31,15
1979-11-26,PHL,113,15,7,IND,112,10,13,25,20
1979-11-27,WAS,91,9,9,DEN,96,8,15,17,24
1979-11-27,SDC,128,9,14,CHI,103,6,17,15,31
1979-11-27,UTH,118,2,18,LAL,122,15,8,17,26
1979-11-27,MIL,93,16,6,NJN,118,7,15,23,21
1979-11-27,SAN,120,12,9,ATL,143,13,10,25,19
1979-11-27,KCK,117,11,12,HOU,115,10,10,21,22
1979-11-27,NYK,116,10,11,DET,114,7,13,17,24
1979-11-28,GOS,108,10,12,SDC,114,10,14,20,26
1979-11-28,SEA,127,14,7,PHX,116,16,8,30,15
1979-11-28,HOU,113,10,11,CLE,111,9,14,19,25
1979-11-28,IND,79,10,14,MIL,87,16,7,26,21
1979-11-28,NJN,98,8,15,DET,89,7,14,15,29
1979-11-28,PHL,120,16,7,WAS,102,9,10,25,17
1979-11-28,BOS,119,15,4,DEN,97,9,15,24,19
1979-11-28,ATL,106,14,10,POR,99,16,8,30,18
1979-11-29,DET,95,7,15,KCK,105,12,12,19,27
1979-11-29,CLE,117,9,15,NYK,115,11,11,20,26
1979-11-30,LAL,100,16,8,CHI,107,6,18,22,26
1979-11-30,PHL,104,17,7,SDC,101,11,14,28,21
1979-11-30,GOS,104,10,13,UTH,112,2,19,12,32
1979-11-30,BOS,100,16,4,NYK,97,11,12,27,16
1979-11-30,NJN,127,9,15,DEN,118,9,16,18,31
1979-11-30,WAS,91,9,11,IND,99,10,15,19,26
1979-11-30,SAN,107,12,10,POR,100,16,9,28,19
1979-11-30,KCK,102,13,12,SEA,107,15,7,28,19
1979-11-30,HOU,106,11,11,ATL,95,15,10,26,21
1979-12-01,DET,134,7,16,SAN,124,13,10,20,26
1979-12-01,WAS,104,9,12,NJN,100,10,15,19,27
1979-12-01,HOU,120,12,11,POR,112,16,10,28,21
1979-12-01,PHX,99,16,9,CHI,86,7,18,23,27
1979-12-01,NYK,121,11,13,DEN,112,9,17,20,30
1979-12-01,ATL,106,15,11,SDC,96,11,15,26,26
1979-12-01,GOS,99,10,14,MIL,109,17,7,27,21
1979-12-01,IND,102,11,15,BOS,106,17,4,28,19
1979-12-01,PHL,117,18,7,CLE,105,10,15,28,22
1979-12-01,UTH,97,3,19,SEA,95,16,7,19,26
1979-12-02,LAL,116,16,9,MIL,103,18,7,34,16
1979-12-02,SEA,111,16,8,GOS,98,10,15,26,23
1979-12-02,CLE,126,10,16,ATL,108,16,11,26,27
1979-12-02,KCK,94,13,13,BOS,88,18,4,31,17
1979-12-03,UTH,89,4,19,MIL,96,18,8,22,27
1979-12-04,NYK,118,12,13,PHX,114,17,9,29,22
1979-12-04,CLE,115,11,16,SDC,112,11,16,22,32
1979-12-04,DET,114,8,16,BOS,118,18,5,26,21
1979-12-04,SAN,121,13,11,LAL,127,17,9,30,20
1979-12-05,WAS,104,10,12,NYK,107,13,13,23,25
1979-12-05,GOS,97,10,16,CHI,90,7,19,17,35
1979-12-05,PHL,132,19,7,SAN,120,13,12,32,19
1979-12-05,HOU,114,13,11,LAL,116,18,9,31,20
1979-12-05,SEA,115,17,8,UTH,96,4,20,21,28
1979-12-05,KCK,109,14,13,DET,93,8,17,22,30
1979-12-05,NJN,115,10,16,PHX,100,17,10,27,26
1979-12-05,DEN,123,9,18,MIL,107,19,8,28,26
1979-12-05,IND,118,11,16,CLE,99,12,16,23,32
1979-12-05,BOS,92,19,5,ATL,120,16,12,35,17
1979-12-06,UTH,87,4,21,POR,82,16,11,20,32
1979-12-06,SDC,105,11,17,GOS,103,11,16,22,33
1979-12-07,LAL,108,19,9,SDC,116,12,17,31,26
1979-12-07,MIL,105,19,9,SAN,117,13,13,32,22
1979-12-07,POR,93,16,12,CHI,95,7,20,23,32
1979-12-07,BOS,100,19,6,PHX,92,17,11,36,17
1979-12-07,HOU,124,13,12,DET,109,8,18,21,30
1979-12-08,PHL,117,20,7,PHX,96,17,12,37,19
1979-12-08,NYK,129,14,13,KCK,145,15,13,29,26
1979-12-08,CLE,116,12,17,BOS,100,20,6,32,23
1979-12-08,IND,103,12,16,DET,102,8,19,20,35
1979-12-08,DEN,103,10,18,UTH,119,5,21,15,39
1979-12-08,SAN,138,14,13,HOU,129,14,12,28,25
1979-12-08,WAS,96,10,13,ATL,95,17,12,27,25
1979-12-08,GOS,100,11,17,SEA,125,18,8,29,25
1979-12-09,MIL,108,19,10,BOS,113,20,7,39,17
1979-12-09,NJN,85,11,16,ATL,122,17,13,28,29
1979-12-09,POR,96,16,13,SDC,98,13,17,29,30
1979-12-09,LAL,131,19,10,DEN,118,10,19,29,29
1979-12-09,SEA,112,19,8,CHI,121,8,20,27,28
1979-12-10,UTH,100,6,21,GOS,93,11,18,17,39
1979-12-11,MIL,99,19,11,SEA,103,19,9,38,20
1979-12-11,DEN,127,10,20,SAN,121,15,13,25,33
1979-12-11,WAS,99,11,13,PHX,123,17,13,28,26
1979-12-11,CHI,104,9,20,POR,93,16,14,25,34
1979-12-11,NYK,122,14,14,IND,124,13,16,27,30
1979-12-12,GOS,96,11,19,DET,114,8,20,19,39
1979-12-12,SDC,107,14,17,HOU,118,14,13,28,30
1979-12-12,IND,107,14,16,SEA,112,20,9,34,25
1979-12-12,KCK,124,16,13,POR,85,16,15,32,28
1979-12-12,PHL,112,21,7,MIL,91,19,12,40,19
1979-12-12,BOS,116,21,7,NJN,102,11,17,32,24
1979-12-12,ATL,114,18,13,NYK,102,14,15,32,28
1979-12-13,UTH,144,7,21,SAN,114,15,14,22,35
1979-12-13,CLE,113,13,17,WAS,115,11,14,24,31
1979-12-13,PHX,121,18,13,HOU,113,15,13,33,26
1979-12-14,BOS,97,22,7,MIL,94,19,13,41,20
1979-12-14,NJN,118,11,18,NYK,105,14,16,25,34
1979-12-14,LAL,138,20,10,DET,122,9,20,29,30
1979-12-14,IND,111,14,17,WAS,109,12,14,26,31
1979-12-14,SDC,112,14,18,DEN,108,11,20,25,38
1979-12-14,SEA,109,21,9,HOU,101,15,14,36,23
1979-12-14,PHL,98,22,7,ATL,103,19,13,41,20
1979-12-14,KCK,103,17,13,UTH,87,8,21,25,34
1979-12-15,CLE,117,13,18,NJN,111,12,18,25,36
1979-12-15,ATL,112,20,13,PHL,96,22,8,42,21
1979-12-15,NYK,96,14,17,BOS,99,23,7,37,24
1979-12-15,PHX,126,19,13,DET,105,9,21,28,34
1979-12-15,CHI,113,10,20,WAS,115,12,15,22,35
1979-12-15,POR,106,16,16,DEN,98,11,21,27,37
1979-12-15,GOS,101,11,20,SAN,102,15,15,26,35
1979-12-16,SDC,133,15,18,DET,126,9,22,24,40
1979-12-16,KCK,107,18,13,IND,105,15,17,33,30
1979-12-16,MIL,104,19,14,UTH,79,8,22,27,36
1979-12-16,NJN,112,12,19,BOS,115,24,7,36,26
1979-12-16,SEA,123,22,9,DEN,121,11,22,33,31
1979-12-16,POR,123,17,16,HOU,101,15,15,32,31
1979-12-16,LAL,121,21,10,SAN,119,16,15,37,25
1979-12-18,NYK,101,14,18,ATL,99,21,13,35,31
1979-12-18,DET,102,9,23,PHL,114,22,9,31,32
1979-12-18,KCK,110,19,13,SDC,96,16,18,35,31
1979-12-18,CHI,118,10,21,LAL,129,22,10,32,31
1979-12-18,UTH,105,8,23,CLE,103,14,18,22,41
1979-12-19,SEA,114,23,9,NJN,122,12,20,35,29
1979-12-19,PHX,117,20,13,UTH,99,9,23,29,36
1979-12-19,SAN,127,16,16,IND,123,15,18,31,34
1979-12-19,ATL,119,21,14,LAL,112,23,10,44,24
1979-12-19,HOU,102,15,16,CHI,108,10,22,25,38
1979-12-19,GOS,125,11,21,CLE,128,14,19,25,40
1979-12-19,WAS,97,13,15,KCK,107,20,13,33,28
1979-12-19,DEN,114,11,23,POR,106,18,16,29,39
1979-12-19,BOS,112,25,7,PHL,89,23,9,48,16
1979-12-20,MIL,120,20,14,KCK,109,21,13,41,27
1979-12-20,DET,103,9,24,ATL,122,22,14,31,38
1979-12-20,SDC,128,19,21,NYK,118,19,20,38,41
1979-12-21,PHL,117,23,10,HOU,106,15,17,38,27
1979-12-21,POR,100,18,17,NJN,97,13,20,31,37
1979-12-21,LAL,114,23,11,GOS,108,11,22,34,33
1979-12-21,SEA,121,23,10,NYK,102,15,18,38,28
1979-12-21,UTH,98,9,24,SDC,110,16,19,25,43
1979-12-21,CHI,117,11,22,PHX,127,21,13,32,35
1979-12-21,BOS,133,26,7,SAN,114,17,16,43,23
1979-12-22,WAS,122,13,16,HOU,114,15,18,28,34
1979-12-22,PHL,126,24,10,BOS,113,27,7,51,17
1979-12-22,GOS,107,11,23,NJN,101,13,21,24,44
1979-12-22,CHI,126,11,23,CLE,117,15,19,26,42
1979-12-22,SAN,141,17,17,DET,112,9,25,26,42
1979-12-22,IND,130,15,19,ATL,110,23,14,38,33
1979-12-22,DEN,130,12,23,LAL,128,24,11,36,34
1979-12-22,KCK,111,21,14,PHX,115,22,13,43,27
1979-12-23,PHX,106,23,13,MIL,103,21,14,44,27
1979-12-23,SDC,124,17,19,UTH,118,9,25,26,44
1979-12-23,POR,103,19,17,NYK,111,15,19,34,36
1979-12-23,LAL,102,24,12,SEA,97,24,10,48,22
1979-12-25,NYK,131,16,19,NJN,102,13,22,29,41
1979-12-25,WAS,92,14,16,PHL,95,25,10,39,26
1979-12-25,CLE,111,15,20,DET,101,9,26,24,46
1979-12-25,POR,113,19,18,GOS,91,12,23,31,41
1979-12-25,UTH,122,9,26,DEN,111,13,23,22,49
1979-12-26,SEA,124,24,11,SDC,104,18,19,42,30
1979-12-26,KCK,118,21,15,LAL,111,25,12,46,27
1979-12-26,MIL,110,21,15,CHI,101,12,23,33,38
1979-12-26,DET,97,9,27,IND,98,16,19,25,46
1979-12-26,HOU,143,15,19,SAN,110,18,17,33,36
1979-12-26,PHX,119,24,13,POR,99,20,18,44,31
1979-12-26,NJN,116,13,23,WAS,104,14,17,27,40
1979-12-26,DEN,99,13,24,GOS,94,12,24,25,48
1979-12-27,WAS,117,14,18,MIL,108,22,15,36,33
1979-12-27,SAN,114,18,18,PHL,118,26,10,44,28
1979-12-27,ATL,112,23,15,HOU,110,16,19,39,34
1979-12-27,CLE,125,16,20,NYK,110,17,19,33,39
1979-12-27,SDC,97,18,20,BOS,118,27,8,45,28
1979-12-27,UTH,116,10,26,LAL,124,25,13,35,39
1979-12-28,LAL,123,26,13,BOS,105,28,8,54,21
1979-12-28,SEA,126,25,11,POR,97,20,19,45,30
1979-12-28,PHX,118,25,13,KCK,112,22,15,47,28
1979-12-28,NJN,116,14,23,IND,101,17,19,31,42
1979-12-28,DET,114,9,28,DEN,98,14,24,23,52
1979-12-28,CHI,102,12,24,NYK,120,17,20,29,44
1979-12-29,CLE,124,17,20,DEN,106,14,25,31,45
1979-12-29,WAS,90,15,18,SDC,93,18,21,33,39
1979-12-29,GOS,88,12,25,BOS,104,28,9,40,34
1979-12-29,IND,114,17,20,UTH,116,10,27,27,47
1979-12-29,NYK,117,18,20,MIL,105,22,16,40,36
1979-12-29,ATL,115,24,15,DET,104,10,28,34,43
1979-12-29,HOU,104,16,20,PHL,100,27,10,43,30
1979-12-29,SAN,127,18,19,KCK,125,22,16,40,35
1979-12-30,MIL,88,22,17,UTH,95,11,27,33,44
1979-12-30,POR,100,20,20,SEA,107,26,11,46,31
1979-12-30,LAL,113,27,13,PHX,105,26,13,53,26
1980-01-01,POR,109,20,21,WAS,99,15,19,35,40
1980-01-01,NYK,128,19,21,SAN,120,19,19,38,40
1980-01-02,UTH,121,12,27,KCK,128,22,17,34,44
1980-01-02,HOU,103,17,20,BOS,111,29,9,46,29
1980-01-02,SAN,118,19,20,PHX,109,26,14,45,34
1980-01-02,NJN,97,15,23,SDC,103,20,21,35,44
1980-01-02,GOS,111,12,26,POR,92,21,21,33,47
1980-01-02,DEN,135,14,26,DET,116,10,29,24,55
1980-01-02,IND,120,17,21,LAL,127,28,13,45,34
1980-01-02,SEA,134,27,11,WAS,139,15,20,42,31
1980-01-03,NYK,138,20,21,SDC,101,21,21,41,42
1980-01-03,CLE,108,18,20,PHL,109,27,11,45,31
1980-01-03,ATL,119,25,15,NJN,126,15,24,40,39
1980-01-03,MIL,106,22,18,IND,96,17,22,39,40
1980-01-04,POR,115,21,22,UTH,97,12,28,33,50
1980-01-04,NJN,104,16,24,HOU,101,17,21,33,45
1980-01-04,SEA,123,27,12,DET,105,10,30,37,42
1980-01-04,GOS,105,13,26,WAS,117,16,20,29,46
1980-01-04,KCK,115,23,17,SAN,106,20,20,43,37
1980-01-04,CHI,121,12,25,SDC,118,21,22,33,47
1980-01-05,DEN,111,15,26,IND,105,17,23,32,49
1980-01-05,HOU,111,17,22,PHX,110,26,15,43,37
1980-01-05,UTH,107,12,29,WAS,108,17,21,29,50
1980-01-05,SAN,119,20,21,BOS,111,30,9,50,30
1980-01-05,GOS,112,13,27,SEA,121,28,12,41,39
1980-01-05,CLE,98,18,21,MIL,99,23,18,41,39
1980-01-05,ATL,107,25,16,KCK,112,24,17,49,33
1980-01-05,NYK,124,21,21,CHI,117,13,25,34,46
1980-01-06,POR,119,22,22,DET,102,10,31,32,53
1980-01-06,KCK,120,25,17,DEN,101,16,26,41,43
1980-01-06,MIL,113,24,18,LAL,103,29,13,53,31
1980-01-06,NJN,108,17,24,CLE,100,18,22,35,46
1980-01-06,SDC,105,21,23,SEA,103,29,12,50,35
1980-01-08,CLE,115,18,23,HOU,118,18,22,36,45
1980-01-08,KCK,116,26,17,SDC,124,22,23,48,40
1980-01-08,NYK,108,22,21,PHL,111,29,11,51,32
1980-01-08,UTH,124,12,30,DET,110,10,32,22,62
1980-01-08,CHI,110,13,26,MIL,102,25,18,38,44
1980-01-08,SAN,137,21,21,DEN,134,16,27,37,48
1980-01-08,POR,118,23,22,IND,122,17,24,40,46
1980-01-09,PHL,108,30,11,NJN,105,18,24,48,35
1980-01-09,PHX,113,26,16,GOS,100,13,28,39,44
1980-01-09,BOS,112,30,10,NYK,95,22,22,52,32
1980-01-09,WAS,103,18,21,LAL,101,29,14,47,35
1980-01-09,SEA,120,29,13,IND,111,18,24,47,37
1980-01-09,HOU,114,19,22,DEN,112,16,28,35,50
1980-01-09,MIL,107,25,19,SDC,111,23,23,48,42
1980-01-09,ATL,111,25,17,CLE,107,18,24,43,41
1980-01-10,KCK,104,26,18,CHI,83,14,26,40,44
1980-01-11,PHL,119,28,11,WAS,106,17,20,45,31
1980-01-11,CHI,105,14,27,IND,110,18,25,32,52
1980-01-11,BOS,108,31,10,ATL,93,26,17,57,27
1980-01-11,DET,100,10,33,LAL,123,29,15,39,48
1980-01-11,KCK,112,27,18,DEN,99,16,29,43,47
1980-01-11,SDC,116,24,23,GOS,112,13,29,37,52
1980-01-11,NJN,107,18,25,POR,128,23,23,41,48
1980-01-11,SEA,100,30,13,UTH,90,13,30,43,43
1980-01-11,MIL,109,25,20,NYK,107,22,23,47,43
1980-01-11,SAN,116,22,21,CLE,109,18,25,40,46
1980-01-12,IND,122,19,25,DET,109,10,34,29,59
1980-01-12,ATL,120,26,18,SAN,101,23,21,49,39
1980-01-12,HOU,112,20,22,CLE,96,18,26,38,48
1980-01-12,SDC,119,25,23,UTH,102,13,31,38,54
1980-01-12,DEN,102,16,30,SEA,105,31,13,47,43
1980-01-12,GOS,107,13,30,PHX,96,27,16,40,46
1980-01-13,SAN,104,23,22,ATL,107,27,18,50,40
1980-01-13,WAS,127,19,21,POR,95,24,23,43,44
1980-01-13,PHL,126,31,11,NYK,112,22,24,53,35
1980-01-13,KCK,120,28,18,NJN,101,18,26,46,44
1980-01-13,DET,107,10,35,CHI,102,14,28,24,63
1980-01-13,MIL,117,26,20,HOU,121,21,22,47,42
1980-01-13,SEA,109,32,13,GOS,101,14,30,46,43
1980-01-13,BOS,98,32,10,LAL,100,30,15,62,25
1980-01-13,PHX,106,27,17,UTH,103,13,32,40,49
1980-01-15,DEN,99,16,31,PHX,107,28,17,44,48
1980-01-15,LAL,112,31,15,UTH,99,13,33,44,48
1980-01-15,CHI,111,14,29,KCK,109,29,18,43,47
1980-01-15,WAS,100,20,21,SEA,120,33,13,53,34
1980-01-15,NYK,110,22,25,CLE,129,18,27,40,52
1980-01-15,SAN,123,23,23,NJN,119,18,27,41,50
1980-01-16,HOU,112,22,22,NJN,122,18,28,40,50
1980-01-16,SDC,111,26,23,ATL,108,28,18,54,41
1980-01-16,UTH,108,13,34,PHX,115,29,17,42,51
1980-01-16,IND,117,20,25,DEN,99,16,32,36,57
1980-01-16,MIL,108,26,21,KCK,112,29,19,55,40
1980-01-16,PHL,121,32,11,POR,110,24,24,56,35
1980-01-16,GOS,96,14,31,LAL,97,32,15,46,46
1980-01-16,BOS,114,36,13,CHI,104,18,32,54,45
1980-01-17,PHX,101,30,17,ATL,99,28,19,58,36
1980-01-17,CLE,116,19,27,SAN,112,24,23,43,50
1980-01-17,DET,110,11,35,WAS,107,20,22,31,57
1980-01-18,LAL,108,33,15,ATL,102,28,20,61,35
1980-01-18,NJN,105,19,28,PHL,112,33,11,52,39
1980-01-18,MIL,111,26,22,DEN,120,16,33,42,55
1980-01-18,HOU,134,22,23,WAS,111,20,23,42,46
1980-01-18,CHI,102,15,29,UTH,107,13,35,28,64
1980-01-18,GOS,92,14,32,SDC,91,27,23,41,55
1980-01-18,NYK,117,22,26,SEA,124,34,13,56,39
1980-01-18,BOS,111,32,11,POR,93,24,25,56,36
1980-01-19,DET,122,12,35,HOU,110,23,23,35,58
1980-01-19,CHI,117,15,30,DEN,108,17,33,32,63
1980-01-19,PHX,137,31,17,SDC,123,27,24,58,41
1980-01-19,SAN,130,24,24,WAS,117,20,24,44,48
1980-01-19,PHL,111,34,11,CLE,107,20,27,54,38
1980-01-19,IND,108,21,25,KCK,103,30,19,51,44
1980-01-19,UTH,116,14,35,GOS,99,15,32,29,67
1980-01-20,MIL,89,26,23,POR,88,24,26,50,49
1980-01-20,BOS,106,33,11,SEA,108,35,13,68,24
1980-01-21,LAL,132,34,15,NYK,114,22,27,56,42
1980-01-22,CLE,114,20,28,WAS,91,20,25,40,53
1980-01-22,SAN,129,25,24,SDC,109,27,25,52,49
1980-01-22,CHI,145,16,30,DET,131,13,35,29,65
1980-01-22,BOS,112,33,12,HOU,106,23,24,56,36
1980-01-22,KCK,101,30,20,ATL,89,28,21,58,41
1980-01-22,UTH,127,15,35,MIL,122,27,23,42,58
1980-01-23,GOS,102,15,33,MIL,104,27,24,42,57
1980-01-23,ATL,96,28,22,SEA,98,36,13,64,35
1980-01-23,DEN,93,17,34,PHL,118,35,11,52,45
1980-01-23,PHX,109,32,17,NYK,119,22,28,54,45
1980-01-23,DET,104,13,36,BOS,131,34,12,47,48
1980-01-23,HOU,111,23,25,SDC,110,27,26,50,51
1980-01-23,NJN,117,19,29,CLE,103,21,28,40,57
1980-01-23,IND,130,22,25,SAN,144,26,24,48,49
1980-01-24,WAS,87,20,26,NJN,98,20,29,40,55
1980-01-24,UTH,88,16,35,KCK,110,31,20,47,55
1980-01-24,POR,111,24,27,LAL,103,35,15,59,42
1980-01-25,NJN,116,21,29,DET,119,13,37,34,66
1980-01-25,CHI,113,17,30,KCK,107,32,20,49,50
1980-01-25,SAN,125,27,24,SEA,116,37,13,64,37
1980-01-25,PHX,110,32,18,MIL,96,28,24,60,42
1980-01-25,GOS,105,15,34,NYK,110,23,28,38,62
1980-01-25,IND,139,22,26,SDC,117,27,27,49,53
1980-01-25,BOS,107,35,12,WAS,118,20,27,55,39
1980-01-25,LAL,124,35,16,PHL,103,36,11,71,27
1980-01-26,KCK,112,32,21,UTH,107,16,36,48,57
1980-01-26,ATL,109,28,23,CHI,104,18,30,46,53
1980-01-26,HOU,123,24,25,SEA,111,37,14,61,39
1980-01-26,CLE,114,21,29,IND,115,23,26,44,55
1980-01-26,DEN,100,17,35,POR,96,25,27,42,62
1980-01-27,BOS,131,35,13,SDC,108,27,28,62,41
1980-01-27,DET,93,14,37,NYK,98,24,28,38,65
1980-01-27,SAN,111,28,24,ATL,118,29,23,57,47
1980-01-27,NJN,128,21,30,CHI,127,18,31,39,61
1980-01-27,LAL,112,36,16,MIL,102,28,25,64,41
1980-01-27,IND,123,24,26,CLE,121,21,30,45,56
1980-01-27,WAS,116,21,27,GOS,107,15,35,36,62
1980-01-27,PHX,125,33,18,PHL,118,36,12,69,30
1980-01-28,UTH,107,16,37,PHL,101,36,13,52,50
1980-01-28,NYK,107,25,28,GOS,103,15,36,40,64
1980-01-29,POR,96,25,28,MIL,103,28,26,53,54
1980-01-29,CHI,99,18,33,BOS,103,37,13,55,46
1980-01-29,DET,100,14,38,GOS,111,15,37,29,75
1980-01-29,IND,133,25,26,HOU,112,25,25,50,51
1980-01-29,CLE,154,21,31,LAL,153,37,16,58,47
1980-01-29,DEN,111,18,35,KCK,121,33,21,51,56
1980-01-29,ATL,98,30,23,WAS,82,22,27,52,50
1980-01-29,SDC,133,27,29,PHX,121,34,18,61,47
1980-01-30,WAS,120,22,28,IND,119,26,26,48,54
1980-01-30,SEA,97,37,15,KCK,99,34,21,71,36
1980-01-30,BOS,110,38,13,CLE,103,22,31,60,44
1980-01-30,HOU,111,25,26,SAN,118,28,25,53,51
1980-01-30,PHX,122,34,19,DEN,114,18,36,52,55
1980-01-30,PHL,121,36,14,DET,108,14,39,50,53
1980-01-30,UTH,102,17,37,NJN,100,22,30,39,67
1980-01-31,WAS,103,23,28,BOS,119,39,13,62,41
1980-01-31,DEN,127,18,37,NJN,126,22,31,40,68
1980-01-31,IND,102,26,27,NYK,112,26,28,52,55
1980-01-31,HOU,105,25,27,PHL,110,37,14,62,41
1980-01-31,POR,94,25,29,KCK,93,35,21,60,50
1980-01-31,CHI,97,18,34,LAL,107,37,17,55,51
1980-01-31,ATL,111,31,23,GOS,107,16,37,47,60
1980-01-31,SEA,105,37,16,MIL,101,29,26,66,42
1980-02-05,CLE,121,22,33,SEA,123,38,16,60,49
1980-02-05,KCK,99,35,22,POR,105,26,29,61,51
1980-02-05,SAN,115,29,25,NJN,123,22,32,51,57
1980-02-05,IND,108,26,28,PHL,109,38,14,64,42
1980-02-05,UTH,116,18,37,CHI,106,18,35,36,72
1980-02-05,NYK,105,27,28,LAL,116,38,17,65,45
1980-02-06,MIL,111,29,27,CLE,109,22,32,51,59
1980-02-06,PHX,97,35,19,KCK,95,35,23,70,42
1980-02-06,DEN,122,19,37,CHI,111,18,36,37,73
1980-02-06,GOS,117,16,38,SDC,92,28,29,44,67
1980-02-06,HOU,115,25,28,NJN,114,23,32,48,60
1980-02-06,BOS,129,40,13,PHL,110,39,14,79,27
1980-02-07,IND,134,26,29,WAS,104,23,29,49,58
1980-02-07,DET,102,14,40,SEA,119,39,16,53,56
1980-02-07,UTH,90,19,37,ATL,92,32,23,51,60
1980-02-08,PHL,94,39,15,SEA,109,40,16,79,31
1980-02-08,GOS,100,17,38,KCK,107,35,24,52,62
1980-02-08,NJN,120,23,33,LAL,125,39,17,62,50
1980-02-08,BOS,130,41,13,IND,108,27,29,68,42
1980-02-08,CHI,109,18,37,PHX,113,36,19,54,56
1980-02-08,HOU,105,26,28,CLE,104,22,34,48,62
1980-02-08,SDC,118,28,30,POR,104,27,29,55,59
1980-02-08,MIL,115,30,27,WAS,90,23,30,53,57
1980-02-09,DEN,123,20,37,SDC,104,29,30,49,67
1980-02-09,NYK,114,27,29,DET,107,14,41,41,70
1980-02-09,IND,131,27,30,SAN,127,29,26,56,56
1980-02-09,HOU,117,27,28,UTH,95,19,38,46,66
1980-02-10,PHL,105,39,16,LAL,104,40,17,79,33
1980-02-10,SAN,148,29,27,UTH,128,19,39,48,66
1980-02-10,CLE,117,22,35,CHI,123,18,38,40,73
1980-02-10,GOS,96,17,39,ATL,98,33,23,50,62
1980-02-10,KCK,108,36,24,WAS,106,23,31,59,55
1980-02-10,NJN,107,23,34,SEA,122,41,16,64,50
1980-02-10,MIL,109,31,27,PHX,107,37,19,68,46
1980-02-10,BOS,128,42,13,DET,111,14,42,56,55
1980-02-12,DEN,111,21,37,WAS,128,23,32,44,69
1980-02-12,SAN,118,30,27,HOU,120,28,28,58,55
1980-02-12,CHI,100,19,38,GOS,94,17,40,36,78
1980-02-12,POR,89,27,30,ATL,95,34,23,61,53
1980-02-13,DET,102,14,43,CLE,107,22,36,36,79
1980-02-13,SEA,93,42,16,ATL,86,35,23,77,39
1980-02-13,IND,96,28,30,NJN,98,23,35,51,65
1980-02-13,PHX,135,37,20,BOS,134,43,13,80,33
1980-02-13,MIL,111,32,27,CHI,101,20,38,52,65
1980-02-13,HOU,122,29,28,NYK,117,28,29,57,57
1980-02-13,PHL,107,40,16,UTH,85,19,40,59,56
1980-02-13,SDC,103,29,31,WAS,108,24,32,53,63
1980-02-13,LAL,129,40,18,POR,103,27,31,67,49
1980-02-14,CLE,114,23,36,IND,118,28,31,51,67
1980-02-14,SEA,93,43,16,DEN,84,21,38,64,54
1980-02-14,NJN,137,24,35,UTH,96,19,41,43,76
1980-02-14,SAN,124,30,28,NYK,128,28,30,58,58
1980-02-14,MIL,120,33,27,GOS,103,17,41,50,68
1980-02-15,CHI,124,20,39,SAN,131,30,29,50,68
1980-02-15,IND,107,29,31,GOS,118,17,42,46,73
1980-02-15,LAL,114,41,18,KCK,100,37,24,78,42
1980-02-15,POR,91,27,32,BOS,106,43,14,70,46
1980-02-15,HOU,103,30,28,MIL,114,34,27,64,55
1980-02-15,PHX,116,38,20,WAS,104,25,32,63,52
1980-02-15,DEN,111,21,39,ATL,98,35,24,56,63
1980-02-15,DET,104,14,44,PHL,114,41,16,55,60
1980-02-16,CLE,123,23,37,DET,104,14,45,37,82
1980-02-16,NYK,102,29,30,UTH,121,19,42,48,72
1980-02-16,PHL,100,42,16,CHI,92,20,40,62,56
1980-02-17,SAN,135,31,29,MIL,134,35,27,66,56
1980-02-17,SDC,107,29,32,KCK,108,37,25,66,57
1980-02-17,DEN,112,22,39,HOU,99,30,29,52,68
1980-02-17,SEA,109,44,16,BOS,108,44,14,88,30
1980-02-17,POR,103,27,33,GOS,98,18,42,45,75
1980-02-17,IND,108,29,32,CHI,100,20,41,49,73
1980-02-17,PHX,128,39,20,NJN,98,25,35,64,55
1980-02-17,PHL,115,43,16,CLE,100,24,37,67,53
1980-02-17,DET,99,14,46,ATL,108,35,25,49,71
1980-02-17,LAL,111,42,18,WAS,107,25,33,67,51
1980-02-19,CHI,115,20,42,SEA,106,45,16,65,58
1980-02-19,CLE,128,24,38,PHX,109,40,20,64,58
1980-02-19,NYK,113,29,31,POR,103,28,33,57,64
1980-02-19,SDC,113,29,33,NJN,123,25,36,54,69
1980-02-20,UTH,98,20,42,BOS,105,44,15,64,57
1980-02-20,ATL,106,36,25,MIL,103,35,28,71,53
1980-02-20,IND,131,30,32,NYK,86,30,31,60,63
1980-02-20,KCK,107,38,25,SEA,105,45,17,83,42
1980-02-20,DEN,103,23,39,LAL,116,43,18,66,57
1980-02-20,GOS,115,18,43,HOU,102,30,30,48,73
1980-02-20,SAN,125,32,29,CHI,117,21,42,53,71
1980-02-21,DET,116,14,47,PHX,125,40,21,54,68
1980-02-21,WAS,118,25,34,CLE,115,25,38,50,72
1980-02-21,SDC,104,29,34,PHL,99,44,16,73,50
1980-02-22,UTH,82,20,43,HOU,94,30,31,50,74
1980-02-22,GOS,121,19,43,DEN,122,23,40,42,83
1980-02-22,WAS,123,26,34,SAN,117,33,29,59,63
1980-02-22,LAL,132,44,18,NJN,110,26,36,70,54
1980-02-22,ATL,111,37,25,PHX,104,41,21,78,46
1980-02-23,NYK,127,30,32,CLE,112,25,39,55,71
1980-02-23,DEN,105,24,40,BOS,124,45,15,69,55
1980-02-23,UTH,95,20,44,SEA,105,45,18,65,62
1980-02-23,DET,107,14,48,POR,130,28,34,42,82
1980-02-24,CHI,110,21,43,SDC,102,30,34,51,77
1980-02-24,CLE,100,25,40,POR,115,29,34,54,74
1980-02-24,GOS,100,19,44,PHL,103,44,17,63,61
1980-02-24,WAS,112,27,34,NYK,97,31,32,58,66
1980-02-24,IND,105,31,32,PHX,113,41,22,72,54
1980-02-24,KCK,72,39,25,MIL,94,35,29,74,54
1980-02-24,LAL,112,45,18,HOU,100,31,31,76,49
1980-02-24,NJN,129,26,37,SAN,123,33,30,59,67
1980-02-26,HOU,93,31,32,IND,88,31,33,62,65
1980-02-26,DEN,121,24,41,PHX,112,42,22,66,63
1980-02-26,CHI,105,22,43,UTH,85,20,45,42,88
1980-02-26,LAL,131,46,18,SEA,108,46,18,92,36
1980-02-26,MIL,122,36,29,SDC,88,30,35,66,64
1980-02-26,POR,96,30,34,PHL,98,45,17,75,51
1980-02-26,KCK,117,39,26,GOS,99,19,45,58,71
1980-02-26,BOS,108,46,15,ATL,97,38,25,84,40
1980-02-27,NJN,120,27,37,GOS,133,19,46,46,83
1980-02-27,DET,113,14,49,SDC,129,30,36,44,85
1980-02-27,BOS,130,47,15,SAN,125,33,31,80,46
1980-02-27,PHX,110,42,23,MIL,119,37,29,79,52
1980-02-27,HOU,110,32,32,WAS,97,28,34,60,66
1980-02-27,ATL,116,38,26,IND,111,31,34,69,60
1980-02-27,SEA,98,46,19,PHL,101,46,17,92,36
1980-02-28,NYK,133,31,33,SAN,124,33,32,64,65
1980-02-28,WAS,105,28,35,HOU,99,33,32,61,67
1980-02-28,UTH,101,20,46,PHX,111,42,24,62,70
1980-02-29,DET,137,14,50,NJN,128,27,38,41,88
1980-02-29,KCK,98,40,26,SDC,93,31,36,71,62
1980-02-29,ATL,111,39,26,CLE,103,25,41,64,67
1980-02-29,BOS,110,48,15,GOS,99,20,46,68,61
1980-02-29,LAL,117,47,18,MIL,126,38,29,85,47
1980-02-29,SEA,108,46,20,CHI,101,23,43,69,63
1980-02-29,PHL,104,47,17,DEN,103,25,41,72,58
1980-02-29,POR,87,30,35,UTH,91,20,47,50,82
1980-03-01,NYK,115,32,33,NJN,108,27,39,59,72
1980-03-02,SEA,103,47,20,UTH,91,21,47,68,67
1980-03-02,NJN,113,27,40,NYK,96,33,33,60,73
1980-03-02,ATL,100,40,26,DEN,93,25,42,65,68
1980-03-02,SDC,98,31,37,MIL,101,39,29,70,66
1980-03-02,HOU,91,33,33,KCK,94,41,26,74,59
1980-03-02,PHL,144,48,17,GOS,99,20,47,68,64
1980-03-02,SAN,119,33,33,CLE,123,25,42,58,75
1980-03-02,BOS,118,49,15,DET,115,15,50,64,65
1980-03-02,PHX,123,43,24,LAL,115,47,19,90,43
1980-03-02,POR,110,30,36,CHI,107,23,44,53,80
1980-03-02,WAS,118,29,35,IND,104,31,35,60,70
1980-03-04,NJN,114,28,40,IND,109,31,36,59,76
1980-03-04,ATL,83,41,26,HOU,93,33,34,74,60
1980-03-04,MIL,124,40,29,LAL,127,47,20,87,49
1980-03-04,SAN,108,33,34,BOS,137,50,15,83,49
1980-03-04,SDC,116,31,38,CLE,105,26,42,57,80
1980-03-04,POR,97,31,36,SEA,98,48,20,79,56
1980-03-04,WAS,135,30,35,DET,107,15,51,45,86
1980-03-04,UTH,105,21,48,GOS,111,20,48,41,96
1980-03-05,GOS,105,21,48,CHI,106,23,45,44,93
1980-03-05,PHL,120,49,17,IND,113,31,37,80,54
1980-03-05,DEN,112,25,43,MIL,109,40,30,65,73
1980-03-05,KCK,101,42,26,LAL,117,48,20,90,46
1980-03-05,DET,120,15,52,NYK,113,33,34,48,86
1980-03-05,HOU,99,34,34,BOS,103,51,15,85,49
1980-03-05,PHX,127,44,24,SEA,111,49,20,93,44
1980-03-06,WAS,96,31,35,NJN,122,29,40,60,75
1980-03-06,UTH,117,21,49,POR,110,31,37,52,86
1980-03-07,SAN,112,33,35,NYK,118,33,35,66,70
1980-03-07,LAL,101,49,20,CHI,99,24,45,73,65
1980-03-07,IND,94,31,38,ATL,99,41,27,72,65
1980-03-07,KCK,104,42,27,CLE,111,26,43,68,70
1980-03-07,BOS,111,52,15,PHL,92,50,17,102,32
1980-03-07,POR,113,31,38,DEN,104,26,43,57,81
1980-03-07,DET,105,16,52,WAS,106,31,36,47,88
1980-03-07,PHX,110,45,24,UTH,94,22,49,67,73
1980-03-07,NJN,110,30,40,HOU,111,34,35,64,75
1980-03-08,NYK,110,34,35,DET,104,16,53,50,88
1980-03-08,HOU,79,35,35,ATL,97,42,27,77,62
1980-03-08,DEN,97,26,44,SEA,104,49,21,75,65
1980-03-08,GOS,80,21,49,MIL,105,40,31,61,80
1980-03-08,UTH,98,22,50,SDC,113,32,38,54,88
1980-03-09,BOS,128,53,15,WAS,133,32,36,85,51
1980-03-09,SAN,118,33,36,PHL,134,50,18,83,54
1980-03-09,ATL,98,43,27,NYK,92,35,35,78,62
1980-03-09,KCK,113,42,28,SEA,93,50,21,92,49
1980-03-09,PHX,113,46,24,CHI,103,24,46,70,70
1980-03-09,POR,142,32,38,LAL,121,50,20,82,58
1980-03-09,SDC,107,33,38,GOS,125,21,50,54,88
1980-03-09,IND,107,31,39,CLE,113,27,43,58,82
1980-03-09,NJN,140,30,41,DET,100,16,54,46,95
1980-03-11,IND,114,31,40,BOS,108,53,16,84,56
1980-03-11,CHI,100,24,47,KCK,98,43,28,67,75
1980-03-11,CLE,122,28,43,NJN,119,31,41,59,84
1980-03-11,NYK,129,35,36,HOU,109,35,36,70,72
1980-03-11,SDC,106,33,39,LAL,123,50,21,83,60
1980-03-11,DEN,96,26,45,GOS,87,22,50,48,95
1980-03-11,WAS,104,33,36,SAN,111,33,37,66,73
1980-03-11,ATL,97,50,30,PHL,102,57,23,107,53
1980-03-12,DET,119,16,55,NJN,137,31,42,47,97
1980-03-12,BOS,121,53,17,HOU,105,35,37,88,54
1980-03-12,MIL,112,41,31,SEA,103,50,22,91,53
1980-03-12,LAL,102,51,21,POR,94,33,38,84,59
1980-03-12,PHL,105,51,18,WAS,98,33,37,84,55
1980-03-12,GOS,113,22,51,PHX,122,47,24,69,75
1980-03-13,NYK,100,36,36,IND,107,32,40,68,76
1980-03-13,SDC,116,33,40,DEN,102,27,45,60,85
1980-03-14,LAL,132,52,21,DEN,126,27,46,79,67
1980-03-14,WAS,92,33,38,HOU,85,35,38,68,76
1980-03-14,ATL,88,44,27,BOS,87,54,17,98,44
1980-03-14,MIL,120,42,31,POR,110,33,39,75,70
1980-03-14,CHI,101,25,47,SEA,122,50,23,75,70
1980-03-14,DET,102,16,56,SAN,113,34,37,50,93
1980-03-14,IND,104,33,40,PHL,94,52,18,85,58
1980-03-15,NYK,120,36,37,BOS,123,54,18,90,55
1980-03-15,SDC,120,34,40,PHX,109,48,24,82,64
1980-03-15,CHI,110,25,48,POR,108,33,40,58,88
1980-03-15,CLE,100,29,43,SAN,98,35,37,64,80
1980-03-16,WAS,124,34,38,NYK,133,36,38,70,76
1980-03-16,LAL,128,53,21,PHX,106,48,25,101,46
1980-03-16,DEN,127,27,47,SDC,107,35,40,62,87
1980-03-16,MIL,128,43,31,KCK,121,43,29,86,60
1980-03-16,DET,99,16,57,HOU,102,35,39,51,96
1980-03-16,NJN,107,32,42,SAN,120,35,38,67,80
1980-03-16,GOS,115,22,52,UTH,103,22,51,44,103
1980-03-16,CLE,123,30,43,PHL,109,52,19,82,62
1980-03-16,ATL,95,45,27,IND,90,34,40,79,67
1980-03-17,NJN,92,32,43,BOS,117,55,18,87,61
1980-03-17,PHL,123,52,20,DET,109,16,58,68,78
1980-03-18,DEN,96,28,47,UTH,94,22,52,50,99
1980-03-18,KCK,109,43,30,PHX,112,48,26,91,56
1980-03-18,POR,123,33,41,MIL,122,44,31,77,72
1980-03-18,LAL,113,54,21,GOS,100,23,52,77,73
1980-03-18,BOS,114,56,18,IND,102,34,41,90,59
1980-03-18,NYK,111,37,38,ATL,110,46,27,83,65
1980-03-18,SAN,100,36,38,WAS,94,34,39,70,77
1980-03-18,DET,107,16,59,CLE,108,31,43,47,102
1980-03-18,SDC,101,35,41,CHI,115,26,48,61,89
1980-03-19,HOU,139,36,39,NYK,113,38,38,74,77
1980-03-19,PHX,112,49,26,LAL,108,55,21,104,47
1980-03-19,PHL,99,53,20,SAN,105,37,38,90,58
1980-03-19,UTH,103,22,53,CHI,100,27,48,49,101
1980-03-19,SEA,106,51,23,MIL,108,44,32,95,55
1980-03-19,IND,125,34,42,NJN,112,32,44,66,86
1980-03-19,ATL,109,46,28,WAS,93,34,40,80,68
1980-03-19,GOS,113,23,53,POR,115,34,41,57,94
1980-03-20,KCK,121,43,31,DEN,105,29,47,72,78
1980-03-20,DET,106,16,60,BOS,124,57,18,73,78
1980-03-20,WAS,119,34,41,PHL,113,53,21,87,62
1980-03-20,CLE,109,32,43,HOU,96,37,39,69,82
1980-03-21,MIL,121,45,32,GOS,93,23,54,68,86
1980-03-21,UTH,98,23,53,KCK,102,44,31,67,84
1980-03-21,SAN,116,38,38,IND,109,35,42,73,80
1980-03-21,CHI,128,27,49,DEN,134,29,48,56,97
1980-03-21,SEA,107,51,24,SDC,104,35,42,86,66
1980-03-21,POR,100,35,41,PHX,111,50,26,85,67
1980-03-21,PHL,108,53,22,NJN,99,32,45,85,67
1980-03-21,ATL,108,47,28,DET,95,16,61,63,89
1980-03-22,CLE,109,33,43,BOS,105,58,18,91,61
1980-03-22,HOU,125,37,40,IND,110,35,43,72,83
1980-03-22,NYK,113,38,39,WAS,122,35,41,73,80
1980-03-22,SEA,92,52,24,LAL,97,55,22,107,46
1980-03-23,ATL,103,48,28,SAN,95,39,38,87,66
1980-03-23,LAL,101,56,22,UTH,96,23,54,79,76
1980-03-23,SEA,112,52,25,KCK,90,45,31,97,56
1980-03-23,CHI,129,27,50,GOS,115,23,55,50,105
1980-03-23,POR,98,35,42,SDC,91,35,43,70,85
1980-03-23,PHX,118,51,26,DEN,102,30,48,81,74
1980-03-23,PHL,112,54,22,NYK,108,38,40,92,62
1980-03-23,BOS,96,58,19,NJN,101,32,46,90,65
1980-03-23,WAS,119,36,41,DET,114,16,62,52,103
1980-03-25,SAN,126,39,39,HOU,107,38,40,77,79
1980-03-25,POR,106,36,42,KCK,102,45,32,81,74
1980-03-25,SEA,104,53,25,PHX,95,52,26,105,51
1980-03-25,UTH,109,23,55,DEN,91,30,49,53,104
1980-03-25,CHI,111,28,50,MIL,122,46,32,74,82
1980-03-25,CLE,115,34,43,NYK,128,38,41,72,84
1980-03-25,WAS,95,37,41,BOS,96,58,20,95,61
1980-03-26,DET,114,16,63,IND,124,35,44,51,107
1980-03-26,BOS,129,59,20,NYK,121,39,41,98,61
1980-03-26,HOU,113,38,41,SAN,101,40,39,78,80
1980-03-26,PHX,109,52,27,SEA,99,54,25,106,52
1980-03-26,PHL,84,55,22,ATL,81,49,28,104,50
1980-03-26,DEN,115,30,50,CHI,122,28,51,58,101
1980-03-26,GOS,106,23,56,KCK,100,45,33,68,89
1980-03-27,NYK,101,39,42,PHL,103,56,22,95,64
1980-03-27,CLE,118,34,44,WAS,111,37,42,71,86
1980-03-27,ATL,117,49,29,NJN,100,33,46,82,75
1980-03-27,MIL,143,47,32,DEN,95,30,51,77,83
1980-03-27,SDC,93,35,44,POR,96,37,42,72,86
1980-03-27,UTH,95,24,55,LAL,97,57,22,81,77
1980-03-28,WAS,100,37,43,ATL,80,50,29,87,72
1980-03-28,NJN,99,33,47,PHL,92,57,22,90,69
1980-03-28,SEA,108,54,26,GOS,82,24,56,78,82
1980-03-28,KCK,116,45,34,MIL,114,48,32,93,66
1980-03-28,PHX,114,53,27,POR,100,38,42,91,69
1980-03-28,IND,127,36,44,SAN,122,40,40,76,84
1980-03-28,HOU,128,39,41,DET,112,16,64,55,105
1980-03-28,BOS,130,60,20,CLE,122,35,44,95,64
1980-03-28,LAL,126,58,22,SDC,88,35,45,93,67
1980-03-29,CHI,111,29,51,UTH,106,24,56,53,107
1980-03-30,SEA,135,55,26,POR,104,38,43,93,69
1980-03-30,SAN,144,40,41,DET,124,16,65,56,106
1980-03-30,PHX,122,54,27,SDC,104,35,46,89,73
1980-03-30,PHL,116,58,23,BOS,110,61,20,119,43
1980-03-30,MIL,107,48,33,UTH,91,24,57,72,90
1980-03-30,KCK,114,46,34,CHI,110,30,51,76,85
1980-03-30,IND,106,37,44,HOU,121,40,41,77,85
1980-03-30,GOS,93,24,57,LAL,95,59,22,83,79
1980-03-30,CLE,111,35,45,ATL,102,50,31,85,76
1980-03-30,NJN,87,34,47,WAS,93,38,43,72,90
1980-10-10,PHX,121,0,0,GOS,101,0,0,0,0
1980-10-10,DEN,112,0,0,SAN,113,0,0,0,0
1980-10-10,PHL,103,0,0,MIL,106,0,0,0,0
1980-10-10,SDC,120,0,0,HOU,104,0,0,0,0
1980-10-10,DET,85,0,0,WAS,95,0,0,0,0
1980-10-10,SEA,98,0,0,LAL,99,0,0,0,0
1980-10-10,BOS,130,0,0,CLE,103,0,0,0,0
1980-10-10,UTH,96,0,0,POR,86,0,0,0,0
1980-10-10,NJN,91,0,0,IND,110,0,0,0,0
1980-10-11,DAL,103,0,0,SAN,92,1,0,1,0
1980-10-11,IND,100,1,0,DET,87,0,1,1,1
1980-10-11,CLE,96,0,1,NJN,99,0,1,0,2
1980-10-11,ATL,101,0,0,CHI,93,0,0,0,0
1980-10-11,WAS,120,1,0,PHL,126,0,1,1,1
1980-10-11,GOS,104,0,1,SDC,91,1,0,1,1
1980-10-11,NYK,114,0,0,MIL,109,1,0,1,0
1980-10-11,KCK,98,0,0,UTH,91,1,0,1,0
1980-10-12,DEN,121,0,1,UTH,125,1,1,1,2
1980-10-12,LAL,114,1,0,HOU,103,0,1,1,1
1980-10-12,PHX,109,1,0,KCK,100,1,0,2,0
1980-10-12,POR,107,0,1,SEA,96,0,1,0,2
1980-10-13,NJN,108,1,1,DET,92,0,2,1,3
1980-10-14,CLE,99,0,2,DET,91,0,3,0,5
1980-10-14,DAL,83,1,0,SEA,85,0,2,1,2
1980-10-14,ATL,122,1,0,BOS,116,1,0,2,0
1980-10-14,SAN,109,1,1,KCK,103,1,1,2,2
1980-10-14,NYK,113,1,0,PHL,93,1,1,2,1
1980-10-15,GOS,95,1,1,POR,92,1,1,2,2
1980-10-15,DEN,133,0,2,DAL,98,1,1,1,3
1980-10-15,HOU,103,0,2,SEA,100,1,2,1,4
1980-10-15,UTH,93,2,1,PHX,107,2,0,4,1
1980-10-15,KCK,107,1,2,LAL,112,2,0,3,2
1980-10-15,NJN,111,2,1,PHL,119,1,2,3,3
1980-10-15,IND,97,2,0,CHI,108,0,1,2,1
1980-10-16,MIL,103,1,1,BOS,110,1,1,2,2
1980-10-16,CLE,90,1,2,WAS,88,1,1,2,3
1980-10-16,DET,99,0,4,SAN,102,2,1,2,5
1980-10-17,CHI,98,1,1,CLE,79,2,2,3,3
1980-10-17,SDC,116,1,1,DEN,129,1,2,2,3
1980-10-17,LAL,116,3,0,PHX,109,3,0,6,0
1980-10-17,DAL,91,1,2,KCK,103,1,3,2,5
1980-10-17,POR,99,1,2,HOU,102,1,2,2,4
1980-10-17,WAS,112,1,2,NJN,114,2,2,3,4
1980-10-17,ATL,113,2,0,NYK,101,2,0,4,0
1980-10-18,UTH,117,2,2,DEN,115,2,2,4,4
1980-10-18,CLE,105,2,3,MIL,107,1,2,3,5
1980-10-18,SAN,110,3,1,DAL,96,1,3,4,4
1980-10-18,IND,103,2,1,BOS,99,2,1,4,2
1980-10-18,KCK,122,2,3,SEA,127,1,3,3,6
1980-10-18,PHL,117,2,2,WAS,101,1,3,3,5
1980-10-18,CHI,90,2,1,NJN,107,3,2,5,3
1980-10-18,DET,123,0,5,ATL,125,3,0,3,5
1980-10-18,GOS,108,2,1,HOU,101,2,2,4,3
1980-10-19,MIL,105,2,2,NJN,93,4,2,6,4
1980-10-19,LAL,125,4,0,GOS,107,3,1,7,1
1980-10-19,SDC,84,1,2,PHX,102,3,1,4,3
1980-10-20,UTH,92,3,2,SEA,98,2,3,5,5
1980-10-21,NYK,105,2,1,CHI,97,2,2,4,3
1980-10-21,PHX,111,4,1,DAL,99,1,4,5,5
1980-10-21,ATL,116,4,0,IND,121,3,1,7,1
1980-10-21,SAN,123,4,1,SDC,120,1,3,5,4
1980-10-21,KCK,111,2,4,GOS,116,3,2,5,6
1980-10-21,DEN,117,2,3,HOU,119,2,3,4,6
1980-10-21,POR,107,1,3,LAL,103,5,0,6,3
1980-10-21,MIL,115,3,2,CLE,95,2,4,5,6
1980-10-22,NJN,104,4,3,BOS,108,2,2,6,5
1980-10-22,WAS,109,1,4,CLE,96,2,5,3,9
1980-10-22,IND,105,4,1,MIL,119,4,2,8,3
1980-10-22,DET,93,0,6,PHL,94,3,2,3,8
1980-10-22,SEA,102,3,3,DAL,107,1,5,4,8
1980-10-23,SAN,128,5,1,GOS,109,4,2,9,3
1980-10-23,HOU,96,3,3,KCK,105,2,5,5,8
1980-10-23,BOS,107,3,2,NYK,109,3,1,6,3
1980-10-24,IND,104,4,2,ATL,97,4,1,8,3
1980-10-24,NJN,112,4,4,CLE,126,2,6,6,10
1980-10-24,POR,120,2,3,DAL,105,2,5,4,8
1980-10-24,SDC,103,1,4,UTH,100,3,3,4,7
1980-10-24,CHI,104,2,3,WAS,96,2,4,4,7
1980-10-24,LAL,104,5,1,SEA,98,3,4,8,5
1980-10-24,DEN,94,2,4,PHX,117,5,1,7,5
1980-10-25,SEA,75,3,5,PHX,100,6,1,9,6
1980-10-25,ATL,100,4,2,PHL,113,4,2,8,4
1980-10-25,CLE,118,3,6,IND,100,5,2,8,8
1980-10-25,MIL,109,5,2,CHI,93,3,3,8,5
1980-10-25,GOS,86,4,3,DAL,79,2,6,6,9
1980-10-25,KCK,125,3,5,DEN,122,2,5,5,10
1980-10-25,WAS,87,2,5,BOS,103,3,3,5,8
1980-10-25,UTH,99,3,4,LAL,127,6,1,9,5
1980-10-25,HOU,109,3,4,DET,112,0,7,3,11
1980-10-25,NYK,105,4,1,NJN,101,4,5,8,6
1980-10-25,SDC,98,2,4,SAN,116,6,1,8,5
1980-10-26,MIL,111,6,2,WAS,88,2,6,8,8
1980-10-26,LAL,102,7,1,SAN,108,7,1,14,2
1980-10-26,SEA,111,3,6,POR,98,3,3,6,9
1980-10-28,ATL,119,4,3,KCK,109,4,5,8,8
1980-10-28,SAN,120,8,1,POR,112,3,4,11,5
1980-10-28,CLE,101,4,6,PHL,119,5,2,9,8
1980-10-28,SDC,101,2,5,LAL,131,7,2,9,7
1980-10-28,CHI,99,3,4,MIL,106,7,2,10,6
1980-10-28,DAL,96,2,7,UTH,104,3,5,5,12
1980-10-28,SEA,119,4,6,GOS,102,5,3,9,9
1980-10-29,IND,102,5,3,NYK,95,5,1,10,4
1980-10-29,GOS,115,5,4,DEN,109,2,6,7,10
1980-10-29,PHL,115,6,2,CHI,102,3,5,9,7
1980-10-29,DET,85,1,7,BOS,103,4,3,5,10
1980-10-29,HOU,109,3,5,DAL,103,2,8,5,13
1980-10-29,PHX,105,7,1,SDC,89,2,6,9,7
1980-10-29,NJN,116,4,6,MIL,132,8,2,12,8
1980-10-29,UTH,109,4,5,SAN,96,9,1,13,6
1980-10-29,KCK,115,4,6,POR,98,3,5,7,11
1980-10-30,NYK,116,5,2,ATL,115,5,3,10,5
1980-10-31,CHI,114,3,6,IND,121,6,3,9,9
1980-10-31,DET,98,1,8,PHX,103,8,1,9,9
1980-10-31,BOS,115,5,3,KCK,110,5,6,10,9
1980-10-31,NJN,100,4,7,WAS,98,2,7,6,14
1980-10-31,PHL,107,7,2,ATL,96,5,4,12,6
1980-10-31,LAL,107,8,2,CLE,98,4,7,12,9
1980-10-31,SDC,120,2,7,GOS,104,6,4,8,11
1980-10-31,UTH,144,5,5,DAL,122,2,9,7,14
1980-10-31,SEA,96,5,6,SAN,112,9,2,14,8
1980-11-01,IND,113,7,3,NJN,100,5,7,12,10
1980-11-01,GOS,123,6,5,SAN,108,10,2,16,7
1980-11-01,NYK,111,6,2,WAS,93,2,8,8,10
1980-11-01,DEN,123,2,7,SEA,118,5,7,7,14
1980-11-01,CHI,122,3,7,DET,100,1,9,4,16
1980-11-01,ATL,93,5,5,MIL,99,9,2,14,7
1980-11-01,PHL,117,8,2,BOS,113,6,3,14,5
1980-11-01,POR,87,3,6,UTH,95,6,5,9,11
1980-11-01,KCK,100,5,7,PHX,127,9,1,14,8
1980-11-02,POR,102,3,7,CLE,96,4,8,7,15
1980-11-02,LAL,121,9,2,DEN,123,3,7,12,9
1980-11-02,MIL,135,10,2,IND,121,8,3,18,5
1980-11-03,SEA,118,5,8,CLE,83,4,9,9,17
1980-11-04,WAS,122,2,9,ATL,98,5,6,7,15
1980-11-04,UTH,107,7,5,KCK,104,5,8,12,13
1980-11-04,PHX,109,10,1,IND,108,8,4,18,5
1980-11-04,DAL,102,2,10,SDC,116,3,7,5,17
1980-11-04,LAL,119,9,3,POR,118,4,7,13,10
1980-11-04,MIL,96,11,2,DET,98,1,10,12,12
1980-11-05,GOS,106,7,5,CLE,98,4,10,11,15
1980-11-05,HOU,104,4,5,SDC,111,4,7,8,12
1980-11-05,KCK,111,5,9,NYK,102,7,2,12,11
1980-11-05,SAN,114,10,3,PHX,84,11,1,21,4
1980-11-05,SEA,117,6,8,DEN,125,4,7,10,15
1980-11-05,BOS,104,6,4,ATL,87,5,7,11,11
1980-11-05,PHL,107,9,2,DET,103,2,10,11,12
1980-11-05,NJN,105,5,8,CHI,120,4,7,9,15
1980-11-06,WAS,116,3,9,DAL,95,2,11,5,20
1980-11-06,UTH,112,8,5,CLE,96,4,11,12,16
1980-11-07,POR,122,4,8,GOS,113,8,5,12,13
1980-11-07,WAS,114,4,9,DET,88,2,11,6,20
1980-11-07,DEN,115,5,7,NYK,124,7,3,12,10
1980-11-07,CHI,103,5,7,ATL,100,5,8,10,15
1980-11-07,SEA,113,6,9,SDC,94,5,7,11,16
1980-11-07,BOS,101,7,4,MIL,102,11,3,18,7
1980-11-07,DAL,102,2,12,LAL,126,10,3,12,15
1980-11-07,PHL,117,10,2,KCK,100,6,9,16,11
1980-11-08,DET,101,2,12,DAL,73,2,13,4,25
1980-11-08,UTH,102,9,5,NYK,109,8,3,17,8
1980-11-08,NJN,115,5,9,ATL,111,5,9,10,18
1980-11-08,CHI,126,6,7,DEN,130,5,8,11,15
1980-11-08,GOS,118,8,6,IND,111,8,5,16,11
1980-11-08,KCK,111,6,10,CLE,106,4,12,10,22
1980-11-08,SAN,112,11,3,LAL,109,11,3,22,6
1980-11-08,POR,106,5,8,SDC,110,5,8,10,16
1980-11-08,HOU,115,4,6,PHX,116,11,2,15,8
1980-11-09,BOS,111,7,5,CHI,105,6,8,13,13
1980-11-09,MIL,121,12,3,PHL,136,11,2,23,5
1980-11-10,UTH,108,9,6,IND,106,8,6,17,12
1980-11-11,DAL,94,2,14,HOU,105,4,7,6,21
1980-11-11,SAN,113,12,3,IND,119,8,7,20,10
1980-11-11,CLE,96,4,13,MIL,100,12,4,16,17
1980-11-11,POR,101,5,9,KCK,102,7,10,12,19
1980-11-11,ATL,97,5,10,LAL,126,11,4,16,14
1980-11-11,WAS,107,5,9,DEN,92,6,8,11,17
1980-11-11,NYK,149,9,3,DET,118,3,12,12,15
1980-11-11,CHI,80,6,9,PHL,121,12,2,18,11
1980-11-11,SDC,107,6,8,PHX,109,12,2,18,10
1980-11-12,PHL,113,13,2,NYK,125,10,3,23,5
1980-11-12,DET,98,3,13,MIL,122,13,4,16,17
1980-11-12,NJN,118,6,9,DEN,111,6,9,12,18
1980-11-12,PHX,130,13,2,SAN,127,12,4,25,6
1980-11-12,HOU,107,5,7,LAL,104,12,4,17,11
1980-11-12,BOS,93,8,5,WAS,86,6,9,14,14
1980-11-12,GOS,111,9,6,KCK,101,8,10,17,16
1980-11-12,SEA,106,7,9,UTH,114,10,6,17,15
1980-11-13,SDC,107,6,9,SAN,113,12,5,18,14
1980-11-13,CLE,114,4,14,ATL,111,5,11,9,25
1980-11-13,IND,103,9,7,PHL,130,13,3,22,10
1980-11-14,BOS,126,9,5,NJN,102,7,9,16,14
1980-11-14,SEA,127,7,10,KCK,125,8,11,15,21
1980-11-14,LAL,113,12,5,SDC,100,6,10,18,15
1980-11-14,DAL,113,2,15,POR,106,5,10,7,25
1980-11-14,IND,118,9,8,WAS,108,6,10,15,18
1980-11-14,DET,106,3,14,CHI,99,6,10,9,24
1980-11-14,UTH,117,11,6,HOU,115,6,7,17,13
1980-11-14,MIL,125,14,4,NYK,106,11,3,25,7
1980-11-15,ATL,88,5,12,WAS,100,6,11,11,23
1980-11-15,SAN,120,13,5,UTH,104,12,6,25,11
1980-11-15,SEA,143,8,10,HOU,139,6,8,14,18
1980-11-15,DEN,125,6,10,POR,123,5,11,11,21
1980-11-15,GOS,119,10,6,PHX,108,14,2,24,8
1980-11-15,SDC,94,6,11,KCK,96,8,12,14,23
1980-11-15,NYK,100,11,4,CLE,95,5,14,16,18
1980-11-15,PHL,115,14,3,NJN,108,7,10,21,13
1980-11-16,NJN,89,7,11,DET,80,4,14,11,25
1980-11-16,LAL,110,13,5,DAL,102,3,15,16,20
1980-11-16,MIL,108,15,4,CHI,114,6,11,21,15
1980-11-16,PHX,119,14,3,POR,107,5,12,19,15
1980-11-18,POR,122,5,13,DEN,103,7,10,12,23
1980-11-18,HOU,138,6,9,SEA,118,9,10,15,19
1980-11-18,NYK,99,12,4,PHL,113,15,3,27,7
1980-11-18,LAL,107,14,5,KCK,94,9,12,23,17
1980-11-18,UTH,93,12,7,MIL,126,15,5,27,12
1980-11-18,CLE,104,5,15,SDC,94,6,12,11,27
1980-11-18,DET,97,4,15,IND,102,10,8,14,23
1980-11-18,CHI,112,7,11,BOS,113,10,5,17,16
1980-11-18,DAL,91,3,16,PHX,102,15,3,18,19
1980-11-18,WAS,97,7,11,GOS,103,11,6,18,17
1980-11-18,ATL,97,5,13,SAN,93,14,5,19,18
1980-11-19,PHL,110,16,3,GOS,101,12,6,28,9
1980-11-19,NJN,104,8,11,SAN,112,14,6,22,17
1980-11-19,IND,91,11,8,BOS,103,11,5,22,13
1980-11-20,DET,97,4,16,SDC,90,6,13,10,29
1980-11-20,PHX,102,16,3,LAL,99,15,5,31,8
1980-11-20,POR,93,6,13,MIL,97,16,5,22,18
1980-11-20,CLE,114,6,15,HOU,117,7,9,13,24
1980-11-21,CHI,130,7,12,NYK,121,12,5,19,17
1980-11-21,PHL,97,17,3,IND,88,11,9,28,12
1980-11-21,NJN,108,8,12,HOU,116,8,9,16,21
1980-11-21,DEN,134,7,11,KCK,121,9,13,16,24
1980-11-21,LAL,116,15,6,PHX,88,17,3,32,9
1980-11-21,DAL,91,3,17,SEA,101,9,11,12,28
1980-11-21,BOS,108,12,5,GOS,106,12,7,24,12
1980-11-21,WAS,102,7,12,SDC,90,6,14,13,26
1980-11-22,CLE,113,6,16,BOS,98,13,5,19,21
1980-11-22,IND,129,11,10,HOU,120,9,9,20,19
1980-11-22,SAN,101,15,6,PHL,108,18,3,33,9
1980-11-22,DET,117,5,16,NJN,103,8,13,13,29
1980-11-22,NYK,110,12,6,GOS,116,12,8,24,14
1980-11-22,ATL,99,6,13,UTH,93,12,8,18,21
1980-11-22,CHI,114,8,12,WAS,101,8,12,16,24
1980-11-23,LAL,94,16,6,MIL,110,17,5,33,11
1980-11-23,PHX,131,17,4,DEN,113,8,11,25,15
1980-11-23,SDC,110,6,15,SEA,99,10,11,16,26
1980-11-23,POR,116,6,14,DAL,96,3,18,9,32
1980-11-24,NYK,113,12,7,HOU,110,9,10,21,17
1980-11-25,SDC,108,7,15,DEN,94,8,12,15,27
1980-11-25,DAL,92,3,19,PHL,108,19,3,22,22
1980-11-25,ATL,112,7,13,POR,108,7,14,14,27
1980-11-26,BOS,126,13,6,POR,101,7,15,20,21
1980-11-26,IND,110,12,10,ATL,89,8,13,20,23
1980-11-26,CLE,113,7,16,NYK,119,13,7,20,23
1980-11-26,PHX,113,18,4,SEA,103,10,12,28,16
1980-11-26,KCK,118,9,14,NJN,100,8,14,17,28
1980-11-26,HOU,100,9,11,PHL,101,20,3,29,14
1980-11-26,DET,97,6,16,UTH,104,12,9,18,25
1980-11-26,DEN,113,8,13,SDC,109,8,15,16,28
1980-11-26,SAN,125,15,7,CHI,122,9,12,24,19
1980-11-27,WAS,123,8,13,IND,108,13,10,21,23
1980-11-27,GOS,119,13,8,LAL,128,16,7,29,15
1980-11-28,PHX,102,19,4,CHI,101,9,13,28,17
1980-11-28,DET,104,6,17,KCK,94,10,14,16,31
1980-11-28,CLE,126,7,17,WAS,105,9,13,16,30
1980-11-28,MIL,113,18,5,ATL,108,8,14,26,19
1980-11-28,NJN,122,8,15,UTH,95,13,9,21,24
1980-11-28,DAL,117,3,20,DEN,119,9,13,12,33
1980-11-28,BOS,120,14,6,NYK,106,14,7,28,13
1980-11-28,PHL,116,21,3,POR,103,7,16,28,19
1980-11-28,SAN,115,16,7,HOU,124,9,12,25,19
1980-11-28,SEA,92,10,13,SDC,93,8,16,18,29
1980-11-29,IND,117,13,11,CLE,101,8,17,21,28
1980-11-29,PHL,113,22,3,UTH,93,13,10,35,13
1980-11-29,NYK,111,14,8,POR,110,7,17,21,25
1980-11-29,GOS,108,13,9,PHX,113,20,4,33,13
1980-11-29,HOU,115,10,12,DAL,90,3,21,13,33
1980-11-29,DEN,123,10,13,LAL,124,17,7,27,20
1980-11-29,WAS,98,9,14,MIL,89,19,5,28,19
1980-11-29,KCK,104,10,15,SAN,106,16,8,26,23
1980-11-29,ATL,95,8,15,DET,98,7,17,15,32
1980-11-30,SDC,120,9,16,GOS,100,13,10,22,26
1980-11-30,SEA,113,10,14,NJN,89,9,15,19,29
1980-11-30,MIL,107,19,6,BOS,105,15,6,34,12
1980-11-30,LAL,108,18,7,CHI,122,9,14,27,21
1980-11-30,PHX,117,21,4,HOU,114,11,12,32,16
1980-12-02,DEN,124,10,14,CHI,129,10,14,20,28
1980-12-02,DAL,102,3,22,CLE,109,8,18,11,40
1980-12-02,ATL,112,8,16,PHL,108,23,3,31,19
1980-12-02,MIL,119,20,6,UTH,108,13,11,33,17
1980-12-02,POR,105,7,18,NJN,118,9,16,16,34
1980-12-02,NYK,96,15,8,IND,113,14,11,29,19
1980-12-02,DET,85,8,17,BOS,94,15,7,23,24
1980-12-02,WAS,107,10,14,KCK,103,10,16,20,30
1980-12-02,SAN,107,17,8,PHX,122,22,4,39,12
1980-12-03,PHL,104,23,4,NYK,98,15,9,38,13
1980-12-03,LAL,114,18,8,SDC,120,10,16,28,24
1980-12-03,KCK,103,10,17,PHX,100,23,4,33,21
1980-12-03,GOS,131,13,11,NJN,108,10,16,23,27
1980-12-03,SEA,113,11,14,CHI,105,11,14,22,28
1980-12-03,BOS,106,16,7,ATL,101,9,16,25,23
1980-12-03,IND,128,15,11,WAS,115,11,14,26,25
1980-12-03,HOU,118,11,13,CLE,109,9,18,20,31
1980-12-04,SDC,100,11,16,POR,103,7,19,18,35
1980-12-04,SAN,130,17,9,CLE,100,9,19,26,28
1980-12-04,UTH,122,13,12,DEN,118,10,15,23,27
1980-12-05,PHX,88,23,5,NJN,90,10,17,33,22
1980-12-05,WAS,103,11,15,DET,92,8,18,19,33
1980-12-05,KCK,108,11,17,HOU,100,12,13,23,30
1980-12-05,PHL,104,24,4,ATL,100,9,17,33,21
1980-12-05,BOS,97,17,7,DAL,87,3,23,20,30
1980-12-05,DEN,114,10,16,GOS,119,14,11,24,27
1980-12-05,POR,116,8,19,CHI,115,11,15,19,34
1980-12-05,MIL,102,21,6,IND,100,16,11,37,17
1980-12-06,CLE,101,9,20,DET,100,8,19,17,39
1980-12-06,HOU,111,12,14,DEN,108,10,17,22,31
1980-12-06,UTH,98,14,12,SEA,108,12,14,26,26
1980-12-06,NYK,104,15,10,MIL,94,22,6,37,16
1980-12-06,ATL,110,9,18,DAL,104,3,24,12,42
1980-12-06,IND,107,16,12,KCK,88,12,17,28,29
1980-12-06,GOS,119,15,11,LAL,103,18,9,33,20
1980-12-07,LAL,113,18,10,UTH,100,14,13,32,23
1980-12-07,PHX,106,23,6,GOS,88,16,11,39,17
1980-12-07,BOS,103,18,7,WAS,113,12,15,30,22
1980-12-07,SDC,98,11,17,NJN,95,11,17,22,34
1980-12-07,POR,116,9,19,SAN,115,18,9,27,28
1980-12-08,SEA,104,13,14,SAN,99,18,10,31,24
1980-12-09,CHI,108,11,16,PHX,123,24,6,35,22
1980-12-09,POR,111,10,19,SEA,98,14,14,24,33
1980-12-09,DAL,92,3,25,LAL,103,19,10,22,35
1980-12-09,BOS,112,18,8,MIL,89,22,7,40,15
1980-12-09,ATL,114,10,18,SDC,87,12,17,22,35
1980-12-09,NYK,107,16,10,WAS,104,13,15,29,25
1980-12-09,CLE,83,10,20,PHL,96,25,4,35,24
1980-12-09,UTH,90,14,14,SAN,115,18,11,32,25
1980-12-10,NJN,104,11,18,NYK,106,17,10,28,28
1980-12-10,GOS,103,16,12,SEA,108,14,15,30,27
1980-12-10,KCK,112,12,18,SDC,100,12,18,24,36
1980-12-10,WAS,99,13,16,BOS,101,19,8,32,24
1980-12-10,DET,92,8,20,ATL,100,11,18,19,38
1980-12-10,HOU,108,13,14,LAL,109,20,10,33,24
1980-12-10,DEN,116,10,18,DAL,107,3,26,13,44
1980-12-10,PHL,113,26,4,CHI,100,11,17,37,21
1980-12-10,IND,102,17,12,PHX,90,25,6,42,18
1980-12-11,CLE,100,10,21,IND,103,18,12,28,33
1980-12-11,SAN,122,19,11,KCK,104,13,18,32,29
1980-12-11,MIL,119,22,8,NYK,107,18,10,40,18
1980-12-12,POR,106,11,19,HOU,100,13,15,24,34
1980-12-12,BOS,119,20,8,NJN,104,11,19,31,27
1980-12-12,DET,101,8,21,CLE,95,10,22,18,43
1980-12-12,PHL,95,27,4,WAS,79,13,17,40,21
1980-12-12,CHI,118,11,18,UTH,98,14,15,25,33
1980-12-12,SEA,107,15,15,LAL,113,21,10,36,25
1980-12-12,DAL,112,3,27,SDC,109,12,19,15,46
1980-12-13,CHI,95,12,18,BOS,106,21,8,33,26
1980-12-13,CLE,110,10,23,UTH,103,14,16,24,39
1980-12-13,NYK,100,18,11,DET,94,9,21,27,32
1980-12-13,GOS,97,16,13,HOU,99,13,16,29,29
1980-12-13,KCK,114,13,19,DAL,107,4,27,17,46
1980-12-13,WAS,114,13,18,IND,105,19,12,32,30
1980-12-13,SAN,147,20,11,DEN,123,11,18,31,29
1980-12-13,ATL,122,12,18,MIL,119,23,8,35,26
1980-12-14,SDC,91,12,20,SEA,81,15,16,27,36
1980-12-14,PHX,110,25,7,POR,116,12,19,37,26
1980-12-14,NJN,107,11,20,PHL,114,28,4,39,24
1980-12-14,MIL,115,23,9,SAN,98,21,11,44,20
1980-12-14,LAL,122,22,10,GOS,113,16,14,38,24
1980-12-16,WAS,94,14,18,CHI,96,12,19,26,37
1980-12-16,DEN,118,11,19,KCK,133,14,19,25,38
1980-12-16,SDC,97,13,20,LAL,92,23,10,36,30
1980-12-16,DAL,83,4,28,SAN,89,21,12,25,40
1980-12-16,IND,107,19,13,PHL,109,29,4,48,17
1980-12-16,NYK,112,19,11,UTH,97,14,17,33,28
1980-12-16,ATL,131,13,18,NJN,114,11,21,24,39
1980-12-17,DET,103,9,22,NYK,119,20,11,29,33
1980-12-17,GOS,113,16,15,POR,115,13,19,29,34
1980-12-17,NJN,115,11,22,MIL,112,24,9,35,31
1980-12-17,HOU,107,14,16,SAN,113,22,12,36,28
1980-12-17,PHL,103,30,4,CLE,79,11,23,41,27
1980-12-17,PHX,115,25,8,DAL,102,4,29,29,37
1980-12-17,BOS,115,22,8,CHI,98,13,19,35,27
1980-12-17,SEA,101,15,17,KCK,94,15,19,30,36
1980-12-18,UTH,97,14,18,ATL,109,14,18,28,36
1980-12-18,CLE,130,11,24,DEN,122,11,20,22,44
1980-12-18,MIL,121,24,10,DET,104,9,23,33,33
1980-12-18,SDC,102,14,20,DAL,92,4,30,18,50
1980-12-19,PHX,108,26,8,UTH,90,14,19,40,27
1980-12-19,LAL,106,23,11,POR,110,14,19,37,30
1980-12-19,WAS,96,14,19,NYK,102,21,11,35,30
1980-12-19,SAN,126,23,12,GOS,111,16,16,39,28
1980-12-19,DET,109,9,24,IND,106,19,14,28,38
1980-12-19,SEA,95,16,17,ATL,92,15,18,31,35
1980-12-19,PHL,122,31,4,NJN,107,12,22,43,26
1980-12-19,CHI,129,13,20,MIL,106,25,10,38,30
1980-12-19,BOS,133,23,8,HOU,119,14,17,37,25
1980-12-20,CHI,133,14,20,HOU,109,14,18,28,38
1980-12-20,DAL,98,4,31,GOS,101,16,17,20,48
1980-12-20,KCK,103,15,20,IND,107,19,15,34,35
1980-12-20,NYK,120,22,11,DEN,114,11,21,33,32
1980-12-20,UTH,91,14,20,SDC,103,15,20,29,40
1980-12-20,CLE,102,12,24,BOS,107,24,8,36,32
1980-12-20,POR,122,15,19,ATL,119,15,19,30,38
1980-12-21,LAL,135,23,12,SAN,122,24,12,47,24
1980-12-21,MIL,123,25,11,HOU,91,14,19,39,30
1980-12-21,SDC,117,16,20,DET,97,10,24,26,44
1980-12-21,POR,100,16,19,PHX,111,27,8,43,27
1980-12-22,SEA,98,17,17,PHX,109,28,8,45,25
1980-12-23,DAL,96,4,32,UTH,101,14,21,18,53
1980-12-23,CHI,117,15,20,NYK,114,23,11,38,31
1980-12-23,PHX,113,29,8,DET,104,10,25,39,33
1980-12-23,ATL,100,15,20,WAS,83,14,20,29,40
1980-12-23,IND,125,20,15,NJN,109,12,23,32,38
1980-12-23,BOS,136,25,8,DEN,128,11,22,36,30
1980-12-23,HOU,99,14,20,GOS,114,17,17,31,37
1980-12-23,CLE,100,12,25,KCK,102,15,21,27,46
1980-12-23,POR,108,16,20,LAL,102,24,12,40,32
1980-12-25,WAS,109,14,21,NJN,94,12,24,26,45
1980-12-25,POR,115,17,20,GOS,114,18,17,35,37
1980-12-25,PHX,131,30,8,SAN,111,24,13,54,21
1980-12-25,NYK,108,23,12,BOS,117,26,8,49,20
1980-12-26,LAL,116,24,13,IND,115,21,15,45,28
1980-12-26,DAL,119,4,33,DEN,111,11,23,15,56
1980-12-26,DET,94,10,26,HOU,114,14,21,24,47
1980-12-26,CLE,98,12,26,CHI,100,16,20,28,46
1980-12-26,KCK,103,16,21,PHL,113,32,4,48,25
1980-12-26,UTH,109,15,21,GOS,110,18,18,33,39
1980-12-26,SEA,90,17,18,POR,96,18,20,35,38
1980-12-26,NJN,95,12,25,ATL,108,16,20,28,45
1980-12-27,SAN,142,24,14,UTH,117,15,22,39,36
1980-12-27,CHI,104,17,20,DET,97,10,27,27,47
1980-12-27,GOS,104,19,18,SEA,98,17,19,36,37
1980-12-27,ATL,107,17,20,BOS,112,27,8,44,28
1980-12-27,PHX,116,31,8,LAL,106,25,13,56,21
1980-12-27,MIL,112,26,11,DAL,96,5,33,31,44
1980-12-27,DEN,125,11,24,PHL,121,33,4,44,28
1980-12-27,NYK,100,23,13,KCK,99,16,22,39,35
1980-12-27,WAS,115,15,21,HOU,97,15,21,30,42
1980-12-27,SDC,121,22,29,IND,109,30,22,52,51
1980-12-28,NJN,99,12,26,KCK,102,16,23,28,49
1980-12-28,LAL,122,25,14,PHL,116,33,5,58,19
1980-12-29,CLE,112,12,27,DAL,100,5,34,17,61
1980-12-30,NYK,100,24,13,DAL,98,5,35,29,48
1980-12-30,WAS,94,16,21,MIL,115,27,11,43,32
1980-12-30,PHX,97,32,8,BOS,116,28,8,60,16
1980-12-30,HOU,104,15,22,SDC,98,17,20,32,42
1980-12-30,CHI,121,18,20,NJN,110,12,27,30,47
1980-12-30,SAN,102,25,14,SEA,100,17,20,42,34
1980-12-30,UTH,110,15,23,LAL,100,26,14,41,37
1980-12-30,KCK,104,17,23,GOS,106,20,18,37,41
1980-12-30,ATL,96,17,21,DET,89,10,28,27,49
1980-12-30,POR,109,19,20,PHL,108,33,6,52,26
1980-12-30,DEN,127,12,24,IND,110,21,16,33,40
1981-01-01,POR,122,20,20,DEN,119,13,24,33,44
1981-01-01,SDC,85,17,21,BOS,88,29,8,46,29
1981-01-01,HOU,117,16,22,UTH,103,16,23,32,45
1981-01-02,SAN,118,26,14,LAL,112,26,15,52,29
1981-01-02,KCK,101,17,24,UTH,95,16,24,33,48
1981-01-02,DAL,120,5,36,HOU,124,17,22,22,58
1981-01-02,SEA,117,17,21,PHL,120,33,7,50,28
1981-01-02,DEN,132,13,25,PHX,133,32,9,45,34
1981-01-02,ATL,106,18,21,IND,109,21,17,39,38
1981-01-02,NJN,105,12,28,CLE,111,13,27,25,55
1981-01-02,DET,102,10,29,NYK,100,25,13,35,42
1981-01-02,WAS,82,16,22,CHI,92,19,20,35,42
1981-01-02,GOS,121,21,18,BOS,106,30,8,51,26
1981-01-03,NYK,131,25,14,ATL,95,18,22,43,36
1981-01-03,CHI,111,20,20,SAN,119,27,14,47,34
1981-01-03,CLE,132,14,27,WAS,112,16,23,30,50
1981-01-03,IND,128,22,17,SDC,104,17,22,39,39
1981-01-03,GOS,105,22,18,PHL,119,34,7,56,25
1981-01-03,UTH,109,16,25,POR,103,21,20,37,45
1981-01-03,HOU,132,18,22,DEN,134,13,26,31,48
1981-01-04,NJN,104,12,29,IND,113,23,17,35,46
1981-01-04,MIL,128,28,11,SDC,95,17,23,45,34
1981-01-04,POR,111,21,21,BOS,120,30,9,51,30
1981-01-05,SEA,103,17,22,DAL,89,5,37,22,59
1981-01-06,CHI,108,20,21,SDC,93,17,24,37,45
1981-01-06,ATL,106,18,23,PHX,113,33,9,51,32
1981-01-06,NYK,108,26,14,SAN,113,28,14,54,28
1981-01-06,MIL,102,29,11,NJN,86,12,30,41,41
1981-01-06,POR,110,21,22,DET,90,11,29,32,51
1981-01-06,LAL,107,26,16,WAS,98,16,24,42,40
1981-01-07,GOS,109,22,19,DAL,111,5,38,27,57
1981-01-07,DEN,117,14,26,UTH,121,17,25,31,51
1981-01-07,PHL,135,35,7,SAN,102,29,14,64,21
1981-01-07,IND,112,24,17,NJN,103,12,31,36,48
1981-01-07,BOS,108,31,9,PHX,90,34,9,65,18
1981-01-07,SEA,99,18,22,DET,94,11,30,29,52
1981-01-07,HOU,108,18,23,KCK,114,18,24,36,47
1981-01-08,NYK,115,26,15,IND,116,25,17,51,32
1981-01-08,MIL,98,30,11,ATL,95,18,24,48,35
1981-01-08,UTH,99,18,25,DAL,97,6,38,24,63
1981-01-08,KCK,136,19,24,WAS,118,16,25,35,49
1981-01-09,SAN,102,29,15,POR,86,22,22,51,37
1981-01-09,NJN,95,12,32,PHX,112,34,10,46,42
1981-01-09,BOS,117,32,9,CHI,111,21,21,53,30
1981-01-09,PHL,107,36,7,HOU,94,18,24,54,31
1981-01-09,LAL,92,27,16,SEA,87,19,22,46,38
1981-01-09,ATL,107,18,25,CLE,108,15,27,33,52
1981-01-09,SDC,116,17,25,DEN,130,14,27,31,52
1981-01-10,CHI,102,21,22,PHL,117,37,7,58,29
1981-01-10,SEA,119,19,23,DEN,116,15,27,34,50
1981-01-10,CLE,99,16,27,NYK,104,26,16,42,43
1981-01-10,GOS,105,22,20,DET,103,11,31,33,51
1981-01-10,HOU,106,18,25,POR,105,22,23,40,48
1981-01-10,UTH,92,19,25,KCK,99,20,24,39,49
1981-01-10,NJN,115,12,33,BOS,117,33,9,45,42
1981-01-10,DAL,94,6,39,WAS,106,16,26,22,65
1981-01-10,IND,106,26,17,MIL,102,31,11,57,28
1981-01-11,KCK,105,21,24,SDC,115,17,26,38,50
1981-01-11,MIL,123,31,12,PHX,109,35,10,66,22
1981-01-11,SAN,137,30,15,WAS,106,17,26,47,41
1981-01-11,LAL,117,28,16,DET,108,11,32,39,48
1981-01-11,SEA,98,20,23,GOS,106,23,20,43,43
1981-01-13,DAL,112,6,40,CHI,106,21,23,27,63
1981-01-13,DEN,135,15,28,ATL,132,18,26,33,54
1981-01-13,NYK,89,27,16,BOS,93,34,9,61,25
1981-01-13,CLE,104,16,28,LAL,108,29,16,45,44
1981-01-13,DET,96,11,33,MIL,119,32,12,43,45
1981-01-13,PHX,104,35,11,SEA,99,20,24,55,35
1981-01-14,IND,101,27,17,DET,99,11,34,38,51
1981-01-14,HOU,109,19,25,CHI,105,21,24,40,49
1981-01-14,PHX,128,36,11,DEN,102,16,28,52,39
1981-01-14,SAN,116,31,15,NYK,105,27,17,58,32
1981-01-14,SDC,106,18,26,ATL,85,18,27,36,53
1981-01-14,GOS,107,24,20,UTH,110,19,26,43,46
1981-01-14,PHL,110,38,7,NJN,105,12,34,50,41
1981-01-14,BOS,120,35,9,CLE,113,16,29,51,38
1981-01-14,KCK,91,21,25,POR,110,22,24,43,49
1981-01-14,WAS,114,17,27,LAL,104,30,16,47,43
1981-01-15,MIL,113,33,12,PHL,110,39,7,72,19
1981-01-15,DET,89,11,35,WAS,106,18,27,29,62
1981-01-16,NJN,111,12,35,LAL,113,30,17,42,52
1981-01-16,DAL,118,7,40,NYK,110,27,18,34,58
1981-01-16,GOS,110,24,21,ATL,111,18,28,42,49
1981-01-16,IND,94,28,17,SEA,95,20,25,48,42
1981-01-16,UTH,112,20,26,SDC,109,19,26,39,52
1981-01-16,PHX,92,37,11,HOU,89,20,25,57,36
1981-01-16,MIL,118,34,12,KCK,112,21,26,55,38
1981-01-16,PHL,137,39,8,CLE,119,16,30,55,38
1981-01-16,CHI,112,21,25,POR,113,23,24,44,49
1981-01-16,BOS,94,36,9,SAN,85,32,15,68,24
1981-01-17,HOU,98,20,26,NYK,99,27,19,47,45
1981-01-17,WAS,103,19,27,SAN,93,32,16,51,43
1981-01-17,DET,104,11,36,NJN,116,12,36,23,72
1981-01-17,KCK,122,21,27,DEN,123,16,29,37,56
1981-01-17,CHI,98,21,26,CLE,110,16,31,37,57
1981-01-18,BOS,98,37,9,LAL,96,31,17,68,26
1981-01-18,IND,110,28,18,UTH,89,21,26,49,44
1981-01-18,PHL,113,40,8,SEA,92,21,25,61,33
1981-01-18,DEN,97,17,29,HOU,98,20,27,37,56
1981-01-18,MIL,110,35,12,POR,103,24,24,59,36
1981-01-18,PHX,120,38,11,ATL,86,19,28,57,39
1981-01-18,SDC,115,19,27,DAL,109,8,40,27,67
1981-01-18,WAS,110,20,27,NJN,99,13,36,33,63
1981-01-19,BOS,92,38,9,DET,90,11,37,49,46
1981-01-20,NYK,98,28,19,SEA,97,21,26,49,45
1981-01-20,WAS,121,21,27,UTH,113,21,27,42,54
1981-01-20,DAL,91,8,41,KCK,104,21,28,29,69
1981-01-20,SAN,119,32,17,PHX,112,39,11,71,28
1981-01-20,CLE,99,17,31,POR,94,24,25,41,56
1981-01-20,DET,83,11,38,PHL,75,41,8,52,46
1981-01-20,CHI,121,21,27,IND,105,29,18,50,45
1981-01-21,NJN,126,13,37,SEA,122,21,27,34,64
1981-01-21,GOS,98,24,22,MIL,105,36,12,60,34
1981-01-21,HOU,106,21,27,PHX,100,39,12,60,39
1981-01-21,BOS,117,39,9,UTH,87,21,28,60,37
1981-01-21,LAL,116,31,18,ATL,106,19,29,50,47
1981-01-21,DEN,116,17,30,SDC,125,20,27,37,57
1981-01-21,PHL,118,41,9,IND,104,29,19,70,28
1981-01-21,KCK,115,22,28,SAN,108,33,17,55,45
1981-01-22,DET,92,12,38,CHI,125,22,27,34,65
1981-01-22,CLE,108,18,31,NJN,94,14,37,32,68
1981-01-22,SDC,93,21,27,NYK,100,29,19,50,46
1981-01-22,WAS,116,22,27,PHL,128,42,9,64,36
1981-01-23,POR,117,24,26,NYK,90,30,19,54,45
1981-01-23,BOS,104,40,9,IND,103,29,20,69,29
1981-01-23,KCK,113,23,28,HOU,107,22,27,45,55
1981-01-23,WAS,103,22,28,SEA,91,21,28,43,56
1981-01-23,UTH,101,21,29,GOS,103,24,23,45,52
1981-01-23,LAL,110,32,18,DEN,105,17,31,49,49
1981-01-23,ATL,98,19,30,CLE,106,19,31,38,61
1981-01-23,PHX,131,39,13,MIL,122,37,12,76,25
1981-01-23,CHI,106,23,27,DAL,98,8,42,31,69
1981-01-24,DEN,129,17,32,SAN,115,33,18,50,50
1981-01-24,ATL,102,19,31,CHI,104,24,27,43,58
1981-01-24,GOS,117,25,23,NYK,110,30,20,55,43
1981-01-24,IND,107,29,21,DAL,89,8,43,37,64
1981-01-24,DET,117,12,39,CLE,94,20,31,32,70
1981-01-24,SDC,117,21,28,MIL,121,37,13,58,41
1981-01-24,HOU,106,22,28,UTH,91,21,30,43,58
1981-01-25,PHL,98,43,9,PHX,93,40,13,83,22
1981-01-25,NJN,100,14,38,WAS,118,23,28,37,66
1981-01-25,POR,118,25,26,SAN,100,33,19,58,45
1981-01-25,BOS,115,41,9,SEA,106,21,29,62,38
1981-01-26,UTH,102,21,31,DET,99,13,39,34,70
1981-01-26,NYK,94,30,21,PHX,99,40,14,70,35
1981-01-26,LAL,124,33,18,POR,112,26,26,59,44
1981-01-27,DAL,100,8,44,NJN,112,14,39,22,83
1981-01-27,LAL,111,34,18,UTH,104,22,31,56,49
1981-01-27,DEN,143,18,32,DET,123,13,40,31,72
1981-01-27,CLE,114,20,32,IND,109,30,21,50,53
1981-01-27,ATL,104,19,32,WAS,105,24,28,43,60
1981-01-27,SDC,119,21,29,KCK,114,24,28,45,57
1981-01-27,CHI,118,25,27,GOS,101,26,23,51,50
1981-01-28,IND,108,30,23,GOS,102,26,24,56,47
1981-01-28,BOS,104,42,9,PHL,101,44,9,86,18
1981-01-28,HOU,111,23,28,NJN,99,15,39,38,67
1981-01-28,WAS,108,25,28,PHX,98,41,14,66,42
1981-01-28,SEA,110,21,30,MIL,119,38,13,59,43
1981-01-29,UTH,99,22,32,HOU,97,24,28,46,60
1981-01-29,ATL,111,19,33,NYK,114,30,22,49,55
1981-01-29,SAN,122,33,20,NJN,108,15,40,48,60
1981-01-29,LAL,118,35,18,KCK,104,24,29,59,47
1981-01-29,DEN,131,19,32,MIL,118,39,13,58,45
1981-01-29,DET,112,13,41,GOS,117,26,25,39,66
1981-01-29,CHI,108,26,27,BOS,85,43,9,69,36
1981-01-29,SDC,106,23,29,POR,108,26,27,49,56
1981-01-29,CLE,115,21,32,PHX,111,41,15,62,47
1981-02-03,NYK,101,31,22,SDC,98,23,30,54,52
1981-02-03,ATL,93,19,34,PHL,97,44,10,63,44
1981-02-03,DAL,100,8,45,KCK,121,24,30,32,75
1981-02-03,HOU,135,24,29,DEN,128,20,32,44,61
1981-02-03,MIL,99,39,14,IND,108,31,23,70,37
1981-02-03,POR,111,27,27,WAS,104,26,28,53,55
1981-02-03,SAN,102,34,20,DET,99,13,42,47,62
1981-02-04,DEN,132,20,33,SAN,135,35,20,55,53
1981-02-04,CLE,96,22,32,CHI,109,27,27,49,59
1981-02-04,SEA,108,21,31,WAS,99,26,29,47,60
1981-02-04,PHL,107,45,10,BOS,104,43,10,88,20
1981-02-04,PHX,114,41,16,UTH,89,23,32,64,48
1981-02-04,NJN,102,15,41,SDC,110,23,31,38,72
1981-02-04,HOU,116,25,29,DAL,68,8,46,33,75
1981-02-04,KCK,91,25,30,DET,90,13,43,38,73
1981-02-04,IND,96,32,23,LAL,102,36,18,68,41
1981-02-04,GOS,115,27,25,POR,100,28,27,55,52
1981-02-05,MIL,113,39,15,BOS,103,43,11,82,26
1981-02-06,CLE,99,22,33,MIL,103,40,15,62,48
1981-02-06,SEA,92,22,31,KCK,102,26,30,48,61
1981-02-06,GOS,110,28,25,WAS,116,26,30,54,55
1981-02-06,BOS,111,43,12,IND,98,32,24,75,36
1981-02-06,DAL,98,8,47,ATL,100,19,35,27,82
1981-02-06,PHX,112,42,16,HOU,99,26,29,68,45
1981-02-06,DET,102,13,44,LAL,111,37,18,50,62
1981-02-06,SAN,122,36,20,POR,96,28,28,64,48
1981-02-06,CHI,94,28,27,NYK,112,32,22,60,49
1981-02-06,PHL,129,46,10,SDC,113,24,31,70,41
1981-02-06,UTH,116,23,33,DEN,120,20,34,43,67
1981-02-07,CHI,98,28,28,DET,90,13,45,41,73
1981-02-07,DEN,135,21,34,GOS,125,28,26,49,60
1981-02-07,NYK,113,33,22,NJN,106,15,42,48,64
1981-02-07,HOU,87,26,30,ATL,81,20,35,46,65
1981-02-07,IND,99,32,25,CLE,96,22,34,54,59
1981-02-07,SEA,96,22,32,UTH,89,23,34,45,66
1981-02-08,PHX,113,43,16,WAS,107,27,30,70,46
1981-02-08,PHL,102,47,10,LAL,99,38,18,85,28
1981-02-08,SAN,102,37,20,DAL,98,8,48,45,68
1981-02-08,NJN,102,15,43,NYK,116,34,22,49,65
1981-02-08,POR,129,28,29,KCK,123,27,30,55,59
1981-02-08,SEA,133,23,32,DEN,112,22,34,45,66
1981-02-08,MIL,128,41,15,CHI,109,29,28,70,43
1981-02-08,GOS,107,28,27,UTH,101,23,35,51,62
1981-02-08,BOS,123,44,12,SDC,107,24,32,68,44
1981-02-08,DET,101,13,46,IND,124,33,25,46,71
1981-02-10,ATL,116,20,36,GOS,108,29,27,49,63
1981-02-10,SEA,108,24,32,BOS,107,45,12,69,44
1981-02-10,DEN,110,22,35,WAS,115,27,31,49,66
1981-02-10,DAL,95,8,49,DET,101,13,47,21,96
1981-02-10,SDC,93,24,33,PHX,107,44,16,68,49
1981-02-10,CHI,116,29,29,KCK,115,27,31,56,60
1981-02-11,LAL,91,38,19,BOS,105,45,13,83,32
1981-02-11,IND,101,34,25,MIL,107,42,15,76,40
1981-02-11,KCK,99,27,32,UTH,87,23,36,50,68
1981-02-11,HOU,108,27,30,SAN,89,38,20,65,50
1981-02-11,NJN,135,15,44,CHI,133,30,29,45,73
1981-02-11,PHX,119,45,16,DAL,97,8,50,53,66
1981-02-11,PHL,122,48,10,CLE,120,22,35,70,45
1981-02-12,CLE,111,22,36,NYK,122,35,22,57,58
1981-02-12,POR,109,29,29,SEA,112,25,32,54,61
1981-02-12,SAN,110,38,21,ATL,109,21,36,59,57
1981-02-13,PHL,102,49,10,WAS,104,28,31,77,41
1981-02-13,NYK,120,36,22,DET,92,14,47,50,69
1981-02-13,KCK,113,28,32,ATL,106,21,37,49,69
1981-02-13,NJN,103,16,44,IND,100,34,26,50,70
1981-02-13,UTH,104,23,37,BOS,89,46,13,69,50
1981-02-13,HOU,105,28,30,LAL,114,38,20,66,50
1981-02-13,MIL,106,43,15,GOS,110,29,28,72,43
1981-02-13,PHX,110,46,16,SDC,94,24,34,70,50
1981-02-13,DEN,162,22,36,POR,143,29,30,51,66
1981-02-14,HOU,112,28,31,MIL,117,43,16,71,47
1981-02-14,CLE,108,22,37,GOS,90,30,28,52,65
1981-02-14,DET,105,14,48,WAS,103,29,31,43,79
1981-02-14,DAL,99,8,51,SAN,107,39,21,47,72
1981-02-14,CHI,134,30,30,SEA,117,26,32,56,62
1981-02-15,PHL,116,49,11,ATL,98,21,38,70,49
1981-02-15,PHX,101,47,16,NYK,115,37,22,84,38
1981-02-15,DEN,118,23,36,BOS,120,46,14,69,50
1981-02-15,IND,113,34,27,CHI,107,31,30,65,57
1981-02-15,SAN,110,40,21,MIL,108,44,16,84,37
1981-02-15,POR,118,29,31,UTH,84,24,37,53,68
1981-02-15,KCK,107,29,32,SEA,105,26,33,55,65
1981-02-15,LAL,107,39,20,DAL,99,8,52,47,72
1981-02-15,NJN,134,17,44,GOS,132,30,29,47,73
1981-02-17,CLE,109,23,37,DET,108,15,48,38,85
1981-02-17,SAN,116,41,21,BOS,128,47,14,88,35
1981-02-17,DAL,106,8,53,MIL,114,44,17,52,70
1981-02-17,PHX,118,47,17,GOS,109,30,30,77,47
1981-02-17,WAS,104,29,32,POR,124,30,31,59,63
1981-02-17,SDC,128,24,35,CHI,95,31,31,55,66
1981-02-17,UTH,98,24,38,SEA,101,26,34,50,72
1981-02-17,LAL,96,40,20,NYK,87,38,22,78,42
1981-02-18,IND,96,35,27,ATL,99,21,39,56,66
1981-02-18,KCK,114,30,32,BOS,113,48,14,78,46
1981-02-18,SEA,103,27,34,NYK,105,38,23,65,57
1981-02-18,GOS,103,30,31,CHI,100,31,32,61,63
1981-02-18,PHL,111,50,11,DET,97,15,49,65,60
1981-02-18,NJN,110,18,44,CLE,108,24,37,42,81
1981-02-19,SDC,116,25,35,HOU,99,28,32,53,67
1981-02-19,DET,106,15,50,POR,115,31,31,46,81
1981-02-19,WAS,129,29,33,PHL,108,51,11,80,44
1981-02-19,CLE,118,24,38,SAN,104,41,22,65,60
1981-02-19,DEN,127,32,43,PHX,126,54,21,86,64
1981-02-20,NYK,124,39,23,WAS,112,30,33,69,56
1981-02-20,PHL,117,51,12,DAL,109,8,54,59,66
1981-02-20,LAL,107,41,20,HOU,110,28,33,69,53
1981-02-20,UTH,84,24,39,CHI,92,31,33,55,72
1981-02-20,IND,109,35,28,SAN,106,41,23,76,51
1981-02-20,SEA,112,27,35,PHX,111,48,17,75,52
1981-02-20,NJN,123,19,44,POR,113,32,31,51,75
1981-02-20,KCK,112,31,32,MIL,109,45,17,76,49
1981-02-20,GOS,114,31,31,SDC,115,26,35,57,66
1981-02-21,CLE,105,25,38,ATL,118,22,39,47,77
1981-02-21,DET,119,15,51,BOS,130,48,15,63,66
1981-02-21,DEN,129,23,37,KCK,109,32,32,55,69
1981-02-22,NJN,109,20,44,DAL,132,8,55,28,99
1981-02-22,WAS,93,30,34,MIL,102,45,18,75,52
1981-02-22,CHI,116,32,33,ATL,121,23,39,55,72
1981-02-22,GOS,104,31,32,KCK,96,32,33,63,65
1981-02-22,SAN,133,41,24,DEN,129,24,37,65,61
1981-02-22,SDC,108,27,35,UTH,93,24,40,51,75
1981-02-22,NYK,93,40,23,LAL,96,41,21,81,44
1981-02-22,SEA,96,28,35,HOU,111,29,33,57,68
1981-02-22,PHX,116,48,18,PHL,110,52,12,100,30
1981-02-22,IND,109,36,28,POR,113,32,32,68,60
1981-02-23,UTH,102,24,41,HOU,106,30,33,54,74
1981-02-24,DEN,140,24,38,NJN,123,20,45,44,83
1981-02-24,DAL,84,9,55,SEA,102,28,36,37,91
1981-02-24,POR,107,33,32,SDC,121,28,35,61,67
1981-02-24,SAN,131,42,24,GOS,126,32,32,74,56
1981-02-24,CHI,97,32,34,LAL,107,42,21,74,55
1981-02-24,ATL,117,24,39,NYK,120,40,24,64,63
1981-02-25,SDC,95,29,35,PHL,107,52,13,81,48
1981-02-25,BOS,124,49,15,CLE,103,25,39,74,54
1981-02-25,UTH,132,24,42,NJN,106,20,46,44,88
1981-02-25,MIL,126,46,18,LAL,108,43,21,89,39
1981-02-25,WAS,120,30,35,NYK,105,41,24,71,59
1981-02-25,HOU,101,31,33,IND,100,36,29,67,62
1981-02-26,KCK,105,32,34,DAL,102,9,56,41,90
1981-02-26,SAN,123,43,24,SEA,113,29,36,72,60
1981-02-27,DEN,137,25,38,GOS,130,32,33,57,71
1981-02-27,CHI,112,32,35,WAS,100,31,35,63,70
1981-02-27,POR,121,33,33,PHX,117,49,18,82,51
1981-02-27,DET,118,15,52,CLE,109,25,40,40,92
1981-02-27,UTH,83,25,42,PHL,87,53,13,78,55
1981-02-27,HOU,96,32,33,SEA,92,29,37,61,70
1981-02-27,LAL,107,43,22,NJN,103,20,47,63,69
1981-02-27,DAL,111,9,57,IND,118,36,30,45,87
1981-02-27,ATL,102,24,40,BOS,132,50,15,74,55
1981-02-28,HOU,103,33,33,SDC,104,29,36,62,69
1981-02-28,KCK,101,33,34,GOS,110,32,34,65,68
1981-02-28,NYK,97,41,25,CHI,101,33,35,74,60
1981-03-01,POR,108,34,33,UTH,97,25,43,59,76
1981-03-01,ATL,108,24,41,SEA,102,29,38,53,79
1981-03-01,DAL,99,9,58,SDC,91,30,36,39,94
1981-03-01,DEN,137,26,38,CLE,127,25,41,51,79
1981-03-01,MIL,137,47,18,WAS,107,31,36,78,54
1981-03-01,SAN,102,44,24,HOU,86,33,34,77,58
1981-03-01,BOS,114,51,15,PHL,107,54,13,105,28
1981-03-01,NJN,104,20,48,DET,117,16,52,36,100
1981-03-01,LAL,96,44,22,PHX,101,49,19,93,41
1981-03-03,POR,117,35,33,IND,112,37,30,72,63
1981-03-03,UTH,93,25,44,WAS,112,31,37,56,81
1981-03-03,MIL,115,48,18,DET,98,17,52,65,70
1981-03-03,NYK,93,41,26,ATL,100,25,41,66,67
1981-03-03,DAL,105,10,58,BOS,117,52,15,62,73
1981-03-03,KCK,98,33,35,LAL,99,44,23,77,58
1981-03-03,CHI,128,34,35,NJN,102,20,49,54,84
1981-03-04,DEN,123,27,38,LAL,114,45,23,72,61
1981-03-04,SDC,103,30,37,WAS,115,32,37,62,74
1981-03-04,SEA,105,29,39,IND,93,37,31,66,70
1981-03-04,HOU,101,33,35,BOS,108,53,15,86,50
1981-03-04,GOS,107,33,34,UTH,105,25,45,58,79
1981-03-04,PHX,126,50,19,CLE,106,25,42,75,61
1981-03-04,PHL,100,54,14,CHI,111,35,35,89,49
1981-03-04,SAN,97,45,24,KCK,111,33,36,78,60
1981-03-05,UTH,100,25,46,PHX,112,51,19,76,65
1981-03-05,DET,101,17,53,NYK,104,41,27,58,80
1981-03-05,KCK,106,34,36,POR,100,36,33,70,69
1981-03-05,MIL,107,49,18,ATL,91,26,41,75,59
1981-03-06,PHL,131,54,15,DEN,112,28,38,82,53
1981-03-06,NYK,111,42,27,MIL,122,50,18,92,45
1981-03-06,IND,110,37,32,BOS,104,54,15,91,47
1981-03-06,ATL,109,26,42,NJN,106,20,50,46,92
1981-03-06,HOU,104,33,36,WAS,105,33,37,66,73
1981-03-06,GOS,115,34,34,DAL,109,10,59,44,93
1981-03-06,SEA,102,30,39,SAN,94,45,25,75,64
1981-03-06,SDC,140,30,38,CLE,125,25,43,55,81
1981-03-06,PHX,128,52,19,POR,107,36,34,88,53
1981-03-07,GOS,106,35,34,SEA,103,31,39,66,73
1981-03-07,UTH,97,25,47,SDC,94,31,38,56,85
1981-03-07,ATL,114,27,42,HOU,108,33,37,60,79
1981-03-07,DET,109,17,54,DEN,121,28,39,45,93
1981-03-08,PHL,123,55,15,MIL,100,51,18,106,33
1981-03-08,POR,120,36,35,GOS,112,36,34,72,69
1981-03-08,IND,129,38,32,DEN,119,29,39,67,71
1981-03-08,SEA,92,31,40,SDC,103,31,39,62,79
1981-03-08,KCK,105,35,36,PHX,68,53,19,88,55
1981-03-08,BOS,115,54,16,NYK,94,42,28,96,44
1981-03-08,WAS,103,34,37,CHI,99,36,35,70,72
1981-03-08,SAN,133,45,26,DAL,108,10,60,55,86
1981-03-09,MIL,118,51,19,CLE,100,25,44,76,63
1981-03-10,LAL,118,45,24,SAN,104,46,26,91,50
1981-03-10,ATL,116,28,42,CHI,118,36,36,64,78
1981-03-10,DEN,137,29,40,POR,142,37,35,66,75
1981-03-10,SDC,100,32,39,KCK,107,36,36,68,75
1981-03-10,DAL,107,10,61,PHX,103,53,20,63,81
1981-03-10,IND,102,39,32,PHL,103,56,15,95,47
1981-03-11,BOS,122,55,16,MIL,108,52,19,107,35
1981-03-11,PHL,115,57,15,NYK,95,42,29,99,44
1981-03-11,HOU,109,33,38,GOS,92,36,35,69,73
1981-03-11,DET,100,17,55,ATL,97,28,43,45,98
1981-03-11,NJN,109,20,51,WAS,104,35,37,55,88
1981-03-11,CLE,95,25,45,SEA,101,31,41,56,86
1981-03-12,SDC,116,32,40,LAL,122,46,24,78,64
1981-03-12,DAL,120,11,61,GOS,118,36,36,47,97
1981-03-12,WAS,107,35,38,IND,114,39,33,74,71
1981-03-12,MIL,131,52,20,DEN,113,29,41,81,61
1981-03-13,MIL,120,53,20,PHL,104,58,15,111,35
1981-03-13,NYK,127,42,30,CHI,117,37,36,79,66
1981-03-13,CLE,125,25,46,NJN,140,21,51,46,97
1981-03-13,ATL,119,28,44,DEN,117,29,42,57,86
1981-03-13,LAL,116,47,24,KCK,101,37,36,84,60
1981-03-13,BOS,94,56,16,IND,101,40,33,96,49
1981-03-13,HOU,126,34,38,POR,104,38,35,72,73
1981-03-13,DET,100,18,55,SEA,102,32,41,50,96
1981-03-14,HOU,101,35,38,UTH,82,26,47,61,85
1981-03-14,ATL,110,29,44,CLE,112,25,47,54,91
1981-03-14,SDC,126,32,41,SAN,118,46,27,78,68
1981-03-14,IND,94,41,33,DET,101,18,56,59,89
1981-03-15,GOS,112,36,37,SAN,114,46,28,82,65
1981-03-15,MIL,132,54,20,SEA,108,33,41,87,61
1981-03-15,BOS,133,56,17,NJN,125,22,51,78,68
1981-03-15,NYK,120,43,30,PHL,109,58,16,101,46
1981-03-15,DEN,138,29,43,HOU,127,36,38,65,81
1981-03-15,WAS,100,35,39,CLE,101,26,47,61,86
1981-03-15,KCK,87,37,37,CHI,97,37,37,74,74
1981-03-15,POR,135,38,36,DAL,110,12,61,50,97
1981-03-15,LAL,118,48,24,SDC,122,33,41,81,65
1981-03-17,NJN,126,22,52,PHL,120,58,17,80,69
1981-03-17,DAL,109,12,62,LAL,114,48,25,60,87
1981-03-17,NYK,114,44,30,IND,89,41,34,85,64
1981-03-17,CLE,122,27,47,ATL,107,29,45,56,92
1981-03-17,DEN,124,30,43,SEA,112,33,42,63,85
1981-03-17,SAN,94,47,28,UTH,86,26,48,73,76
1981-03-17,CHI,116,38,37,MIL,106,55,20,93,57
1981-03-17,POR,127,39,36,SDC,112,34,41,73,77
1981-03-17,WAS,91,35,40,BOS,112,57,17,92,57
1981-03-18,DET,118,19,56,NJN,115,23,52,42,108
1981-03-18,BOS,97,58,17,ATL,108,29,46,87,63
1981-03-18,MIL,103,55,21,NYK,116,45,30,100,51
1981-03-18,PHX,126,53,21,LAL,114,49,25,102,46
1981-03-18,KCK,124,37,38,DEN,126,31,43,68,81
1981-03-18,UTH,120,26,49,DAL,113,12,63,38,112
1981-03-18,PHL,107,58,18,IND,95,41,35,99,53
1981-03-18,GOS,118,36,38,HOU,117,36,39,72,77
1981-03-19,CLE,111,28,47,CHI,116,39,37,67,84
1981-03-19,SDC,139,34,42,GOS,113,37,38,71,80
1981-03-20,DAL,126,12,64,DEN,125,33,43,45,107
1981-03-20,CHI,120,40,37,PHL,108,59,18,99,55
1981-03-20,LAL,133,49,26,SEA,119,33,43,82,69
1981-03-20,KCK,111,37,39,SAN,114,48,28,85,67
1981-03-20,POR,107,40,36,HOU,103,36,40,76,76
1981-03-20,NJN,108,23,53,ATL,96,30,46,53,99
1981-03-20,IND,107,41,36,NYK,110,46,30,87,66
1981-03-20,BOS,128,58,18,WAS,116,35,41,93,59
1981-03-20,DET,86,20,56,MIL,104,55,22,75,78
1981-03-21,NYK,119,47,30,CLE,105,28,48,75,78
1981-03-21,DAL,105,13,64,UTH,95,27,49,40,113
1981-03-21,GOS,114,37,39,PHX,105,54,22,91,61
1981-03-21,POR,111,41,36,LAL,117,50,26,91,62
1981-03-22,DET,103,20,57,CHI,109,41,37,61,94
1981-03-22,SAN,107,49,28,SDC,99,35,42,84,70
1981-03-22,PHL,126,59,19,BOS,94,59,18,118,37
1981-03-22,DEN,113,33,44,UTH,108,27,50,60,94
1981-03-22,KCK,108,37,40,HOU,114,36,41,73,81
1981-03-22,WAS,121,35,42,ATL,101,30,47,65,89
1981-03-22,GOS,118,38,39,LAL,120,51,26,89,65
1981-03-22,IND,107,41,37,CLE,101,28,49,69,86
1981-03-22,NJN,116,24,53,MIL,125,56,22,80,75
1981-03-22,PHX,107,54,23,SEA,91,33,44,87,67
1981-03-24,NYK,116,48,30,BOS,118,59,19,107,49
1981-03-24,LAL,110,52,26,GOS,103,38,40,90,66
1981-03-24,POR,120,41,37,PHX,111,55,23,96,60
1981-03-24,MIL,131,57,22,NJN,107,24,54,81,76
1981-03-24,SDC,111,35,43,SEA,106,33,45,68,88
1981-03-24,CHI,121,42,37,CLE,108,28,50,70,87
1981-03-24,DAL,111,14,64,HOU,114,37,41,51,105
1981-03-24,UTH,92,27,51,KCK,105,37,41,64,92
1981-03-24,ATL,96,30,48,DET,91,20,58,50,106
1981-03-24,SAN,123,50,28,DEN,125,34,44,84,72
1981-03-25,WAS,105,36,42,NYK,84,48,31,84,73
1981-03-25,SEA,103,33,46,POR,112,42,37,75,83
1981-03-25,HOU,117,38,41,SAN,111,50,29,88,70
1981-03-25,PHX,101,55,24,KCK,110,38,41,93,65
1981-03-25,DEN,115,35,44,DAL,126,14,65,49,109
1981-03-25,GOS,120,38,41,SDC,114,36,43,74,84
1981-03-25,NJN,105,24,55,BOS,111,60,19,84,74
1981-03-25,PHL,114,60,19,DET,75,20,59,80,78
1981-03-26,MIL,137,58,22,CLE,109,28,51,86,73
1981-03-26,ATL,107,31,48,IND,115,42,37,73,85
1981-03-26,UTH,97,27,52,SAN,98,50,30,77,82
1981-03-27,CHI,108,43,37,ATL,83,31,49,74,86
1981-03-27,IND,122,43,37,WAS,107,37,42,80,79
1981-03-27,HOU,91,39,41,KCK,84,39,41,78,82
1981-03-27,PHX,124,55,25,SDC,100,36,44,91,69
1981-03-27,CLE,117,28,52,PHL,138,61,19,89,71
1981-03-27,DAL,109,15,65,POR,123,43,37,58,102
1981-03-27,SEA,90,33,47,LAL,97,53,26,86,73
1981-03-27,BOS,90,61,19,DET,115,20,60,81,79
1981-03-28,WAS,108,37,43,DET,103,21,60,58,103
1981-03-28,UTH,112,27,53,LAL,110,54,26,81,79
1981-03-28,NJN,88,24,56,NYK,90,48,32,72,88
1981-03-28,GOS,139,39,41,DEN,142,35,45,74,86
1981-03-29,LAL,146,54,27,DEN,148,36,45,90,72
1981-03-29,ATL,128,31,50,MIL,132,59,22,90,72
1981-03-29,SAN,135,51,30,HOU,109,40,41,91,71
1981-03-29,PHX,105,56,25,UTH,90,28,53,84,78
1981-03-29,BOS,98,61,20,PHL,94,62,19,123,39
1981-03-29,KCK,113,39,42,DAL,104,15,66,54,108
1981-03-29,SEA,96,33,48,GOS,92,39,42,72,90
1981-03-29,NYK,103,49,32,NJN,95,24,57,73,89
1981-03-29,SDC,129,36,45,POR,144,44,37,80,82
1981-03-29,IND,97,44,37,CHI,101,44,37,88,74
1981-03-29,WAS,138,38,43,CLE,103,28,53,66,96
1981-10-30,BOS,124,0,0,WAS,100,0,0,0,0
1981-10-30,POR,103,0,0,PHX,95,0,0,0,0
1981-10-30,DET,118,0,0,MIL,113,0,0,0,0
1981-10-30,KCK,102,0,0,SAN,113,0,0,0,0
1981-10-30,NJN,99,0,0,NYK,103,0,0,0,0
1981-10-30,LAL,112,0,0,HOU,113,0,0,0,0
1981-10-30,PHL,128,0,0,CLE,104,0,0,0,0
1981-10-30,UTH,105,0,0,DAL,89,0,0,0,0
1981-10-30,DEN,134,0,0,GOS,121,0,0,0,0
1981-10-30,IND,96,0,0,CHI,94,0,0,0,0
1981-10-31,SAN,145,1,0,DEN,120,1,0,2,0
1981-10-31,MIL,119,0,1,BOS,103,1,0,1,1
1981-10-31,CHI,106,0,1,DET,119,1,0,1,1
1981-10-31,NYK,99,1,0,IND,106,1,0,2,0
1981-10-31,SDC,125,0,0,HOU,110,1,0,1,0
1981-10-31,SEA,94,0,0,PHX,84,0,1,0,1
1981-10-31,ATL,106,0,0,PHL,108,1,0,1,0
1981-10-31,DAL,95,0,1,KCK,89,0,1,0,2
1981-10-31,GOS,106,0,1,UTH,91,1,0,1,1
1981-11-01,POR,104,1,0,SEA,94,1,0,2,0
1981-11-03,HOU,101,1,1,NYK,98,1,1,2,2
1981-11-03,DAL,110,1,1,CLE,125,0,1,1,2
1981-11-03,WAS,99,0,1,PHL,112,2,0,2,1
1981-11-03,POR,102,2,0,LAL,100,0,1,2,1
1981-11-03,PHX,111,0,2,SAN,88,2,0,2,2
1981-11-03,CHI,104,0,2,ATL,96,0,1,0,3
1981-11-04,BOS,115,1,1,CHI,93,1,2,2,3
1981-11-04,KCK,129,0,2,SDC,128,1,0,1,2
1981-11-04,NJN,86,0,1,ATL,95,0,2,0,3
1981-11-04,SEA,103,1,1,LAL,106,0,2,1,3
1981-11-04,SAN,128,2,1,CLE,102,1,1,3,2
1981-11-04,PHL,107,3,0,IND,99,2,0,5,0
1981-11-04,DEN,112,1,1,HOU,100,2,1,3,2
1981-11-04,GOS,108,1,1,POR,109,3,0,4,1
1981-11-05,DET,109,2,0,NJN,103,0,2,2,2
1981-11-05,PHX,121,1,2,DAL,93,1,2,2,4
1981-11-05,UTH,110,1,1,GOS,101,1,2,2,3
1981-11-05,MIL,98,1,1,WAS,90,0,2,1,3
1981-11-06,PHL,99,4,0,ATL,106,1,2,5,2
1981-11-06,POR,119,4,0,UTH,109,2,1,6,1
1981-11-06,KCK,90,1,2,HOU,86,2,2,3,4
1981-11-06,LAL,99,1,2,PHX,101,2,2,3,4
1981-11-06,CHI,114,1,3,SDC,93,1,1,2,4
1981-11-06,BOS,111,2,1,IND,94,2,1,4,2
1981-11-06,DAL,95,1,3,NYK,104,1,2,2,5
1981-11-06,WAS,86,0,3,DET,82,3,0,3,3
1981-11-06,SEA,105,1,2,DEN,109,2,1,3,3
1981-11-07,SAN,103,3,1,NYK,96,2,2,5,3
1981-11-07,UTH,95,2,2,PHX,87,3,2,5,4
1981-11-07,HOU,92,2,3,CLE,96,1,2,3,5
1981-11-07,GOS,152,1,3,DEN,107,3,1,4,4
1981-11-07,MIL,105,2,1,SDC,102,1,2,3,3
1981-11-07,CHI,118,2,3,NJN,105,0,3,2,6
1981-11-07,DET,88,3,1,BOS,129,3,1,6,2
1981-11-08,LAL,121,1,3,DAL,111,1,4,2,7
1981-11-08,POR,120,5,0,DEN,116,3,2,8,2
1981-11-08,NJN,89,0,4,IND,86,2,2,2,6
1981-11-09,CLE,102,2,2,CHI,101,3,3,5,5
1981-11-10,POR,117,6,0,DAL,95,1,5,7,5
1981-11-10,DEN,106,3,3,PHX,109,3,3,6,6
1981-11-10,GOS,113,2,3,SEA,123,1,3,3,6
1981-11-10,SDC,97,1,3,UTH,106,3,2,4,5
1981-11-10,IND,109,2,3,CLE,102,3,2,5,5
1981-11-10,NYK,111,2,3,NJN,99,1,4,3,7
1981-11-10,WAS,84,1,3,BOS,90,4,1,5,4
1981-11-10,CHI,119,3,4,KCK,107,2,2,5,6
1981-11-10,ATL,94,2,2,MIL,83,3,1,5,3
1981-11-10,DET,93,3,2,PHL,95,4,1,7,3
1981-11-10,SAN,128,4,1,LAL,102,3,3,7,4
1981-11-11,HOU,93,2,4,LAL,95,2,3,4,7
1981-11-11,NJN,88,1,5,MIL,100,3,2,4,7
1981-11-11,BOS,115,5,1,KCK,100,2,3,7,4
1981-11-11,PHL,117,5,1,CHI,90,4,4,9,5
1981-11-11,SEA,107,2,3,DAL,79,1,6,3,9
1981-11-12,DET,130,3,3,CLE,99,3,3,6,6
1981-11-12,ATL,87,3,2,WAS,95,1,4,4,6
1981-11-12,SDC,122,1,4,POR,115,7,0,8,4
1981-11-12,PHX,95,4,3,IND,93,3,3,7,6
1981-11-13,BOS,111,6,1,NJN,97,1,6,7,7
1981-11-13,LAL,119,3,4,POR,115,7,1,10,5
1981-11-13,UTH,131,4,2,DEN,124,3,4,7,6
1981-11-13,HOU,100,2,5,GOS,102,2,4,4,9
1981-11-13,SEA,112,3,3,SAN,119,5,1,8,4
1981-11-13,MIL,95,4,2,NYK,85,3,3,7,5
1981-11-13,PHL,105,6,1,KCK,85,2,4,8,5
1981-11-14,HOU,109,2,6,UTH,105,5,2,7,8
1981-11-14,CLE,91,3,4,BOS,92,7,1,10,5
1981-11-14,WAS,104,2,4,CHI,99,4,5,6,9
1981-11-14,NYK,102,3,4,PHL,109,7,1,10,5
1981-11-14,DAL,112,1,7,GOS,118,3,4,4,11
1981-11-14,PHX,97,5,3,LAL,98,4,4,9,7
1981-11-14,SDC,114,2,4,IND,123,3,4,5,8
1981-11-14,NJN,103,1,7,KCK,92,2,5,3,12
1981-11-14,ATL,104,3,3,DET,117,4,3,7,6
1981-11-15,LAL,124,5,4,IND,123,4,4,9,8
1981-11-15,POR,105,7,2,SAN,110,6,1,13,3
1981-11-15,MIL,98,5,2,CLE,96,3,5,8,7
1981-11-17,DAL,105,1,8,SAN,112,7,1,8,9
1981-11-17,CHI,95,4,6,BOS,98,8,1,12,7
1981-11-17,WAS,95,3,4,MIL,99,6,2,9,6
1981-11-17,NYK,110,3,5,KCK,124,2,6,5,11
1981-11-17,IND,82,4,5,HOU,102,3,6,7,11
1981-11-18,ATL,102,3,4,PHX,97,5,4,8,8
1981-11-18,UTH,110,5,3,LAL,113,6,4,11,7
1981-11-18,CLE,110,3,6,DET,103,5,3,8,9
1981-11-18,GOS,121,4,4,NJN,107,2,7,6,11
1981-11-18,PHL,102,8,1,MIL,100,7,2,15,3
1981-11-18,DEN,133,3,5,SDC,128,2,5,5,10
1981-11-18,BOS,104,9,1,HOU,106,4,6,13,7
1981-11-18,SAN,111,8,1,SEA,93,3,4,11,5
1981-11-19,IND,102,4,6,KCK,99,3,6,7,12
1981-11-19,SDC,100,2,6,GOS,105,5,4,7,10
1981-11-19,NYK,84,3,6,ATL,89,4,4,7,10
1981-11-19,DET,122,5,4,WAS,97,3,5,8,9
1981-11-20,CLE,94,4,6,PHL,99,9,1,13,7
1981-11-20,POR,106,7,3,NJN,86,2,8,9,11
1981-11-20,DAL,89,1,9,SEA,90,3,5,4,14
1981-11-20,CHI,103,4,7,UTH,105,5,4,9,11
1981-11-20,BOS,112,9,2,MIL,89,7,3,16,5
1981-11-20,LAL,136,7,4,SAN,116,9,1,16,5
1981-11-20,WAS,94,3,6,HOU,95,5,6,8,12
1981-11-21,GOS,129,6,4,SAN,122,9,2,15,6
1981-11-21,DAL,88,1,10,PHX,110,5,5,6,15
1981-11-21,ATL,107,5,4,IND,100,5,6,10,10
1981-11-21,NYK,118,3,7,MIL,112,7,4,10,11
1981-11-21,PHL,135,10,1,HOU,106,6,6,16,7
1981-11-21,DEN,128,4,5,KCK,121,3,7,7,12
1981-11-21,CHI,117,4,8,WAS,105,3,7,7,15
1981-11-21,DET,95,6,4,UTH,86,6,4,12,8
1981-11-21,SDC,117,2,7,LAL,119,8,4,10,11
1981-11-22,SEA,109,4,5,NJN,92,2,9,6,14
1981-11-24,ATL,94,6,4,CLE,92,4,7,10,11
1981-11-24,IND,127,5,7,NYK,112,4,7,9,14
1981-11-24,WAS,107,3,8,GOS,88,7,4,10,12
1981-11-24,MIL,103,7,5,DET,95,7,4,14,9
1981-11-24,SDC,102,2,8,CHI,109,5,8,7,16
1981-11-24,DAL,110,1,11,LAL,125,9,4,10,15
1981-11-24,HOU,84,6,7,NJN,102,2,10,8,17
1981-11-25,KCK,122,3,8,DET,129,7,5,10,13
1981-11-25,BOS,122,10,2,GOS,101,7,5,17,7
1981-11-25,PHX,128,6,5,HOU,114,6,8,12,13
1981-11-25,SAN,96,9,3,LAL,117,10,4,19,7
1981-11-25,CLE,102,4,8,IND,108,6,7,10,15
1981-11-25,DEN,139,5,5,DAL,133,1,12,6,17
1981-11-25,UTH,102,6,5,SDC,100,2,9,8,14
1981-11-25,SEA,110,5,5,POR,103,8,3,13,8
1981-11-27,DET,112,8,5,ATL,114,7,4,15,9
1981-11-27,UTH,93,7,5,POR,103,8,4,15,9
1981-11-27,SEA,117,6,5,HOU,110,6,9,12,14
1981-11-27,IND,112,7,7,PHL,124,11,1,18,8
1981-11-27,PHX,111,7,5,CHI,107,6,8,13,13
1981-11-27,MIL,96,8,5,GOS,113,7,6,15,11
1981-11-27,CLE,95,4,9,NYK,116,4,8,8,17
1981-11-27,SAN,114,9,4,NJN,86,3,10,12,14
1981-11-27,BOS,113,11,2,WAS,100,4,8,15,10
1981-11-27,LAL,129,11,4,SDC,138,2,10,13,14
1981-11-27,KCK,115,3,9,DEN,123,6,5,9,14
1981-11-28,DAL,111,1,13,NJN,107,3,11,4,24
1981-11-28,DEN,131,7,5,UTH,124,7,6,14,11
1981-11-28,SDC,122,3,10,SEA,120,7,5,10,15
1981-11-28,WAS,90,4,9,IND,92,7,8,11,17
1981-11-28,NYK,101,5,8,CLE,90,4,10,9,18
1981-11-28,PHL,116,12,1,DET,103,8,6,20,7
1981-11-28,ATL,90,8,4,BOS,98,12,2,20,6
1981-11-29,KCK,104,3,10,GOS,100,8,6,11,16
1981-11-29,LAL,122,11,5,HOU,104,6,10,17,15
1981-11-29,POR,114,9,4,CHI,109,6,9,15,13
1981-11-29,MIL,105,8,6,SAN,89,10,4,18,10
1981-12-01,NYK,112,6,8,DET,100,8,7,14,15
1981-12-01,DEN,113,8,5,POR,121,10,4,18,9
1981-12-01,HOU,104,6,11,KCK,106,4,10,10,21
1981-12-01,LAL,117,12,5,UTH,86,7,7,19,12
1981-12-01,PHX,117,8,5,SDC,94,4,10,12,15
1981-12-01,IND,90,8,8,BOS,87,13,2,21,10
1981-12-01,SEA,103,7,6,CHI,87,6,10,13,16
1981-12-01,CLE,110,4,11,MIL,126,9,6,13,17
1981-12-01,ATL,98,8,5,PHL,107,13,1,21,6
1981-12-01,WAS,99,4,10,SAN,110,10,5,14,15
1981-12-02,BOS,115,13,3,DET,114,8,8,21,11
1981-12-02,KCK,107,5,10,POR,112,11,4,16,14
1981-12-02,NJN,125,3,12,CLE,106,4,12,7,24
1981-12-02,UTH,114,7,8,DAL,103,2,13,9,21
1981-12-02,SEA,104,8,6,LAL,96,13,5,21,11
1981-12-02,PHL,101,14,1,SAN,106,11,5,25,6
1981-12-02,GOS,120,8,7,CHI,119,6,11,14,18
1981-12-03,NYK,88,7,8,WAS,114,4,11,11,19
1981-12-03,PHX,137,9,5,DEN,109,8,6,17,11
1981-12-03,SDC,113,4,11,DAL,111,2,14,6,25
1981-12-04,KCK,112,5,11,SEA,109,9,6,14,17
1981-12-04,MIL,97,10,6,ATL,80,8,6,18,12
1981-12-04,BOS,111,14,3,PHL,103,14,2,28,5
1981-12-04,UTH,101,8,8,CHI,105,6,12,14,20
1981-12-04,SAN,127,12,5,POR,111,12,4,24,9
1981-12-04,DEN,117,8,7,LAL,126,13,6,21,13
1981-12-04,IND,105,9,8,DET,95,8,9,17,17
1981-12-05,DET,108,8,10,MIL,111,11,6,19,16
1981-12-05,DAL,109,2,15,DEN,105,8,8,10,23
1981-12-05,PHX,101,10,5,UTH,99,8,9,18,14
1981-12-05,GOS,138,9,7,SDC,113,5,11,14,18
1981-12-05,HOU,110,6,12,POR,98,12,5,18,17
1981-12-05,NYK,103,7,9,BOS,83,15,3,22,12
1981-12-05,NJN,105,4,12,PHL,114,14,3,18,15
1981-12-05,WAS,94,5,11,CLE,87,4,13,9,24
1981-12-05,ATL,85,8,7,SEA,92,9,7,17,14
1981-12-06,LAL,119,14,6,KCK,106,6,11,20,17
1981-12-08,POR,108,12,6,GOS,122,10,7,22,13
1981-12-08,NYK,135,8,9,DEN,122,8,9,16,18
1981-12-08,LAL,102,15,6,WAS,98,6,11,21,17
1981-12-08,HOU,96,7,12,SEA,107,10,7,17,19
1981-12-08,DAL,128,3,15,UTH,103,8,10,11,25
1981-12-08,SDC,121,5,12,PHX,110,11,5,16,17
1981-12-08,ATL,88,8,8,NJN,98,4,13,12,21
1981-12-08,CHI,118,7,12,IND,116,10,8,17,20
1981-12-09,PHL,137,15,3,DEN,109,8,10,23,13
1981-12-09,MIL,89,12,6,HOU,83,7,13,19,19
1981-12-09,BOS,109,15,4,NJN,100,5,13,20,17
1981-12-09,CLE,112,4,14,ATL,108,8,9,12,23
1981-12-09,IND,113,10,9,UTH,77,8,11,18,20
1981-12-09,KCK,113,6,12,DAL,109,4,15,10,27
1981-12-09,GOS,134,11,7,PHX,127,11,6,22,13
1981-12-09,SAN,110,13,5,SEA,99,11,7,24,12
1981-12-10,DET,101,8,11,NYK,106,9,9,17,20
1981-12-10,PHX,117,11,7,POR,110,12,7,23,14
1981-12-11,NJN,131,5,14,DEN,123,8,11,13,25
1981-12-11,UTH,122,8,12,KCK,102,7,12,15,24
1981-12-11,DAL,99,4,16,SAN,101,14,5,18,21
1981-12-11,BOS,94,16,4,ATL,86,8,10,24,14
1981-12-11,MIL,103,13,6,IND,100,11,9,24,15
1981-12-11,CHI,118,8,12,HOU,105,7,14,15,26
1981-12-11,PHL,131,16,3,CLE,113,5,14,21,17
1981-12-11,LAL,124,16,6,POR,116,12,8,28,14
1981-12-11,SDC,102,6,12,WAS,106,6,12,12,24
1981-12-12,CLE,115,5,15,DEN,120,8,12,13,27
1981-12-12,HOU,101,7,15,DAL,97,4,17,11,32
1981-12-12,NYK,86,10,9,MIL,104,14,6,24,15
1981-12-12,PHX,98,12,7,WAS,105,7,12,19,19
1981-12-12,CHI,114,9,12,PHL,117,17,3,26,15
1981-12-12,GOS,98,12,7,KCK,96,7,13,19,20
1981-12-12,SEA,117,11,8,DET,111,8,12,19,20
1981-12-12,IND,101,11,10,NJN,88,6,14,17,24
1981-12-12,ATL,108,8,11,BOS,97,17,4,25,15
1981-12-12,SAN,111,15,5,UTH,97,9,12,24,17
1981-12-13,POR,105,12,9,DET,99,8,13,20,22
1981-12-13,SEA,98,12,8,SDC,74,6,13,18,21
1981-12-13,LAL,122,17,6,GOS,118,13,7,30,13
1981-12-13,MIL,127,15,6,PHL,108,18,3,33,9
1981-12-15,CHI,98,9,13,CLE,89,5,16,14,29
1981-12-15,ATL,111,9,11,NYK,98,10,10,19,21
1981-12-15,GOS,104,13,8,DET,108,8,14,21,22
1981-12-15,WAS,102,8,12,DAL,107,4,18,12,30
1981-12-15,DEN,120,9,12,SEA,126,13,8,22,20
1981-12-15,POR,118,13,9,SDC,101,6,14,19,23
1981-12-15,HOU,99,8,15,PHX,95,12,8,20,23
1981-12-15,IND,96,12,10,MIL,104,16,6,28,16
1981-12-15,UTH,108,9,13,SAN,103,16,5,25,18
1981-12-16,CLE,102,5,17,WAS,106,8,13,13,30
1981-12-16,PHL,115,18,4,NYK,117,10,11,28,15
1981-12-16,NJN,97,6,15,CHI,98,10,13,16,28
1981-12-16,KCK,97,7,14,PHX,81,12,9,19,23
1981-12-16,BOS,109,17,5,DAL,92,5,18,22,23
1981-12-17,GOS,120,13,9,LAL,115,18,6,31,15
1981-12-17,SDC,92,6,15,SEA,106,14,8,20,23
1981-12-17,DEN,138,9,13,ATL,103,10,11,19,24
1981-12-17,DET,96,9,14,IND,100,12,11,21,25
1981-12-18,DAL,93,5,19,HOU,112,9,15,14,34
1981-12-18,KCK,100,8,14,UTH,95,10,13,18,27
1981-12-18,WAS,98,9,13,BOS,99,18,5,27,18
1981-12-18,NYK,121,11,11,CHI,106,11,13,22,24
1981-12-18,MIL,88,17,6,NJN,100,6,16,23,22
1981-12-18,SAN,104,16,6,PHX,108,12,10,28,16
1981-12-18,IND,109,13,11,CLE,73,5,18,18,29
1981-12-19,PHL,123,18,5,BOS,118,19,5,37,10
1981-12-19,GOS,126,14,9,ATL,109,10,12,24,21
1981-12-19,CLE,107,5,19,NJN,119,7,16,12,35
1981-12-19,SDC,100,6,16,LAL,106,18,7,24,23
1981-12-19,UTH,103,10,14,SEA,115,15,8,25,22
1981-12-19,HOU,102,10,15,CHI,95,11,14,21,29
1981-12-19,DET,132,9,15,NYK,104,12,11,21,26
1981-12-19,PHX,95,13,10,KCK,87,9,14,22,24
1981-12-19,DEN,138,10,13,SAN,125,16,7,26,20
1981-12-19,DAL,102,5,20,POR,95,14,9,19,29
1981-12-20,LAL,112,19,7,ATL,94,10,13,29,20
1981-12-22,POR,110,14,10,LAL,124,20,7,34,17
1981-12-22,IND,92,14,11,ATL,88,10,14,24,25
1981-12-22,BOS,120,19,6,CLE,116,5,20,24,26
1981-12-22,MIL,101,17,7,KCK,106,9,15,26,22
1981-12-22,CHI,92,11,15,WAS,90,9,14,20,29
1981-12-22,DAL,98,6,20,DET,106,10,15,16,35
1981-12-22,HOU,109,11,15,DEN,121,11,13,22,28
1981-12-22,NYK,105,12,12,PHL,112,19,5,31,17
1981-12-23,NJN,115,8,16,NYK,99,12,13,20,29
1981-12-23,PHX,118,14,10,GOS,103,15,9,29,19
1981-12-23,DEN,119,12,13,DET,124,11,15,23,28
1981-12-23,SEA,113,16,8,UTH,99,10,15,26,23
1981-12-23,CLE,114,5,21,KCK,95,10,15,15,36
1981-12-23,SDC,109,6,17,SAN,114,16,8,22,25
1981-12-25,POR,99,14,11,SEA,94,17,8,31,19
1981-12-25,WAS,115,9,15,IND,98,15,11,24,26
1981-12-25,NYK,95,12,14,NJN,96,9,16,21,30
1981-12-25,PHX,101,15,10,LAL,104,21,7,36,17
1981-12-26,DET,96,12,15,CHI,94,12,15,24,30
1981-12-26,CLE,102,6,21,MIL,109,17,8,23,29
1981-12-26,IND,106,15,12,NYK,112,12,15,27,27
1981-12-26,DAL,117,6,21,DEN,124,12,14,18,35
1981-12-26,SDC,116,6,18,POR,128,15,11,21,29
1981-12-26,UTH,104,10,16,HOU,115,11,16,21,32
1981-12-26,GOS,112,15,10,PHX,96,15,11,30,21
1981-12-26,KCK,119,10,16,BOS,124,20,6,30,22
1981-12-26,SAN,97,17,8,ATL,105,10,15,27,23
1981-12-26,NJN,90,10,16,WAS,105,10,15,20,31
1981-12-27,LAL,139,22,7,SDC,117,6,19,28,26
1981-12-27,PHX,99,15,12,PHL,96,20,5,35,17
1981-12-27,MIL,108,18,8,CHI,96,12,16,30,24
1981-12-28,NJN,95,10,17,IND,103,15,13,25,30
1981-12-28,SEA,104,17,9,GOS,100,16,10,33,19
1981-12-29,DEN,128,13,14,BOS,123,21,6,34,20
1981-12-29,GOS,135,16,11,PHL,142,20,6,36,17
1981-12-29,LAL,121,23,7,UTH,114,10,17,33,24
1981-12-29,WAS,129,11,15,DET,125,13,15,24,30
1981-12-29,HOU,93,12,16,ATL,102,11,15,23,31
1981-12-29,DAL,104,6,22,KCK,92,10,17,16,39
1981-12-29,CHI,108,12,17,NYK,111,13,15,25,32
1981-12-29,IND,96,16,13,MIL,107,19,8,35,21
1981-12-29,SAN,119,17,9,SDC,107,6,20,23,29
1981-12-30,KCK,120,10,18,DEN,116,14,14,24,32
1981-12-30,MIL,107,20,8,WAS,103,12,15,32,23
1981-12-30,ATL,91,12,15,SDC,94,6,21,18,36
1981-12-30,CLE,108,6,22,NYK,110,14,15,20,37
1981-12-30,UTH,110,10,18,BOS,121,21,7,31,25
1981-12-30,SEA,99,18,9,PHL,102,21,6,39,15
1981-12-30,PHX,113,16,12,POR,112,16,11,32,23
1981-12-30,SAN,109,18,9,HOU,104,12,17,30,26
1981-12-30,NJN,130,10,18,DET,119,13,16,23,34
1982-01-01,POR,105,16,12,PHL,120,22,6,38,18
1982-01-01,GOS,125,16,12,KCK,93,11,18,27,30
1982-01-02,SDC,101,7,21,HOU,108,12,18,19,39
1982-01-02,NYK,121,15,15,DET,108,13,17,28,32
1982-01-02,CHI,121,12,18,MIL,128,21,8,33,26
1982-01-02,CLE,103,6,23,BOS,106,22,7,28,30
1982-01-02,PHX,120,17,12,SEA,97,18,10,35,22
1982-01-02,ATL,97,12,16,NJN,95,11,18,23,34
1982-01-02,IND,103,16,14,WAS,107,12,16,28,30
1982-01-02,GOS,119,17,12,DAL,100,7,22,24,34
1982-01-02,UTH,107,10,19,PHL,109,23,6,33,25
1982-01-02,SAN,148,19,9,DEN,133,14,15,33,24
1982-01-03,MIL,122,22,8,DEN,128,14,16,36,24
1982-01-03,POR,127,16,13,KCK,116,11,19,27,32
1982-01-03,LAL,90,24,7,SEA,110,18,11,42,18
1982-01-05,WAS,108,13,16,NJN,114,11,19,24,35
1982-01-05,ATL,113,13,16,CLE,103,6,24,19,40
1982-01-05,POR,115,17,13,SAN,110,20,9,37,22
1982-01-05,MIL,102,22,9,NYK,112,16,15,38,24
1982-01-05,SDC,112,7,22,KCK,104,11,20,18,42
1982-01-05,IND,87,16,15,PHX,82,18,12,34,27
1982-01-05,GOS,111,18,12,HOU,112,13,18,31,30
1982-01-05,DET,124,13,18,PHL,101,24,6,37,24
1982-01-05,CHI,134,12,19,DEN,128,15,16,27,35
1982-01-06,UTH,130,10,20,SAN,115,20,10,30,30
1982-01-06,NJN,95,12,19,MIL,109,22,10,34,29
1982-01-06,BOS,102,23,7,CHI,116,13,19,36,26
1982-01-06,DEN,136,15,17,SDC,114,8,22,23,39
1982-01-06,PHL,126,24,7,WAS,112,13,17,37,24
1982-01-06,SEA,107,19,11,DAL,100,7,23,26,34
1982-01-07,SDC,112,8,23,DAL,113,7,24,15,47
1982-01-07,KCK,107,11,21,NYK,103,17,15,28,36
1982-01-07,SEA,116,20,11,HOU,107,14,18,34,29
1982-01-07,GOS,112,18,13,SAN,123,20,11,38,24
1982-01-07,CLE,100,6,25,WAS,109,13,18,19,43
1982-01-07,DET,94,14,18,PHX,110,18,13,32,31
1982-01-08,MIL,88,23,10,ATL,90,14,16,37,26
1982-01-08,BOS,96,23,8,PHL,90,25,7,48,15
1982-01-08,CHI,119,14,19,LAL,113,24,8,38,27
1982-01-08,NJN,110,12,20,CLE,100,6,26,18,46
1982-01-08,POR,121,18,13,DEN,124,16,17,34,30
1982-01-08,UTH,108,11,20,IND,102,17,15,28,35
1982-01-09,PHL,113,25,8,NJN,120,13,20,38,28
1982-01-09,DEN,110,17,17,SEA,125,21,11,38,28
1982-01-09,GOS,115,18,14,IND,106,17,16,35,30
1982-01-09,SDC,125,8,24,UTH,118,12,20,20,44
1982-01-09,ATL,102,15,16,NYK,89,17,16,32,32
1982-01-09,DET,127,14,19,LAL,130,24,9,38,28
1982-01-09,DAL,105,8,24,PHX,101,19,13,27,37
1982-01-09,SAN,113,21,11,KCK,100,12,21,33,32
1982-01-10,MIL,118,23,11,LAL,107,25,9,48,20
1982-01-10,BOS,134,24,8,DET,124,14,20,38,28
1982-01-10,POR,109,18,14,HOU,111,14,19,32,33
1982-01-10,NYK,126,17,17,WAS,129,14,18,31,35
1982-01-11,NJN,94,14,20,BOS,112,25,8,39,28
1982-01-12,DEN,139,17,18,KCK,126,12,22,29,40
1982-01-12,WAS,92,15,18,PHL,95,25,9,40,27
1982-01-12,UTH,121,12,21,NYK,129,17,18,29,39
1982-01-12,POR,105,18,15,IND,93,17,17,35,32
1982-01-12,HOU,107,15,19,SDC,106,9,24,24,43
1982-01-12,CLE,100,6,27,LAL,114,25,10,31,37
1982-01-12,PHX,133,19,14,GOS,121,19,14,38,28
1982-01-12,SAN,127,22,11,DAL,109,9,24,31,35
1982-01-12,CHI,111,15,19,DET,122,14,21,29,40
1982-01-13,GOS,143,19,15,DEN,128,18,18,37,33
1982-01-13,PHL,107,26,9,MIL,111,24,11,50,20
1982-01-13,SEA,106,22,11,IND,86,17,18,39,29
1982-01-13,KCK,117,12,23,CLE,104,6,28,18,51
1982-01-13,DAL,102,9,25,SDC,105,9,25,18,50
1982-01-13,BOS,116,26,8,ATL,95,16,16,42,24
1982-01-14,PHX,90,20,14,NYK,89,18,18,38,32
1982-01-14,DET,114,15,21,WAS,121,15,19,30,40
1982-01-14,HOU,100,16,19,POR,111,19,15,35,34
1982-01-14,NJN,130,14,21,CHI,104,15,20,29,41
1982-01-15,MIL,122,25,11,BOS,118,27,8,52,19
1982-01-15,PHL,90,26,10,ATL,96,16,17,42,27
1982-01-15,SDC,117,10,25,CLE,108,6,29,16,54
1982-01-15,DEN,128,18,19,DAL,113,9,26,27,45
1982-01-15,GOS,104,20,15,NYK,102,18,19,38,34
1982-01-15,IND,92,17,19,LAL,97,26,10,43,29
1982-01-15,SEA,115,23,11,UTH,103,12,22,35,33
1982-01-15,SAN,128,23,11,HOU,90,16,20,39,31
1982-01-15,WAS,93,16,19,CHI,90,15,21,31,40
1982-01-15,KCK,114,13,23,NJN,104,15,21,28,44
1982-01-16,DET,120,15,22,BOS,128,27,9,42,31
1982-01-16,UTH,120,12,23,CLE,125,6,30,18,53
1982-01-16,PHX,106,21,14,SDC,87,11,25,32,39
1982-01-16,HOU,116,16,21,SAN,99,24,11,40,32
1982-01-16,DAL,103,9,27,POR,110,20,15,29,42
1982-01-17,NJN,105,15,22,PHL,97,26,11,41,33
1982-01-17,WAS,96,17,19,ATL,78,17,17,34,36
1982-01-17,IND,116,17,20,CHI,103,15,22,32,42
1982-01-17,MIL,103,26,11,DET,108,15,23,41,34
1982-01-17,KCK,97,14,23,LAL,109,27,10,41,33
1982-01-17,SDC,131,11,26,DEN,138,19,19,30,45
1982-01-17,SEA,122,25,12,GOS,97,21,16,46,28
1982-01-19,CHI,110,15,23,IND,100,18,20,33,43
1982-01-19,ATL,112,17,18,POR,101,21,15,38,33
1982-01-19,UTH,123,12,24,DET,117,16,23,28,47
1982-01-19,CLE,97,7,30,SEA,99,24,11,31,41
1982-01-19,DEN,140,20,19,LAL,139,28,10,48,29
1982-01-19,NYK,107,18,20,BOS,111,28,9,46,29
1982-01-19,HOU,120,17,21,KCK,112,14,24,31,45
1982-01-19,PHX,108,22,14,SAN,96,24,12,46,26
1982-01-20,WAS,106,18,19,SEA,95,25,11,43,30
1982-01-20,PHL,115,26,12,POR,110,21,16,47,28
1982-01-20,LAL,132,28,11,NJN,113,16,22,44,33
1982-01-20,BOS,112,29,9,IND,103,18,21,47,30
1982-01-20,DAL,109,9,28,MIL,104,26,12,35,40
1982-01-20,GOS,99,21,15,SDC,108,11,27,32,42
1982-01-21,SDC,110,12,27,DET,120,16,24,28,51
1982-01-21,KCK,94,14,25,DAL,110,10,28,24,53
1982-01-21,NYK,104,18,21,ATL,101,18,18,36,39
1982-01-21,SAN,123,24,13,UTH,104,13,24,37,37
1982-01-22,IND,105,18,22,PHL,112,27,12,45,34
1982-01-22,ATL,107,18,19,SAN,115,25,13,43,32
1982-01-22,WAS,110,19,19,POR,97,21,17,40,36
1982-01-22,LAL,123,29,11,DET,111,17,24,46,35
1982-01-22,PHX,97,23,14,NJN,99,16,23,39,37
1982-01-22,DEN,125,21,19,MIL,131,26,13,47,32
1982-01-22,HOU,128,18,21,UTH,110,13,25,31,46
1982-01-22,BOS,106,30,9,SEA,118,26,12,56,21
1982-01-22,CHI,108,16,23,CLE,93,7,31,23,54
1982-01-23,SAN,98,26,13,IND,107,18,23,44,36
1982-01-23,SDC,109,12,28,NJN,113,17,23,29,51
1982-01-23,CLE,99,7,32,ATL,109,18,20,25,52
1982-01-23,HOU,109,19,21,DEN,111,21,20,40,41
1982-01-23,KCK,106,14,26,WAS,109,20,19,34,45
1982-01-23,NYK,139,19,21,CHI,140,17,23,36,44
1982-01-23,GOS,119,21,17,MIL,113,27,13,48,30
1982-01-23,DAL,122,11,28,UTH,110,13,26,24,54
1982-01-23,PHX,113,23,15,DET,90,17,25,40,40
1982-01-23,PHL,100,28,12,SEA,87,27,12,55,24
1982-01-24,BOS,119,30,10,POR,123,21,18,51,28
1982-01-25,NYK,99,19,22,SEA,113,27,13,46,35
1982-01-26,LAL,94,30,11,MIL,96,27,14,57,25
1982-01-26,ATL,88,19,20,DAL,90,12,28,31,48
1982-01-26,HOU,104,19,22,IND,94,19,23,38,45
1982-01-26,WAS,94,21,19,CHI,84,18,23,39,42
1982-01-26,UTH,129,13,27,NJN,138,18,23,31,50
1982-01-26,SAN,103,26,14,PHL,95,29,12,55,26
1982-01-27,KCK,103,14,27,SEA,110,28,13,42,40
1982-01-27,SDC,99,12,29,PHX,92,24,15,36,44
1982-01-27,BOS,131,30,11,NYK,99,19,23,49,34
1982-01-27,CLE,110,7,33,GOS,106,22,17,29,50
1982-01-27,DEN,130,22,20,NJN,116,19,23,41,43
1982-01-27,DET,108,17,26,ATL,107,19,21,36,47
1982-01-27,DAL,86,13,28,PHL,99,29,13,42,41
1982-01-28,CHI,110,18,24,GOS,111,22,18,40,42
1982-01-28,CLE,104,8,33,BOS,116,31,11,39,44
1982-01-28,POR,96,22,18,SDC,93,13,29,35,47
1982-01-28,HOU,109,20,22,PHL,101,30,13,50,35
1982-01-28,SAN,126,27,14,KCK,115,14,28,41,42
1982-01-28,LAL,97,30,12,PHX,87,24,16,54,28
1982-01-28,WAS,98,22,19,NYK,102,19,24,41,43
1982-01-28,UTH,101,13,28,MIL,119,28,14,41,42
1982-02-02,HOU,122,21,22,SDC,106,13,30,34,52
1982-02-02,CHI,112,18,25,NJN,116,19,24,37,49
1982-02-02,POR,102,23,18,KCK,97,14,29,37,47
1982-02-02,GOS,119,23,18,LAL,117,31,12,54,30
1982-02-02,IND,105,19,24,BOS,109,32,11,51,35
1982-02-02,DEN,128,23,20,NYK,117,20,24,43,44
1982-02-02,ATL,105,19,22,DET,106,18,26,37,48
1982-02-02,WAS,99,22,20,CLE,100,8,34,30,54
1982-02-02,SAN,103,28,14,DAL,98,13,29,41,43
1982-02-03,LAL,94,31,13,NYK,98,20,25,51,38
1982-02-03,SEA,97,29,13,KCK,87,14,30,43,43
1982-02-03,MIL,113,29,14,CHI,98,18,26,47,40
1982-02-03,DAL,106,13,30,SDC,113,13,31,26,61
1982-02-03,PHL,122,30,14,WAS,96,22,21,52,35
1982-02-03,UTH,122,13,29,POR,118,24,18,37,47
1982-02-03,NJN,112,20,24,ATL,103,19,23,39,47
1982-02-03,CLE,108,9,34,IND,104,19,25,28,59
1982-02-03,PHX,88,24,17,GOS,90,24,18,48,35
1982-02-04,SAN,118,29,14,PHX,112,24,18,53,32
1982-02-04,IND,131,19,26,DEN,114,24,20,43,46
1982-02-05,GOS,99,25,18,SEA,108,30,13,55,31
1982-02-05,SDC,85,14,31,NYK,90,21,25,35,56
1982-02-05,CHI,103,18,27,DET,110,19,26,37,53
1982-02-05,POR,121,24,19,UTH,100,14,29,38,48
1982-02-05,PHL,116,31,14,NJN,112,21,24,52,38
1982-02-05,BOS,145,33,11,DEN,144,24,21,57,32
1982-02-05,HOU,106,22,22,PHX,104,24,19,46,41
1982-02-05,WAS,87,22,22,LAL,90,31,14,53,36
1982-02-05,MIL,117,30,14,DAL,92,13,31,43,45
1982-02-05,KCK,109,14,31,SAN,102,30,14,44,45
1982-02-06,SEA,129,31,13,UTH,103,14,30,45,43
1982-02-06,ATL,87,19,24,CLE,88,10,34,29,58
1982-02-06,IND,89,20,26,DAL,95,13,32,33,58
1982-02-06,DET,120,20,26,NJN,125,21,25,41,51
1982-02-07,WAS,115,22,23,DEN,124,24,22,46,45
1982-02-07,MIL,107,31,14,PHX,92,24,20,55,34
1982-02-07,CLE,94,11,34,NJN,110,22,25,33,59
1982-02-07,SEA,99,32,13,SDC,97,14,32,46,45
1982-02-07,GOS,116,25,19,SAN,111,30,15,55,34
1982-02-07,KCK,110,15,31,HOU,126,23,22,38,53
1982-02-07,PHL,123,32,14,CHI,107,18,28,50,42
1982-02-07,POR,100,25,19,NYK,98,22,25,47,44
1982-02-07,BOS,113,34,11,LAL,119,32,14,66,25
1982-02-09,DET,128,20,27,CHI,123,18,29,38,56
1982-02-09,SAN,110,30,16,WAS,112,22,24,52,40
1982-02-09,UTH,123,14,31,GOS,107,26,19,40,50
1982-02-09,ATL,117,19,25,LAL,130,33,14,52,39
1982-02-09,IND,101,20,27,MIL,108,32,14,52,41
1982-02-09,SDC,121,14,33,HOU,129,24,22,38,55
1982-02-09,SEA,114,33,13,NYK,105,22,26,55,39
1982-02-10,CLE,91,11,35,POR,105,26,19,37,54
1982-02-10,CHI,91,18,30,ATL,73,19,26,37,56
1982-02-10,KCK,125,15,32,LAL,102,34,14,49,46
1982-02-10,DAL,102,14,32,WAS,119,23,24,37,56
1982-02-10,PHL,102,33,14,IND,96,20,28,53,42
1982-02-10,PHX,112,24,21,BOS,110,34,12,58,33
1982-02-10,NJN,115,23,25,DET,108,21,27,44,52
1982-02-10,DEN,148,25,22,UTH,151,15,31,40,53
1982-02-11,HOU,117,25,22,SEA,100,34,13,59,35
1982-02-11,DET,123,21,28,CLE,113,11,36,32,64
1982-02-11,NYK,120,22,27,GOS,117,26,20,48,47
1982-02-11,MIL,116,33,14,POR,105,27,19,60,33
1982-02-12,KCK,114,16,32,UTH,129,16,31,32,63
1982-02-12,PHX,94,25,21,ATL,90,19,27,44,48
1982-02-12,LAL,94,34,15,SAN,100,30,17,64,32
1982-02-12,NJN,109,24,25,GOS,98,26,21,50,46
1982-02-12,DAL,103,14,33,SEA,100,34,14,48,47
1982-02-12,SDC,116,14,34,BOS,129,34,13,48,47
1982-02-13,CLE,109,11,37,IND,110,20,29,31,66
1982-02-13,DET,120,22,28,POR,128,27,20,49,48
1982-02-13,NYK,107,23,27,PHL,114,34,14,57,41
1982-02-13,DEN,146,25,23,SDC,129,14,35,39,58
1982-02-13,HOU,111,26,22,WAS,104,24,24,50,46
1982-02-13,UTH,120,17,31,PHX,115,26,21,43,52
1982-02-13,CHI,90,19,30,MIL,120,34,14,53,44
1982-02-14,LAL,103,34,16,BOS,108,35,13,69,29
1982-02-14,CLE,97,11,38,MIL,125,35,14,46,52
1982-02-14,PHL,117,35,14,NYK,105,23,28,58,42
1982-02-14,IND,107,21,29,POR,91,28,20,49,49
1982-02-14,SAN,114,31,17,SEA,94,34,15,65,32
1982-02-14,NJN,109,25,25,DAL,111,15,33,40,58
1982-02-14,KCK,93,16,33,GOS,103,26,22,42,55
1982-02-15,UTH,134,18,31,DEN,145,26,23,44,54
1982-02-16,POR,97,28,21,WAS,100,24,25,52,46
1982-02-16,SDC,91,14,36,ATL,102,19,28,33,64
1982-02-16,CHI,86,19,31,PHX,91,26,22,45,53
1982-02-16,DET,111,22,29,HOU,109,27,22,49,51
1982-02-16,NYK,110,23,29,DAL,112,16,33,39,62
1982-02-16,DEN,119,27,23,KCK,106,16,34,43,57
1982-02-16,LAL,108,34,17,SEA,101,34,16,68,33
1982-02-17,KCK,110,16,35,PHX,107,27,22,43,57
1982-02-17,SAN,126,32,17,DET,112,23,29,55,46
1982-02-17,GOS,121,27,22,BOS,105,36,13,63,35
1982-02-17,NJN,115,25,26,CHI,105,19,32,44,58
1982-02-17,PHL,114,36,14,DAL,109,17,33,53,47
1982-02-17,CLE,102,11,39,HOU,110,27,23,38,62
1982-02-17,MIL,104,36,14,IND,93,22,29,58,43
1982-02-17,UTH,109,18,32,ATL,117,20,28,38,60
1982-02-18,SEA,105,34,17,WAS,87,25,25,59,42
1982-02-18,IND,119,22,30,SDC,114,14,37,36,67
1982-02-19,POR,117,28,22,BOS,127,36,14,64,36
1982-02-19,NYK,90,23,30,PHX,104,27,23,50,53
1982-02-19,SEA,122,35,17,ATL,127,21,28,56,45
1982-02-19,LAL,126,35,17,GOS,106,28,22,63,39
1982-02-19,NJN,96,26,26,HOU,103,28,23,54,49
1982-02-19,PHL,132,37,14,UTH,117,18,33,55,47
1982-02-19,MIL,106,37,14,CLE,88,11,40,48,54
1982-02-19,DEN,121,28,23,SAN,126,33,17,61,40
1982-02-19,KCK,113,17,35,SDC,97,14,38,31,73
1982-02-20,SAN,101,34,17,SDC,118,14,39,48,56
1982-02-20,GOS,110,28,23,WAS,102,25,26,53,49
1982-02-20,NJN,125,26,27,UTH,108,18,34,44,61
1982-02-20,CLE,116,11,41,DAL,109,17,34,28,75
1982-02-20,DET,115,23,30,IND,100,23,30,46,60
1982-02-21,SEA,103,35,18,BOS,100,37,14,72,32
1982-02-21,NYK,122,23,31,HOU,106,29,23,52,54
1982-02-21,CHI,97,19,33,DAL,113,17,35,36,68
1982-02-21,POR,97,28,23,ATL,109,22,28,50,51
1982-02-21,IND,118,23,31,NJN,107,27,27,50,58
1982-02-21,PHL,109,38,14,PHX,102,28,23,66,37
1982-02-21,DEN,131,28,24,LAL,132,36,17,64,41
1982-02-21,KCK,104,18,35,MIL,110,38,14,56,49
1982-02-23,ATL,103,23,28,KCK,94,18,36,41,64
1982-02-23,CHI,123,19,34,POR,122,28,24,47,58
1982-02-23,LAL,145,37,17,DEN,129,28,25,65,42
1982-02-23,NYK,113,24,31,MIL,110,39,14,63,45
1982-02-23,HOU,105,29,24,DAL,95,18,35,47,59
1982-02-23,SAN,143,34,18,GOS,123,29,23,63,41
1982-02-23,WAS,106,25,27,UTH,113,18,35,43,62
1982-02-23,SDC,101,15,39,PHL,115,39,14,54,53
1982-02-24,BOS,132,37,15,UTH,90,19,35,56,50
1982-02-24,KCK,111,18,37,POR,123,28,25,46,62
1982-02-24,PHX,131,28,24,CLE,97,12,41,40,65
1982-02-24,IND,118,24,31,NYK,87,25,31,49,62
1982-02-24,DEN,110,28,26,HOU,120,30,24,58,50
1982-02-24,NJN,106,27,28,MIL,113,39,15,66,43
1982-02-25,SEA,98,36,18,LAL,104,38,17,74,35
1982-02-25,DAL,104,18,36,GOS,106,29,24,47,60
1982-02-25,DET,116,24,30,SAN,119,35,18,59,48
1982-02-26,PHX,131,29,24,DEN,122,28,27,57,51
1982-02-26,WAS,100,25,28,KCK,98,18,38,43,66
1982-02-26,UTH,97,19,36,SEA,98,36,19,55,55
1982-02-26,LAL,116,39,17,PHL,114,40,14,79,31
1982-02-26,BOS,122,38,15,SDC,110,15,40,53,55
1982-02-26,ATL,110,24,28,CHI,116,20,34,44,62
1982-02-26,NJN,110,27,29,POR,106,29,25,56,54
1982-02-26,HOU,111,31,24,GOS,95,30,24,61,48
1982-02-26,IND,108,25,31,SAN,100,36,18,61,49
1982-02-27,DAL,108,18,37,HOU,105,32,24,50,61
1982-02-27,NYK,107,25,32,POR,105,29,26,54,58
1982-02-27,DEN,134,28,28,PHL,125,40,15,68,43
1982-02-27,DET,127,24,31,KCK,119,18,39,42,70
1982-02-28,IND,112,26,31,DET,101,25,31,51,62
1982-02-28,ATL,77,24,29,GOS,105,30,25,54,54
1982-02-28,CHI,118,21,34,SAN,104,36,19,57,53
1982-02-28,SEA,98,37,19,PHX,103,30,24,67,43
1982-02-28,WAS,113,26,28,NYK,109,26,32,52,60
1982-02-28,LAL,102,40,17,CLE,101,12,42,52,59
1982-02-28,BOS,106,39,15,MIL,102,40,15,79,30
1982-02-28,NJN,110,28,29,SDC,95,15,41,43,70
1982-03-02,UTH,117,19,37,KCK,125,18,40,37,77
1982-03-02,CHI,112,22,34,PHL,109,40,16,62,50
1982-03-02,POR,119,29,27,PHX,108,31,24,60,51
1982-03-02,DEN,124,29,28,IND,132,27,31,56,59
1982-03-02,WAS,124,27,28,NJN,130,29,29,56,57
1982-03-02,DAL,97,19,37,BOS,101,40,15,59,52
1982-03-02,MIL,101,40,16,DET,91,25,32,65,48
1982-03-02,HOU,117,32,25,SAN,119,36,20,68,45
1982-03-02,NYK,108,26,33,SDC,101,15,42,41,75
1982-03-02,GOS,117,31,25,CLE,108,12,43,43,68
1982-03-03,NJN,111,30,29,LAL,103,41,17,71,46
1982-03-03,SEA,136,37,20,CLE,107,12,44,49,64
1982-03-03,KCK,120,19,40,IND,82,28,31,47,71
1982-03-03,ATL,87,24,30,MIL,96,41,16,65,46
1982-03-03,PHX,115,31,25,UTH,102,19,38,50,63
1982-03-03,PHL,125,40,17,SDC,107,15,43,55,60
1982-03-04,NYK,129,27,33,LAL,119,41,18,68,51
1982-03-04,DET,122,25,33,CHI,97,23,34,48,67
1982-03-04,UTH,124,19,39,HOU,128,32,26,51,65
1982-03-04,SAN,101,37,20,BOS,110,41,15,78,35
1982-03-04,GOS,104,32,25,DAL,98,19,38,51,63
1982-03-05,PHX,110,32,25,KCK,98,20,40,52,65
1982-03-05,DEN,127,29,29,WAS,126,27,29,56,58
1982-03-05,HOU,98,33,26,BOS,100,42,15,75,41
1982-03-05,POR,110,30,27,CLE,111,12,45,42,72
1982-03-05,CHI,90,23,35,NJN,107,31,29,54,64
1982-03-05,SEA,98,38,20,DAL,97,19,39,57,59
1982-03-05,SDC,116,15,44,GOS,117,33,25,48,69
1982-03-05,PHL,89,41,17,ATL,80,24,31,65,48
1982-03-06,SAN,171,37,21,MIL,166,42,16,79,37
1982-03-06,ATL,112,24,32,NJN,92,32,29,56,61
1982-03-06,UTH,113,19,40,WAS,127,27,30,46,70
1982-03-06,NYK,111,28,33,DET,115,26,33,54,66
1982-03-07,DEN,147,30,29,CLE,127,13,45,43,74
1982-03-07,GOS,102,34,25,POR,106,30,28,64,53
1982-03-07,SEA,144,39,20,SDC,106,15,45,54,65
1982-03-07,BOS,107,43,15,NYK,106,28,34,71,49
1982-03-07,KCK,124,20,41,CHI,122,23,36,43,77
1982-03-07,DAL,106,19,40,IND,108,28,32,47,72
1982-03-07,PHX,92,33,25,HOU,94,33,27,66,52
1982-03-07,PHL,119,42,17,LAL,113,41,19,83,36
1982-03-08,DET,101,27,33,BOS,111,44,15,71,48
1982-03-08,SAN,113,38,21,DAL,121,19,41,57,62
1982-03-08,ATL,98,25,32,MIL,95,42,17,67,49
1982-03-09,IND,85,29,32,GOS,92,34,26,63,58
1982-03-09,LAL,105,41,20,KCK,99,21,41,62,61
1982-03-09,WAS,95,28,30,PHX,103,33,26,61,56
1982-03-09,ATL,120,26,32,DEN,106,31,29,57,61
1982-03-09,SDC,138,15,46,SAN,127,38,22,53,68
1982-03-09,CHI,109,23,37,SEA,104,40,20,63,57
1982-03-09,NYK,126,28,35,UTH,112,19,41,47,76
1982-03-09,HOU,103,34,27,MIL,91,42,18,76,45
1982-03-10,BOS,121,45,15,IND,100,29,33,74,48
1982-03-10,DET,113,27,34,DEN,124,31,30,58,64
1982-03-10,NJN,113,32,30,PHX,105,34,26,66,56
1982-03-10,PHL,134,43,17,GOS,114,35,26,78,43
1982-03-10,MIL,98,42,19,CHI,101,24,37,66,56
1982-03-10,DAL,104,20,41,POR,102,31,28,51,69
1982-03-11,SDC,107,16,46,KCK,113,21,42,37,88
1982-03-11,CLE,95,13,46,PHX,101,34,27,47,73
1982-03-11,ATL,107,27,32,UTH,91,19,42,46,74
1982-03-12,NJN,109,33,30,BOS,113,46,15,79,45
1982-03-12,DET,121,27,35,GOS,117,35,27,62,62
1982-03-12,WAS,110,28,31,IND,105,29,34,57,65
1982-03-12,HOU,115,35,27,DEN,130,32,30,67,57
1982-03-12,LAL,105,42,20,CHI,111,25,37,67,57
1982-03-12,MIL,110,42,20,SEA,112,40,21,82,41
1982-03-12,SAN,108,38,23,POR,112,31,29,69,52
1982-03-13,NYK,99,29,35,WAS,109,29,31,58,66
1982-03-13,CLE,121,13,47,UTH,115,19,43,32,90
1982-03-13,ATL,110,28,32,IND,90,29,35,57,67
1982-03-13,SDC,118,16,47,DAL,126,21,41,37,88
1982-03-13,HOU,112,35,28,POR,107,32,29,67,57
1982-03-14,LAL,138,42,21,DAL,116,22,41,64,62
1982-03-14,KCK,114,22,42,PHL,128,44,17,66,59
1982-03-14,WAS,92,30,31,ATL,85,29,32,59,63
1982-03-14,SAN,119,38,24,CHI,117,26,37,64,61
1982-03-14,BOS,105,47,15,PHX,92,35,27,82,42
1982-03-14,MIL,129,42,21,UTH,100,19,44,61,65
1982-03-14,CLE,103,14,47,DET,109,28,35,42,82
1982-03-14,DEN,127,33,30,GOS,101,35,28,68,58
1982-03-14,NJN,97,33,31,SEA,98,41,21,74,52
1982-03-16,MIL,106,43,21,PHL,91,45,17,88,38
1982-03-16,WAS,97,31,31,BOS,98,48,15,79,46
1982-03-16,NYK,91,29,36,SAN,114,39,24,68,60
1982-03-16,DET,114,29,35,SDC,110,16,48,45,83
1982-03-16,DEN,154,34,30,UTH,138,19,45,53,75
1982-03-16,POR,108,32,30,LAL,120,43,21,75,51
1982-03-16,IND,109,29,36,SEA,96,42,21,71,57
1982-03-16,HOU,109,36,28,PHX,114,35,28,71,56
1982-03-17,GOS,116,35,29,KCK,117,22,43,57,72
1982-03-17,PHX,133,36,28,DEN,135,35,30,71,58
1982-03-17,NJN,93,33,32,SAN,90,40,24,73,56
1982-03-17,DAL,92,22,42,CHI,102,26,38,48,80
1982-03-17,UTH,112,19,46,LAL,120,44,21,63,67
1982-03-17,PHL,102,45,18,WAS,93,31,32,76,50
1982-03-17,CLE,113,14,48,SDC,107,16,49,30,97
1982-03-17,BOS,113,49,15,ATL,109,29,33,78,48
1982-03-18,POR,109,32,31,GOS,95,35,30,67,61
1982-03-18,DET,119,30,35,SEA,115,42,22,72,57
1982-03-18,ATL,95,29,34,HOU,94,36,29,65,63
1982-03-19,BOS,134,50,15,SAN,110,40,25,90,40
1982-03-19,MIL,119,44,21,CLE,97,15,48,59,69
1982-03-19,HOU,102,36,30,DET,111,31,35,67,65
1982-03-19,WAS,108,31,33,SDC,98,16,50,47,83
1982-03-19,DAL,106,22,43,LAL,112,45,21,67,64
1982-03-19,DEN,130,36,30,CHI,120,27,38,63,68
1982-03-19,KCK,103,23,43,SEA,109,42,23,65,66
1982-03-19,UTH,129,19,47,POR,131,33,31,52,78
1982-03-19,PHL,112,46,18,IND,95,30,36,76,54
1982-03-20,CLE,102,15,49,SAN,115,40,26,55,75
1982-03-20,IND,104,30,37,NJN,101,34,32,64,69
1982-03-20,NYK,98,29,37,ATL,104,30,34,59,71
1982-03-21,CLE,93,15,50,CHI,98,27,39,42,89
1982-03-21,GOS,113,35,31,UTH,102,19,48,54,79
1982-03-21,ATL,119,31,34,DET,111,32,35,63,69
1982-03-21,LAL,107,46,21,HOU,102,36,31,82,52
1982-03-21,MIL,102,45,21,NJN,86,34,33,79,54
1982-03-21,PHL,111,47,18,BOS,123,51,15,98,33
1982-03-21,PHX,105,36,29,SEA,115,43,23,79,52
1982-03-21,WAS,110,32,33,NYK,109,29,38,61,71
1982-03-21,KCK,118,23,44,SDC,97,16,51,39,95
1982-03-21,POR,109,34,31,DAL,101,22,44,56,75
1982-03-23,GOS,95,36,31,PHX,91,36,30,72,61
1982-03-23,ATL,107,32,34,WAS,87,33,33,65,67
1982-03-23,UTH,115,19,49,HOU,117,36,32,55,81
1982-03-23,NYK,120,29,39,CLE,97,15,51,44,90
1982-03-23,POR,104,35,31,MIL,109,46,21,81,52
1982-03-23,CHI,103,28,39,BOS,110,52,15,80,54
1982-03-23,LAL,116,47,21,DAL,118,22,45,69,66
1982-03-23,SAN,106,41,26,SDC,98,16,52,57,78
1982-03-24,PHX,104,36,31,DAL,96,23,45,59,76
1982-03-24,SEA,99,44,23,MIL,97,47,21,91,44
1982-03-24,PHL,106,47,19,NJN,111,34,34,81,53
1982-03-24,BOS,136,53,15,CLE,115,15,52,68,67
1982-03-24,IND,106,31,37,WAS,114,33,34,64,71
1982-03-24,KCK,110,24,44,ATL,106,33,34,57,78
1982-03-24,DEN,129,37,30,SAN,115,42,26,79,56
1982-03-25,UTH,105,19,50,GOS,107,37,31,56,81
1982-03-25,POR,95,35,32,HOU,108,37,32,72,64
1982-03-25,DET,100,32,36,PHL,98,47,20,79,56
1982-03-25,SDC,117,16,53,DEN,129,38,30,54,83
1982-03-26,WAS,104,34,34,NJN,88,35,34,69,68
1982-03-26,IND,87,31,38,ATL,100,33,35,64,73
1982-03-26,PHX,113,37,31,MIL,112,47,22,84,53
1982-03-26,GOS,102,38,31,POR,89,35,33,73,64
1982-03-26,DAL,96,23,46,KCK,87,25,44,48,90
1982-03-26,CLE,111,15,53,PHL,115,47,21,62,74
1982-03-26,CHI,131,28,40,NYK,107,30,39,58,79
1982-03-26,BOS,125,54,15,DET,104,33,36,87,51
1982-03-26,SEA,97,45,23,HOU,99,38,32,83,55
1982-03-26,SAN,110,42,27,LAL,105,47,22,89,49
1982-03-27,DAL,85,24,46,ATL,96,34,35,58,81
1982-03-27,SDC,99,16,54,MIL,128,47,23,63,77
1982-03-27,DEN,140,39,30,PHX,134,38,31,77,61
1982-03-27,NJN,121,35,35,DET,123,33,37,68,72
1982-03-27,UTH,110,19,51,SAN,114,43,27,62,78
1982-03-28,NJN,113,35,36,NYK,106,30,40,65,76
1982-03-28,KCK,111,25,45,LAL,116,47,23,72,68
1982-03-28,CLE,101,15,54,WAS,104,35,34,50,88
1982-03-28,GOS,92,39,31,HOU,94,39,32,78,63
1982-03-28,BOS,98,55,15,PHL,116,48,21,103,36
1982-03-28,SEA,109,45,24,POR,101,35,34,80,58
1982-03-28,IND,102,31,39,CHI,101,29,40,60,79
1982-03-29,UTH,102,19,52,PHX,113,38,32,57,84
1982-03-30,LAL,143,48,23,SDC,120,16,55,64,78
1982-03-30,DEN,145,40,30,SEA,142,46,24,86,54
1982-03-30,MIL,116,48,23,PHL,114,49,21,97,44
1982-03-30,WAS,127,36,34,DET,98,34,37,70,71
1982-03-30,SAN,107,44,27,GOS,113,39,32,83,59
1982-03-30,NYK,108,30,41,IND,104,32,39,62,80
1982-03-30,POR,109,35,35,KCK,99,25,46,60,81
1982-03-30,CHI,92,29,41,ATL,107,35,35,64,76
1982-03-30,HOU,99,40,32,DAL,95,24,47,64,79
1982-03-31,IND,108,32,40,DET,106,34,38,66,78
1982-03-31,SEA,109,46,25,KCK,116,25,47,71,72
1982-03-31,BOS,119,55,16,WAS,109,37,34,92,50
1982-03-31,PHL,99,49,22,CHI,98,29,42,78,64
1982-03-31,NJN,103,36,36,CLE,87,15,55,51,91
1982-03-31,PHX,127,39,32,SDC,106,16,56,55,88
1982-03-31,DAL,119,24,48,DEN,120,41,30,65,78
1982-04-01,MIL,117,49,23,ATL,113,36,35,85,58
1982-04-01,DET,120,34,39,DAL,121,24,49,58,88
1982-04-01,POR,109,36,35,SAN,105,44,28,80,63
1982-04-01,NYK,111,31,41,CLE,110,15,56,46,97
1982-04-01,SDC,100,16,57,LAL,117,49,23,65,80
1982-04-01,HOU,104,41,32,GOS,101,40,32,81,64
1982-04-02,SEA,111,46,26,SAN,86,44,29,90,55
1982-04-02,ATL,107,36,36,BOS,110,56,16,92,52
1982-04-02,PHL,135,50,22,CLE,115,15,57,65,79
1982-04-02,DEN,127,42,30,POR,121,37,35,79,65
1982-04-02,CHI,105,29,43,MIL,114,50,23,79,66
1982-04-02,UTH,127,19,53,KCK,118,26,47,45,100
1982-04-02,NJN,98,37,36,WAS,96,37,35,74,71
1982-04-02,LAL,99,50,23,PHX,109,40,32,90,55
1982-04-03,SDC,124,16,58,UTH,133,20,53,36,111
1982-04-03,ATL,106,36,37,WAS,101,37,36,73,73
1982-04-03,DET,105,34,40,IND,102,33,40,67,80
1982-04-03,DAL,102,25,49,GOS,107,40,33,65,82
1982-04-04,BOS,114,57,16,CHI,112,29,44,86,60
1982-04-04,SAN,93,44,30,HOU,95,42,32,86,62
1982-04-04,SEA,140,47,26,DEN,116,43,30,90,56
1982-04-04,CLE,109,15,58,NJN,119,38,36,53,94
1982-04-04,PHL,127,51,22,NYK,106,32,41,83,63
1982-04-04,PHX,104,41,32,KCK,95,26,48,67,80
1982-04-04,LAL,129,50,24,POR,111,37,36,87,60
1982-04-04,MIL,129,51,23,IND,115,33,41,84,64
1982-04-06,SDC,96,16,59,GOS,110,41,33,57,92
1982-04-06,UTH,129,21,53,DAL,114,25,50,46,103
1982-04-06,HOU,97,43,32,LAL,108,51,24,94,56
1982-04-06,MIL,122,52,23,BOS,116,58,16,110,39
1982-04-06,SEA,102,48,26,PHX,91,42,32,90,58
1982-04-06,WAS,94,37,37,CLE,85,15,59,52,96
1982-04-06,CHI,104,29,45,PHL,117,52,22,81,67
1982-04-06,POR,136,37,37,DEN,122,43,31,80,68
1982-04-06,ATL,106,37,37,NYK,104,32,42,69,79
1982-04-07,IND,85,33,42,WAS,97,38,37,71,79
1982-04-07,DET,120,35,40,ATL,115,38,37,73,77
1982-04-07,SAN,118,44,31,KCK,113,26,49,70,80
1982-04-07,GOS,121,42,33,DEN,129,43,32,85,65
1982-04-07,CLE,105,15,60,CHI,122,29,46,44,106
1982-04-07,NJN,113,39,36,PHL,116,53,22,92,58
1982-04-07,DAL,123,25,51,UTH,109,22,53,47,104
1982-04-08,PHX,104,42,33,POR,106,38,37,80,70
1982-04-08,SDC,115,16,60,SEA,117,49,26,65,86
1982-04-08,NYK,106,32,43,BOS,110,58,17,90,60
1982-04-09,ATL,103,38,38,PHL,88,54,22,92,60
1982-04-09,KCK,115,26,50,UTH,99,22,54,48,104
1982-04-09,LAL,153,52,24,DEN,128,44,32,96,56
1982-04-09,POR,124,39,37,SDC,104,16,61,55,98
1982-04-09,DET,100,36,40,MIL,118,53,23,89,63
1982-04-09,DAL,105,26,51,PHX,100,42,34,68,85
1982-04-09,IND,100,33,43,CLE,97,15,61,48,104
1982-04-09,BOS,106,59,17,NJN,103,39,37,98,54
1982-04-09,CHI,98,30,46,WAS,114,39,37,69,83
1982-04-10,PHX,116,42,35,SEA,99,50,26,92,61
1982-04-10,HOU,105,43,33,SAN,100,45,31,88,64
1982-04-10,UTH,151,22,55,DEN,136,44,33,66,88
1982-04-10,CLE,114,15,62,NYK,117,32,44,47,106
1982-04-10,GOS,132,42,34,SDC,119,16,62,58,96
1982-04-10,WAS,115,40,37,MIL,114,54,23,94,60
1982-04-10,NJN,115,39,38,IND,86,34,43,73,81
1982-04-11,LAL,107,53,24,SEA,104,50,27,103,51
1982-04-11,KCK,121,27,50,SAN,126,45,32,72,82
1982-04-11,DET,97,36,41,NYK,89,33,44,69,85
1982-04-11,POR,116,40,37,GOS,106,43,34,83,71
1982-04-11,PHL,109,54,23,BOS,110,60,17,114,40
1982-04-11,DAL,109,27,51,HOU,97,44,33,71,84
1982-04-11,ATL,108,39,38,CHI,89,30,47,69,85
1982-04-12,UTH,112,23,55,SDC,107,16,63,39,118
1982-04-13,SEA,88,50,28,POR,86,41,37,91,65
1982-04-13,CHI,120,30,48,BOS,115,61,17,91,65
1982-04-13,MIL,99,54,24,WAS,109,41,37,95,61
1982-04-13,IND,89,34,44,PHL,93,54,24,88,68
1982-04-13,SDC,94,16,64,PHX,105,43,35,59,99
1982-04-13,HOU,99,44,34,KCK,95,27,51,71,85
1982-04-13,CLE,111,15,63,ATL,119,40,38,55,101
1982-04-13,SAN,144,46,32,DEN,137,44,34,90,66
1982-04-13,GOS,106,43,35,LAL,101,54,24,97,59
1982-04-13,NYK,102,33,45,NJN,104,40,38,73,83
1982-04-14,NJN,98,41,38,WAS,94,42,37,83,75
1982-04-14,DEN,141,44,35,HOU,122,45,34,89,69
1982-04-14,KCK,114,27,52,DAL,95,28,51,55,103
1982-04-14,PHL,119,55,24,DET,111,37,41,92,65
1982-04-14,BOS,100,61,18,MIL,91,54,25,115,43
1982-04-14,PHX,104,44,35,SAN,92,47,32,91,67
1982-04-14,NYK,116,33,46,CHI,120,31,48,64,94
1982-04-14,SEA,93,51,28,GOS,104,44,35,95,63
1982-04-14,LAL,128,54,25,UTH,115,24,55,78,80
1982-04-15,SDC,129,16,65,POR,123,41,38,57,103
1982-04-15,IND,108,34,45,ATL,102,41,38,75,83
1982-04-15,DET,120,37,42,CLE,110,15,64,52,106
1982-04-16,POR,99,41,39,PHX,113,45,35,86,74
1982-04-16,NJN,113,42,38,BOS,96,62,18,104,56
1982-04-16,DAL,106,28,52,SAN,118,47,33,75,85
1982-04-16,WAS,96,42,38,PHL,100,56,24,98,62
1982-04-16,MIL,112,54,26,NYK,99,33,47,87,73
1982-04-16,CHI,112,32,48,CLE,102,15,65,47,113
1982-04-16,KCK,123,28,52,DEN,121,45,35,73,87
1982-04-16,HOU,107,45,35,UTH,100,24,56,69,91
1982-04-16,ATL,109,41,39,IND,91,35,45,76,84
1982-04-16,LAL,125,55,25,GOS,109,45,35,100,60
1982-04-17,DET,132,38,42,NJN,147,43,38,81,80
1982-04-17,DEN,130,45,36,DAL,124,28,53,73,89
1982-04-17,GOS,94,45,36,SEA,95,51,29,96,65
1982-04-18,PHL,110,57,24,MIL,86,55,26,112,50
1982-04-18,CHI,112,33,48,IND,104,35,46,68,94
1982-04-18,KCK,106,29,52,HOU,104,46,35,75,87
1982-04-18,WAS,99,42,39,ATL,96,42,39,84,78
1982-04-18,BOS,119,62,19,NYK,99,33,48,95,67
1982-04-18,CLE,113,15,66,DET,116,38,43,53,109
1982-04-18,SAN,120,48,33,UTH,128,24,57,72,90
1982-04-18,POR,119,41,40,SEA,114,52,29,93,69
1982-04-18,PHX,115,46,35,LAL,120,56,25,102,60
1982-10-29,NJN,114,0,0,CHI,102,0,0,0,0
1982-10-29,KCK,113,0,0,POR,111,0,0,0,0
1982-10-29,IND,93,0,0,WAS,90,0,0,0,0
1982-10-29,SDC,99,0,0,PHX,113,0,0,0,0
1982-10-29,SEA,128,0,0,HOU,95,0,0,0,0
1982-10-29,DET,94,0,0,ATL,86,0,0,0,0
1982-10-29,CLE,93,0,0,BOS,104,0,0,0,0
1982-10-29,NYK,89,0,0,PHL,104,0,0,0,0
1982-10-29,UTH,114,0,0,SAN,120,0,0,0,0
1982-10-29,LAL,117,0,0,GOS,132,0,0,0,0
1982-10-29,DEN,117,0,0,DAL,125,0,0,0,0
1982-10-30,MIL,108,0,0,NYK,86,0,1,0,1
1982-10-30,SAN,112,1,0,POR,107,0,1,1,1
1982-10-30,GOS,117,1,0,HOU,110,0,1,1,1
1982-10-30,DAL,123,1,0,UTH,128,0,1,1,1
1982-10-30,ATL,97,0,1,BOS,112,1,0,1,1
1982-10-30,CHI,125,0,1,WAS,143,0,1,0,2
1982-10-30,PHL,110,1,0,NJN,99,1,0,2,0
1982-10-31,CLE,95,0,1,MIL,119,1,0,1,1
1982-10-31,SDC,109,0,1,SEA,127,1,0,1,1
1982-10-31,IND,115,1,0,DET,118,1,0,2,0
1982-10-31,DEN,114,0,1,PHX,110,1,0,1,1
1982-11-02,PHX,92,1,1,POR,87,0,2,1,3
1982-11-02,HOU,103,0,2,DAL,113,1,1,1,3
1982-11-02,ATL,105,0,2,WAS,88,1,1,1,3
1982-11-02,NJN,110,1,1,SDC,100,0,2,1,3
1982-11-02,KCK,119,1,0,MIL,112,2,0,3,0
1982-11-02,UTH,92,1,1,SEA,120,2,0,3,1
1982-11-02,CLE,119,0,2,DET,128,2,0,2,2
1982-11-03,WAS,104,1,2,NJN,85,2,1,3,3
1982-11-03,PHL,130,2,0,SDC,111,0,3,2,3
1982-11-03,DET,152,3,0,CHI,144,0,2,3,2
1982-11-03,DAL,102,2,1,HOU,101,0,3,2,4
1982-11-03,GOS,99,2,0,NYK,97,0,2,2,2
1982-11-03,DEN,134,1,1,LAL,135,0,1,1,2
1982-11-03,SEA,109,3,0,SAN,107,2,0,5,0
1982-11-03,BOS,111,2,0,IND,104,1,1,3,1
1982-11-04,PHX,119,2,1,UTH,104,1,2,3,3
1982-11-04,ATL,100,1,2,MIL,104,2,1,3,3
1982-11-04,POR,107,0,3,SAN,108,2,1,2,4
1982-11-04,CHI,118,0,3,CLE,111,0,3,0,6
1982-11-04,LAL,131,1,1,DEN,108,1,2,2,3
1982-11-05,CLE,91,0,4,NJN,99,2,2,2,6
1982-11-05,SEA,112,4,0,NYK,103,0,3,4,3
1982-11-05,MIL,130,3,1,SDC,99,0,4,3,5
1982-11-05,BOS,104,3,0,WAS,97,2,2,5,2
1982-11-05,GOS,104,3,0,SAN,105,3,1,6,1
1982-11-05,KCK,113,2,0,DAL,118,3,1,5,1
1982-11-05,DET,109,4,0,PHL,120,3,0,7,0
1982-11-06,CHI,129,1,3,SDC,124,0,5,1,8
1982-11-06,DEN,127,1,3,GOS,118,3,1,4,4
1982-11-06,ATL,95,1,3,DET,93,4,1,5,4
1982-11-06,DAL,100,4,1,PHX,112,3,1,7,2
1982-11-06,WAS,119,2,3,IND,115,1,2,3,5
1982-11-06,PHL,119,4,0,BOS,115,4,0,8,0
1982-11-06,POR,110,0,4,NYK,102,0,4,0,8
1982-11-06,UTH,101,1,3,LAL,104,2,1,3,4
1982-11-07,NJN,100,3,2,BOS,102,4,1,7,3
1982-11-07,LAL,103,3,1,POR,89,1,4,4,5
1982-11-07,SAN,101,4,1,PHX,100,4,1,8,2
1982-11-07,MIL,90,4,1,SEA,102,5,0,9,1
1982-11-09,LAL,139,4,1,KCK,117,2,1,6,2
1982-11-09,WAS,105,3,3,DET,108,4,2,7,5
1982-11-09,SAN,118,5,1,UTH,104,1,4,6,5
1982-11-09,HOU,91,0,4,PHX,119,4,2,4,6
1982-11-09,IND,100,1,3,SDC,95,0,6,1,9
1982-11-09,NYK,82,0,5,NJN,84,3,3,3,8
1982-11-09,CHI,111,2,3,SEA,112,6,0,8,3
1982-11-09,DEN,105,2,3,ATL,106,2,3,4,6
1982-11-09,POR,111,1,5,GOS,96,3,2,4,7
1982-11-10,DET,115,5,2,IND,91,2,3,7,5
1982-11-10,UTH,125,1,5,DEN,119,2,4,3,9
1982-11-10,DAL,91,4,2,SEA,94,7,0,11,2
1982-11-10,PHL,145,5,0,CHI,108,2,4,7,4
1982-11-10,BOS,101,5,1,MIL,105,4,2,9,3
1982-11-10,NJN,99,4,3,NYK,90,0,6,4,9
1982-11-10,GOS,120,3,3,CLE,132,0,5,3,8
1982-11-10,PHX,106,5,2,KCK,100,2,2,7,4
1982-11-11,POR,111,2,5,HOU,90,0,5,2,10
1982-11-11,SDC,109,0,7,SAN,105,6,1,6,8
1982-11-12,DEN,111,2,5,POR,128,3,5,5,10
1982-11-12,UTH,98,2,5,ATL,106,3,3,5,8
1982-11-12,CHI,113,2,5,NJN,105,5,3,7,8
1982-11-12,WAS,87,3,4,NYK,88,0,7,3,11
1982-11-12,LAL,127,5,1,HOU,96,0,6,5,7
1982-11-12,PHX,94,6,2,CLE,81,1,5,7,7
1982-11-12,DET,111,6,2,MIL,100,5,2,11,4
1982-11-12,BOS,118,5,2,DAL,110,4,3,9,5
1982-11-12,PHL,108,6,0,IND,117,2,4,8,4
1982-11-13,DAL,130,4,4,DEN,140,2,6,6,10
1982-11-13,SAN,98,6,2,SEA,107,8,0,14,2
1982-11-13,SDC,111,1,7,KCK,112,2,3,3,10
1982-11-13,NJN,100,5,4,PHL,110,6,1,11,5
1982-11-13,GOS,114,3,4,ATL,101,4,3,7,7
1982-11-13,IND,119,3,4,CHI,115,3,5,6,9
1982-11-13,NYK,112,1,7,DET,100,7,2,8,9
1982-11-14,HOU,99,0,7,SEA,102,9,0,9,7
1982-11-14,POR,94,4,5,PHX,102,7,2,11,7
1982-11-14,PHL,102,7,1,WAS,93,3,5,10,6
1982-11-14,MIL,98,5,3,BOS,100,6,2,11,5
1982-11-14,LAL,111,6,1,CLE,98,1,6,7,7
1982-11-16,PHX,113,8,2,LAL,105,7,1,15,3
1982-11-16,NYK,120,2,7,HOU,93,0,8,2,15
1982-11-16,MIL,115,5,4,IND,103,4,4,9,8
1982-11-16,SDC,130,1,8,DEN,136,3,6,4,14
1982-11-16,CHI,125,3,6,GOS,120,4,4,7,10
1982-11-16,SAN,102,6,3,KCK,105,3,3,9,6
1982-11-16,POR,106,4,6,ATL,87,4,4,8,10
1982-11-17,SEA,119,10,0,ATL,97,4,5,14,5
1982-11-17,DAL,118,4,5,LAL,117,7,2,11,7
1982-11-17,IND,124,4,5,GOS,122,4,5,8,10
1982-11-17,BOS,112,7,2,HOU,94,0,9,7,11
1982-11-17,UTH,101,2,6,NJN,97,5,5,7,11
1982-11-17,PHL,120,8,1,DET,103,7,3,15,4
1982-11-17,WAS,112,3,6,SAN,114,6,4,9,10
1982-11-18,SDC,107,1,9,CLE,98,1,7,2,16
1982-11-18,NYK,77,3,7,MIL,89,6,4,9,11
1982-11-18,PHX,107,9,2,DEN,118,4,6,13,8
1982-11-19,PHL,121,9,1,MIL,109,7,4,16,5
1982-11-19,DET,106,7,4,GOS,102,4,6,11,10
1982-11-19,LAL,122,7,3,WAS,92,3,7,10,10
1982-11-19,POR,118,5,6,NJN,108,5,6,10,12
1982-11-19,BOS,119,8,2,SAN,111,7,4,15,6
1982-11-19,CHI,127,4,6,UTH,111,3,6,7,12
1982-11-19,SEA,101,11,0,CLE,94,1,8,12,8
1982-11-19,IND,98,5,5,HOU,109,0,10,5,15
1982-11-20,NYK,83,3,8,BOS,97,9,2,12,10
1982-11-20,PHX,91,9,3,ATL,80,4,6,13,9
1982-11-20,SAN,134,7,5,GOS,112,4,7,11,12
1982-11-20,SDC,87,2,9,WAS,95,3,8,5,17
1982-11-20,CHI,131,5,6,DET,128,8,4,13,10
1982-11-20,DAL,120,5,5,KCK,127,4,3,9,8
1982-11-21,POR,129,6,6,CLE,79,1,9,7,15
1982-11-21,LAL,143,8,3,DEN,129,5,6,13,9
1982-11-21,IND,98,5,6,MIL,109,7,5,12,11
1982-11-21,SEA,91,12,0,NJN,111,5,7,17,7
1982-11-23,HOU,106,1,10,DET,128,8,5,9,15
1982-11-23,ATL,132,4,7,CHI,102,6,6,10,13
1982-11-23,GOS,103,4,8,NJN,110,6,7,10,15
1982-11-23,SAN,136,8,5,DEN,126,5,7,13,12
1982-11-23,NYK,90,3,9,IND,94,5,7,8,16
1982-11-23,CLE,99,1,10,UTH,121,3,7,4,17
1982-11-23,PHL,103,10,1,POR,106,7,6,17,7
1982-11-24,SEA,93,12,1,LAL,111,9,3,21,4
1982-11-24,KCK,122,5,3,DET,112,9,5,14,8
1982-11-24,SDC,114,2,10,NJN,109,7,7,9,17
1982-11-24,MIL,119,8,5,UTH,106,4,7,12,12
1982-11-24,DEN,129,5,8,SAN,123,9,5,14,13
1982-11-24,BOS,104,10,2,POR,95,8,6,18,8
1982-11-24,PHX,93,10,3,WAS,106,4,8,14,11
1982-11-24,IND,106,6,7,PHL,121,10,2,16,9
1982-11-24,DAL,133,5,6,CHI,127,6,7,11,13
1982-11-25,HOU,79,1,11,KCK,88,6,3,7,14
1982-11-26,BOS,137,11,2,UTH,103,4,8,15,10
1982-11-26,CLE,102,1,11,PHL,120,11,2,12,13
1982-11-26,DET,132,9,6,POR,118,8,7,17,13
1982-11-26,PHX,110,10,4,NJN,99,7,8,17,12
1982-11-26,SAN,122,9,6,CHI,120,6,8,15,14
1982-11-26,SDC,115,3,10,LAL,117,10,3,13,13
1982-11-26,IND,85,6,8,WAS,87,5,8,11,16
1982-11-26,SEA,127,12,2,DEN,106,6,8,18,10
1982-11-27,ATL,117,5,7,IND,98,6,9,11,16
1982-11-27,KCK,105,7,3,PHX,99,11,4,18,7
1982-11-27,PHL,126,12,2,UTH,113,4,9,16,11
1982-11-27,DAL,106,6,6,SAN,107,10,6,16,12
1982-11-27,WAS,107,6,8,POR,90,8,8,14,16
1982-11-27,DEN,141,6,9,SDC,125,3,11,9,20
1982-11-27,GOS,118,4,9,SEA,133,13,2,17,11
1982-11-27,HOU,108,1,12,CHI,99,6,9,7,21
1982-11-27,MIL,109,9,5,NYK,96,3,10,12,15
1982-11-28,BOS,124,12,2,MIL,109,10,5,22,7
1982-11-28,LAL,142,11,3,GOS,127,4,10,15,13
1982-11-28,CLE,118,1,12,KCK,110,8,3,9,15
1982-11-30,SAN,117,11,6,LAL,114,12,3,23,9
1982-11-30,MIL,88,10,6,CLE,78,2,12,12,18
1982-11-30,POR,121,8,9,SDC,114,3,12,11,21
1982-11-30,NJN,112,7,9,KCK,103,8,4,15,13
1982-11-30,DEN,129,7,9,DAL,140,6,7,13,16
1982-11-30,NYK,124,3,11,UTH,93,4,10,7,21
1982-11-30,BOS,116,13,2,DET,123,10,6,23,8
1982-11-30,GOS,110,4,11,PHX,98,11,5,15,16
1982-11-30,ATL,111,6,7,PHL,97,13,2,19,9
1982-12-01,HOU,95,2,12,LAL,106,12,4,14,16
1982-12-01,IND,105,6,10,MIL,125,11,6,17,16
1982-12-01,DET,105,11,6,SAN,97,12,6,23,12
1982-12-01,CLE,84,2,13,NYK,101,4,11,6,24
1982-12-01,WAS,99,7,8,NJN,105,8,9,15,17
1982-12-01,BOS,122,13,3,ATL,97,7,7,20,10
1982-12-01,SEA,131,14,2,SDC,110,3,13,17,15
1982-12-01,KCK,143,8,5,CHI,132,6,10,14,15
1982-12-02,DAL,110,7,7,GOS,100,5,11,12,18
1982-12-02,PHX,108,11,6,PHL,116,13,3,24,9
1982-12-02,UTH,119,4,11,POR,112,9,9,13,20
1982-12-03,SAN,88,12,7,HOU,78,2,13,14,20
1982-12-03,IND,111,6,11,CLE,103,2,14,8,25
1982-12-03,LAL,115,13,4,POR,100,9,10,22,14
1982-12-03,KCK,107,9,5,GOS,123,5,12,14,17
1982-12-03,MIL,115,12,6,BOS,112,14,3,26,9
1982-12-03,WAS,105,7,9,NYK,98,5,11,12,20
1982-12-03,DEN,132,7,10,CHI,124,6,11,13,21
1982-12-03,SDC,110,3,14,PHL,127,14,3,17,17
1982-12-03,ATL,99,7,8,NJN,107,9,9,16,17
1982-12-04,DET,112,12,6,BOS,119,14,4,26,10
1982-12-04,UTH,131,5,11,CHI,124,6,12,11,23
1982-12-04,DAL,105,8,7,WAS,115,8,9,16,16
1982-12-04,PHX,103,11,7,SDC,113,3,15,14,22
1982-12-04,CLE,109,2,15,IND,89,7,11,9,26
1982-12-04,HOU,94,2,14,SAN,93,13,7,15,21
1982-12-04,NYK,79,5,12,ATL,80,7,9,12,21
1982-12-05,KCK,106,9,6,SEA,103,15,2,24,8
1982-12-05,GOS,119,6,12,UTH,111,6,11,12,23
1982-12-05,NJN,108,10,9,MIL,103,13,6,23,15
1982-12-05,LAL,104,14,4,PHL,114,15,3,29,7
1982-12-07,POR,137,9,11,UTH,121,6,12,15,23
1982-12-07,HOU,88,3,14,SEA,107,15,3,18,17
1982-12-07,CHI,91,6,13,NYK,85,5,13,11,26
1982-12-07,GOS,121,7,12,SDC,114,4,15,11,27
1982-12-07,SAN,106,13,8,DAL,92,8,8,21,16
1982-12-07,CLE,90,3,15,ATL,102,8,9,11,24
1982-12-08,UTH,101,6,13,HOU,93,3,15,9,28
1982-12-08,IND,130,7,12,DEN,126,8,10,15,22
1982-12-08,DAL,110,8,9,SEA,94,16,3,24,12
1982-12-08,NJN,98,11,9,WAS,95,9,9,20,18
1982-12-08,LAL,89,14,5,PHX,86,11,8,25,13
1982-12-08,PHL,132,16,3,ATL,85,9,9,25,12
1982-12-08,DET,109,12,7,NYK,120,5,14,17,21
1982-12-08,KCK,101,10,6,SAN,102,14,8,24,14
1982-12-08,BOS,113,15,4,CLE,93,3,16,18,20
1982-12-08,MIL,101,13,7,CHI,111,7,13,20,20
1982-12-09,WAS,98,9,10,DEN,90,8,11,17,21
1982-12-09,GOS,98,8,12,POR,107,10,11,18,23
1982-12-10,PHX,97,11,9,HOU,83,3,16,14,25
1982-12-10,ATL,83,9,10,MIL,104,13,8,22,18
1982-12-10,KCK,118,10,7,SDC,106,4,16,14,23
1982-12-10,CLE,107,3,17,DEN,117,8,12,11,29
1982-12-10,BOS,123,16,4,PHL,97,17,3,33,7
1982-12-10,UTH,122,7,13,LAL,128,15,5,22,18
1982-12-10,IND,108,8,12,NYK,100,6,14,14,26
1982-12-10,SEA,100,16,4,GOS,101,8,13,24,17
1982-12-10,NJN,102,12,9,SAN,114,15,8,27,17
1982-12-10,DET,121,12,8,DAL,122,9,9,21,17
1982-12-11,DAL,124,10,9,SDC,118,4,17,14,26
1982-12-11,HOU,94,3,17,UTH,101,7,14,10,31
1982-12-11,CHI,107,8,13,ATL,117,9,11,17,24
1982-12-11,SAN,110,16,8,KCK,122,11,7,27,15
1982-12-11,GOS,107,9,13,LAL,128,16,5,25,18
1982-12-11,PHL,128,17,4,DET,111,12,9,29,13
1982-12-11,NYK,85,6,15,WAS,79,10,10,16,25
1982-12-12,POR,99,11,11,PHX,94,12,9,23,20
1982-12-12,BOS,126,17,4,DEN,112,9,12,26,16
1982-12-12,MIL,120,14,8,IND,108,9,12,23,20
1982-12-14,CHI,102,8,14,WAS,108,10,11,18,25
1982-12-14,NYK,99,7,15,DET,104,12,10,19,25
1982-12-14,POR,107,12,11,LAL,103,17,5,29,16
1982-12-14,SEA,109,16,5,PHX,114,12,10,28,15
1982-12-14,GOS,122,9,14,DAL,113,11,9,20,23
1982-12-14,HOU,93,3,18,SAN,102,16,9,19,27
1982-12-15,DET,104,13,10,BOS,108,18,4,31,14
1982-12-15,UTH,119,8,14,SDC,113,4,18,12,32
1982-12-15,KCK,119,12,7,NJN,118,12,10,24,17
1982-12-15,PHL,99,18,4,CLE,93,3,18,21,22
1982-12-15,MIL,98,15,8,DEN,113,9,13,24,21
1982-12-15,IND,101,9,13,ATL,107,10,11,19,24
1982-12-16,DEN,108,10,13,SAN,120,17,9,27,22
1982-12-16,PHX,94,13,10,GOS,98,10,14,23,24
1982-12-16,SEA,103,16,6,DAL,93,11,10,27,16
1982-12-16,ATL,106,11,11,CLE,97,3,19,14,30
1982-12-16,NYK,113,7,16,BOS,105,19,4,26,20
1982-12-16,SDC,103,4,19,POR,111,13,11,17,30
1982-12-17,HOU,114,3,19,IND,107,9,14,12,33
1982-12-17,PHL,109,19,4,NYK,95,8,16,27,20
1982-12-17,DET,110,13,11,WAS,119,11,11,24,22
1982-12-17,SEA,93,17,6,KCK,90,13,7,30,13
1982-12-17,LAL,117,17,6,NJN,106,12,11,29,17
1982-12-17,SAN,110,18,9,UTH,103,9,14,27,23
1982-12-17,MIL,115,15,9,CHI,93,8,15,23,24
1982-12-18,ATL,103,12,11,BOS,107,19,5,31,16
1982-12-18,CLE,90,3,20,DET,97,13,12,16,32
1982-12-18,DEN,114,10,14,NJN,123,12,12,22,26
1982-12-18,UTH,116,9,15,HOU,97,4,19,13,34
1982-12-18,WAS,100,12,11,PHL,97,20,4,32,15
1982-12-18,SDC,107,4,20,SEA,121,18,6,22,26
1982-12-18,POR,108,14,11,DAL,105,11,11,25,22
1982-12-18,PHX,126,13,11,LAL,100,18,6,31,17
1982-12-18,GOS,90,11,14,KCK,106,13,8,24,22
1982-12-18,CHI,131,8,16,IND,127,9,15,17,31
1982-12-19,MIL,113,16,9,SAN,98,19,9,35,18
1982-12-19,BOS,114,20,5,DET,131,14,12,34,17
1982-12-19,LAL,110,18,7,DAL,108,11,12,29,19
1982-12-20,UTH,119,10,15,KCK,117,14,8,24,23
1982-12-21,NJN,97,13,12,DET,102,15,12,28,24
1982-12-21,SAN,113,19,10,PHX,114,14,11,33,21
1982-12-21,SDC,118,4,21,DAL,121,11,13,15,34
1982-12-21,NYK,101,8,17,MIL,94,17,9,25,26
1982-12-21,SEA,99,19,6,POR,94,15,11,34,17
1982-12-21,PHL,122,20,5,BOS,105,20,6,40,11
1982-12-21,WAS,77,13,11,CLE,74,3,21,16,32
1982-12-21,GOS,92,11,15,HOU,85,4,20,15,35
1982-12-21,CHI,124,9,16,ATL,116,12,12,21,28
1982-12-22,BOS,140,20,7,CHI,131,10,16,30,23
1982-12-22,CLE,100,3,22,IND,98,9,16,12,38
1982-12-22,LAL,124,19,7,UTH,100,11,15,30,22
1982-12-22,KCK,146,14,9,DEN,102,10,15,24,24
1982-12-23,POR,88,15,12,HOU,82,4,21,19,33
1982-12-23,MIL,101,17,10,ATL,90,12,13,29,23
1982-12-23,PHX,125,15,11,DAL,106,12,13,27,24
1982-12-23,SDC,115,4,22,LAL,120,20,7,24,29
1982-12-23,DET,127,16,12,DEN,135,10,16,26,28
1982-12-23,SEA,120,20,6,GOS,95,12,15,32,21
1982-12-23,NJN,97,13,13,WAS,90,14,11,27,24
1982-12-25,UTH,101,11,16,PHX,111,16,11,27,27
1982-12-25,POR,95,16,12,SEA,88,21,6,37,18
1982-12-25,NYK,110,9,17,NJN,112,14,13,23,30
1982-12-25,WAS,91,14,12,ATL,97,12,14,26,26
1982-12-26,KCK,120,15,9,UTH,118,11,17,26,26
1982-12-26,IND,87,9,17,NYK,81,9,18,18,35
1982-12-26,MIL,106,18,10,DET,96,16,13,34,23
1982-12-26,HOU,94,4,22,LAL,96,21,7,25,29
1982-12-26,SDC,112,4,23,POR,105,17,12,21,35
1982-12-26,SAN,122,19,11,PHL,124,21,5,40,16
1982-12-26,SEA,88,21,7,PHX,87,17,11,38,18
1982-12-27,NJN,94,15,13,CLE,82,4,22,19,35
1982-12-27,WAS,89,14,13,CHI,87,10,17,24,30
1982-12-27,DEN,130,11,16,GOS,128,12,16,23,32
1982-12-28,DEN,155,12,16,IND,150,10,17,22,33
1982-12-28,ATL,123,13,14,SDC,113,5,23,18,37
1982-12-28,HOU,93,4,23,PHL,104,22,5,26,28
1982-12-28,KCK,129,16,9,BOS,124,21,7,37,16
1982-12-28,CHI,103,10,18,MIL,113,19,10,29,28
1982-12-28,UTH,105,11,18,DET,98,16,14,27,32
1982-12-28,PHX,116,17,12,POR,94,17,13,34,25
1982-12-29,DAL,116,12,14,PHL,126,23,5,35,19
1982-12-29,SAN,124,19,12,SDC,115,5,24,24,36
1982-12-29,NJN,104,16,13,ATL,99,14,14,30,27
1982-12-29,SEA,109,22,7,UTH,92,12,18,34,25
1982-12-29,GOS,110,12,17,LAL,120,22,7,34,24
1982-12-29,CLE,87,4,23,NYK,91,9,19,13,42
1982-12-29,WAS,94,15,13,MIL,87,20,10,35,23
1982-12-30,HOU,93,4,24,SDC,108,5,25,9,49
1982-12-30,NYK,94,10,19,CLE,89,4,24,14,43
1982-12-30,MIL,111,20,11,DAL,99,12,15,32,26
1982-12-30,LAL,137,23,7,SEA,117,23,7,46,14
1982-12-30,KCK,107,17,9,POR,113,17,14,34,23
1982-12-30,UTH,114,12,19,IND,115,10,18,22,37
1982-12-30,PHX,115,18,12,DET,98,16,15,34,27
1982-12-30,DEN,132,13,16,BOS,145,21,8,34,24
1982-12-30,CHI,102,10,19,SAN,105,20,12,30,31
1983-01-01,NYK,98,11,19,WAS,77,16,13,27,32
1983-01-01,NJN,111,17,13,DAL,105,12,16,29,29
1983-01-01,SDC,105,6,25,DET,117,16,16,22,41
1983-01-01,UTH,112,12,20,BOS,127,22,8,34,28
1983-01-01,DEN,127,13,17,PHX,125,19,12,32,29
1983-01-01,POR,102,18,14,GOS,74,12,18,30,32
1983-01-02,MIL,103,21,11,HOU,82,4,25,25,36
1983-01-02,POR,122,19,14,DEN,104,14,17,33,31
1983-01-02,PHX,116,19,13,SEA,99,23,8,42,21
1983-01-02,ATL,104,14,15,KCK,108,17,10,31,25
1983-01-02,GOS,114,12,19,IND,105,11,18,23,37
1983-01-02,LAL,127,24,7,DET,112,17,16,41,23
1983-01-02,CLE,95,4,25,SAN,103,21,12,25,37
1983-01-04,DEN,137,14,18,KCK,121,18,10,32,28
1983-01-04,POR,119,20,14,IND,117,11,19,31,33
1983-01-04,CHI,147,10,20,DET,138,17,17,27,37
1983-01-04,ATL,95,14,16,SAN,104,22,12,36,28
1983-01-04,MIL,95,22,11,NJN,102,18,13,40,24
1983-01-04,GOS,88,13,19,UTH,100,12,21,25,40
1983-01-04,HOU,87,4,26,BOS,88,23,8,27,34
1983-01-04,NYK,85,12,19,PHX,97,20,13,32,32
1983-01-04,WAS,92,16,14,DAL,84,12,17,28,31
1983-01-05,SEA,104,23,9,IND,108,11,20,34,29
1983-01-05,DET,130,17,18,CLE,116,4,26,21,44
1983-01-05,PHL,122,24,5,LAL,120,25,7,49,12
1983-01-05,KCK,138,18,11,DEN,118,15,18,33,29
1983-01-05,UTH,115,13,21,SDC,122,6,26,19,47
1983-01-05,DAL,136,12,18,SAN,131,23,12,35,30
1983-01-06,CLE,107,4,27,LAL,125,25,8,29,35
1983-01-06,SDC,107,7,26,HOU,109,4,27,11,53
1983-01-06,NYK,98,12,20,ATL,99,14,17,26,37
1983-01-06,NJN,94,19,13,PHX,93,21,13,40,26
1983-01-06,GOS,94,13,20,POR,93,21,14,34,34
1983-01-07,CHI,98,11,20,NJN,111,20,13,31,33
1983-01-07,ATL,110,15,17,DAL,102,13,18,28,35
1983-01-07,KCK,139,19,11,UTH,117,13,22,32,33
1983-01-07,MIL,109,22,12,DET,92,18,18,40,30
1983-01-07,DEN,125,15,19,HOU,97,5,27,20,46
1983-01-07,IND,101,12,20,PHX,108,21,14,33,34
1983-01-07,WAS,89,17,14,PHL,106,25,5,42,19
1983-01-07,SAN,113,23,13,BOS,116,24,8,47,21
1983-01-08,ATL,109,16,17,CHI,89,11,21,27,38
1983-01-08,HOU,82,5,28,UTH,87,13,23,18,51
1983-01-08,GOS,110,14,20,SEA,104,23,10,37,30
1983-01-08,SDC,122,7,27,DEN,120,16,19,23,46
1983-01-08,DAL,110,13,19,BOS,114,25,8,38,27
1983-01-08,PHL,125,26,5,KCK,113,20,11,46,16
1983-01-08,CLE,98,4,28,WAS,82,17,15,21,43
1983-01-08,NYK,90,12,21,LAL,108,26,8,38,29
1983-01-09,MIL,106,23,12,PHX,96,22,14,45,26
1983-01-09,NJN,110,21,13,DET,102,18,19,39,32
1983-01-09,POR,110,21,15,SEA,101,23,11,44,26
1983-01-11,CHI,96,11,22,PHX,109,22,15,33,37
1983-01-11,HOU,97,5,29,SDC,105,8,27,13,56
1983-01-11,UTH,106,14,23,KCK,98,20,12,34,35
1983-01-11,NYK,103,12,22,GOS,79,15,20,27,42
1983-01-11,ATL,99,17,17,PHL,109,27,5,44,22
1983-01-11,NJN,110,22,13,LAL,96,27,8,49,21
1983-01-11,SEA,119,23,12,DEN,131,16,20,39,32
1983-01-11,SAN,109,23,14,DAL,101,13,20,36,34
1983-01-12,DAL,112,13,21,SDC,110,9,27,22,48
1983-01-12,DEN,126,17,20,UTH,118,15,23,32,43
1983-01-12,IND,114,12,21,NJN,120,23,13,35,34
1983-01-12,BOS,139,26,8,GOS,117,15,21,41,29
1983-01-12,DET,116,18,20,WAS,100,17,16,35,36
1983-01-12,KCK,118,20,13,SAN,113,24,14,44,27
1983-01-12,PHL,122,28,5,MIL,121,24,12,52,17
1983-01-12,CLE,96,5,28,CHI,98,11,23,16,51
1983-01-13,MIL,110,24,13,CLE,100,5,29,29,42
1983-01-13,PHX,102,23,15,SEA,99,23,13,46,28
1983-01-14,WAS,104,17,17,GOS,116,15,22,32,39
1983-01-14,SAN,96,24,15,HOU,92,5,30,29,45
1983-01-14,SEA,99,23,14,POR,102,22,15,45,29
1983-01-14,IND,123,12,22,CHI,126,12,23,24,45
1983-01-14,DAL,149,14,21,DEN,139,18,20,32,41
1983-01-14,BOS,133,27,8,NJN,108,24,13,51,21
1983-01-14,SDC,127,9,28,KCK,120,21,13,30,41
1983-01-14,ATL,88,17,18,NYK,80,13,22,30,40
1983-01-14,DET,105,19,20,PHL,115,29,5,48,25
1983-01-15,NJN,100,24,14,NYK,96,13,23,37,37
1983-01-15,POR,121,23,15,KCK,110,21,14,44,29
1983-01-15,HOU,111,5,31,DEN,131,18,21,23,52
1983-01-15,UTH,107,15,24,DAL,105,15,21,30,45
1983-01-15,CHI,126,13,23,MIL,128,25,13,38,36
1983-01-15,CLE,90,5,30,BOS,86,28,8,33,38
1983-01-15,PHL,114,30,5,IND,105,12,23,42,28
1983-01-15,ATL,101,18,18,LAL,120,27,9,45,27
1983-01-15,PHX,114,24,15,SDC,101,10,28,34,43
1983-01-15,SAN,117,25,15,WAS,96,17,18,42,33
1983-01-16,SDC,111,10,29,UTH,115,16,24,26,53
1983-01-16,SEA,111,23,15,KCK,96,21,15,44,30
1983-01-16,MIL,109,26,13,GOS,108,16,22,42,35
1983-01-17,NJN,96,25,14,ATL,102,18,19,43,33
1983-01-17,NYK,119,13,24,CHI,109,13,24,26,48
1983-01-18,SAN,143,26,15,DEN,124,19,21,45,36
1983-01-18,HOU,100,5,32,WAS,98,17,19,22,51
1983-01-18,CLE,90,6,30,PHL,98,31,5,37,35
1983-01-18,IND,126,12,24,BOS,130,28,9,40,33
1983-01-18,GOS,102,16,23,DAL,112,15,22,31,45
1983-01-19,ATL,116,19,19,SEA,111,24,15,43,34
1983-01-19,PHX,118,25,15,SAN,113,27,15,52,30
1983-01-19,UTH,95,17,24,GOS,103,16,24,33,48
1983-01-19,PHL,126,32,5,CHI,106,13,25,45,30
1983-01-19,DET,107,19,21,MIL,106,27,13,46,34
1983-01-19,LAL,107,28,9,SDC,104,10,30,38,39
1983-01-19,KCK,91,21,16,NYK,88,14,24,35,40
1983-01-19,DEN,130,19,22,HOU,93,6,32,25,54
1983-01-20,WAS,89,17,20,CLE,97,6,31,23,51
1983-01-20,DAL,121,16,22,POR,112,24,15,40,37
1983-01-20,SDC,100,10,31,IND,95,12,25,22,56
1983-01-21,PHL,130,33,5,SEA,117,24,16,57,21
1983-01-21,NJN,105,25,15,CLE,99,7,31,32,46
1983-01-21,GOS,136,17,24,DEN,121,20,22,37,46
1983-01-21,UTH,108,17,25,NYK,93,14,25,31,50
1983-01-21,MIL,111,27,14,WAS,104,17,21,44,35
1983-01-21,PHX,117,26,15,IND,118,12,26,38,41
1983-01-21,LAL,119,29,9,SAN,110,27,16,56,25
1983-01-21,CHI,106,13,26,BOS,117,29,9,42,35
1983-01-21,KCK,115,22,16,HOU,108,6,33,28,49
1983-01-22,DEN,98,20,23,NYK,102,14,26,34,49
1983-01-22,DET,111,20,21,ATL,109,20,19,40,40
1983-01-22,WAS,86,17,22,CHI,95,13,27,30,49
1983-01-22,HOU,96,6,34,POR,113,24,16,30,50
1983-01-22,DAL,126,17,22,UTH,88,18,25,35,47
1983-01-22,SDC,99,11,31,GOS,89,18,24,29,55
1983-01-23,KCK,92,23,16,PHX,102,26,16,49,32
1983-01-23,BOS,105,30,9,CLE,91,7,32,37,41
1983-01-23,MIL,107,28,14,PHL,96,34,5,62,19
1983-01-23,SAN,107,27,17,POR,108,25,16,52,33
1983-01-23,LAL,105,30,9,IND,102,13,26,43,35
1983-01-23,NJN,105,26,15,SEA,102,24,17,50,32
1983-01-24,WAS,93,17,23,BOS,91,31,9,48,32
1983-01-24,ATL,108,20,20,DET,112,21,21,41,41
1983-01-25,CHI,99,14,27,PHL,116,34,6,48,33
1983-01-25,POR,120,26,16,LAL,125,31,9,57,25
1983-01-25,ATL,96,20,21,PHX,94,27,16,47,37
1983-01-25,DEN,119,20,24,KCK,112,23,17,43,41
1983-01-25,IND,126,13,27,DAL,134,18,22,31,49
1983-01-25,NYK,111,15,26,CLE,78,7,33,22,59
1983-01-25,UTH,106,18,26,SAN,116,27,18,45,44
1983-01-25,HOU,114,6,35,NJN,111,27,15,33,50
1983-01-25,SDC,102,12,31,MIL,115,29,14,41,45
1983-01-26,PHL,113,35,6,PHX,102,27,17,62,23
1983-01-26,LAL,115,32,9,MIL,113,30,14,62,23
1983-01-26,CLE,119,7,34,CHI,124,14,28,21,62
1983-01-26,KCK,115,23,18,DAL,125,19,22,42,40
1983-01-26,DET,109,22,21,SEA,118,24,18,46,39
1983-01-26,BOS,125,31,10,WAS,99,18,23,49,33
1983-01-27,POR,120,26,17,UTH,106,18,27,44,44
1983-01-27,IND,138,13,28,SAN,143,28,18,41,46
1983-01-27,WAS,99,18,24,SEA,86,25,18,43,42
1983-01-27,SDC,110,12,32,ATL,100,21,21,33,53
1983-01-27,HOU,98,7,35,GOS,84,18,25,25,60
1983-01-28,DEN,118,21,24,POR,109,27,17,48,41
1983-01-28,DAL,110,20,22,NJN,115,27,16,47,38
1983-01-28,BOS,111,32,10,PHX,104,27,18,59,28
1983-01-28,KCK,99,23,19,PHL,114,36,6,59,25
1983-01-28,DET,106,22,22,CLE,107,7,35,29,57
1983-01-28,CHI,91,15,28,NYK,93,16,26,31,54
1983-01-28,LAL,109,33,9,ATL,85,21,22,54,31
1983-01-29,GOS,110,18,26,MIL,102,30,15,48,41
1983-01-29,DAL,119,20,23,HOU,113,8,35,28,58
1983-01-29,SAN,120,29,18,NJN,109,28,16,57,34
1983-01-29,WAS,88,19,24,PHX,82,27,19,46,43
1983-01-29,CLE,89,8,35,SEA,88,25,19,33,54
1983-01-29,IND,133,13,29,KCK,122,23,20,36,49
1983-01-29,UTH,109,18,28,PHL,126,37,6,55,34
1983-01-29,NYK,97,17,26,SDC,106,13,32,30,58
1983-01-29,DET,128,22,23,CHI,126,15,29,37,52
1983-01-30,BOS,110,33,10,LAL,95,34,9,67,19
1983-01-31,BOS,110,34,10,CHI,104,15,30,49,40
1983-01-31,NYK,114,17,27,KCK,97,23,21,40,48
1983-02-01,DEN,124,22,24,PHL,133,38,6,60,30
1983-02-01,POR,99,27,18,MIL,115,30,16,57,34
1983-02-01,ATL,93,21,23,CLE,84,9,35,30,58
1983-02-01,NJN,120,28,17,IND,111,14,29,42,46
1983-02-01,CHI,129,15,31,HOU,76,8,36,23,67
1983-02-02,WAS,115,20,24,KCK,117,23,22,43,46
1983-02-02,CLE,105,9,36,NJN,118,29,17,38,53
1983-02-02,IND,141,14,30,DET,135,23,23,37,53
1983-02-02,SAN,98,30,18,NYK,109,18,27,48,45
1983-02-02,BOS,120,35,10,SDC,110,14,32,49,42
1983-02-02,SEA,117,25,20,MIL,114,31,16,56,36
1983-02-02,PHX,112,27,20,UTH,96,18,29,45,49
1983-02-02,HOU,135,8,37,DEN,128,22,25,30,62
1983-02-02,DAL,122,21,23,LAL,120,34,10,55,33
1983-02-03,GOS,111,19,26,PHL,117,39,6,58,32
1983-02-03,DET,108,23,24,SDC,115,14,33,37,57
1983-02-03,ATL,112,22,23,DEN,126,22,26,44,49
1983-02-04,PHX,115,28,20,HOU,99,9,37,37,57
1983-02-04,POR,115,27,19,PHL,109,40,6,67,25
1983-02-04,IND,93,15,30,BOS,102,36,10,51,40
1983-02-04,NJN,120,30,17,CHI,98,16,31,46,48
1983-02-04,KCK,125,24,22,LAL,143,34,11,58,33
1983-02-04,SEA,115,26,20,SAN,103,30,19,56,39
1983-02-04,DAL,101,22,23,NYK,120,19,27,41,50
1983-02-04,CLE,81,9,37,ATL,92,22,24,31,61
1983-02-04,UTH,110,18,30,MIL,122,31,17,49,47
1983-02-04,WAS,100,20,25,SDC,93,15,33,35,58
1983-02-05,DET,111,23,25,NJN,101,31,17,54,42
1983-02-05,CHI,117,16,32,CLE,113,9,38,25,70
1983-02-05,DEN,143,23,26,UTH,136,18,31,41,57
1983-02-05,HOU,101,9,38,NYK,102,20,27,29,65
1983-02-05,GOS,106,19,27,SAN,102,30,20,49,47
1983-02-06,CLE,110,9,39,SDC,107,15,34,24,73
1983-02-06,POR,105,28,19,DAL,112,22,24,50,43
1983-02-06,WAS,103,21,25,IND,99,15,31,36,56
1983-02-06,GOS,92,20,27,PHX,109,29,20,49,47
1983-02-06,BOS,111,37,10,ATL,116,23,24,60,34
1983-02-06,SEA,96,27,20,PHL,97,40,7,67,27
1983-02-06,LAL,116,35,11,KCK,106,24,23,59,34
1983-02-07,NYK,105,21,27,IND,99,15,32,36,59
1983-02-08,SEA,118,27,21,LAL,121,36,11,63,32
1983-02-08,WAS,104,22,25,BOS,101,37,11,59,36
1983-02-08,HOU,116,9,39,KCK,115,24,24,33,63
1983-02-08,CHI,93,17,32,POR,109,28,20,45,52
1983-02-08,PHX,100,30,20,DAL,112,23,24,53,44
1983-02-08,SAN,147,30,21,DET,143,24,25,54,46
1983-02-08,ATL,109,24,24,NJN,115,31,18,55,42
1983-02-08,SDC,125,15,35,DEN,98,24,26,39,61
1983-02-09,LAL,113,37,11,UTH,99,18,32,55,43
1983-02-09,CLE,104,10,39,MIL,94,32,17,42,56
1983-02-09,DEN,134,24,27,SEA,125,27,22,51,49
1983-02-09,BOS,106,37,12,NYK,96,22,27,59,39
1983-02-09,KCK,103,24,25,GOS,98,20,28,44,53
1983-02-09,DAL,122,24,24,DET,113,24,26,48,50
1983-02-09,NJN,105,32,18,IND,90,15,33,47,51
1983-02-09,PHL,106,41,7,ATL,93,24,25,65,32
1983-02-10,SAN,128,31,21,GOS,109,20,29,51,50
1983-02-10,SDC,101,16,35,PHX,100,30,21,46,56
1983-02-10,CHI,110,17,33,PHL,116,42,7,59,40
1983-02-10,IND,95,15,34,CLE,99,11,39,26,73
1983-02-10,WAS,104,23,25,HOU,100,10,39,33,64
1983-02-10,MIL,102,32,18,POR,92,29,20,61,38
1983-02-10,UTH,99,18,33,SEA,105,27,23,45,56
1983-02-15,HOU,91,10,40,ATL,101,24,26,34,66
1983-02-15,CHI,110,17,34,IND,113,15,35,32,69
1983-02-15,GOS,111,20,30,WAS,93,24,25,44,55
1983-02-15,POR,115,29,21,SDC,106,17,35,46,56
1983-02-15,LAL,103,38,11,SAN,124,32,21,70,32
1983-02-16,UTH,112,18,34,SAN,101,33,21,51,55
1983-02-16,KCK,102,25,25,PHX,111,30,22,55,47
1983-02-16,PHL,116,43,7,DEN,95,25,27,68,34
1983-02-16,CLE,99,12,39,DAL,96,25,24,37,63
1983-02-16,SEA,100,28,23,BOS,108,38,12,66,35
1983-02-16,IND,113,16,35,CHI,117,17,35,33,70
1983-02-16,MIL,126,33,18,DET,121,24,27,57,45
1983-02-17,GOS,102,21,30,SDC,112,17,36,38,66
1983-02-17,POR,121,30,21,BOS,114,39,12,69,33
1983-02-17,DET,113,24,28,HOU,110,10,41,34,69
1983-02-17,DAL,110,25,25,LAL,127,38,12,63,37
1983-02-17,NYK,108,22,28,CLE,92,13,39,35,67
1983-02-17,NJN,108,33,18,DEN,117,25,28,58,46
1983-02-18,SEA,115,28,24,WAS,112,24,26,52,50
1983-02-18,UTH,97,19,34,POR,101,31,21,50,55
1983-02-18,PHL,127,44,7,HOU,98,10,42,54,49
1983-02-18,KCK,124,25,26,LAL,118,39,12,64,38
1983-02-18,MIL,121,34,18,IND,94,16,36,50,54
1983-02-19,DAL,122,25,26,ATL,100,25,26,50,52
1983-02-19,GOS,115,21,31,BOS,109,39,13,60,44
1983-02-19,DET,112,25,28,PHX,101,31,22,56,50
1983-02-19,NYK,124,23,28,DEN,115,26,28,49,56
1983-02-20,POR,104,32,21,WAS,95,24,27,56,48
1983-02-20,PHL,104,45,7,NYK,89,24,28,69,35
1983-02-20,SDC,107,18,36,UTH,97,19,35,37,71
1983-02-20,KCK,128,26,26,HOU,106,10,43,36,69
1983-02-20,CHI,124,18,35,DAL,111,26,26,44,61
1983-02-20,CLE,81,13,40,PHX,103,31,23,44,63
1983-02-20,MIL,109,35,18,NJN,108,33,19,68,37
1983-02-20,IND,112,16,37,LAL,126,39,13,55,50
1983-02-20,SAN,103,33,22,ATL,100,25,27,58,49
1983-02-20,SEA,116,29,24,GOS,112,22,31,51,55
1983-02-22,IND,108,16,38,NJN,110,33,20,49,58
1983-02-22,PHX,112,32,23,MIL,105,36,18,68,41
1983-02-22,NYK,108,24,29,DAL,106,26,27,50,56
1983-02-22,HOU,107,10,44,POR,113,33,21,43,65
1983-02-22,SEA,117,30,24,SDC,101,19,36,49,60
1983-02-22,CHI,144,19,35,DEN,133,26,29,45,64
1983-02-22,UTH,98,19,36,WAS,99,24,28,43,64
1983-02-22,ATL,97,25,28,GOS,109,22,32,47,60
1983-02-23,KCK,113,27,26,WAS,107,25,28,52,54
1983-02-23,NJN,119,34,20,CHI,86,20,35,54,55
1983-02-23,SAN,124,34,22,POR,114,34,21,68,43
1983-02-23,LAL,104,40,13,BOS,113,39,14,79,27
1983-02-23,DET,107,26,28,NYK,120,25,29,51,57
1983-02-23,CLE,99,13,41,GOS,98,23,32,36,73
1983-02-23,PHL,133,46,7,DAL,101,26,28,72,35
1983-02-24,UTH,103,19,37,PHX,110,33,23,52,60
1983-02-24,ATL,116,25,29,DET,107,26,29,51,58
1983-02-24,HOU,103,10,45,MIL,114,36,19,46,64
1983-02-24,DEN,138,26,30,SEA,129,31,24,57,54
1983-02-24,SDC,122,19,37,BOS,107,40,14,59,51
1983-02-25,SEA,101,31,25,PHX,106,34,23,65,48
1983-02-25,NJN,115,35,20,GOS,107,23,33,58,53
1983-02-25,PHL,116,47,7,CHI,111,20,36,67,43
1983-02-25,IND,101,16,39,NYK,113,26,29,42,68
1983-02-25,KCK,125,28,26,SAN,131,35,22,63,48
1983-02-25,DAL,133,26,29,POR,117,34,22,60,51
1983-02-26,DEN,125,27,30,WAS,111,25,29,52,59
1983-02-26,ATL,95,26,29,NJN,88,36,20,62,49
1983-02-26,UTH,101,19,38,LAL,92,40,14,59,52
1983-02-26,PHX,101,35,23,BOS,103,40,15,75,38
1983-02-26,DAL,118,27,29,KCK,107,28,27,55,56
1983-02-26,NYK,94,27,29,CHI,79,20,37,47,66
1983-02-26,SAN,104,36,22,MIL,107,37,19,73,41
1983-02-26,CLE,102,14,41,DET,122,26,30,40,71
1983-02-26,HOU,120,10,46,SDC,108,20,37,30,83
1983-02-27,IND,107,16,40,ATL,125,27,29,43,69
1983-02-27,CLE,98,14,42,POR,92,34,23,48,65
1983-02-27,SEA,101,31,26,UTH,98,20,38,51,64
1983-02-27,PHL,115,48,7,GOS,104,23,34,71,41
1983-02-27,LAL,120,40,15,DEN,135,28,30,68,45
1983-03-01,BOS,129,41,15,KCK,111,28,28,69,43
1983-03-01,CHI,111,20,38,LAL,114,40,16,60,54
1983-03-01,SAN,119,36,23,SEA,104,32,26,68,49
1983-03-01,ATL,109,28,29,IND,106,16,41,44,70
1983-03-01,WAS,99,25,30,MIL,101,38,19,63,49
1983-03-01,UTH,127,20,39,SDC,105,20,38,40,77
1983-03-01,DEN,132,29,30,CLE,121,15,42,44,72
1983-03-01,HOU,115,11,46,DAL,123,28,29,39,75
1983-03-01,GOS,103,23,35,DET,114,27,30,50,65
1983-03-01,NYK,94,28,29,PHL,106,49,7,77,36
1983-03-02,GOS,108,23,36,DEN,128,30,30,53,66
1983-03-02,PHX,110,35,24,SAN,106,37,23,72,47
1983-03-02,MIL,117,39,19,LAL,127,41,16,80,35
1983-03-02,NJN,124,36,21,HOU,85,11,47,47,68
1983-03-02,SDC,102,20,39,POR,104,34,24,54,63
1983-03-02,DAL,108,29,29,SEA,105,32,27,61,56
1983-03-03,ATL,91,29,29,WAS,89,25,31,54,60
1983-03-03,DET,118,28,30,KCK,125,28,29,56,59
1983-03-03,UTH,118,21,39,CLE,113,15,43,36,82
1983-03-04,POR,138,35,24,DEN,142,31,30,66,54
1983-03-04,DAL,102,30,29,MIL,108,39,20,69,49
1983-03-04,CHI,124,20,39,NJN,119,37,21,57,60
1983-03-04,BOS,115,42,15,PHL,110,50,7,92,22
1983-03-04,KCK,120,29,29,IND,103,16,42,45,71
1983-03-04,ATL,115,30,29,HOU,87,11,48,41,77
1983-03-04,WAS,96,25,32,LAL,93,42,16,67,48
1983-03-04,SDC,99,20,40,SAN,107,37,24,57,64
1983-03-04,PHX,109,36,24,GOS,102,23,37,59,61
1983-03-05,DET,108,28,31,LAL,122,42,17,70,48
1983-03-05,GOS,127,23,38,UTH,121,22,39,45,77
1983-03-05,DAL,91,30,30,CLE,98,15,44,45,74
1983-03-05,NYK,105,28,30,BOS,98,43,15,71,45
1983-03-05,HOU,103,11,49,SEA,126,32,28,43,77
1983-03-05,DEN,126,32,30,MIL,120,40,20,72,50
1983-03-06,SAN,117,38,24,CLE,98,16,44,54,68
1983-03-06,KCK,144,30,29,SDC,105,20,41,50,70
1983-03-06,POR,105,35,25,UTH,110,22,40,57,65
1983-03-06,CHI,106,21,39,IND,98,16,43,37,82
1983-03-06,NJN,112,37,22,PHL,106,50,8,87,30
1983-03-06,WAS,102,26,32,ATL,91,31,29,57,61
1983-03-07,BOS,121,43,16,NJN,114,38,22,81,38
1983-03-07,PHL,123,50,9,DET,114,29,32,79,41
1983-03-08,HOU,99,11,50,CLE,102,16,45,27,95
1983-03-08,NYK,107,29,30,SEA,98,33,28,62,58
1983-03-08,DEN,129,33,30,SAN,118,39,24,72,54
1983-03-08,DAL,120,30,31,PHX,99,37,24,67,55
1983-03-08,DET,107,28,32,IND,101,16,44,44,76
1983-03-08,GOS,112,24,38,LAL,116,43,17,67,55
1983-03-08,ATL,110,31,30,POR,93,35,26,66,56
1983-03-09,MIL,109,40,21,ATL,100,32,30,72,51
1983-03-09,KCK,129,31,29,DAL,113,31,31,62,60
1983-03-09,UTH,109,23,40,DEN,122,34,30,57,70
1983-03-09,LAL,119,44,17,SDC,114,20,42,64,59
1983-03-09,BOS,106,44,16,SEA,112,33,29,77,45
1983-03-09,SAN,108,39,25,PHX,105,37,25,76,50
1983-03-09,NJN,92,38,23,NYK,103,30,30,68,53
1983-03-09,IND,97,16,45,POR,101,35,27,51,72
1983-03-09,WAS,110,27,32,CHI,92,22,39,49,71
1983-03-10,HOU,109,11,51,GOS,119,24,39,35,90
1983-03-11,IND,121,16,46,SEA,127,34,29,50,75
1983-03-11,SDC,130,20,43,CHI,123,22,40,42,83
1983-03-11,NJN,98,38,24,BOS,93,44,17,82,41
1983-03-11,UTH,119,23,41,DAL,110,31,32,54,73
1983-03-11,MIL,108,41,21,KCK,100,32,29,73,50
1983-03-12,NYK,97,31,30,POR,95,36,27,67,57
1983-03-12,LAL,123,45,17,CHI,116,22,41,67,58
1983-03-12,WAS,86,28,32,PHL,95,51,9,79,41
1983-03-12,DET,119,29,33,ATL,120,32,31,61,64
1983-03-12,SAN,131,40,25,GOS,120,25,39,65,64
1983-03-12,HOU,94,11,52,PHX,105,37,26,48,78
1983-03-13,MIL,117,42,21,CLE,83,17,45,59,66
1983-03-13,DEN,130,35,30,UTH,117,24,41,59,71
1983-03-13,IND,118,16,47,DET,114,29,34,45,81
1983-03-13,KCK,115,32,30,SEA,120,35,29,67,59
1983-03-13,DAL,111,31,33,SDC,102,21,43,52,76
1983-03-13,NJN,109,39,24,POR,94,36,28,75,52
1983-03-13,BOS,110,44,18,NYK,122,32,30,76,48
1983-03-13,PHL,97,52,9,WAS,93,28,33,80,42
1983-03-15,NYK,119,33,30,ATL,97,33,31,66,61
1983-03-15,WAS,95,28,34,CLE,92,17,46,45,80
1983-03-15,NJN,109,40,24,DET,90,29,35,69,59
1983-03-15,POR,115,36,29,KCK,98,32,31,68,60
1983-03-15,DEN,139,36,30,GOS,115,25,40,61,70
1983-03-15,PHX,116,38,26,CHI,108,22,42,60,68
1983-03-15,HOU,110,11,53,DAL,123,32,33,43,86
1983-03-15,SAN,130,41,25,SDC,109,21,44,62,69
1983-03-15,IND,128,17,47,PHL,132,53,9,70,56
1983-03-16,ATL,94,33,32,WAS,81,29,34,62,66
1983-03-16,DET,115,29,36,UTH,125,24,42,53,78
1983-03-16,SEA,110,36,29,KCK,102,32,32,68,61
1983-03-16,CLE,90,17,47,NJN,96,41,24,58,71
1983-03-16,LAL,104,46,17,PHX,95,39,26,85,43
1983-03-16,MIL,93,43,21,NYK,105,34,30,77,51
1983-03-16,PHL,105,54,9,BOS,100,44,19,98,28
1983-03-16,GOS,111,25,41,CHI,113,22,43,47,84
1983-03-17,SDC,101,21,45,SAN,111,42,25,63,70
1983-03-17,PHX,125,39,27,HOU,99,11,54,50,81
1983-03-17,DAL,120,33,33,IND,105,17,48,50,81
1983-03-18,POR,101,37,29,CHI,117,23,43,60,72
1983-03-18,SEA,147,37,29,DEN,117,37,30,74,59
1983-03-18,CLE,73,17,48,ATL,97,34,32,51,80
1983-03-18,DET,103,29,37,MIL,99,43,22,72,59
1983-03-18,WAS,100,29,35,NYK,106,35,30,64,65
1983-03-18,LAL,109,47,17,KCK,96,32,33,79,50
1983-03-18,GOS,120,25,42,HOU,122,11,55,36,97
1983-03-18,BOS,116,44,20,NJN,103,42,24,86,44
1983-03-19,MIL,97,43,23,PHL,105,55,9,98,32
1983-03-19,SDC,107,21,46,LAL,99,48,17,69,63
1983-03-19,SAN,138,43,25,IND,118,17,49,60,74
1983-03-19,NYK,90,36,30,WAS,96,29,36,65,66
1983-03-19,PHX,115,40,27,DAL,112,34,33,74,60
1983-03-19,ATL,99,35,32,UTH,94,25,42,60,74
1983-03-20,KCK,128,32,34,GOS,114,25,43,57,77
1983-03-20,CLE,79,17,49,BOS,90,45,20,62,69
1983-03-20,DET,119,30,37,PHL,121,56,9,86,46
1983-03-20,DEN,106,37,31,POR,118,37,30,74,61
1983-03-20,MIL,107,43,24,NJN,92,42,25,85,49
1983-03-20,SEA,128,38,29,CHI,116,24,43,62,72
1983-03-20,LAL,117,48,18,DAL,110,34,34,82,52
1983-03-22,DEN,130,37,32,PHX,117,41,27,78,59
1983-03-22,DAL,111,34,35,GOS,102,25,44,59,79
1983-03-22,WAS,121,30,36,UTH,98,25,43,55,79
1983-03-22,SDC,128,22,46,HOU,98,12,55,34,101
1983-03-22,KCK,117,33,34,CLE,94,17,50,50,84
1983-03-22,LAL,123,49,18,SEA,108,39,29,88,47
1983-03-22,CHI,116,24,44,DET,134,30,38,54,82
1983-03-22,MIL,116,44,24,BOS,108,46,20,90,44
1983-03-22,POR,119,38,30,SAN,102,44,25,82,55
1983-03-22,IND,102,17,50,ATL,111,36,32,53,82
1983-03-22,NYK,89,36,31,PHL,76,57,9,93,40
1983-03-23,DET,109,31,38,IND,96,17,51,48,89
1983-03-23,NJN,124,42,26,UTH,104,25,44,67,70
1983-03-23,SEA,137,39,30,SAN,117,44,26,83,56
1983-03-23,CLE,84,17,51,NYK,81,37,31,54,82
1983-03-23,PHL,104,57,10,MIL,101,45,24,102,34
1983-03-23,BOS,114,46,21,ATL,102,37,32,83,53
1983-03-24,POR,104,39,30,HOU,97,12,56,51,86
1983-03-24,PHX,112,41,28,KCK,95,34,34,75,62
1983-03-24,CHI,96,24,45,WAS,102,31,36,55,81
1983-03-24,SDC,113,23,46,DAL,118,35,35,58,81
1983-03-25,BOS,124,47,21,CLE,102,18,51,65,72
1983-03-25,LAL,120,50,18,SAN,132,44,27,94,45
1983-03-25,SEA,104,40,30,HOU,106,12,57,52,87
1983-03-25,MIL,96,45,25,WAS,97,32,36,77,61
1983-03-25,ATL,87,37,33,NYK,104,37,32,74,65
1983-03-25,DEN,131,38,32,DET,120,32,38,70,70
1983-03-25,PHL,92,58,10,NJN,101,43,26,101,36
1983-03-25,IND,119,17,52,UTH,117,25,45,42,97
1983-03-26,CHI,118,24,46,BOS,108,48,21,72,67
1983-03-26,PHX,124,42,28,DEN,110,39,32,81,60
1983-03-26,DAL,111,36,35,KCK,114,34,35,70,70
1983-03-26,NJN,102,44,26,ATL,81,37,34,81,60
1983-03-26,SDC,121,23,47,GOS,117,25,45,48,92
1983-03-26,NYK,81,38,32,MIL,89,45,26,83,58
1983-03-27,KCK,110,35,35,POR,95,40,30,75,65
1983-03-27,WAS,120,33,36,IND,101,18,52,51,88
1983-03-27,PHL,94,58,11,CLE,80,18,52,76,63
1983-03-27,LAL,114,50,19,HOU,93,13,57,63,76
1983-03-27,UTH,108,25,46,SEA,122,40,31,65,77
1983-03-29,GOS,109,25,46,DAL,106,36,36,61,82
1983-03-29,IND,130,18,53,BOS,101,48,22,66,75
1983-03-29,HOU,95,13,58,KCK,111,36,35,49,93
1983-03-29,WAS,94,34,36,MIL,81,46,26,80,62
1983-03-29,CHI,97,25,46,PHL,95,59,11,84,57
1983-03-29,PHX,115,43,28,UTH,107,25,47,68,75
1983-03-29,ATL,95,37,35,CLE,82,18,53,55,88
1983-03-29,LAL,127,51,19,SDC,109,24,47,75,66
1983-03-29,SAN,136,45,27,DEN,129,39,33,84,60
1983-03-29,POR,114,40,31,DET,107,32,39,72,70
1983-03-30,CLE,102,18,54,HOU,95,13,59,31,113
1983-03-30,PHL,120,59,12,ATL,113,38,35,97,47
1983-03-30,SEA,135,41,31,DET,124,32,40,73,71
1983-03-30,UTH,117,25,48,DAL,103,36,37,61,85
1983-03-30,NJN,97,45,26,WAS,100,35,36,80,62
1983-03-30,BOS,142,48,23,IND,116,19,53,67,76
1983-03-30,SDC,103,24,48,NYK,97,38,33,62,81
1983-03-31,DEN,116,39,34,LAL,122,52,19,91,53
1983-03-31,PHX,106,44,28,POR,89,41,31,85,59
1983-04-01,SEA,101,42,31,DAL,95,36,38,78,69
1983-04-01,LAL,102,53,19,NYK,88,38,34,91,53
1983-04-01,DET,120,32,41,CLE,111,19,54,51,95
1983-04-01,CHI,107,26,46,ATL,108,38,36,64,82
1983-04-01,UTH,112,26,48,GOS,108,26,46,52,94
1983-04-01,PHL,104,60,12,NJN,111,45,27,105,39
1983-04-01,SAN,124,46,27,HOU,99,13,60,59,87
1983-04-01,SDC,119,25,48,KCK,135,37,35,62,83
1983-04-01,BOS,97,50,23,MIL,83,47,27,97,50
1983-04-01,IND,109,19,59,WAS,123,39,38,58,97
1983-04-02,PHX,115,45,28,NYK,108,38,35,83,63
1983-04-02,WAS,117,36,36,BOS,120,49,23,85,59
1983-04-02,DEN,107,39,35,SDC,99,25,49,64,84
1983-04-02,GOS,112,26,47,KCK,122,38,35,64,82
1983-04-02,ATL,109,39,36,IND,99,19,54,58,90
1983-04-02,HOU,101,13,61,SAN,112,47,27,60,88
1983-04-02,NJN,103,46,27,MIL,105,46,27,92,54
1983-04-02,POR,110,41,32,DAL,98,36,39,77,71
1983-04-03,DET,122,33,41,CHI,107,26,47,59,88
1983-04-03,CLE,84,19,55,PHL,96,60,13,79,68
1983-04-04,SEA,121,43,31,LAL,111,54,19,97,50
1983-04-05,ATL,95,40,36,BOS,117,51,23,91,59
1983-04-05,UTH,126,27,48,HOU,97,13,62,40,110
1983-04-05,WAS,95,36,37,NJN,89,46,28,82,65
1983-04-05,POR,107,42,32,LAL,101,54,20,96,52
1983-04-05,SDC,109,25,50,SEA,115,44,31,69,81
1983-04-05,PHX,126,46,28,GOS,106,26,48,72,76
1983-04-05,SAN,130,48,27,KCK,113,39,35,87,62
1983-04-05,NYK,110,38,36,DET,107,34,41,72,77
1983-04-05,MIL,108,47,28,PHL,116,61,13,108,41
1983-04-05,CHI,91,26,48,CLE,101,19,56,45,104
1983-04-06,DAL,99,36,40,HOU,101,13,63,49,103
1983-04-06,DET,107,34,42,WAS,96,37,37,71,79
1983-04-06,KCK,130,39,36,DEN,113,40,35,79,71
1983-04-06,NJN,121,46,29,IND,110,19,55,65,84
1983-04-06,PHL,109,62,13,SAN,112,49,27,111,40
1983-04-06,BOS,102,52,23,NYK,98,39,36,91,59
1983-04-07,CLE,87,20,56,MIL,100,47,29,67,85
1983-04-07,SEA,102,45,31,SDC,96,25,51,70,82
1983-04-07,PHX,108,47,28,LAL,117,54,21,101,49
1983-04-07,GOS,118,26,49,POR,107,43,32,69,81
1983-04-08,DET,102,35,42,NJN,92,47,29,82,71
1983-04-08,NYK,102,39,37,SAN,100,50,27,89,64
1983-04-08,LAL,118,55,21,GOS,107,27,49,82,70
1983-04-08,KCK,112,40,36,UTH,97,28,48,68,84
1983-04-08,ATL,138,40,37,CHI,101,26,49,66,86
1983-04-08,PHL,126,62,14,IND,118,19,56,81,70
1983-04-08,DAL,115,36,41,DEN,132,40,36,76,77
1983-04-08,POR,98,43,33,PHX,99,47,29,90,62
1983-04-08,BOS,99,53,23,WAS,107,37,38,90,61
1983-04-09,WAS,100,38,38,ATL,78,41,37,79,75
1983-04-09,CHI,104,26,50,MIL,115,48,29,74,79
1983-04-09,NJN,115,47,30,CLE,105,20,57,67,87
1983-04-09,UTH,102,28,49,KCK,108,41,36,69,85
1983-04-09,HOU,105,14,63,DEN,123,41,36,55,99
1983-04-09,SAN,111,50,28,DAL,122,36,42,86,70
1983-04-10,BOS,115,53,24,DET,113,36,42,89,66
1983-04-10,MIL,121,49,29,CHI,91,26,51,75,80
1983-04-10,PHL,113,63,14,NYK,97,40,37,103,51
1983-04-10,CLE,110,20,58,IND,105,19,57,39,115
1983-04-10,GOS,102,27,50,SDC,93,25,52,52,102
1983-04-10,LAL,95,56,21,PHX,101,48,29,104,50
1983-04-10,POR,93,43,34,SEA,102,46,31,89,65
1983-04-11,NYK,121,40,38,IND,92,19,58,59,96
1983-04-12,GOS,108,28,50,PHX,115,49,29,77,79
1983-04-12,HOU,113,14,64,LAL,114,56,22,70,86
1983-04-12,UTH,125,28,50,DEN,116,42,36,70,86
1983-04-12,CHI,102,26,52,KCK,112,42,36,68,88
1983-04-12,NJN,93,48,30,BOS,99,54,24,102,54
1983-04-12,ATL,102,41,38,PHL,97,64,14,105,52
1983-04-12,SEA,106,47,31,POR,101,43,35,90,66
1983-04-13,PHL,76,64,15,WAS,95,40,38,104,53
1983-04-13,DEN,131,42,37,HOU,112,14,65,56,102
1983-04-13,DAL,106,37,42,UTH,99,29,50,66,92
1983-04-13,PHX,109,50,29,SEA,96,48,31,98,60
1983-04-13,CLE,98,21,58,CHI,107,26,53,47,111
1983-04-13,KCK,114,43,36,ATL,103,42,38,85,74
1983-04-13,IND,113,19,60,MIL,90,50,29,69,89
1983-04-13,NYK,108,41,38,NJN,100,48,31,89,69
1983-04-13,SAN,114,50,29,LAL,109,57,22,107,51
1983-04-13,SDC,92,25,53,GOS,113,28,51,53,104
1983-04-13,DET,113,36,43,BOS,101,55,24,91,67
1983-04-14,POR,120,43,36,SDC,83,25,54,68,90
1983-04-14,MIL,97,50,30,WAS,90,41,38,91,68
1983-04-15,POR,112,44,36,GOS,106,29,51,73,87
1983-04-15,DEN,137,43,37,DAL,126,38,42,81,79
1983-04-15,SDC,101,25,55,PHX,113,51,29,76,84
1983-04-15,IND,124,20,60,CLE,132,21,59,41,119
1983-04-15,LAL,100,57,23,SEA,99,48,32,105,55
1983-04-15,BOS,117,55,25,CHI,120,27,53,82,78
1983-04-15,SAN,121,51,29,UTH,118,29,51,80,80
1983-04-15,DET,83,37,43,NYK,100,42,38,79,81
1983-04-15,NJN,98,48,32,PHL,100,64,16,112,48
1983-04-15,KCK,117,44,36,HOU,102,14,66,58,102
1983-04-16,WAS,102,41,39,DET,95,37,44,78,83
1983-04-16,ATL,96,42,39,MIL,79,51,30,93,69
1983-04-16,DAL,120,38,43,SAN,132,52,29,90,72
1983-04-16,HOU,117,14,67,UTH,126,29,52,43,119
1983-04-16,GOS,133,29,52,SEA,122,48,33,77,85
1983-04-17,IND,99,20,61,NJN,112,48,33,68,94
1983-04-17,DEN,125,44,37,KCK,116,45,36,89,73
1983-04-17,LAL,108,58,23,POR,119,45,36,103,59
1983-04-17,PHX,110,52,29,SDC,101,25,56,77,85
1983-04-17,CLE,118,22,59,WAS,105,42,39,64,98
1983-04-17,BOS,114,55,26,PHL,101,65,16,120,42
1983-04-17,CHI,103,28,53,NYK,120,43,38,71,91
1983-10-28,MIL,104,0,0,IND,83,0,0,0,0
1983-10-28,KCK,107,0,0,LAL,117,0,0,0,0
1983-10-28,PHL,117,0,0,WAS,114,0,0,0,0
1983-10-28,SEA,109,0,0,GOS,110,0,0,0,0
1983-10-28,NJN,126,0,0,ATL,108,0,0,0,0
1983-10-28,DET,127,0,0,BOS,121,0,0,0,0
1983-10-28,POR,107,0,0,SDC,93,0,0,0,0
1983-10-28,CLE,106,0,0,NYK,113,0,0,0,0
1983-10-28,DEN,139,0,0,UTH,125,0,0,0,0
1983-10-29,UTH,115,0,1,LAL,120,1,0,1,1
1983-10-29,NYK,100,1,0,WAS,97,0,1,1,1
1983-10-29,CHI,104,0,0,NJN,97,1,0,1,0
1983-10-29,GOS,97,1,0,POR,95,1,0,2,0
1983-10-29,ATL,117,0,1,DET,115,1,0,1,1
1983-10-29,HOU,106,0,0,SAN,100,0,0,0,0
1983-10-29,SDC,141,0,1,DEN,128,1,0,1,1
1983-10-29,IND,112,0,1,PHL,124,1,0,1,1
1983-10-29,DAL,120,0,0,PHX,103,0,0,0,0
1983-10-29,CLE,89,0,1,BOS,108,0,1,0,2
1983-10-30,SAN,123,0,1,DAL,101,1,0,1,1
1983-10-30,KCK,116,0,1,SEA,121,0,1,0,2
1983-11-01,DET,106,1,1,MIL,93,1,0,2,1
1983-11-01,IND,116,0,2,HOU,108,1,0,1,2
1983-11-01,PHX,93,0,1,SEA,103,1,1,1,2
1983-11-01,PHL,99,2,0,CHI,91,1,0,3,0
1983-11-01,DEN,124,1,1,DAL,130,1,1,2,2
1983-11-01,ATL,95,1,1,WAS,92,0,2,1,3
1983-11-01,SAN,124,1,1,POR,126,1,1,2,2
1983-11-01,KCK,116,0,2,GOS,114,2,0,2,2
1983-11-01,NJN,125,1,1,CLE,113,0,2,1,3
1983-11-02,CLE,103,0,3,HOU,94,1,1,1,4
1983-11-02,DAL,123,2,1,POR,117,2,1,4,2
1983-11-02,BOS,119,1,1,MIL,105,1,1,2,2
1983-11-02,SEA,125,2,1,NYK,119,2,0,4,1
1983-11-02,SDC,110,1,1,LAL,106,2,0,3,1
1983-11-03,WAS,111,0,3,DET,88,2,1,2,4
1983-11-03,KCK,128,1,2,DEN,131,1,2,2,4
1983-11-03,PHX,142,0,2,SAN,120,1,2,1,4
1983-11-03,NJN,112,2,1,CHI,107,1,1,3,2
1983-11-03,UTH,129,0,2,GOS,112,2,1,2,3
1983-11-04,ATL,103,2,1,CHI,90,1,2,3,3
1983-11-04,PHL,94,3,0,MIL,104,1,2,4,2
1983-11-04,BOS,121,2,1,IND,105,1,2,3,3
1983-11-04,SDC,121,2,1,SEA,97,3,1,5,2
1983-11-04,DET,108,2,2,HOU,113,1,2,3,4
1983-11-04,POR,106,2,2,NYK,97,2,1,4,3
1983-11-04,CLE,105,1,3,DAL,84,3,1,4,4
1983-11-05,GOS,102,2,2,NYK,100,2,2,4,4
1983-11-05,IND,99,1,3,CLE,87,2,3,3,6
1983-11-05,NJN,112,3,1,PHL,119,3,1,6,2
1983-11-05,UTH,124,1,2,SAN,118,1,3,2,5
1983-11-05,WAS,117,1,3,BOS,120,3,1,4,4
1983-11-05,DAL,107,3,2,LAL,102,2,1,5,3
1983-11-05,DEN,127,2,2,SDC,121,3,1,5,3
1983-11-05,KCK,123,1,3,HOU,106,2,2,3,5
1983-11-06,POR,122,3,2,PHX,96,1,2,4,4
1983-11-06,SAN,132,1,4,SEA,115,3,2,4,6
1983-11-06,MIL,97,2,2,ATL,84,3,1,5,3
1983-11-08,SEA,123,3,3,PHX,116,1,3,4,6
1983-11-08,GOS,97,3,2,ATL,90,3,2,6,4
1983-11-08,WAS,119,1,4,SDC,113,3,2,4,6
1983-11-08,NYK,90,2,3,MIL,97,3,2,5,5
1983-11-08,IND,97,2,3,BOS,99,4,1,6,4
1983-11-08,CHI,100,1,3,KCK,97,2,3,3,6
1983-11-08,HOU,104,2,3,POR,122,4,2,6,5
1983-11-08,DEN,124,3,2,LAL,133,2,2,5,4
1983-11-09,NJN,127,3,2,WAS,110,2,4,5,6
1983-11-09,LAL,120,3,2,DAL,106,4,2,7,4
1983-11-09,SAN,105,2,4,UTH,99,2,2,4,6
1983-11-09,MIL,95,4,2,KCK,93,2,4,6,6
1983-11-09,SEA,113,4,3,CLE,101,2,4,6,7
1983-11-09,DET,120,2,3,PHL,116,4,1,6,4
1983-11-09,BOS,129,5,1,SDC,122,3,3,8,4
1983-11-10,HOU,109,2,4,UTH,118,2,3,4,7
1983-11-10,POR,115,5,2,CLE,110,2,5,7,7
1983-11-10,GOS,99,4,2,PHX,104,1,4,5,6
1983-11-10,IND,91,2,4,NYK,99,2,4,4,8
1983-11-11,NYK,116,3,4,SDC,95,3,4,6,8
1983-11-11,PHL,108,4,2,KCK,100,2,5,6,7
1983-11-11,SEA,104,5,3,ATL,93,3,3,8,6
1983-11-11,WAS,125,2,5,CHI,124,2,3,4,8
1983-11-11,BOS,126,6,1,DET,118,3,3,9,4
1983-11-11,NJN,107,4,2,MIL,103,5,2,9,4
1983-11-11,LAL,119,4,2,PHX,105,2,4,6,6
1983-11-11,DAL,112,4,3,SAN,105,3,4,7,7
1983-11-12,SAN,126,3,5,DEN,107,3,3,6,8
1983-11-12,GOS,109,4,3,CLE,102,2,6,6,9
1983-11-12,HOU,100,2,5,DAL,98,5,3,7,8
1983-11-12,DET,131,3,4,KCK,106,2,6,5,10
1983-11-12,UTH,136,3,3,POR,122,6,2,9,5
1983-11-12,IND,111,2,5,NJN,101,5,2,7,7
1983-11-12,CHI,101,2,4,BOS,116,7,1,9,5
1983-11-13,MIL,108,5,3,SEA,107,6,3,11,6
1983-11-13,LAL,124,5,2,UTH,118,4,3,9,5
1983-11-13,PHL,124,5,2,SDC,116,3,5,8,7
1983-11-13,POR,135,6,3,ATL,105,3,4,9,7
1983-11-13,PHX,113,2,5,GOS,98,5,3,7,8
1983-11-15,LAL,126,6,2,MIL,97,6,3,12,5
1983-11-15,CHI,112,2,5,DET,110,4,4,6,9
1983-11-15,WAS,100,3,5,KCK,101,2,7,5,12
1983-11-15,ATL,107,3,5,SDC,102,3,6,6,11
1983-11-15,GOS,115,5,4,SAN,112,4,5,9,9
1983-11-15,DEN,124,3,4,BOS,140,8,1,11,5
1983-11-15,POR,114,7,3,UTH,112,4,4,11,7
1983-11-15,NYK,94,4,4,IND,87,3,5,7,9
1983-11-15,HOU,86,3,5,NJN,104,5,3,8,8
1983-11-16,PHX,115,3,5,CLE,104,2,7,5,12
1983-11-16,DET,122,4,5,SEA,120,6,4,10,9
1983-11-16,PHL,102,6,2,NYK,97,5,4,11,6
1983-11-16,UTH,122,4,5,BOS,109,9,1,13,6
1983-11-17,GOS,120,6,4,DEN,131,3,5,9,9
1983-11-17,ATL,99,4,5,PHL,94,7,2,11,7
1983-11-17,LAL,127,7,2,CLE,114,2,8,9,10
1983-11-17,SDC,141,3,7,MIL,122,6,4,9,11
1983-11-17,WAS,102,3,6,IND,94,3,6,6,12
1983-11-17,SAN,128,4,6,KCK,129,3,7,7,13
1983-11-17,DAL,115,5,4,NJN,113,6,3,11,7
1983-11-17,CHI,110,3,5,SEA,119,6,5,9,10
1983-11-18,DET,128,5,5,UTH,120,5,5,10,10
1983-11-18,DEN,134,4,5,HOU,127,3,6,7,11
1983-11-18,PHX,94,4,5,MIL,109,6,5,10,10
1983-11-18,BOS,103,9,2,NYK,110,5,5,14,7
1983-11-19,NYK,104,6,5,DET,101,6,5,12,10
1983-11-19,CHI,110,3,6,IND,105,3,7,6,13
1983-11-19,DEN,133,5,5,MIL,126,7,5,12,10
1983-11-19,WAS,126,4,6,UTH,113,5,6,9,12
1983-11-19,DAL,116,6,4,PHX,107,4,6,10,10
1983-11-19,PHL,92,7,3,BOS,91,9,3,16,6
1983-11-19,POR,110,8,3,LAL,117,8,2,16,5
1983-11-19,HOU,125,3,7,GOS,105,6,5,9,12
1983-11-19,ATL,104,5,5,SEA,92,7,5,12,10
1983-11-19,SAN,109,4,7,NJN,100,6,4,10,11
1983-11-20,SDC,99,4,7,CLE,97,2,9,6,16
1983-11-22,HOU,118,4,7,PHX,96,4,7,8,14
1983-11-22,ATL,104,6,5,IND,93,3,8,9,13
1983-11-22,KCK,118,4,7,SDC,99,5,7,9,14
1983-11-22,DAL,118,7,4,SAN,117,5,7,12,11
1983-11-22,WAS,101,5,6,GOS,102,6,6,11,12
1983-11-22,LAL,126,9,2,UTH,130,5,7,14,9
1983-11-22,NYK,117,7,5,BOS,113,9,4,16,9
1983-11-22,POR,156,8,4,DEN,116,6,5,14,9
1983-11-22,PHL,112,8,3,DET,108,6,6,14,9
1983-11-23,MIL,118,7,6,GOS,94,7,6,14,12
1983-11-23,CLE,107,2,10,WAS,98,5,7,7,17
1983-11-23,SAN,105,5,8,PHL,113,9,3,14,11
1983-11-23,SEA,106,7,6,LAL,98,9,3,16,9
1983-11-23,UTH,117,6,7,CHI,128,4,6,10,13
1983-11-23,PHX,108,4,8,NJN,110,6,5,10,13
1983-11-23,DEN,133,6,6,SDC,114,5,8,11,14
1983-11-23,IND,113,3,9,DET,115,6,7,9,16
1983-11-25,SAN,133,5,9,SDC,120,5,9,10,18
1983-11-25,PHX,120,4,9,CHI,94,5,6,9,15
1983-11-25,DET,111,7,7,WAS,120,5,8,12,15
1983-11-25,IND,105,3,10,GOS,110,7,7,10,17
1983-11-25,DAL,98,8,4,KCK,96,5,7,13,11
1983-11-25,SEA,90,8,6,POR,100,9,4,17,10
1983-11-25,HOU,101,5,7,PHL,115,10,3,15,10
1983-11-25,BOS,109,9,5,ATL,102,7,5,16,10
1983-11-25,UTH,126,6,8,DEN,124,7,6,13,14
1983-11-25,LAL,147,9,4,NJN,123,7,5,16,9
1983-11-26,DEN,107,7,7,PHX,104,5,9,12,16
1983-11-26,POR,122,10,4,SEA,94,8,7,18,11
1983-11-26,KCK,117,5,8,UTH,116,7,8,12,16
1983-11-26,ATL,115,7,6,HOU,109,5,8,12,14
1983-11-26,DAL,115,9,4,GOS,109,8,7,17,11
1983-11-26,SDC,102,5,10,NJN,104,7,6,12,16
1983-11-26,NYK,96,8,5,CLE,84,3,10,11,15
1983-11-26,MIL,109,8,6,WAS,92,6,8,14,14
1983-11-27,CLE,114,3,11,SAN,106,6,9,9,20
1983-11-27,LAL,103,10,4,CHI,100,5,7,15,11
1983-11-27,IND,101,3,11,NYK,91,9,5,12,16
1983-11-27,BOS,114,10,5,DET,99,7,8,17,13
1983-11-28,KCK,113,6,8,POR,104,11,4,17,12
1983-11-29,DET,103,7,9,CLE,93,4,11,11,20
1983-11-29,UTH,114,7,9,PHX,110,5,10,12,19
1983-11-29,HOU,116,5,9,CHI,110,5,8,10,17
1983-11-29,WAS,88,6,9,MIL,94,9,6,15,15
1983-11-29,IND,96,4,11,PHL,98,11,3,15,14
1983-11-29,SEA,119,8,8,SDC,114,5,11,13,19
1983-11-29,NYK,118,9,6,SAN,106,6,10,15,16
1983-11-29,ATL,96,8,6,DEN,105,8,7,16,13
1983-11-29,GOS,105,8,8,LAL,111,11,4,19,12
1983-11-30,NJN,104,8,6,NYK,113,10,6,18,12
1983-11-30,DAL,113,10,4,HOU,102,6,9,16,13
1983-11-30,CLE,112,4,12,POR,105,11,5,15,17
1983-11-30,PHX,118,5,11,KCK,120,7,8,12,19
1983-11-30,BOS,130,11,5,SAN,106,6,11,17,16
1983-11-30,PHL,122,12,3,ATL,110,8,7,20,10
1983-11-30,MIL,139,10,6,DEN,122,9,7,19,13
1983-11-30,SDC,115,5,12,UTH,117,8,9,13,21
1983-12-01,NYK,127,11,6,WAS,93,6,10,17,16
1983-12-01,GOS,106,8,9,KCK,95,8,8,16,17
1983-12-02,BOS,115,12,5,POR,106,11,6,23,11
1983-12-02,DET,128,8,9,ATL,92,8,8,16,17
1983-12-02,PHX,113,5,12,UTH,116,9,9,14,21
1983-12-02,HOU,125,6,10,SEA,102,9,8,15,18
1983-12-02,LAL,118,12,4,DAL,133,11,4,23,8
1983-12-02,SAN,123,6,12,CHI,94,5,9,11,21
1983-12-02,SDC,109,5,13,GOS,108,9,9,14,22
1983-12-02,MIL,122,11,6,NJN,107,8,7,19,13
1983-12-02,CLE,108,5,12,IND,99,4,12,9,24
1983-12-03,NYK,117,12,6,HOU,101,7,10,19,16
1983-12-03,NJN,122,8,8,POR,128,11,7,19,15
1983-12-03,ATL,102,8,9,CLE,91,6,12,14,21
1983-12-03,DAL,110,12,4,CHI,100,5,10,17,14
1983-12-03,DEN,121,9,8,SEA,111,9,9,18,17
1983-12-03,DET,117,9,9,IND,99,4,13,13,22
1983-12-03,UTH,112,10,9,KCK,107,8,9,18,18
1983-12-03,WAS,103,6,11,PHL,98,13,3,19,14
1983-12-04,BOS,114,13,5,PHL,121,13,4,26,9
1983-12-04,SAN,106,7,12,PHX,122,5,13,12,25
1983-12-04,LAL,120,12,5,SDC,99,6,13,18,18
1983-12-06,KCK,112,8,10,DAL,103,13,4,21,14
1983-12-06,ATL,95,9,9,PHX,88,6,13,15,22
1983-12-06,NYK,112,13,6,DEN,117,10,8,23,14
1983-12-06,GOS,108,9,10,SEA,103,9,10,18,20
1983-12-06,CHI,105,5,11,BOS,118,13,6,18,17
1983-12-06,NJN,114,8,9,CLE,105,6,13,14,22
1983-12-06,HOU,109,7,11,WAS,113,7,11,14,22
1983-12-06,POR,130,12,7,SAN,118,7,13,19,20
1983-12-07,SDC,106,6,14,SAN,102,7,14,13,28
1983-12-07,PHL,133,14,4,DEN,128,11,8,25,12
1983-12-07,UTH,116,11,9,POR,111,13,7,24,16
1983-12-07,DAL,112,13,5,WAS,114,8,11,21,16
1983-12-07,MIL,103,12,6,HOU,101,7,12,19,18
1983-12-07,IND,95,4,14,BOS,100,14,6,18,20
1983-12-07,CLE,106,6,14,ATL,92,10,9,16,23
1983-12-08,LAL,129,13,5,KCK,106,9,10,22,15
1983-12-08,GOS,130,10,10,DET,129,10,9,20,19
1983-12-08,PHX,120,6,14,NYK,97,13,7,19,21
1983-12-09,POR,123,13,8,DET,117,10,10,23,18
1983-12-09,SEA,132,9,11,DAL,124,13,6,22,17
1983-12-09,SDC,92,7,14,NYK,111,13,8,20,22
1983-12-09,IND,110,4,15,ATL,104,10,10,14,25
1983-12-09,CLE,83,7,14,MIL,96,13,6,20,20
1983-12-09,BOS,119,15,6,DEN,90,11,9,26,15
1983-12-09,CHI,112,5,12,HOU,115,7,13,12,25
1983-12-09,UTH,117,12,9,SAN,126,7,15,19,24
1983-12-09,PHL,93,15,4,NJN,100,9,9,24,13
1983-12-10,ATL,87,10,11,BOS,104,16,6,26,17
1983-12-10,GOS,123,11,10,DAL,126,13,7,24,17
1983-12-10,KCK,119,9,11,IND,103,5,15,14,26
1983-12-10,SAN,125,8,15,WAS,102,9,11,17,26
1983-12-10,HOU,121,8,13,UTH,128,12,10,20,23
1983-12-10,CHI,95,5,13,CLE,101,7,15,12,28
1983-12-10,PHX,109,7,14,SDC,93,7,15,14,29
1983-12-11,MIL,87,14,6,PHL,97,15,5,29,11
1983-12-11,LAL,98,14,5,NYK,109,14,8,28,13
1983-12-11,POR,105,14,8,GOS,101,11,11,25,19
1983-12-11,NJN,141,10,9,DEN,130,11,10,21,19
1983-12-11,SEA,135,10,11,DET,131,10,11,20,22
1983-12-11,SDC,118,7,16,DAL,116,14,7,21,23
1983-12-13,HOU,129,8,14,PHX,110,8,14,16,28
1983-12-13,GOS,122,11,12,NJN,133,11,9,22,21
1983-12-13,DEN,184,11,11,DET,186,10,12,21,23
1983-12-13,POR,102,15,8,SEA,89,11,11,26,19
1983-12-13,CLE,105,8,15,UTH,107,13,10,21,25
1983-12-13,WAS,89,9,12,ATL,94,10,12,19,24
1983-12-13,NYK,100,15,8,BOS,102,17,6,32,14
1983-12-13,CHI,96,5,14,MIL,88,14,7,19,21
1983-12-14,ATL,96,11,12,WAS,99,9,13,20,25
1983-12-14,DAL,117,14,8,IND,109,5,16,19,24
1983-12-14,PHL,115,16,5,MIL,93,14,8,30,13
1983-12-14,SAN,129,9,15,SDC,114,8,16,17,31
1983-12-14,BOS,110,18,6,CLE,108,8,16,26,22
1983-12-14,SEA,99,11,12,KCK,105,10,11,21,23
1983-12-15,PHX,114,8,15,LAL,104,14,6,22,21
1983-12-15,NYK,107,15,9,CHI,113,6,14,21,23
1983-12-15,UTH,138,14,10,HOU,111,9,14,23,24
1983-12-15,GOS,119,11,13,KCK,116,11,11,22,24
1983-12-15,POR,118,16,8,NJN,105,12,9,28,17
1983-12-16,BOS,93,19,6,WAS,100,10,13,29,19
1983-12-16,MIL,110,14,9,DAL,105,15,8,29,17
1983-12-16,LAL,122,14,7,SDC,109,8,17,22,24
1983-12-16,SAN,120,10,15,IND,92,5,17,15,32
1983-12-16,PHL,115,17,5,CLE,105,8,17,25,22
1983-12-16,DEN,115,11,12,POR,119,17,8,28,20
1983-12-16,SEA,110,11,13,NJN,106,12,10,23,23
1983-12-17,ATL,113,11,13,SAN,108,11,15,22,28
1983-12-17,WAS,119,11,13,CLE,95,8,18,19,31
1983-12-17,PHX,119,9,15,KCK,99,11,12,20,27
1983-12-17,HOU,109,9,15,IND,94,5,18,14,33
1983-12-17,UTH,127,15,10,GOS,111,12,13,27,23
1983-12-17,NYK,102,15,10,MIL,96,15,9,30,19
1983-12-17,CHI,102,7,14,DAL,84,15,9,22,23
1983-12-17,DET,115,11,12,BOS,129,19,7,30,19
1983-12-18,LAL,122,15,7,POR,115,18,8,33,15
1983-12-18,GOS,99,12,14,SDC,97,8,18,20,32
1983-12-18,DEN,122,11,13,NJN,118,12,11,23,24
1983-12-20,KCK,131,11,13,DEN,114,12,13,23,26
1983-12-20,DET,116,11,13,DAL,104,15,10,26,23
1983-12-20,SEA,102,12,13,LAL,108,16,7,28,20
1983-12-20,GOS,105,13,14,PHX,109,10,15,23,29
1983-12-20,ATL,98,12,13,NJN,87,12,12,24,25
1983-12-20,WAS,108,12,13,SAN,106,11,16,23,29
1983-12-21,CLE,112,8,19,DET,119,12,13,20,32
1983-12-21,UTH,133,16,10,IND,115,5,19,21,29
1983-12-21,BOS,107,20,7,ATL,96,13,13,33,20
1983-12-21,PHL,122,18,5,SAN,121,11,17,29,22
1983-12-21,PHX,112,11,15,POR,116,18,9,29,24
1983-12-21,SDC,128,8,19,HOU,97,10,15,18,34
1983-12-22,MIL,99,15,10,CHI,116,8,14,23,24
1983-12-22,GOS,109,13,15,LAL,102,17,7,30,22
1983-12-22,DEN,132,12,14,IND,133,5,20,17,34
1983-12-22,SEA,112,12,14,HOU,116,10,16,22,30
1983-12-22,NJN,101,12,13,DAL,98,15,11,27,24
1983-12-23,DET,106,13,13,PHL,108,19,5,32,18
1983-12-23,KCK,126,12,13,SAN,122,11,18,23,31
1983-12-23,SDC,115,9,19,PHX,121,11,16,20,35
1983-12-23,CHI,114,9,14,WAS,93,13,13,22,27
1983-12-23,CLE,83,8,20,MIL,89,15,11,23,31
1983-12-23,LAL,123,17,8,GOS,116,14,15,31,23
1983-12-23,ATL,114,13,14,NYK,113,16,10,29,24
1983-12-23,POR,97,19,9,HOU,84,11,16,30,25
1983-12-23,BOS,125,21,7,NJN,113,13,13,34,20
1983-12-23,UTH,118,17,10,DEN,116,12,15,29,25
1983-12-25,NYK,112,16,11,NJN,110,13,14,29,25
1983-12-25,POR,141,20,9,LAL,121,18,8,38,17
1983-12-26,PHX,140,12,16,DEN,133,12,16,24,32
1983-12-27,WAS,116,13,14,NJN,106,13,15,26,29
1983-12-27,IND,115,6,20,MIL,104,16,11,22,31
1983-12-27,HOU,95,11,17,SDC,110,9,20,20,37
1983-12-27,ATL,112,14,14,DAL,109,15,12,29,26
1983-12-27,CHI,102,10,14,NYK,96,17,11,27,25
1983-12-27,SAN,100,11,19,BOS,115,22,7,33,26
1983-12-27,GOS,102,14,16,UTH,111,18,10,32,26
1983-12-27,DET,140,13,14,POR,100,21,9,34,23
1983-12-27,KCK,109,13,13,PHL,112,20,5,33,18
1983-12-27,LAL,118,18,9,DEN,116,12,17,30,26
1983-12-28,SEA,105,12,15,UTH,113,19,10,31,25
1983-12-28,DAL,109,15,13,SDC,92,10,20,25,33
1983-12-28,NYK,108,17,12,DET,111,14,14,31,26
1983-12-28,NJN,85,13,16,MIL,89,16,12,29,28
1983-12-28,PHX,128,13,16,GOS,105,14,17,27,33
1983-12-29,CHI,100,11,14,POR,99,21,10,32,24
1983-12-29,DEN,101,12,18,PHL,89,21,5,33,23
1983-12-29,CLE,88,8,21,ATL,77,15,14,23,35
1983-12-29,SAN,138,11,20,KCK,127,13,14,24,34
1983-12-29,HOU,107,11,18,BOS,94,23,7,34,25
1983-12-30,NJN,118,13,17,IND,106,7,20,20,37
1983-12-30,WAS,91,14,14,NYK,86,17,13,31,27
1983-12-30,DET,103,15,14,CHI,96,12,14,27,28
1983-12-30,ATL,109,15,15,CLE,98,9,21,24,36
1983-12-30,DAL,109,16,13,BOS,114,23,8,39,21
1983-12-30,KCK,96,13,15,SDC,99,10,21,23,36
1983-12-30,PHX,121,14,16,HOU,110,12,18,26,34
1983-12-30,MIL,93,17,12,POR,88,21,11,38,23
1983-12-30,LAL,105,19,9,GOS,116,14,18,33,27
1983-12-30,DEN,135,13,18,UTH,130,20,10,33,28
1983-12-30,SEA,97,12,16,PHL,93,21,6,33,22
1984-01-01,POR,103,21,12,PHL,115,21,7,42,19
1984-01-02,IND,96,7,21,ATL,86,16,15,23,36
1984-01-03,NJN,103,14,17,BOS,105,24,8,38,25
1984-01-03,HOU,117,12,19,DAL,119,16,14,28,33
1984-01-03,GOS,115,15,18,PHL,106,22,7,37,25
1984-01-03,POR,123,21,13,KCK,104,13,16,34,29
1984-01-03,SAN,137,12,20,UTH,124,20,11,32,31
1984-01-03,CHI,102,12,15,PHX,97,15,16,27,31
1984-01-03,DEN,109,14,18,SEA,110,13,16,27,34
1984-01-03,WAS,103,15,14,DET,102,16,14,31,28
1984-01-03,MIL,104,18,12,CLE,92,9,22,27,34
1984-01-03,NYK,117,17,14,LAL,105,19,10,36,24
1984-01-04,ATL,88,16,16,NJN,91,14,18,30,34
1984-01-04,CLE,99,9,23,LAL,106,19,11,28,34
1984-01-04,UTH,116,20,12,HOU,111,12,20,32,32
1984-01-04,BOS,113,25,8,WAS,104,16,14,41,22
1984-01-04,SDC,122,11,21,KCK,121,13,17,24,38
1984-01-04,DET,128,16,15,PHX,114,15,17,31,32
1984-01-04,DAL,105,17,14,SEA,102,14,16,31,30
1984-01-04,IND,102,8,21,CHI,89,13,15,21,36
1984-01-05,MIL,102,19,12,PHL,103,22,8,41,20
1984-01-06,ATL,91,16,17,MIL,87,19,13,35,30
1984-01-06,POR,144,22,13,DEN,129,14,19,36,32
1984-01-06,WAS,96,16,15,CHI,88,13,16,29,31
1984-01-06,UTH,130,21,12,KCK,110,13,18,34,30
1984-01-06,LAL,117,20,11,SAN,124,13,20,33,31
1984-01-06,BOS,115,26,8,CLE,97,9,24,35,32
1984-01-06,PHL,108,23,8,NJN,104,15,18,38,26
1984-01-06,SDC,106,12,21,DAL,123,18,14,30,35
1984-01-06,DET,118,17,15,NYK,107,18,14,35,29
1984-01-06,IND,104,9,21,PHX,88,15,18,24,39
1984-01-06,SEA,118,14,17,HOU,102,12,21,26,38
1984-01-07,GOS,154,16,18,SAN,133,14,20,30,38
1984-01-07,DEN,141,14,20,DAL,117,19,14,33,34
1984-01-07,CHI,87,13,17,WAS,73,17,15,30,32
1984-01-07,NJN,108,15,19,ATL,104,17,17,32,36
1984-01-07,NYK,140,18,15,IND,103,10,21,28,36
1984-01-07,CLE,106,9,25,PHL,98,24,8,33,33
1984-01-07,KCK,100,13,19,PHX,98,15,19,28,38
1984-01-08,MIL,100,19,14,DET,111,18,15,37,29
1984-01-08,LAL,118,20,12,HOU,129,12,22,32,34
1984-01-08,SEA,125,15,17,POR,110,23,13,38,30
1984-01-09,NJN,107,16,19,WAS,103,17,16,33,35
1984-01-09,NYK,111,19,15,PHL,73,24,9,43,24
1984-01-10,UTH,107,22,12,PHX,98,15,20,37,32
1984-01-10,ATL,103,17,18,GOS,101,17,18,34,36
1984-01-10,HOU,132,13,22,LAL,136,20,13,33,35
1984-01-10,POR,133,23,14,SAN,120,14,21,37,35
1984-01-10,SEA,111,16,17,SDC,106,12,22,28,39
1984-01-10,KCK,112,14,19,DAL,102,19,15,33,34
1984-01-10,MIL,104,19,15,CLE,116,10,25,29,40
1984-01-10,CHI,105,14,17,IND,104,10,22,24,39
1984-01-11,PHX,129,15,21,SDC,104,12,23,27,44
1984-01-11,DEN,163,15,20,SAN,155,14,22,29,42
1984-01-11,PHL,121,24,10,WAS,99,17,17,41,27
1984-01-11,BOS,135,27,8,GOS,112,17,19,44,27
1984-01-11,DAL,117,19,16,UTH,102,23,12,42,28
1984-01-11,NJN,120,17,19,CHI,105,15,17,32,36
1984-01-11,IND,96,10,23,DET,112,19,15,29,38
1984-01-12,KCK,89,15,19,LAL,95,21,13,36,32
1984-01-12,HOU,117,13,23,POR,120,24,14,37,37
1984-01-12,WAS,91,17,18,ATL,106,18,18,35,36
1984-01-13,SAN,133,14,23,HOU,103,13,24,27,47
1984-01-13,MIL,103,19,16,NYK,101,20,15,39,31
1984-01-13,ATL,117,19,18,IND,108,10,24,29,42
1984-01-13,PHL,104,25,10,BOS,105,28,8,53,18
1984-01-13,DAL,113,20,16,POR,110,25,14,45,30
1984-01-13,SDC,119,12,24,UTH,122,23,13,35,37
1984-01-13,DET,115,20,15,CHI,104,15,18,35,33
1984-01-13,SEA,103,17,17,PHX,99,16,21,33,38
1984-01-13,NJN,111,18,19,GOS,114,17,20,35,39
1984-01-13,DEN,134,16,20,LAL,141,22,13,38,33
1984-01-14,CLE,131,11,25,DET,132,21,15,32,40
1984-01-14,UTH,121,24,13,WAS,96,17,19,41,32
1984-01-14,PHL,129,25,11,GOS,103,18,20,43,31
1984-01-14,CHI,111,15,19,NYK,113,20,16,35,35
1984-01-14,HOU,109,13,25,KCK,104,15,20,28,45
1984-01-15,LAL,91,23,13,SEA,102,18,17,41,30
1984-01-15,DAL,126,21,16,DEN,107,16,21,37,37
1984-01-15,MIL,106,20,16,BOS,87,29,8,49,24
1984-01-15,KCK,109,15,21,SDC,96,12,25,27,46
1984-01-15,IND,134,10,25,NJN,140,18,20,28,45
1984-01-15,PHX,110,16,22,WAS,101,17,20,33,42
1984-01-15,SAN,126,15,23,POR,111,25,15,40,38
1984-01-17,PHL,128,26,11,DET,117,22,15,48,26
1984-01-17,POR,121,25,16,DAL,114,22,16,47,32
1984-01-17,ATL,112,20,18,UTH,106,25,13,45,31
1984-01-17,GOS,123,18,21,SDC,110,12,26,30,47
1984-01-17,KCK,113,16,21,BOS,122,29,9,45,30
1984-01-17,LAL,108,23,14,WAS,95,17,21,40,35
1984-01-17,NYK,115,21,16,NJN,121,19,20,40,36
1984-01-17,CHI,103,15,20,CLE,105,11,26,26,46
1984-01-17,IND,92,10,26,MIL,112,21,16,31,42
1984-01-17,HOU,124,14,25,DEN,115,16,22,30,47
1984-01-18,SDC,110,12,27,WAS,101,17,22,29,49
1984-01-18,MIL,99,22,16,ATL,90,21,18,43,34
1984-01-18,SAN,148,16,23,DEN,127,16,23,32,46
1984-01-18,DET,115,22,16,NJN,124,20,20,42,36
1984-01-18,CLE,107,12,26,PHL,109,27,11,39,37
1984-01-18,SEA,114,19,17,DAL,107,22,17,41,34
1984-01-19,PHX,138,17,22,LAL,123,24,14,41,36
1984-01-19,GOS,107,19,21,POR,103,26,16,45,37
1984-01-19,NYK,109,21,17,CHI,92,15,21,36,38
1984-01-20,BOS,132,30,9,IND,125,10,27,40,36
1984-01-20,SDC,108,13,27,SEA,110,20,17,33,44
1984-01-20,HOU,138,15,25,SAN,104,17,23,32,48
1984-01-20,PHL,109,28,11,CLE,106,12,27,40,38
1984-01-20,MIL,133,23,16,WAS,103,17,23,40,39
1984-01-20,DAL,113,22,18,UTH,120,25,14,47,32
1984-01-20,DEN,116,16,24,KCK,114,16,22,32,46
1984-01-20,DET,116,22,17,ATL,94,21,19,43,36
1984-01-21,NJN,120,21,20,DET,103,23,17,44,37
1984-01-21,CLE,94,12,28,CHI,111,15,22,27,50
1984-01-21,IND,111,10,28,DAL,118,22,19,32,47
1984-01-21,POR,114,26,17,KCK,94,16,23,42,40
1984-01-21,HOU,115,16,25,UTH,105,26,14,42,39
1984-01-21,WAS,94,17,24,PHL,90,29,11,46,35
1984-01-21,PHX,131,18,22,SEA,102,21,17,39,39
1984-01-21,NYK,95,22,17,ATL,97,21,20,43,37
1984-01-21,SAN,113,17,24,LAL,108,24,15,41,39
1984-01-21,DEN,126,17,24,GOS,115,20,21,37,45
1984-01-22,BOS,109,31,9,MIL,98,24,16,55,25
1984-01-24,WAS,123,18,24,MIL,117,24,17,42,41
1984-01-24,NYK,111,22,18,PHL,102,29,12,51,30
1984-01-24,CHI,93,16,22,ATL,100,22,20,38,42
1984-01-24,UTH,115,26,15,DAL,123,23,19,49,34
1984-01-24,KCK,113,16,24,NJN,104,22,20,38,44
1984-01-24,SAN,117,18,24,SEA,109,21,18,39,42
1984-01-24,DET,107,23,18,IND,114,10,29,33,47
1984-01-24,HOU,118,17,25,GOS,98,20,22,37,47
1984-01-24,LAL,116,24,16,PHX,110,19,22,43,38
1984-01-24,SDC,118,13,28,POR,113,27,17,40,45
1984-01-24,CLE,97,12,29,BOS,118,32,9,44,38
1984-01-25,IND,117,11,29,DEN,112,18,24,29,53
1984-01-25,ATL,109,23,20,MIL,105,24,18,47,38
1984-01-25,BOS,102,33,9,PHL,98,29,13,62,22
1984-01-25,DAL,112,24,19,GOS,110,20,23,44,42
1984-01-26,KCK,106,17,24,SEA,114,21,19,38,43
1984-01-26,LAL,131,25,16,HOU,102,18,25,43,41
1984-01-26,WAS,97,19,24,NYK,104,23,18,42,42
1984-01-26,CHI,125,16,23,DEN,126,18,25,34,48
1984-01-26,SAN,123,19,24,GOS,116,20,24,39,48
1984-01-26,UTH,125,26,16,NJN,115,22,21,48,37
1984-01-26,SDC,119,14,28,PHX,101,19,23,33,51
1984-01-31,UTH,98,27,16,SEA,94,22,19,49,35
1984-01-31,CLE,114,12,30,DET,112,23,19,35,49
1984-01-31,KCK,107,17,25,HOU,122,18,26,35,51
1984-01-31,WAS,118,19,25,ATL,94,24,20,43,45
1984-01-31,CHI,83,16,24,BOS,106,34,9,50,33
1984-01-31,GOS,119,20,25,MIL,123,24,19,44,44
1984-01-31,SAN,113,20,24,NYK,117,24,18,44,42
1984-01-31,LAL,129,26,16,POR,124,27,18,53,34
1984-01-31,IND,111,12,29,SDC,97,15,28,27,57
1984-02-01,BOS,119,35,9,KCK,110,17,26,52,35
1984-02-01,PHL,111,29,14,IND,103,13,29,42,43
1984-02-01,PHX,109,19,24,POR,106,27,19,46,43
1984-02-01,DAL,98,25,19,NYK,105,25,18,50,37
1984-02-01,DEN,108,19,25,LAL,116,27,16,46,41
1984-02-01,SEA,99,22,20,MIL,98,25,19,47,39
1984-02-01,NJN,111,22,22,SDC,106,15,29,37,51
1984-02-01,ATL,116,24,21,CHI,103,16,25,40,46
1984-02-02,UTH,116,28,16,PHX,95,20,24,48,40
1984-02-02,HOU,123,19,26,DAL,107,25,20,44,46
1984-02-02,WAS,129,20,25,DET,139,23,20,43,45
1984-02-02,GOS,117,20,26,SAN,107,20,25,40,51
1984-02-03,POR,116,27,20,MIL,110,25,20,52,40
1984-02-03,PHL,88,30,14,ATL,99,25,21,55,35
1984-02-03,LAL,109,28,16,UTH,105,29,16,57,32
1984-02-03,NJN,112,23,22,KCK,114,17,27,40,49
1984-02-03,BOS,125,36,9,IND,106,13,30,49,39
1984-02-03,CLE,106,13,30,CHI,76,16,26,29,56
1984-02-03,DET,126,24,20,SDC,111,15,30,39,50
1984-02-03,SEA,121,23,20,SAN,106,20,26,43,46
1984-02-03,DAL,111,25,21,DEN,114,19,26,44,47
1984-02-04,UTH,116,29,17,MIL,102,25,21,54,38
1984-02-04,GOS,107,21,26,PHX,104,20,25,41,51
1984-02-04,KCK,107,18,27,DEN,100,20,26,38,53
1984-02-04,WAS,125,20,26,IND,101,13,31,33,57
1984-02-04,CLE,108,14,30,SDC,100,15,31,29,61
1984-02-04,CHI,105,16,27,NJN,108,23,23,39,50
1984-02-04,ATL,102,26,21,PHL,97,30,15,56,36
1984-02-04,HOU,95,20,26,NYK,103,26,18,46,44
1984-02-05,POR,97,28,20,PHX,82,20,26,48,46
1984-02-05,BOS,137,37,9,DET,134,25,20,62,29
1984-02-05,SEA,104,24,20,DAL,96,25,22,49,42
1984-02-05,SAN,98,20,27,LAL,110,29,16,49,43
1984-02-06,NJN,115,24,23,BOS,112,38,9,62,32
1984-02-06,NYK,116,27,18,GOS,94,22,26,49,44
1984-02-07,IND,105,13,32,LAL,106,30,16,43,48
1984-02-07,KCK,110,19,27,MIL,112,25,22,44,49
1984-02-07,ATL,109,27,21,NJN,102,25,23,52,44
1984-02-07,CHI,104,16,28,PHL,89,30,16,46,44
1984-02-07,PHX,138,20,27,SAN,131,20,28,40,55
1984-02-07,SEA,115,25,20,DEN,105,20,27,45,47
1984-02-07,WAS,95,21,26,HOU,92,20,27,41,53
1984-02-07,UTH,103,30,17,SDC,109,15,32,45,49
1984-02-07,DET,130,25,21,CLE,99,15,30,40,51
1984-02-07,POR,101,29,20,DAL,85,25,23,54,43
1984-02-08,CLE,119,15,31,GOS,108,22,27,37,58
1984-02-08,PHL,118,30,17,HOU,107,20,28,50,45
1984-02-08,SAN,110,20,29,KCK,118,19,28,39,57
1984-02-08,SDC,105,16,32,POR,114,30,20,46,52
1984-02-08,DEN,114,20,28,DAL,120,25,24,45,52
1984-02-08,MIL,113,26,22,NYK,103,28,18,54,40
1984-02-08,BOS,109,38,10,LAL,111,31,16,69,26
1984-02-08,NJN,110,25,24,CHI,114,17,28,42,52
1984-02-09,PHX,118,21,27,ATL,105,28,21,49,48
1984-02-09,IND,107,13,33,SEA,102,26,20,39,53
1984-02-10,PHL,91,31,17,CHI,100,18,28,49,45
1984-02-10,SDC,113,16,33,ATL,101,28,22,44,55
1984-02-10,DET,134,26,21,GOS,116,22,28,48,49
1984-02-10,CLE,95,16,31,SEA,90,26,21,42,52
1984-02-10,POR,123,31,20,DEN,117,20,29,51,49
1984-02-10,WAS,96,22,26,LAL,93,32,16,54,42
1984-02-10,DAL,115,26,24,KCK,96,20,28,46,52
1984-02-10,MIL,127,27,22,SAN,132,20,30,47,52
1984-02-10,BOS,114,38,11,HOU,101,20,29,58,40
1984-02-10,UTH,111,30,18,NYK,121,28,19,58,37
1984-02-11,PHX,108,22,27,DAL,89,27,24,49,51
1984-02-11,DET,116,27,21,SAN,123,21,30,48,51
1984-02-11,DEN,112,20,30,NYK,138,29,19,49,49
1984-02-11,CHI,101,19,28,GOS,96,22,29,41,57
1984-02-11,IND,83,14,33,CLE,86,17,31,31,64
1984-02-11,KCK,94,20,29,WAS,91,23,26,43,55
1984-02-12,MIL,107,27,23,SDC,100,17,33,44,56
1984-02-12,POR,112,32,20,UTH,114,30,19,62,39
1984-02-12,BOS,91,39,11,PHL,109,31,18,70,29
1984-02-12,NJN,107,25,25,HOU,103,20,30,45,55
1984-02-12,LAL,108,32,17,ATL,87,28,23,60,40
1984-02-13,IND,108,14,34,SAN,117,22,30,36,64
1984-02-14,GOS,105,22,30,SEA,102,26,22,48,52
1984-02-14,CLE,103,18,31,NJN,93,26,25,44,56
1984-02-14,DEN,96,20,31,WAS,108,23,27,43,58
1984-02-14,CHI,112,20,28,SDC,99,17,34,37,62
1984-02-14,HOU,119,20,31,DET,126,27,22,47,53
1984-02-14,KCK,100,21,29,NYK,106,30,19,51,48
1984-02-14,MIL,92,28,23,PHX,83,23,27,51,50
1984-02-14,UTH,100,31,19,ATL,98,28,24,59,43
1984-02-15,NJN,108,26,26,SAN,114,23,30,49,56
1984-02-15,DAL,119,27,25,PHL,116,32,18,59,43
1984-02-15,IND,91,14,35,MIL,107,29,23,43,58
1984-02-15,CLE,104,19,31,PHX,90,23,28,42,59
1984-02-15,SEA,116,26,23,WAS,99,24,27,50,50
1984-02-16,SDC,100,17,35,HOU,111,20,32,37,67
1984-02-16,DEN,117,20,32,ATL,102,28,25,48,57
1984-02-16,KCK,121,21,30,UTH,99,32,19,53,49
1984-02-16,GOS,115,23,30,BOS,125,39,12,62,42
1984-02-16,NYK,100,31,19,IND,94,14,36,45,55
1984-02-17,LAL,138,33,17,DEN,141,21,32,54,49
1984-02-17,CHI,109,21,28,SAN,111,24,30,45,58
1984-02-17,DAL,129,28,25,PHX,123,23,29,51,54
1984-02-17,SEA,100,27,23,BOS,111,40,12,67,35
1984-02-17,PHL,114,32,19,NJN,109,26,27,58,46
1984-02-17,MIL,105,30,23,UTH,91,32,20,62,43
1984-02-17,POR,87,32,21,WAS,96,24,28,56,49
1984-02-18,NYK,112,32,19,NJN,102,26,28,58,47
1984-02-18,CLE,93,20,31,IND,118,14,37,34,68
1984-02-18,SDC,116,17,36,LAL,120,33,18,50,54
1984-02-18,KCK,111,22,30,ATL,106,28,26,50,56
1984-02-18,GOS,113,23,31,WAS,107,25,28,48,59
1984-02-18,HOU,102,21,32,PHX,126,23,30,44,62
1984-02-18,DAL,115,29,25,DET,120,28,22,57,47
1984-02-19,SEA,132,27,24,DEN,120,22,32,49,56
1984-02-19,SAN,140,25,30,DET,142,29,22,54,52
1984-02-19,PHL,101,33,19,NYK,97,33,19,66,38
1984-02-19,IND,106,15,37,UTH,104,32,21,47,58
1984-02-19,CHI,103,21,29,MIL,113,31,23,52,52
1984-02-19,POR,101,32,22,BOS,107,41,12,73,34
1984-02-21,GOS,135,24,31,DEN,133,22,33,46,64
1984-02-21,SAN,111,25,31,PHX,114,24,30,49,61
1984-02-21,KCK,119,23,30,DET,112,30,22,53,52
1984-02-21,HOU,119,21,33,MIL,102,32,23,53,56
1984-02-21,LAL,128,34,18,SEA,112,28,24,62,42
1984-02-21,NJN,119,26,29,PHL,116,34,19,60,48
1984-02-21,NYK,89,33,20,POR,106,32,23,65,43
1984-02-21,CHI,95,21,30,UTH,117,32,22,53,52
1984-02-21,ATL,102,28,27,CLE,84,20,32,48,59
1984-02-22,IND,111,16,37,CHI,121,21,31,37,68
1984-02-22,DAL,112,29,26,HOU,106,22,33,51,59
1984-02-22,WAS,101,25,29,POR,104,33,23,58,52
1984-02-22,SEA,121,28,25,LAL,114,35,18,63,43
1984-02-22,DEN,127,22,34,SAN,121,25,32,47,66
1984-02-22,SDC,114,17,37,BOS,107,42,12,59,49
1984-02-22,DET,114,30,23,NYK,111,33,21,63,44
1984-02-23,CLE,116,20,33,PHL,109,34,20,54,53
1984-02-23,NJN,110,27,29,IND,103,16,38,43,67
1984-02-23,GOS,103,25,31,SDC,108,18,37,43,68
1984-02-23,UTH,143,33,22,SAN,142,25,33,58,55
1984-02-23,KCK,95,24,30,PHX,107,25,30,49,60
1984-02-24,LAL,116,35,19,BOS,108,42,13,77,32
1984-02-24,ATL,105,29,27,NYK,104,33,22,62,49
1984-02-24,CHI,96,22,31,WAS,102,25,30,47,61
1984-02-24,PHX,100,26,30,DEN,117,23,34,49,64
1984-02-24,PHL,114,34,21,POR,119,34,23,68,44
1984-02-24,IND,108,16,39,DET,100,31,23,47,62
1984-02-24,DAL,88,30,26,MIL,95,32,24,62,50
1984-02-24,SEA,112,29,25,UTH,81,34,22,63,47
1984-02-25,HOU,112,22,34,GOS,118,25,32,47,66
1984-02-25,CLE,94,21,33,WAS,83,26,30,47,63
1984-02-25,DEN,148,24,34,KCK,136,24,31,48,65
1984-02-25,ATL,122,30,27,CHI,87,22,32,52,59
1984-02-25,UTH,95,34,23,DAL,97,30,27,64,50
1984-02-25,NJN,117,28,29,NYK,104,33,23,61,52
1984-02-25,SAN,119,25,34,MIL,130,33,24,58,58
1984-02-26,SEA,93,30,25,SDC,101,19,37,49,62
1984-02-26,PHX,109,26,31,BOS,116,42,14,68,45
1984-02-26,IND,102,17,39,POR,100,35,23,52,62
1984-02-26,PHL,99,34,22,LAL,101,36,19,70,41
1984-02-26,DET,121,31,24,CLE,109,22,33,53,57
1984-02-27,NYK,96,33,24,ATL,92,31,27,64,51
1984-02-28,POR,117,35,24,SDC,99,20,37,55,61
1984-02-28,CHI,108,22,33,LAL,124,37,19,59,52
1984-02-28,HOU,111,22,35,SEA,105,30,26,52,61
1984-02-28,SAN,104,25,35,DAL,116,31,27,56,62
1984-02-28,KCK,142,24,32,CLE,137,22,34,46,66
1984-02-28,GOS,140,26,32,DEN,137,25,34,51,66
1984-02-28,IND,92,18,39,WAS,100,26,31,44,70
1984-02-28,ATL,96,31,28,DET,101,32,24,63,52
1984-02-28,PHX,113,26,32,UTH,100,34,24,60,56
1984-02-29,DET,137,33,24,WAS,106,27,31,60,55
1984-02-29,NJN,102,29,29,LAL,92,38,19,67,48
1984-02-29,DAL,124,32,27,SEA,127,30,27,62,54
1984-02-29,MIL,112,34,24,CHI,83,22,34,56,58
1984-02-29,SDC,102,20,38,PHX,95,27,32,47,70
1984-02-29,UTH,97,34,25,PHL,103,34,23,68,48
1984-02-29,BOS,98,43,14,NYK,102,34,24,77,38
1984-03-01,POR,121,36,24,SAN,98,25,36,61,60
1984-03-01,DEN,119,25,35,CLE,113,22,35,47,70
1984-03-01,HOU,101,23,35,KCK,108,25,32,48,67
1984-03-01,PHX,112,27,33,PHL,100,35,23,62,56
1984-03-02,WAS,78,27,32,MIL,98,35,24,62,56
1984-03-02,ATL,94,31,29,LAL,98,38,20,69,49
1984-03-02,BOS,104,43,15,CHI,100,22,35,65,50
1984-03-02,DAL,108,32,28,KCK,94,26,32,58,60
1984-03-02,DET,102,34,24,NYK,117,35,24,69,48
1984-03-02,SDC,103,21,38,GOS,110,27,32,48,70
1984-03-02,UTH,110,34,26,CLE,104,22,36,56,62
1984-03-02,SEA,99,31,27,IND,90,18,40,49,67
1984-03-03,CHI,102,22,36,ATL,98,31,30,53,66
1984-03-03,PHX,120,28,33,SAN,106,25,37,53,70
1984-03-03,NYK,106,36,24,MIL,111,36,24,72,48
1984-03-03,GOS,106,28,32,HOU,108,23,36,51,68
1984-03-03,POR,118,37,24,IND,98,18,41,55,65
1984-03-03,DEN,131,26,35,UTH,122,35,26,61,61
1984-03-03,KCK,105,26,33,DAL,103,33,28,59,61
1984-03-03,NJN,100,30,29,WAS,90,27,33,57,62
1984-03-04,SDC,122,21,39,PHL,127,35,24,56,63
1984-03-04,BOS,117,44,15,SEA,93,32,27,76,42
1984-03-04,DET,114,34,25,LAL,118,39,20,73,45
1984-03-05,NJN,120,31,29,UTH,116,35,27,66,56
1984-03-06,WAS,85,27,34,BOS,108,45,15,72,49
1984-03-06,CHI,108,23,36,DET,124,34,26,57,62
1984-03-06,SAN,129,25,38,CLE,122,22,37,47,75
1984-03-06,KCK,128,27,33,POR,110,38,24,65,57
1984-03-06,DEN,130,27,35,HOU,128,24,36,51,71
1984-03-06,GOS,125,28,33,IND,109,18,42,46,75
1984-03-06,ATL,104,31,31,MIL,109,37,24,68,55
1984-03-06,NYK,124,36,25,SEA,110,32,28,68,53
1984-03-07,PHX,123,29,33,HOU,110,24,37,53,70
1984-03-07,SDC,114,21,40,IND,110,18,43,39,83
1984-03-07,BOS,117,46,15,UTH,106,35,28,81,43
1984-03-07,LAL,105,40,20,PHL,113,36,24,76,44
1984-03-07,DAL,115,33,29,CLE,103,22,38,55,67
1984-03-07,DET,107,35,26,ATL,93,31,32,66,58
1984-03-07,MIL,100,38,24,NJN,106,32,29,70,53
1984-03-08,WAS,106,27,35,SEA,96,32,29,59,64
1984-03-08,KCK,115,28,33,CHI,110,23,37,51,70
1984-03-09,PHX,130,30,33,IND,110,18,44,48,77
1984-03-09,DAL,120,34,29,LAL,121,40,21,74,50
1984-03-09,DET,122,36,26,NJN,118,33,29,69,55
1984-03-09,MIL,128,38,25,BOS,129,47,15,85,40
1984-03-09,PHL,92,37,24,SEA,84,32,30,69,54
1984-03-09,ATL,101,31,33,POR,104,38,25,69,58
1984-03-09,SDC,134,22,40,DEN,126,28,35,50,75
1984-03-10,SDC,115,23,40,CHI,110,23,38,46,78
1984-03-10,SAN,123,26,38,HOU,118,24,38,50,76
1984-03-10,DAL,120,34,30,GOS,103,29,33,63,63
1984-03-10,NYK,114,37,25,UTH,105,35,29,72,54
1984-03-10,LAL,114,41,21,IND,126,18,45,59,66
1984-03-10,DET,115,37,26,WAS,100,28,35,65,61
1984-03-11,BOS,117,48,15,PHX,109,31,33,79,48
1984-03-11,MIL,94,38,26,ATL,108,31,34,69,60
1984-03-11,NJN,106,33,30,SEA,105,32,31,65,61
1984-03-11,KCK,109,29,33,GOS,115,29,34,58,67
1984-03-11,PHL,120,38,24,UTH,97,35,30,73,54
1984-03-11,HOU,108,24,39,CLE,101,22,39,46,78
1984-03-11,DEN,149,28,36,POR,123,39,25,67,61
1984-03-13,MIL,116,38,27,DET,95,38,26,76,53
1984-03-13,WAS,108,28,36,DEN,103,29,36,57,72
1984-03-13,LAL,114,41,22,SEA,98,32,32,73,54
1984-03-13,UTH,124,35,31,POR,119,39,26,74,57
1984-03-13,IND,106,19,45,PHL,121,39,24,58,69
1984-03-13,NYK,117,38,25,PHX,96,31,34,69,59
1984-03-13,SAN,137,27,38,DAL,131,35,30,62,68
1984-03-13,CLE,92,22,40,ATL,83,32,34,54,74
1984-03-13,HOU,117,25,39,SDC,109,24,40,49,79
1984-03-13,GOS,101,30,34,CHI,112,23,39,53,73
1984-03-14,ATL,93,32,35,KCK,101,29,34,61,69
1984-03-14,NJN,108,34,30,PHX,102,31,35,65,65
1984-03-14,PHL,92,40,24,MIL,91,39,27,79,51
1984-03-14,BOS,99,49,15,WAS,103,29,36,78,51
1984-03-14,DAL,105,35,31,SDC,101,24,41,59,72
1984-03-14,DET,121,38,27,DEN,125,29,37,67,64
1984-03-15,SEA,106,32,33,CHI,90,24,39,56,72
1984-03-15,IND,107,19,46,KCK,108,30,34,49,80
1984-03-15,GOS,111,30,35,UTH,115,36,31,66,66
1984-03-15,NYK,105,39,25,CLE,82,23,40,62,65
1984-03-15,LAL,143,42,22,SAN,124,28,38,70,60
1984-03-16,BOS,109,49,16,MIL,99,39,28,88,44
1984-03-16,SEA,126,33,33,SAN,123,28,39,61,72
1984-03-16,CLE,102,23,41,DEN,118,30,37,53,78
1984-03-16,WAS,109,30,36,PHX,110,31,36,61,72
1984-03-16,SDC,128,24,42,HOU,118,26,39,50,81
1984-03-16,POR,155,39,27,CHI,156,24,40,63,67
1984-03-16,PHL,102,41,24,ATL,105,32,36,73,60
1984-03-16,DET,108,38,28,NJN,117,35,30,73,58
1984-03-17,POR,133,39,28,GOS,96,30,36,69,64
1984-03-17,HOU,111,26,40,LAL,123,43,22,69,62
1984-03-17,NYK,123,40,25,KCK,109,31,34,71,59
1984-03-17,PHL,131,41,25,PHX,112,32,36,73,61
1984-03-17,ATL,88,33,36,BOS,103,50,16,83,52
1984-03-17,IND,98,19,47,NJN,100,36,30,55,77
1984-03-17,UTH,118,37,31,DAL,103,36,31,73,62
1984-03-18,CLE,97,23,42,KCK,108,31,35,54,77
1984-03-18,SDC,135,25,42,SAN,140,28,40,53,82
1984-03-18,SEA,126,34,33,GOS,99,30,37,64,70
1984-03-18,MIL,109,39,29,WAS,101,30,37,69,66
1984-03-18,DEN,107,31,37,CHI,104,25,40,56,77
1984-03-19,UTH,143,38,31,DET,125,38,29,76,60
1984-03-20,MIL,94,40,29,LAL,99,44,22,84,51
1984-03-20,SAN,135,29,40,ATL,132,33,37,62,77
1984-03-20,CHI,108,25,41,CLE,104,23,43,48,84
1984-03-20,PHX,146,32,37,DEN,120,32,37,64,74
1984-03-20,HOU,102,26,41,KCK,115,32,35,58,76
1984-03-20,GOS,103,30,38,SEA,102,35,33,65,71
1984-03-20,WAS,99,30,38,NJN,91,37,30,67,68
1984-03-20,POR,106,40,28,SDC,105,25,43,65,71
1984-03-20,IND,123,19,48,BOS,121,51,16,70,64
1984-03-21,KCK,116,33,35,LAL,123,45,22,78,57
1984-03-21,SEA,104,35,34,PHX,102,33,37,68,71
1984-03-21,SDC,123,25,44,DET,132,38,30,63,74
1984-03-21,DAL,102,36,32,ATL,101,33,38,69,70
1984-03-21,CLE,100,23,44,NYK,99,41,25,64,69
1984-03-21,DEN,134,32,38,HOU,125,26,42,58,80
1984-03-21,NJN,95,37,31,MIL,102,40,30,77,61
1984-03-22,WAS,101,31,38,PHL,106,42,25,73,63
1984-03-22,SAN,129,30,40,UTH,126,39,31,69,71
1984-03-22,NYK,100,41,26,BOS,108,51,17,92,43
1984-03-23,IND,119,20,48,CHI,112,26,41,46,89
1984-03-23,PHL,100,43,25,CLE,95,24,44,67,69
1984-03-23,LAL,118,46,22,DET,121,39,30,85,52
1984-03-23,SDC,108,25,45,SEA,102,36,34,61,79
1984-03-23,DEN,126,33,38,KCK,116,33,36,66,74
1984-03-23,POR,124,41,28,PHX,98,33,38,74,66
1984-03-23,BOS,97,52,17,NJN,101,37,32,89,49
1984-03-23,DAL,116,37,32,HOU,104,26,43,63,75
1984-03-23,UTH,104,39,32,GOS,115,31,38,70,70
1984-03-24,PHX,109,33,39,DET,120,40,30,73,69
1984-03-24,NYK,107,41,27,WAS,99,31,39,72,66
1984-03-24,KCK,125,33,37,SAN,118,31,40,64,77
1984-03-24,DAL,119,38,32,DEN,101,34,38,72,70
1984-03-24,HOU,103,26,44,ATL,102,33,39,59,83
1984-03-24,MIL,106,41,30,IND,92,21,48,62,78
1984-03-24,GOS,94,32,38,POR,106,42,28,74,66
1984-03-25,PHL,119,44,25,BOS,114,52,18,96,43
1984-03-25,CHI,99,26,42,IND,102,21,49,47,91
1984-03-25,CLE,101,24,45,WAS,96,31,40,55,85
1984-03-25,NJN,107,38,32,NYK,94,42,27,80,59
1984-03-25,LAL,114,46,23,SDC,102,26,45,72,68
1984-03-25,SEA,98,36,35,UTH,121,39,33,75,68
1984-03-27,NYK,97,42,28,DAL,88,39,32,81,60
1984-03-27,POR,93,43,28,SEA,87,36,36,79,64
1984-03-27,PHX,116,33,40,SDC,109,26,46,59,86
1984-03-27,HOU,140,27,44,DEN,137,34,39,61,83
1984-03-27,UTH,110,40,33,KCK,106,34,37,74,70
1984-03-27,CLE,106,25,45,NJN,103,39,32,64,77
1984-03-27,CHI,83,26,43,DET,111,41,30,67,73
1984-03-27,WAS,93,31,41,BOS,106,52,19,83,60
1984-03-27,SAN,117,31,41,GOS,116,32,39,63,80
1984-03-27,ATL,97,33,40,PHL,78,45,25,78,65
1984-03-28,DET,108,42,30,CHI,101,26,44,68,74
1984-03-28,SEA,111,36,37,KCK,94,34,38,70,75
1984-03-28,IND,99,22,49,NYK,93,43,28,65,77
1984-03-28,SDC,122,26,47,LAL,115,47,23,73,70
1984-03-28,BOS,114,53,19,DAL,107,39,33,92,52
1984-03-28,MIL,130,42,30,CLE,98,26,45,68,75
1984-03-28,PHL,109,45,26,WAS,103,31,42,76,68
1984-03-29,UTH,106,41,33,SEA,96,37,37,78,70
1984-03-29,NJN,118,39,33,DET,116,43,30,82,63
1984-03-29,POR,120,44,28,KCK,113,34,39,78,67
1984-03-29,PHX,124,34,40,GOS,119,32,40,66,80
1984-03-29,LAL,115,47,24,HOU,109,28,44,75,68
1984-03-30,MIL,119,43,30,CHI,86,26,45,69,75
1984-03-30,SDC,124,27,47,GOS,112,32,41,59,88
1984-03-30,IND,90,23,49,CLE,87,26,46,49,95
1984-03-30,PHL,118,46,26,DAL,110,39,34,85,60
1984-03-30,WAS,107,31,43,NYK,79,43,29,74,72
1984-03-30,DEN,145,34,40,SAN,136,32,41,66,81
1984-03-30,BOS,105,54,19,ATL,96,34,40,88,59
1984-03-31,DET,107,43,31,MIL,105,44,30,87,61
1984-03-31,PHX,97,35,40,LAL,119,48,24,83,64
1984-03-31,CLE,119,26,47,IND,120,24,49,50,96
1984-03-31,SAN,106,32,42,SEA,124,37,38,69,80
1984-03-31,NJN,98,40,33,BOS,107,55,19,95,52
1984-03-31,HOU,102,28,45,POR,106,45,28,73,73
1984-03-31,KCK,105,34,40,UTH,103,42,33,76,73
1984-03-31,ATL,109,34,41,NYK,106,43,30,77,71
1984-03-31,CHI,104,26,46,PHL,111,47,26,73,72
1984-04-01,DEN,129,35,40,SDC,103,28,47,63,87
1984-04-01,LAL,121,49,24,GOS,110,32,42,81,66
1984-04-01,WAS,102,32,43,DAL,98,39,35,71,78
1984-04-02,UTH,111,42,34,HOU,100,28,46,70,80
1984-04-02,NYK,115,43,31,CHI,113,26,47,69,78
1984-04-03,DAL,88,39,36,POR,91,46,28,85,64
1984-04-03,GOS,99,32,43,HOU,92,28,47,60,90
1984-04-03,MIL,109,44,31,NJN,92,40,34,84,65
1984-04-03,SAN,137,32,43,LAL,109,50,24,82,67
1984-04-03,CLE,86,26,48,BOS,98,56,19,82,67
1984-04-03,DEN,124,36,40,SEA,113,38,38,74,78
1984-04-03,DET,118,44,31,PHL,115,48,26,92,57
1984-04-03,CHI,96,26,48,NYK,113,44,31,70,79
1984-04-03,WAS,106,33,43,IND,94,25,49,58,92
1984-04-03,PHX,113,35,41,KCK,109,35,40,70,81
1984-04-04,NJN,112,40,35,IND,111,25,50,65,85
1984-04-04,SDC,116,28,48,KCK,121,35,41,63,89
1984-04-04,ATL,99,35,41,WAS,92,34,43,69,84
1984-04-05,UTH,115,43,34,LAL,129,50,25,93,59
1984-04-05,POR,114,47,28,HOU,129,28,48,75,76
1984-04-05,MIL,113,45,31,PHL,103,48,27,93,58
1984-04-05,CLE,114,26,49,CHI,99,26,49,52,98
1984-04-05,DEN,124,37,40,GOS,128,33,43,70,83
1984-04-06,BOS,113,57,19,CLE,94,27,49,84,68
1984-04-06,SDC,121,28,49,POR,112,47,29,75,78
1984-04-06,DAL,131,39,37,SAN,118,33,43,72,80
1984-04-06,LAL,112,51,25,KCK,97,36,41,87,66
1984-04-06,PHX,117,36,41,SEA,108,38,39,74,80
1984-04-06,PHL,112,48,28,IND,106,25,51,73,79
1984-04-06,CHI,111,26,50,ATL,103,36,41,62,91
1984-04-06,NYK,107,45,31,DET,115,45,31,90,62
1984-04-07,DAL,109,40,37,UTH,100,43,35,83,72
1984-04-07,WAS,98,34,44,NJN,121,41,35,75,79
1984-04-07,GOS,98,34,43,KCK,89,36,42,70,85
1984-04-07,SAN,126,33,44,SDC,112,29,49,62,93
1984-04-07,MIL,110,46,31,DET,92,46,31,92,62
1984-04-07,ATL,122,36,42,IND,103,25,52,61,94
1984-04-08,DEN,121,37,41,PHX,126,37,41,74,82
1984-04-08,POR,113,47,30,LAL,119,52,25,99,55
1984-04-08,BOS,117,58,19,CHI,110,27,50,85,69
1984-04-08,PHL,109,49,28,NYK,108,45,32,94,60
1984-04-08,SEA,120,38,40,HOU,107,29,48,67,88
1984-04-08,NJN,124,42,35,CLE,97,27,50,69,85
1984-04-09,NYK,118,45,33,CLE,113,27,51,72,84
1984-04-09,WAS,136,34,45,CHI,134,27,51,61,96
1984-04-10,PHX,100,38,41,POR,88,47,31,85,72
1984-04-10,SAN,121,34,44,HOU,111,29,49,63,93
1984-04-10,MIL,95,47,31,BOS,96,59,19,106,50
1984-04-10,SDC,114,29,50,DAL,116,41,37,70,87
1984-04-10,KCK,113,36,43,SEA,125,39,40,75,83
1984-04-10,DET,100,46,32,IND,98,25,53,71,85
1984-04-10,GOS,117,35,43,LAL,115,53,25,88,68
1984-04-10,UTH,135,43,36,DEN,120,37,42,80,78
1984-04-10,NJN,106,43,35,PHL,102,50,28,93,63
1984-04-11,PHL,113,50,29,DET,126,47,32,97,61
1984-04-11,BOS,102,60,19,NYK,96,46,33,106,52
1984-04-11,HOU,110,29,50,DEN,130,37,43,66,93
1984-04-11,LAL,121,53,26,POR,108,47,32,100,58
1984-04-11,CLE,95,27,52,MIL,108,47,32,74,84
1984-04-11,IND,111,25,54,ATL,114,37,42,62,96
1984-04-11,CHI,112,27,52,NJN,129,44,35,71,87
1984-04-12,PHX,119,39,41,DAL,118,42,37,81,78
1984-04-12,KCK,114,36,44,SAN,102,35,44,71,88
1984-04-12,UTH,113,44,36,SDC,94,29,51,73,87
1984-04-12,SEA,105,40,40,GOS,100,36,43,76,83
1984-04-13,IND,119,25,55,WAS,115,35,45,60,100
1984-04-13,DET,128,48,32,BOS,120,61,19,109,51
1984-04-13,POR,102,47,33,GOS,101,36,44,83,77
1984-04-13,CHI,85,27,53,MIL,109,48,32,75,85
1984-04-13,HOU,128,29,51,SAN,129,35,45,64,96
1984-04-13,NJN,112,45,35,ATL,118,38,42,83,77
1984-04-13,CLE,98,27,53,NYK,107,46,34,73,87
1984-04-13,LAL,103,54,26,DAL,104,42,38,96,64
1984-04-14,WAS,109,35,46,CLE,117,27,54,62,100
1984-04-14,ATL,115,39,42,DET,107,49,32,88,74
1984-04-14,SDC,146,29,52,UTH,128,45,36,74,88
1984-04-14,KCK,108,37,44,HOU,96,29,52,66,96
1984-04-14,MIL,104,49,32,IND,92,26,55,75,87
1984-04-14,NYK,100,47,34,PHL,103,50,30,97,64
1984-04-15,GOS,98,36,45,DAL,96,43,38,79,83
1984-04-15,PHL,129,51,30,CHI,115,27,54,78,84
1984-04-15,SEA,108,41,40,POR,103,48,33,89,73
1984-04-15,BOS,118,61,20,NJN,111,45,36,106,56
1984-04-15,LAL,114,54,27,PHX,123,40,41,94,68
1984-04-15,SAN,157,36,45,DEN,154,38,43,74,88
1984-10-26,SEA,102,0,0,UTH,94,0,0,0,0
1984-10-26,PHL,111,0,0,CLE,101,0,0,0,0
1984-10-26,DET,123,0,0,BOS,130,0,0,0,0
1984-10-26,NJN,104,0,0,ATL,119,0,0,0,0
1984-10-26,CHI,109,0,0,WAS,93,0,0,0,0
1984-10-26,GOS,114,0,0,PHX,122,0,0,0,0
1984-10-27,SAN,113,0,0,LAL,112,0,0,0,0
1984-10-27,DEN,125,0,0,GOS,121,0,1,0,1
1984-10-27,DAL,111,0,0,HOU,121,0,0,0,0
1984-10-27,UTH,94,0,1,LAC,103,0,0,0,1
1984-10-27,IND,102,0,0,WAS,104,0,1,0,1
1984-10-27,ATL,108,1,0,PHL,111,1,0,2,0
1984-10-27,MIL,108,0,0,CHI,106,1,0,1,0
1984-10-27,CLE,106,0,1,NJN,131,0,1,0,2
1984-10-27,KCK,119,0,0,POR,140,0,0,0,0
1984-10-27,NYK,137,0,0,DET,118,0,1,0,1
1984-10-28,DAL,107,0,1,LAL,96,0,1,0,2
1984-10-28,SEA,87,1,0,PHX,102,1,0,2,0
1984-10-29,CHI,116,1,1,MIL,110,1,0,2,1
1984-10-30,LAL,144,0,2,GOS,110,0,2,0,4
1984-10-30,HOU,106,1,0,DAL,84,1,1,2,1
1984-10-30,WAS,119,1,1,ATL,104,1,1,2,2
1984-10-30,POR,115,1,0,SEA,83,1,1,2,1
1984-10-30,UTH,117,0,2,NYK,111,1,0,1,2
1984-10-30,KCK,104,0,1,CHI,109,2,1,2,2
1984-10-30,SAN,126,1,0,DEN,118,1,0,2,0
1984-10-30,NJN,96,1,1,PHL,118,2,0,3,1
1984-10-30,DET,124,0,2,CLE,107,0,2,0,4
1984-10-30,PHX,99,2,0,LAC,96,1,0,3,0
1984-10-31,MIL,105,1,1,WAS,79,2,1,3,2
1984-10-31,IND,100,0,1,DAL,101,1,2,1,3
1984-10-31,BOS,116,1,0,NJN,105,1,2,2,2
1984-11-01,ATL,114,1,2,DET,118,1,2,2,4
1984-11-01,SEA,105,1,2,LAL,103,1,2,2,4
1984-11-01,DEN,129,1,1,CHI,113,3,1,4,2
1984-11-01,KCK,106,0,2,HOU,109,2,0,2,2
1984-11-01,LAC,107,1,1,NYK,105,1,1,2,2
1984-11-01,PHX,139,3,0,POR,130,2,0,5,0
1984-11-01,GOS,108,0,3,SAN,123,2,0,2,3
1984-11-02,LAL,119,1,3,SAN,100,3,0,4,3
1984-11-02,PHL,107,3,0,DAL,103,2,2,5,2
1984-11-02,WAS,96,2,2,MIL,102,2,1,4,3
1984-11-02,BOS,127,2,0,DET,116,2,2,4,2
1984-11-02,CLE,109,0,3,IND,116,0,2,0,5
1984-11-02,UTH,107,1,2,SEA,101,2,2,3,4
1984-11-03,NJN,118,1,3,IND,117,1,2,2,5
1984-11-03,DAL,93,2,3,PHX,105,4,0,6,3
1984-11-03,KCK,114,0,3,DEN,128,2,1,2,4
1984-11-03,LAC,112,2,1,POR,131,2,1,4,2
1984-11-03,ATL,127,1,3,WAS,107,2,3,3,6
1984-11-03,GOS,112,0,4,UTH,107,2,2,2,6
1984-11-03,MIL,117,3,1,CLE,88,0,4,3,5
1984-11-03,HOU,105,3,0,NYK,93,1,2,4,2
1984-11-04,LAL,124,2,3,POR,116,3,1,5,4
1984-11-04,SAN,131,3,1,NYK,130,1,3,4,4
1984-11-05,CLE,98,0,5,DET,107,2,3,2,8
1984-11-05,LAC,107,2,2,DEN,104,3,1,5,3
1984-11-06,LAL,130,3,3,DEN,146,3,2,6,5
1984-11-06,DAL,107,2,4,NYK,104,1,4,3,8
1984-11-06,HOU,108,4,0,KCK,94,0,4,4,4
1984-11-06,SAN,99,4,1,SEA,91,2,3,6,4
1984-11-06,POR,116,3,2,PHX,99,5,0,8,2
1984-11-07,PHL,134,4,0,IND,113,1,3,5,3
1984-11-07,MIL,103,4,1,ATL,99,2,3,6,4
1984-11-07,DET,118,3,3,CHI,122,3,2,6,5
1984-11-07,BOS,135,3,0,LAC,108,3,2,6,2
1984-11-07,NJN,99,2,3,WAS,88,2,4,4,7
1984-11-07,UTH,136,2,3,SAN,124,5,1,7,4
1984-11-08,DAL,112,3,4,ATL,105,2,4,5,8
1984-11-08,WAS,93,2,5,LAC,88,3,3,5,8
1984-11-08,PHX,112,5,1,CLE,111,0,6,5,7
1984-11-08,NYK,106,1,5,CHI,121,4,2,5,7
1984-11-08,HOU,99,5,0,SEA,89,2,4,7,4
1984-11-08,DEN,128,4,2,POR,125,4,2,8,4
1984-11-08,GOS,122,1,4,LAL,106,3,4,4,8
1984-11-09,POR,126,4,3,LAL,130,3,5,7,8
1984-11-09,BOS,130,4,0,PHL,119,5,0,9,0
1984-11-09,NJN,99,3,3,KCK,101,0,5,3,8
1984-11-09,MIL,122,5,1,IND,105,1,4,6,5
1984-11-09,UTH,125,3,3,GOS,117,2,4,5,7
1984-11-10,PHX,107,6,1,ATL,114,2,5,8,6
1984-11-10,DEN,147,5,2,UTH,135,4,3,9,5
1984-11-10,IND,116,1,5,CHI,118,5,2,6,7
1984-11-10,SAN,127,5,2,CLE,103,0,7,5,9
1984-11-10,DAL,106,4,4,SEA,102,2,5,6,9
1984-11-10,HOU,117,6,0,LAC,92,3,4,9,4
1984-11-10,WAS,112,3,5,BOS,95,5,0,8,5
1984-11-10,NYK,113,1,6,KCK,100,1,5,2,11
1984-11-10,DET,104,3,4,MIL,100,6,1,9,5
1984-11-11,LAL,121,4,5,NJN,111,3,4,7,9
1984-11-11,POR,109,4,4,GOS,97,2,5,6,9
1984-11-12,UTH,123,4,4,DAL,97,5,4,9,8
1984-11-12,IND,115,1,6,BOS,132,5,1,6,7
1984-11-13,POR,94,5,4,DAL,101,5,5,10,9
1984-11-13,ATL,99,3,5,MIL,110,6,2,9,7
1984-11-13,HOU,106,7,0,CLE,98,0,8,7,8
1984-11-13,CHI,120,6,2,SAN,117,6,2,12,4
1984-11-13,LAC,90,3,5,NJN,99,3,5,6,10
1984-11-13,DEN,122,6,2,PHX,110,6,2,12,4
1984-11-13,NYK,92,2,6,WAS,103,4,5,6,11
1984-11-13,SEA,109,2,6,GOS,102,2,6,4,12
1984-11-14,IND,125,1,7,HOU,117,8,0,9,7
1984-11-14,PHX,98,6,3,NJN,86,4,5,10,8
1984-11-14,PHL,133,5,1,DET,137,4,4,9,5
1984-11-14,BOS,115,6,1,NYK,99,2,7,8,8
1984-11-14,WAS,125,5,5,SAN,106,6,3,11,8
1984-11-15,ATL,99,3,6,CLE,102,0,9,3,15
1984-11-15,CHI,105,7,2,BOS,125,7,1,14,3
1984-11-15,LAC,90,3,6,MIL,103,7,2,10,8
1984-11-15,GOS,117,2,7,DAL,112,6,5,8,12
1984-11-15,POR,129,5,5,UTH,120,5,4,10,9
1984-11-16,IND,128,2,7,SAN,117,6,4,8,11
1984-11-16,LAL,128,5,5,KCK,116,1,6,6,11
1984-11-16,DEN,119,7,2,HOU,102,8,1,15,3
1984-11-16,PHX,118,7,3,MIL,106,8,2,15,5
1984-11-16,WAS,118,6,5,NYK,104,2,8,8,13
1984-11-16,SEA,91,3,6,POR,89,6,5,9,11
1984-11-16,DET,90,5,4,PHL,101,5,2,10,6
1984-11-17,GOS,114,3,7,NJN,131,4,6,7,13
1984-11-17,HOU,141,8,2,SAN,133,6,5,14,7
1984-11-17,CHI,100,7,3,PHL,109,6,2,13,5
1984-11-17,ATL,118,3,7,IND,108,3,7,6,14
1984-11-17,DAL,110,6,6,DET,124,5,5,11,11
1984-11-17,NYK,112,2,9,CLE,88,1,9,3,18
1984-11-17,UTH,108,5,5,PHX,94,8,3,13,8
1984-11-17,LAC,121,3,7,KCK,113,1,7,4,14
1984-11-18,SEA,97,4,6,NJN,102,5,6,9,12
1984-11-18,LAL,96,6,5,MIL,89,8,3,14,8
1984-11-18,POR,113,6,6,LAC,105,4,7,10,13
1984-11-19,CHI,120,7,4,IND,137,3,8,10,12
1984-11-20,NYK,106,3,9,GOS,101,3,8,6,17
1984-11-20,LAL,130,7,5,PHX,108,8,4,15,9
1984-11-20,HOU,123,9,2,DET,117,6,5,15,7
1984-11-20,KCK,129,1,8,UTH,122,6,5,7,13
1984-11-20,DAL,109,6,7,MIL,108,8,4,14,11
1984-11-20,PHL,105,7,2,WAS,120,7,5,14,7
1984-11-20,SEA,114,4,7,DEN,124,8,2,12,9
1984-11-20,POR,117,7,6,NJN,107,6,6,13,12
1984-11-21,LAC,106,4,8,DEN,112,9,2,13,10
1984-11-21,MIL,108,8,5,CHI,98,7,5,15,10
1984-11-21,WAS,97,8,5,KCK,92,2,8,10,13
1984-11-21,SAN,101,6,6,DET,114,6,6,12,12
1984-11-21,BOS,135,8,1,GOS,91,3,9,11,10
1984-11-21,ATL,122,4,7,UTH,90,6,6,10,13
1984-11-21,PHX,97,8,5,LAL,102,8,5,16,10
1984-11-21,IND,107,4,8,PHL,112,7,3,11,11
1984-11-21,CLE,101,1,10,NYK,109,4,9,5,19
1984-11-23,UTH,111,6,7,HOU,98,10,2,16,9
1984-11-23,SEA,94,4,8,CHI,113,7,6,11,14
1984-11-23,DET,97,7,6,NYK,120,5,9,12,15
1984-11-23,BOS,118,9,1,WAS,110,9,5,18,6
1984-11-23,CLE,106,1,11,GOS,107,3,10,4,21
1984-11-23,PHX,117,8,6,PHL,119,8,3,16,9
1984-11-23,IND,105,4,9,KCK,122,2,9,6,18
1984-11-24,MIL,103,9,5,GOS,97,4,10,13,15
1984-11-24,DEN,114,10,2,PHL,110,9,3,19,5
1984-11-24,DAL,113,7,7,HOU,95,10,3,17,10
1984-11-24,LAC,103,4,9,LAL,108,9,5,13,14
1984-11-24,ATL,101,5,7,NJN,99,6,7,11,14
1984-11-24,KCK,124,3,9,BOS,135,10,1,13,10
1984-11-24,SAN,117,6,7,UTH,123,7,7,13,14
1984-11-24,WAS,112,9,6,DET,106,7,7,16,13
1984-11-24,POR,141,8,6,CHI,131,8,6,16,12
1984-11-24,NYK,119,6,9,IND,100,4,10,10,19
1984-11-25,CLE,118,1,12,ATL,111,6,7,7,19
1984-11-25,LAC,114,4,10,PHX,109,8,7,12,17
1984-11-25,LAL,94,10,5,SEA,105,4,9,14,14
1984-11-27,CLE,106,2,12,POR,115,9,6,11,18
1984-11-27,SAN,97,6,8,HOU,114,10,4,16,12
1984-11-27,WAS,89,10,6,PHL,93,9,4,19,10
1984-11-27,GOS,109,4,11,CHI,103,8,7,12,18
1984-11-27,NYK,97,7,9,ATL,96,6,8,13,17
1984-11-27,IND,126,4,11,MIL,105,10,5,14,16
1984-11-27,DEN,139,11,2,LAC,110,5,10,16,12
1984-11-27,DAL,99,8,7,BOS,114,11,1,19,8
1984-11-27,SEA,104,5,9,KCK,96,3,10,8,19
1984-11-27,PHX,115,8,8,UTH,102,8,7,16,15
1984-11-28,ATL,95,6,9,MIL,83,10,6,16,15
1984-11-28,LAC,106,5,11,SEA,90,6,9,11,20
1984-11-28,HOU,100,11,4,BOS,110,12,1,23,5
1984-11-28,DET,120,7,8,POR,113,10,6,17,14
1984-11-28,UTH,109,8,8,LAL,114,10,6,18,14
1984-11-28,PHL,122,10,4,IND,101,5,11,15,15
1984-11-28,NJN,111,6,8,NYK,96,8,9,14,17
1984-11-29,SAN,124,6,9,DAL,116,8,8,14,17
1984-11-29,GOS,110,5,11,KCK,107,3,11,8,22
1984-11-29,PHX,100,9,8,CHI,95,8,8,17,16
1984-11-30,NJN,123,7,8,IND,100,5,12,12,20
1984-11-30,LAC,100,6,11,CHI,104,8,9,14,20
1984-11-30,ATL,102,7,9,HOU,116,11,5,18,14
1984-11-30,DET,106,8,8,WAS,114,10,7,18,15
1984-11-30,MIL,118,10,7,NYK,100,8,10,18,17
1984-11-30,UTH,116,8,9,DEN,97,12,2,20,11
1984-11-30,LAL,130,11,6,KCK,121,3,12,14,18
1984-11-30,PHL,126,11,4,POR,116,10,7,21,11
1984-11-30,DAL,108,8,9,SEA,98,6,10,14,19
1984-12-01,CLE,104,2,13,BOS,110,13,1,15,14
1984-12-01,IND,109,5,13,DET,131,8,9,13,22
1984-12-01,NYK,93,8,11,POR,115,10,8,18,19
1984-12-01,WAS,100,11,7,MIL,97,11,7,22,14
1984-12-01,SAN,142,7,9,LAC,110,6,12,13,21
1984-12-01,HOU,86,12,5,SEA,94,6,11,18,16
1984-12-01,PHX,115,10,8,GOS,103,6,11,16,19
1984-12-01,DEN,118,12,3,UTH,111,9,9,21,12
1984-12-02,BOS,122,14,1,CLE,99,2,14,16,15
1984-12-02,LAL,112,12,6,CHI,113,9,9,21,15
1984-12-02,PHL,114,12,4,NJN,112,8,8,20,12
1984-12-03,SEA,108,7,11,PHX,96,11,8,18,19
1984-12-04,HOU,100,12,6,LAC,116,6,13,18,19
1984-12-04,POR,112,11,8,PHX,104,11,9,22,17
1984-12-04,NYK,100,8,12,DEN,98,13,3,21,15
1984-12-04,GOS,105,6,12,UTH,107,9,10,15,22
1984-12-04,SAN,114,8,9,ATL,106,7,10,15,19
1984-12-04,CHI,112,10,9,NJN,97,8,9,18,18
1984-12-04,CLE,112,2,15,LAL,116,12,7,14,22
1984-12-04,DET,104,9,9,BOS,99,15,1,24,10
1984-12-05,BOS,123,15,2,DEN,107,13,4,28,6
1984-12-05,KCK,121,3,13,ATL,100,7,11,10,24
1984-12-05,DAL,106,9,9,LAC,110,7,13,16,22
1984-12-05,PHL,112,13,4,MIL,111,11,8,24,12
1984-12-05,NJN,93,8,10,LAL,104,13,7,21,17
1984-12-06,GOS,114,6,13,HOU,113,12,7,18,20
1984-12-06,NYK,83,9,12,DAL,112,9,10,18,22
1984-12-06,MIL,114,11,9,DET,99,10,9,21,18
1984-12-06,POR,113,12,8,SAN,96,9,9,21,17
1984-12-06,WAS,111,12,7,IND,106,5,14,17,21
1984-12-06,UTH,99,10,10,SEA,106,8,11,18,21
1984-12-07,CHI,95,11,9,NYK,93,9,13,20,22
1984-12-07,PHX,121,11,10,KCK,113,4,13,15,23
1984-12-07,DET,122,10,10,DEN,115,13,5,23,15
1984-12-07,ATL,101,7,12,LAC,89,8,13,15,25
1984-12-07,PHL,122,14,4,LAL,116,14,7,28,11
1984-12-07,SEA,114,9,11,SAN,117,9,10,18,21
1984-12-08,CHI,99,12,9,DAL,97,10,10,22,19
1984-12-08,CLE,108,2,16,DEN,114,13,6,15,22
1984-12-08,POR,120,13,8,HOU,127,12,8,25,16
1984-12-08,NJN,98,8,11,BOS,107,16,2,24,13
1984-12-08,MIL,99,12,9,IND,96,5,15,17,24
1984-12-08,GOS,98,7,13,PHX,102,12,10,19,23
1984-12-08,WAS,101,13,7,LAL,98,14,8,27,15
1984-12-09,BOS,128,17,2,ATL,127,8,12,25,14
1984-12-09,LAC,126,8,14,SAN,123,10,10,18,24
1984-12-09,UTH,123,10,11,KCK,120,4,14,14,25
1984-12-09,SEA,96,9,12,HOU,90,13,8,22,20
1984-12-09,PHL,110,15,4,NYK,94,9,14,24,18
1984-12-10,IND,98,5,16,ATL,104,8,13,13,29
1984-12-11,KCK,121,4,15,SAN,120,10,11,14,26
1984-12-11,PHX,120,13,10,HOU,112,13,9,26,19
1984-12-11,CHI,101,13,9,DET,108,11,10,24,19
1984-12-11,WAS,82,14,7,UTH,85,11,11,25,18
1984-12-11,NYK,110,9,15,PHL,106,16,4,25,19
1984-12-11,CLE,106,2,17,MIL,120,13,9,15,26
1984-12-11,DEN,123,14,6,POR,122,13,9,27,15
1984-12-11,GOS,104,7,14,LAC,116,9,14,16,28
1984-12-11,BOS,130,18,2,NJN,121,8,12,26,14
1984-12-12,DET,102,12,10,CHI,95,13,10,25,20
1984-12-12,SAN,126,10,12,DEN,105,15,6,25,18
1984-12-12,ATL,116,9,13,CLE,99,2,18,11,31
1984-12-12,LAL,131,14,9,GOS,107,7,15,21,24
1984-12-12,DAL,116,10,11,KCK,107,5,15,15,26
1984-12-12,PHL,110,16,5,BOS,107,19,2,35,7
1984-12-12,NJN,116,8,13,MIL,109,14,9,22,22
1984-12-13,LAC,106,10,14,POR,100,13,10,23,24
1984-12-13,HOU,96,13,10,ATL,93,10,13,23,23
1984-12-13,PHX,116,14,10,WAS,86,14,8,28,18
1984-12-13,NYK,119,10,15,UTH,115,12,11,22,26
1984-12-13,SEA,124,10,12,LAL,122,15,9,25,21
1984-12-14,DAL,119,11,11,SAN,102,11,12,22,23
1984-12-14,BOS,117,19,3,UTH,106,12,12,31,15
1984-12-14,MIL,111,14,10,PHL,115,17,5,31,15
1984-12-14,DET,120,13,10,IND,96,5,17,18,27
1984-12-14,GOS,105,7,16,POR,92,13,11,20,27
1984-12-14,DEN,117,15,7,KCK,123,5,16,20,23
1984-12-14,NJN,111,9,13,CHI,109,13,11,22,24
1984-12-15,SAN,120,11,13,PHX,111,15,10,26,23
1984-12-15,LAC,109,11,14,WAS,103,14,9,25,23
1984-12-15,CLE,102,2,19,NYK,97,11,15,13,34
1984-12-15,CHI,102,13,12,PHL,114,18,5,31,17
1984-12-15,IND,112,5,18,NJN,100,10,13,15,31
1984-12-15,ATL,94,10,14,BOS,101,20,3,30,17
1984-12-15,HOU,117,14,10,DAL,115,12,11,26,21
1984-12-15,KCK,110,6,16,SEA,105,11,12,17,28
1984-12-16,MIL,115,14,11,UTH,102,12,13,26,24
1984-12-16,LAC,103,12,14,GOS,85,8,16,20,30
1984-12-16,DEN,101,15,8,SEA,112,11,13,26,21
1984-12-16,LAL,109,15,10,WAS,101,14,10,29,20
1984-12-18,WAS,104,14,11,NJN,95,10,14,24,25
1984-12-18,NYK,108,11,16,BOS,126,21,3,32,19
1984-12-18,CLE,118,3,19,SAN,110,12,13,15,32
1984-12-18,KCK,127,7,16,PHX,116,15,11,22,27
1984-12-18,IND,88,6,18,UTH,81,12,14,18,32
1984-12-18,MIL,110,15,11,DAL,96,12,12,27,23
1984-12-18,CHI,96,13,13,HOU,104,15,10,28,23
1984-12-18,GOS,122,8,17,DEN,126,15,9,23,26
1984-12-18,ATL,116,10,15,LAL,117,16,10,26,25
1984-12-18,SEA,109,12,13,POR,99,13,12,25,25
1984-12-19,DEN,129,16,9,DET,148,14,10,30,19
1984-12-19,BOS,92,22,3,MIL,107,16,11,38,14
1984-12-19,NJN,115,10,15,WAS,106,15,11,25,26
1984-12-19,LAC,91,13,14,SEA,86,13,13,26,27
1984-12-19,HOU,116,16,10,LAL,123,17,10,33,20
1984-12-19,PHL,123,19,5,SAN,118,12,14,31,19
1984-12-20,POR,113,13,13,KCK,118,8,16,21,29
1984-12-20,NYK,112,11,17,CLE,97,4,19,15,36
1984-12-20,ATL,129,10,16,CHI,132,13,14,23,30
1984-12-20,UTH,117,12,15,DET,116,15,10,27,25
1984-12-21,PHL,101,20,5,MIL,104,17,11,37,16
1984-12-21,LAL,119,18,10,PHX,105,15,12,33,22
1984-12-21,WAS,125,15,12,NYK,111,12,17,27,29
1984-12-21,DEN,116,16,10,DAL,93,12,13,28,23
1984-12-21,BOS,117,22,4,IND,107,7,18,29,22
1984-12-21,NJN,116,11,15,SAN,122,12,15,23,30
1984-12-21,GOS,94,8,18,SEA,91,13,14,21,32
1984-12-22,KCK,129,9,16,DET,123,15,11,24,27
1984-12-22,PHL,107,20,6,NJN,93,11,16,31,22
1984-12-22,MIL,101,18,11,SAN,90,13,15,31,26
1984-12-22,CHI,110,14,14,BOS,85,23,4,37,18
1984-12-22,PHX,110,15,13,POR,108,13,14,28,27
1984-12-22,HOU,125,16,11,DEN,107,17,10,33,21
1984-12-22,IND,103,7,19,CLE,106,4,20,11,39
1984-12-22,UTH,96,13,15,DAL,113,12,14,25,29
1984-12-22,ATL,119,10,17,WAS,101,16,12,26,29
1984-12-23,SEA,107,13,15,LAC,97,14,14,27,29
1984-12-25,CLE,109,5,20,ATL,106,11,17,16,37
1984-12-25,POR,106,13,15,GOS,97,9,18,22,33
1984-12-25,DET,108,15,12,PHL,109,21,6,36,18
1984-12-25,NYK,114,12,18,NJN,120,11,17,23,35
1984-12-26,LAL,101,19,10,SEA,97,14,15,33,25
1984-12-26,DAL,124,13,14,LAC,118,14,15,27,29
1984-12-26,DEN,130,17,11,SAN,119,13,16,30,27
1984-12-26,WAS,114,16,13,IND,89,7,20,23,33
1984-12-26,ATL,117,11,18,NYK,105,12,19,23,37
1984-12-26,MIL,97,19,11,HOU,87,17,11,36,22
1984-12-26,UTH,133,13,16,KCK,122,10,16,23,32
1984-12-26,NJN,112,12,17,DET,97,15,13,27,30
1984-12-26,PHX,114,16,13,BOS,119,23,5,39,18
1984-12-27,LAC,103,14,16,BOS,118,24,5,38,21
1984-12-27,SEA,98,14,16,GOS,101,9,19,23,35
1984-12-27,SAN,141,13,17,POR,120,14,15,27,32
1984-12-27,CHI,112,15,14,CLE,108,6,20,21,34
1984-12-27,KCK,96,10,17,HOU,92,17,12,27,29
1984-12-28,DEN,123,18,11,LAL,135,20,10,38,21
1984-12-28,WAS,125,17,13,ATL,111,12,18,29,31
1984-12-28,IND,110,7,21,DET,116,15,14,22,35
1984-12-28,PHX,111,16,14,DAL,125,14,14,30,28
1984-12-28,UTH,111,14,16,PHL,114,22,6,36,22
1984-12-28,NJN,100,13,17,NYK,97,12,20,25,37
1984-12-29,KCK,115,11,17,IND,123,7,22,18,39
1984-12-29,CLE,102,6,21,MIL,115,20,11,26,32
1984-12-29,DET,108,16,14,NJN,110,14,17,30,31
1984-12-29,HOU,108,17,13,POR,92,14,16,31,29
1984-12-29,SAN,112,14,17,BOS,120,25,5,39,22
1984-12-29,SEA,108,14,17,DEN,115,18,12,32,29
1984-12-29,LAL,113,21,10,LAC,107,14,17,35,27
1984-12-29,NYK,108,12,21,WAS,116,18,13,30,34
1984-12-29,CHI,101,16,14,ATL,104,12,19,28,33
1984-12-29,DAL,97,15,14,UTH,99,14,17,29,31
1984-12-29,GOS,95,10,19,PHL,109,23,6,33,25
1984-12-30,LAC,109,14,18,PHX,117,16,15,30,33
1984-12-30,MIL,114,21,11,BOS,98,26,5,47,16
1985-01-01,POR,106,14,17,PHL,111,24,6,38,23
1985-01-01,UTH,117,15,17,IND,119,8,22,23,39
1985-01-02,NJN,95,15,17,BOS,110,26,6,41,23
1985-01-02,DET,108,16,15,CLE,100,6,22,22,37
1985-01-02,ATL,121,13,19,CHI,107,16,15,29,34
1985-01-02,SEA,109,14,18,PHL,118,25,6,39,24
1985-01-02,DEN,111,19,12,HOU,113,18,13,37,25
1985-01-02,KCK,107,11,18,PHX,115,17,15,28,33
1985-01-03,POR,123,14,18,SEA,89,14,19,28,37
1985-01-03,SAN,116,14,18,DAL,115,15,15,29,33
1985-01-03,CLE,100,6,23,WAS,93,19,13,25,36
1985-01-03,MIL,111,22,11,LAC,87,14,19,36,30
1985-01-03,GOS,96,10,20,IND,112,9,22,19,42
1985-01-04,UTH,118,15,18,DEN,108,19,13,34,31
1985-01-04,LAL,120,22,10,POR,95,15,18,37,28
1985-01-04,KCK,132,11,19,LAC,112,14,20,25,39
1985-01-04,NJN,105,15,18,PHX,98,18,15,33,33
1985-01-04,BOS,105,27,6,NYK,94,12,22,39,28
1985-01-04,CHI,106,16,16,MIL,101,23,11,39,27
1985-01-04,DET,134,17,15,ATL,111,14,19,31,34
1985-01-05,NYK,119,12,23,CHI,113,17,16,29,39
1985-01-05,SEA,104,14,20,IND,97,10,22,24,42
1985-01-05,DAL,135,15,16,KCK,107,12,19,27,35
1985-01-05,GOS,94,10,21,HOU,103,19,13,29,34
1985-01-05,WAS,113,19,14,DET,121,18,15,37,29
1985-01-05,CLE,111,7,23,PHX,106,18,16,25,39
1985-01-05,MIL,106,23,12,PHL,110,26,6,49,18
1985-01-05,DEN,115,19,14,LAC,127,14,21,33,35
1985-01-05,ATL,124,14,20,NJN,114,16,18,30,38
1985-01-06,UTH,121,16,18,HOU,92,20,13,36,31
1985-01-06,POR,118,15,19,IND,101,10,23,25,42
1985-01-06,LAL,99,23,10,SAN,98,15,18,38,28
1985-01-07,LAC,116,15,21,UTH,106,17,18,32,39
1985-01-07,NYK,97,13,23,BOS,108,28,6,41,29
1985-01-07,KCK,110,12,20,GOS,101,10,22,22,42
1985-01-07,PHL,100,27,6,PHX,99,18,17,45,23
1985-01-07,SEA,84,15,20,DAL,102,16,16,31,36
1985-01-08,LAL,124,24,10,DEN,126,19,15,43,25
1985-01-08,POR,102,16,19,DAL,108,17,16,33,35
1985-01-08,SAN,139,15,19,GOS,94,10,23,25,42
1985-01-08,HOU,112,20,14,KCK,110,13,20,33,34
1985-01-08,CLE,107,8,23,NJN,101,16,19,24,42
1985-01-08,MIL,95,23,13,WAS,99,19,15,42,28
1985-01-09,PHL,126,28,6,DET,122,19,15,47,21
1985-01-09,IND,105,10,24,MIL,106,23,14,33,38
1985-01-09,DEN,100,20,15,NYK,95,13,24,33,39
1985-01-09,BOS,111,29,6,CHI,108,17,17,46,23
1985-01-09,PHX,94,18,18,SEA,88,15,21,33,39
1985-01-10,LAL,120,24,11,UTH,112,17,19,41,30
1985-01-10,GOS,86,10,24,SEA,89,15,22,25,46
1985-01-10,KCK,110,13,21,DAL,117,18,16,31,37
1985-01-11,DET,120,19,16,IND,109,10,25,29,41
1985-01-11,CHI,113,17,18,NYK,97,13,25,30,43
1985-01-11,DAL,102,19,16,LAL,121,25,11,44,27
1985-01-11,NJN,122,16,20,ATL,103,15,20,31,40
1985-01-11,MIL,130,24,14,CLE,117,9,23,33,37
1985-01-11,SAN,103,16,19,POR,123,16,20,32,39
1985-01-11,DEN,143,21,15,KCK,121,13,22,34,37
1985-01-11,BOS,103,30,6,WAS,101,20,15,50,21
1985-01-11,PHL,115,29,6,HOU,108,21,14,50,20
1985-01-11,PHX,84,19,18,LAC,98,16,21,35,39
1985-01-12,CLE,101,9,24,CHI,98,18,18,27,42
1985-01-12,ATL,111,15,21,BOS,119,31,6,46,27
1985-01-12,GOS,102,10,25,LAC,104,17,21,27,46
1985-01-12,PHX,109,19,19,UTH,94,17,20,36,39
1985-01-12,IND,100,10,26,NYK,95,13,26,23,52
1985-01-13,SEA,119,16,22,KCK,114,13,23,29,45
1985-01-13,DAL,124,19,17,POR,101,17,20,36,37
1985-01-13,NJN,100,17,20,HOU,99,21,15,38,35
1985-01-13,MIL,140,25,14,DEN,116,22,15,47,29
1985-01-13,DET,121,20,16,LAL,98,26,11,46,27
1985-01-13,WAS,104,20,16,PHL,115,30,6,50,22
1985-01-14,CHI,122,18,19,DEN,113,22,16,40,35
1985-01-14,CLE,91,10,24,WAS,101,20,17,30,41
1985-01-15,SEA,101,17,22,LAC,83,18,21,35,43
1985-01-15,IND,113,11,26,ATL,120,15,22,26,48
1985-01-15,POR,121,17,21,HOU,117,21,16,38,37
1985-01-15,MIL,115,26,14,LAL,105,26,12,52,26
1985-01-15,SAN,121,16,20,UTH,101,17,21,33,41
1985-01-15,GOS,104,10,26,DAL,149,20,17,30,43
1985-01-15,NYK,82,13,27,PHL,93,31,6,44,33
1985-01-15,KCK,112,13,24,CLE,116,10,25,23,49
1985-01-16,LAC,98,18,22,HOU,88,21,17,39,39
1985-01-16,PHX,98,20,19,DAL,95,21,17,41,36
1985-01-16,PHL,122,32,6,ATL,99,16,22,48,28
1985-01-16,DEN,115,22,17,GOS,107,10,27,32,44
1985-01-16,NJN,100,18,20,CHI,94,19,19,37,39
1985-01-16,UTH,101,17,22,WAS,103,21,17,38,39
1985-01-16,BOS,104,32,6,LAL,102,26,13,58,19
1985-01-17,CHI,98,19,20,CLE,93,11,25,30,45
1985-01-17,NYK,89,13,28,DET,105,21,16,34,44
1985-01-17,KCK,130,13,25,SAN,141,17,20,30,45
1985-01-18,ATL,104,16,23,SEA,90,18,22,34,45
1985-01-18,IND,91,11,27,BOS,86,33,6,44,33
1985-01-18,MIL,102,27,14,NJN,93,19,20,46,34
1985-01-18,DEN,108,23,17,WAS,106,22,17,45,34
1985-01-18,LAL,110,26,14,DAL,92,21,18,47,32
1985-01-18,PHX,101,21,19,HOU,112,21,18,42,37
1985-01-18,UTH,127,17,23,POR,122,18,21,35,44
1985-01-19,HOU,120,22,18,UTH,95,18,23,40,41
1985-01-19,IND,110,12,27,CHI,107,20,20,32,47
1985-01-19,GOS,109,10,28,LAL,139,27,14,37,42
1985-01-19,CLE,105,11,26,SEA,106,18,23,29,49
1985-01-19,SAN,106,18,20,PHX,100,21,20,39,40
1985-01-19,NYK,88,13,29,ATL,86,17,23,30,52
1985-01-19,POR,120,18,22,DEN,123,24,17,42,39
1985-01-19,KCK,103,13,26,WAS,98,22,18,35,44
1985-01-19,LAC,100,19,22,DAL,101,21,19,40,41
1985-01-19,NJN,107,19,21,DET,109,22,16,41,37
1985-01-20,BOS,113,33,7,PHL,97,33,6,66,13
1985-01-21,WAS,128,22,19,CLE,115,11,27,33,46
1985-01-21,IND,129,13,27,GOS,127,10,29,23,56
1985-01-22,NYK,92,14,29,SEA,90,19,23,33,52
1985-01-22,HOU,101,23,18,PHX,97,21,21,44,39
1985-01-22,CLE,100,11,28,PHL,101,33,7,44,35
1985-01-22,WAS,109,23,19,GOS,104,10,30,33,49
1985-01-22,UTH,102,18,24,NJN,99,19,22,37,46
1985-01-22,CHI,123,20,21,POR,115,18,23,38,44
1985-01-22,SAN,117,19,20,KCK,113,14,26,33,46
1985-01-22,ATL,113,17,24,DET,130,23,16,40,40
1985-01-22,LAL,123,28,14,LAC,114,19,23,47,37
1985-01-23,ATL,101,17,25,PHX,100,21,22,38,47
1985-01-23,DAL,122,22,19,SAN,110,20,20,42,39
1985-01-23,BOS,97,34,7,SEA,107,19,24,53,31
1985-01-23,IND,104,14,27,POR,136,18,24,32,51
1985-01-24,DEN,119,25,17,NJN,110,19,23,44,40
1985-01-24,UTH,109,19,24,CLE,110,11,29,30,53
1985-01-24,WAS,93,24,19,DAL,92,23,19,47,38
1985-01-24,KCK,119,14,27,MIL,120,28,14,42,41
1985-01-24,DET,137,24,16,GOS,118,10,31,34,47
1985-01-25,HOU,107,24,18,SAN,122,20,21,44,39
1985-01-25,BOS,125,34,8,IND,94,14,28,48,36
1985-01-25,LAL,109,29,14,PHL,104,34,7,63,21
1985-01-25,CHI,93,21,21,SEA,76,20,24,41,45
1985-01-26,HOU,102,24,19,MIL,105,29,14,53,33
1985-01-26,CHI,117,22,21,ATL,104,18,25,40,46
1985-01-26,DET,132,25,16,SEA,113,20,25,45,41
1985-01-26,DEN,144,26,17,CLE,127,12,29,38,46
1985-01-26,KCK,120,14,28,GOS,111,10,32,24,60
1985-01-26,WAS,110,25,19,PHX,105,21,23,46,42
1985-01-26,LAC,113,19,24,PHL,120,34,8,53,32
1985-01-26,DAL,93,23,20,NJN,103,19,24,42,44
1985-01-26,UTH,96,19,25,LAL,83,30,14,49,39
1985-01-26,NYK,109,15,29,IND,106,14,29,29,58
1985-01-27,DET,115,26,16,WAS,105,26,19,52,35
1985-01-27,SAN,93,21,21,MIL,106,30,14,51,35
1985-01-27,BOS,128,35,8,POR,127,19,24,54,32
1985-01-28,DAL,111,23,21,PHL,109,35,8,58,29
1985-01-28,NYK,117,16,29,LAC,91,19,25,35,54
1985-01-28,HOU,97,24,20,NJN,93,20,24,44,44
1985-01-28,UTH,100,20,25,DEN,104,27,17,47,42
1985-01-29,DEN,128,28,17,PHX,100,21,24,49,41
1985-01-29,POR,106,19,25,LAL,122,30,15,49,40
1985-01-29,GOS,101,10,33,MIL,108,31,14,41,47
1985-01-29,CLE,110,12,30,LAC,94,19,26,31,56
1985-01-29,ATL,115,18,26,IND,106,14,30,32,56
1985-01-29,BOS,131,36,8,DET,130,27,16,63,24
1985-01-29,CHI,103,23,21,KCK,97,15,28,38,49
1985-01-29,SAN,130,21,22,NJN,127,20,25,41,47
1985-01-30,IND,120,14,31,CLE,115,13,30,27,61
1985-01-30,WAS,106,26,20,CHI,95,24,21,50,41
1985-01-30,DET,120,27,17,KCK,116,15,29,42,46
1985-01-30,PHL,122,35,9,BOS,104,37,8,72,17
1985-01-30,LAL,113,31,15,HOU,116,25,20,56,35
1985-01-30,PHX,110,21,25,NYK,93,17,29,38,54
1985-01-31,GOS,109,10,34,POR,129,19,26,29,60
1985-01-31,SEA,96,20,26,SAN,94,22,22,42,48
1985-01-31,NJN,122,20,26,LAC,99,19,27,39,53
1985-01-31,DEN,121,29,17,DAL,110,24,21,53,38
1985-02-01,DAL,109,24,22,UTH,121,20,26,44,48
1985-02-01,POR,93,20,26,SAN,104,22,23,42,49
1985-02-01,BOS,142,37,9,KCK,123,15,30,52,39
1985-02-01,PHL,121,36,9,CHI,110,24,22,60,31
1985-02-01,ATL,126,19,26,CLE,108,13,31,32,57
1985-02-01,LAL,105,31,16,NYK,104,17,30,48,46
1985-02-01,SEA,91,21,26,MIL,109,32,14,53,40
1985-02-01,IND,102,15,31,WAS,95,27,20,42,51
1985-02-02,CLE,124,13,32,KCK,106,15,31,28,63
1985-02-02,WAS,91,27,21,BOS,97,38,9,65,30
1985-02-02,POR,95,20,27,MIL,105,33,14,53,41
1985-02-02,DET,110,28,17,ATL,102,20,26,48,43
1985-02-02,UTH,105,21,26,SAN,104,23,23,44,49
1985-02-02,GOS,114,10,35,NYK,98,17,31,27,66
1985-02-02,NJN,101,21,26,PHL,96,37,9,58,35
1985-02-02,HOU,131,26,20,DEN,128,30,17,56,37
1985-02-02,LAC,96,19,28,LAL,105,32,16,51,44
1985-02-03,PHX,120,22,25,SEA,109,21,27,43,52
1985-02-03,LAL,122,33,16,IND,100,16,31,49,47
1985-02-03,DAL,114,24,23,DEN,106,30,18,54,41
1985-02-04,SAN,114,23,24,GOS,109,11,35,34,59
1985-02-04,WAS,112,27,22,CLE,121,14,32,41,54
1985-02-04,MIL,111,34,14,DET,113,29,17,63,31
1985-02-04,PHL,106,37,10,ATL,92,20,27,57,37
1985-02-04,LAC,115,19,29,IND,96,16,32,35,61
1985-02-05,CHI,106,24,23,BOS,110,39,9,63,32
1985-02-05,HOU,104,27,20,LAL,113,34,16,61,36
1985-02-05,ATL,103,20,28,DAL,112,25,23,45,51
1985-02-05,KCK,135,15,32,SAN,116,24,24,39,56
1985-02-05,SEA,108,21,28,NYK,110,17,32,38,60
1985-02-05,DET,117,30,17,NJN,119,22,26,52,43
1985-02-05,POR,126,20,28,UTH,106,22,26,42,54
1985-02-05,PHX,108,23,25,DEN,103,30,19,53,44
1985-02-06,DEN,120,30,20,SEA,101,21,29,51,49
1985-02-06,PHL,116,38,10,WAS,111,27,23,65,33
1985-02-06,DAL,129,26,23,GOS,103,11,36,37,59
1985-02-06,NJN,106,23,26,MIL,93,34,15,57,41
1985-02-06,BOS,113,40,9,CLE,108,15,32,55,41
1985-02-07,POR,133,21,28,NYK,122,18,32,39,60
1985-02-07,SAN,120,24,25,LAC,108,20,29,44,54
1985-02-07,CLE,108,15,33,CHI,99,24,24,39,57
1985-02-07,HOU,112,27,21,GOS,105,11,37,38,58
1985-02-07,PHX,105,24,25,IND,97,16,33,40,58
1985-02-07,KCK,96,16,32,UTH,114,22,27,38,59
1985-02-07,MIL,91,34,16,ATL,94,20,29,54,45
1985-02-07,WAS,128,27,24,DET,126,30,18,57,42
1985-02-12,DEN,131,31,20,ATL,107,21,29,52,49
1985-02-12,SAN,127,25,25,KCK,109,16,33,41,58
1985-02-12,GOS,110,11,38,UTH,122,23,27,34,65
1985-02-12,POR,111,22,28,BOS,103,41,9,63,37
1985-02-12,IND,116,16,34,PHL,124,39,10,55,44
1985-02-12,HOU,126,28,21,PHX,114,25,25,53,46
1985-02-12,CHI,139,24,25,DET,126,30,19,54,44
1985-02-12,LAL,121,35,16,LAC,110,20,30,55,46
1985-02-12,MIL,111,34,17,NJN,103,24,26,58,43
1985-02-12,CLE,112,16,33,DAL,131,27,23,43,56
1985-02-12,SEA,109,21,30,WAS,94,28,24,49,54
1985-02-13,LAC,108,20,31,GOS,105,11,39,31,70
1985-02-13,NJN,112,24,27,CLE,105,16,34,40,61
1985-02-13,UTH,88,24,27,ATL,94,21,30,45,57
1985-02-13,DET,124,30,20,DAL,119,28,23,58,43
1985-02-13,PHL,131,40,10,NYK,129,18,33,58,43
1985-02-14,NYK,105,18,34,HOU,113,29,21,47,55
1985-02-14,SAN,131,26,25,PHX,102,25,26,51,51
1985-02-14,IND,128,16,35,MIL,132,35,17,51,52
1985-02-14,KCK,123,16,34,DEN,138,32,20,48,54
1985-02-14,SEA,94,22,30,BOS,110,41,10,63,40
1985-02-15,LAL,120,36,16,ATL,111,22,30,58,46
1985-02-15,CHI,96,25,25,IND,114,16,36,41,61
1985-02-15,GOS,100,11,40,BOS,107,42,10,53,50
1985-02-15,POR,93,23,28,WAS,89,28,25,51,53
1985-02-15,DEN,129,33,20,SAN,119,27,25,60,45
1985-02-15,DAL,103,28,24,PHX,126,25,27,53,51
1985-02-15,PHL,107,41,10,CLE,112,16,35,57,45
1985-02-15,NJN,124,25,27,DET,123,31,20,56,47
1985-02-15,UTH,109,24,28,LAC,100,21,31,45,59
1985-02-16,CLE,115,17,35,HOU,122,30,21,47,56
1985-02-16,SEA,106,22,31,KCK,111,16,35,38,66
1985-02-16,NYK,117,18,35,NJN,126,26,27,44,62
1985-02-16,DET,114,31,21,PHL,125,41,11,72,32
1985-02-17,GOS,125,11,41,WAS,121,28,26,39,67
1985-02-17,LAC,90,21,32,ATL,91,22,31,43,63
1985-02-17,IND,97,17,36,PHX,115,26,27,43,63
1985-02-17,POR,115,24,28,KCK,96,17,35,41,63
1985-02-17,LAL,117,37,16,BOS,111,43,10,80,26
1985-02-17,MIL,125,36,17,CHI,105,25,26,61,43
1985-02-18,LAC,125,21,33,SAN,121,27,26,48,59
1985-02-18,DET,122,31,22,PHX,103,27,27,58,49
1985-02-18,CLE,120,17,36,PHL,113,42,11,59,47
1985-02-18,UTH,94,25,28,BOS,110,43,11,68,39
1985-02-19,NYK,118,18,36,MIL,129,37,17,55,53
1985-02-19,CHI,117,25,27,LAL,127,38,16,63,43
1985-02-19,KCK,116,17,36,POR,96,25,28,42,64
1985-02-19,ATL,107,23,31,GOS,104,12,41,35,72
1985-02-19,HOU,115,31,21,DAL,124,28,25,59,46
1985-02-20,SAN,104,27,27,WAS,105,28,27,55,54
1985-02-20,NJN,104,27,27,UTH,110,25,29,52,56
1985-02-20,PHX,122,27,28,HOU,126,31,22,58,50
1985-02-20,IND,92,17,37,CLE,102,18,36,35,73
1985-02-20,DAL,104,29,25,POR,98,25,29,54,54
1985-02-20,DET,112,32,22,MIL,113,38,17,70,39
1985-02-20,PHL,137,42,12,GOS,116,12,42,54,54
1985-02-20,LAC,105,22,33,SEA,118,22,32,44,65
1985-02-20,DEN,132,34,20,BOS,129,44,11,78,31
1985-02-21,KCK,117,18,36,LAL,123,39,16,57,52
1985-02-22,SEA,133,23,32,DEN,123,35,20,58,52
1985-02-22,BOS,115,44,12,CHI,105,25,28,69,40
1985-02-22,DAL,110,30,25,WAS,101,29,27,59,52
1985-02-22,HOU,117,32,22,POR,103,25,30,57,52
1985-02-22,ATL,105,24,31,NYK,113,18,37,42,68
1985-02-22,NJN,127,27,28,GOS,131,12,43,39,71
1985-02-22,PHL,110,43,12,DET,99,32,23,75,35
1985-02-22,PHX,111,27,29,SAN,118,27,28,54,57
1985-02-22,CLE,98,19,36,UTH,102,26,29,45,65
1985-02-22,IND,122,17,38,LAL,113,40,16,57,54
1985-02-23,KCK,98,18,37,DAL,121,31,25,49,62
1985-02-23,HOU,115,33,22,WAS,123,29,28,62,50
1985-02-23,CHI,140,25,29,GOS,125,13,43,38,72
1985-02-23,DET,103,32,24,NJN,111,27,29,59,53
1985-02-23,CLE,128,19,37,MIL,106,39,17,58,54
1985-02-24,NYK,114,19,37,LAL,119,40,17,59,54
1985-02-24,SAN,121,28,28,POR,137,25,31,53,59
1985-02-24,IND,100,18,38,BOS,113,45,12,63,50
1985-02-24,DEN,117,35,21,PHX,107,27,30,62,51
1985-02-24,SEA,108,24,32,LAC,102,22,34,46,66
1985-02-24,PHL,117,44,12,UTH,108,27,29,71,41
1985-02-26,NYK,129,19,38,SAN,122,28,29,47,67
1985-02-26,ATL,94,24,32,DEN,106,36,21,60,53
1985-02-26,DAL,96,32,25,UTH,103,27,30,59,55
1985-02-26,LAL,100,41,17,HOU,94,33,23,74,40
1985-02-26,GOS,128,13,44,SEA,119,25,32,38,76
1985-02-26,CHI,118,26,29,CLE,123,20,37,46,66
1985-02-26,POR,110,26,31,LAC,99,22,35,48,66
1985-02-26,KCK,110,18,38,PHX,103,27,31,45,69
1985-02-26,MIL,116,39,18,PHL,97,45,12,84,30
1985-02-27,WAS,111,30,28,DEN,124,37,21,67,49
1985-02-27,DET,108,32,25,CHI,99,26,30,58,55
1985-02-27,BOS,111,46,12,SAN,102,28,30,74,42
1985-02-27,LAC,109,22,36,HOU,117,33,24,55,60
1985-02-27,NJN,114,28,29,ATL,91,24,33,52,62
1985-02-27,IND,108,18,39,NYK,106,20,38,38,77
1985-02-27,UTH,100,28,30,MIL,119,40,18,68,48
1985-02-28,KCK,119,19,38,PHL,127,45,13,64,51
1985-02-28,GOS,124,14,44,POR,120,27,31,41,75
1985-02-28,PHX,117,27,32,LAL,105,42,17,69,49
1985-02-28,SEA,95,25,33,CLE,120,21,37,46,70
1985-03-01,POR,103,27,32,CLE,111,22,37,49,69
1985-03-01,UTH,115,28,31,HOU,119,34,24,62,55
1985-03-01,DAL,140,32,26,DEN,141,38,21,70,47
1985-03-01,CHI,109,26,31,NYK,104,20,39,46,70
1985-03-01,BOS,105,47,12,ATL,114,24,34,71,46
1985-03-01,DET,98,33,25,SAN,108,28,31,61,56
1985-03-01,WAS,98,30,29,NJN,100,29,29,59,58
1985-03-02,NYK,97,20,40,WAS,109,30,30,50,70
1985-03-02,IND,92,19,39,SEA,106,25,34,44,73
1985-03-02,DEN,123,39,21,MIL,122,41,18,80,39
1985-03-02,ATL,92,25,34,SAN,105,29,31,54,65
1985-03-02,GOS,108,15,44,LAC,102,22,37,37,81
1985-03-02,PHX,114,28,32,KCK,111,19,39,47,71
1985-03-02,DAL,106,32,27,LAL,125,42,18,74,45
1985-03-03,LAC,122,22,38,KCK,126,19,40,41,78
1985-03-03,CHI,113,27,31,NJN,117,30,29,57,60
1985-03-03,BOS,138,47,13,DET,129,33,26,80,39
1985-03-03,HOU,99,35,24,PHL,90,46,13,81,37
1985-03-03,POR,121,27,33,UTH,93,28,32,55,65
1985-03-04,SAN,109,30,31,PHL,103,46,14,76,45
1985-03-04,GOS,104,16,44,CLE,108,23,37,39,81
1985-03-04,PHX,99,29,32,DAL,107,32,28,61,60
1985-03-05,MIL,102,41,20,SEA,87,26,34,67,54
1985-03-05,DAL,108,33,28,IND,102,19,40,52,68
1985-03-05,NYK,102,20,41,BOS,110,48,13,68,54
1985-03-05,KCK,134,20,40,NJN,113,31,29,51,69
1985-03-05,ATL,91,25,35,POR,100,28,33,53,68
1985-03-05,DEN,133,40,21,HOU,131,36,24,76,45
1985-03-05,CHI,104,27,32,WAS,99,31,30,58,62
1985-03-06,NJN,129,31,30,SEA,108,26,35,57,65
1985-03-06,DET,114,34,27,NYK,90,20,42,54,69
1985-03-06,HOU,90,36,25,UTH,94,28,33,64,58
1985-03-06,WAS,127,31,31,POR,121,29,33,60,64
1985-03-06,PHL,96,46,15,ATL,86,25,36,71,51
1985-03-06,BOS,104,49,13,CHI,107,28,32,77,45
1985-03-06,LAC,112,22,39,CLE,114,24,37,46,76
1985-03-06,SAN,108,31,31,IND,102,19,41,50,72
1985-03-06,LAL,145,43,18,GOS,119,16,45,59,63
1985-03-07,KCK,142,21,40,DEN,140,41,21,62,61
1985-03-07,PHX,119,29,33,SAN,117,32,31,61,64
1985-03-07,DET,114,35,27,UTH,122,29,33,64,60
1985-03-08,HOU,125,36,26,IND,105,19,42,55,68
1985-03-08,CHI,117,29,32,LAC,101,22,40,51,72
1985-03-08,PHL,128,47,15,SEA,114,26,36,73,51
1985-03-08,BOS,133,49,14,DAL,122,34,28,83,42
1985-03-08,NJN,110,32,30,POR,128,29,34,61,64
1985-03-08,MIL,127,42,20,KCK,114,22,40,64,60
1985-03-09,NYK,131,20,43,PHL,129,48,15,68,58
1985-03-09,SAN,117,32,32,HOU,123,37,26,69,58
1985-03-09,DEN,126,41,22,IND,116,19,43,60,65
1985-03-09,PHX,115,30,33,GOS,118,16,46,46,79
1985-03-09,WAS,92,32,31,SEA,93,26,37,58,68
1985-03-09,CHI,105,30,32,UTH,111,30,33,60,65
1985-03-09,ATL,113,25,37,DET,115,35,28,60,65
1985-03-09,LAL,133,44,18,CLE,106,25,37,69,55
1985-03-10,KCK,129,22,41,LAC,111,22,41,44,82
1985-03-10,NJN,113,32,31,DAL,126,34,29,66,60
1985-03-10,MIL,110,43,20,POR,94,30,34,73,54
1985-03-11,DAL,103,35,29,SEA,100,27,37,62,66
1985-03-11,CLE,122,25,38,IND,110,19,44,44,82
1985-03-11,ATL,115,25,38,MIL,121,44,20,69,58
1985-03-11,WAS,119,32,32,CHI,112,30,33,62,65
1985-03-11,DET,121,36,28,LAC,114,22,42,58,70
1985-03-12,IND,109,19,45,NJN,108,32,32,51,77
1985-03-12,LAL,123,45,18,UTH,108,31,33,76,51
1985-03-12,NYK,119,21,43,PHX,123,30,34,51,77
1985-03-12,GOS,145,17,46,SAN,122,32,33,49,79
1985-03-12,HOU,131,38,26,DEN,129,42,22,80,48
1985-03-12,KCK,120,23,41,POR,114,30,35,53,76
1985-03-12,ATL,115,25,39,BOS,126,50,14,75,53
1985-03-12,CHI,111,30,34,DET,110,37,28,67,62
1985-03-13,NJN,114,32,33,WAS,109,33,32,65,65
1985-03-13,BOS,123,51,14,PHX,106,31,34,82,48
1985-03-13,MIL,128,45,20,CLE,93,26,38,71,58
1985-03-13,UTH,105,31,34,LAL,120,46,18,77,52
1985-03-13,DAL,118,36,29,KCK,100,24,41,60,70
1985-03-13,PHL,121,48,16,LAC,103,22,43,70,59
1985-03-14,GOS,112,18,46,ATL,120,25,40,43,86
1985-03-14,IND,112,20,45,LAC,113,22,44,42,89
1985-03-14,NYK,106,21,44,CHI,97,31,34,52,78
1985-03-14,SEA,93,27,38,SAN,100,32,34,59,72
1985-03-15,CLE,96,26,39,BOS,119,52,14,78,53
1985-03-15,CHI,103,31,35,PHX,97,31,35,62,70
1985-03-15,PHL,119,49,16,NYK,110,22,44,71,60
1985-03-15,WAS,120,33,33,HOU,114,39,27,72,60
1985-03-15,UTH,115,31,35,KCK,112,24,42,55,77
1985-03-15,DAL,127,37,29,DEN,108,42,23,79,52
1985-03-15,LAL,115,47,18,SAN,114,33,34,80,52
1985-03-15,POR,126,30,36,GOS,101,18,47,48,83
1985-03-16,NYK,116,22,45,IND,114,20,46,42,91
1985-03-16,MIL,125,46,20,PHX,96,31,36,77,56
1985-03-16,LAC,112,23,44,LAL,123,48,18,71,62
1985-03-16,PHL,127,50,16,NJN,107,33,33,83,49
1985-03-16,SEA,108,27,39,ATL,99,26,40,53,79
1985-03-16,DAL,128,38,29,CLE,135,26,40,64,69
1985-03-17,BOS,134,53,14,HOU,120,39,28,92,42
1985-03-17,POR,114,31,36,ATL,101,26,41,57,77
1985-03-17,KCK,107,24,43,UTH,101,32,35,56,78
1985-03-17,LAC,100,23,45,GOS,109,18,48,41,93
1985-03-17,CHI,119,32,35,MIL,117,47,20,79,55
1985-03-17,SAN,124,33,35,DEN,119,42,24,75,59
1985-03-17,NJN,129,33,34,IND,105,20,47,53,81
1985-03-17,SEA,106,28,39,DET,98,39,29,67,68
1985-03-18,UTH,136,32,36,GOS,125,19,48,51,84
1985-03-18,DEN,113,42,25,DAL,111,38,30,80,55
1985-03-18,LAC,136,24,48,DET,116,41,32,65,80
1985-03-19,CLE,116,27,40,PHL,89,51,16,78,56
1985-03-19,MIL,130,47,21,NJN,111,34,34,81,55
1985-03-19,ATL,103,26,42,WAS,97,34,34,60,76
1985-03-19,POR,143,32,36,DET,123,39,30,71,66
1985-03-19,DAL,96,38,31,SAN,89,34,35,72,66
1985-03-19,HOU,106,39,29,CHI,100,33,35,72,64
1985-03-19,PHX,112,31,37,LAL,130,49,18,80,55
1985-03-20,LAC,121,23,46,UTH,110,33,36,56,82
1985-03-20,SEA,123,29,39,GOS,109,19,49,48,88
1985-03-20,PHL,117,51,17,KCK,118,25,43,76,60
1985-03-20,BOS,107,54,14,MIL,105,48,21,102,35
1985-03-20,WAS,105,34,35,NYK,102,23,45,57,80
1985-03-20,SAN,106,34,36,CHI,98,33,36,67,72
1985-03-20,NJN,128,34,35,CLE,108,28,40,62,75
1985-03-20,IND,119,20,48,DEN,123,43,25,63,73
1985-03-21,GOS,113,19,50,DET,122,39,31,58,81
1985-03-21,PHX,114,31,38,POR,104,33,36,64,74
1985-03-22,ATL,102,27,42,KCK,121,26,43,53,85
1985-03-22,IND,113,20,49,NYK,118,23,46,43,95
1985-03-22,HOU,107,40,29,LAL,130,50,18,90,47
1985-03-22,PHL,112,51,18,MIL,131,48,22,99,40
1985-03-22,BOS,129,55,14,CLE,117,28,41,83,55
1985-03-22,SEA,85,30,39,UTH,110,33,37,63,76
1985-03-22,NJN,111,35,35,DEN,123,44,25,79,60
1985-03-22,SAN,114,35,36,DAL,123,39,31,74,67
1985-03-23,DAL,97,40,31,CHI,107,33,37,73,68
1985-03-23,POR,126,33,37,LAC,123,24,46,57,83
1985-03-23,CLE,86,28,42,ATL,91,27,43,55,85
1985-03-23,MIL,140,49,22,IND,129,20,50,69,72
1985-03-23,GOS,123,19,51,PHX,109,32,38,51,89
1985-03-23,KCK,113,27,43,NYK,105,24,46,51,89
1985-03-23,WAS,98,35,35,BOS,104,56,14,91,49
1985-03-24,UTH,110,34,37,CHI,92,34,37,68,74
1985-03-24,SAN,104,35,37,SEA,99,30,40,65,77
1985-03-24,LAL,148,51,18,DET,130,40,31,91,49
1985-03-24,PHL,124,51,19,DEN,103,45,25,96,44
1985-03-25,MIL,126,50,22,NYK,106,24,47,74,69
1985-03-25,KCK,121,28,43,SEA,106,30,41,58,84
1985-03-25,LAC,99,24,47,POR,120,34,37,58,84
1985-03-26,DAL,134,40,32,GOS,107,20,51,60,83
1985-03-26,PHX,93,32,39,DET,119,40,32,72,71
1985-03-26,ATL,108,28,43,NJN,109,35,36,63,79
1985-03-26,HOU,115,40,30,KCK,93,29,43,69,73
1985-03-26,DEN,104,45,26,UTH,89,35,37,80,63
1985-03-26,WAS,96,35,36,MIL,107,51,22,86,58
1985-03-26,CLE,112,28,43,NYK,98,24,48,52,91
1985-03-26,POR,116,35,37,LAL,113,52,18,87,55
1985-03-26,CHI,120,34,38,IND,119,20,51,54,89
1985-03-27,DET,127,37,29,HOU,110,39,26,76,55
1985-03-27,SEA,97,30,42,LAL,122,52,19,82,61
1985-03-27,PHL,115,52,19,WAS,97,35,37,87,56
1985-03-27,NJN,95,36,36,BOS,105,57,14,93,50
1985-03-27,SAN,121,36,37,GOS,120,20,52,56,89
1985-03-27,IND,99,20,52,ATL,125,28,44,48,96
1985-03-27,UTH,116,35,38,DAL,101,41,32,76,70
1985-03-28,DEN,133,46,26,KCK,115,29,44,75,70
1985-03-28,LAC,116,25,48,PHX,110,32,40,57,88
1985-03-28,NYK,116,24,49,MIL,121,52,22,76,71
1985-03-28,CLE,122,29,43,CHI,114,35,38,64,81
1985-03-29,LAL,120,53,19,DAL,115,41,33,94,52
1985-03-29,BOS,112,58,14,PHL,108,53,19,111,33
1985-03-29,UTH,114,36,38,SAN,109,37,37,73,75
1985-03-29,WAS,122,35,38,NJN,98,36,37,71,75
1985-03-29,SEA,99,30,43,POR,125,36,37,66,80
1985-03-29,HOU,121,41,30,GOS,116,20,53,61,83
1985-03-30,PHX,114,32,41,LAC,123,26,48,58,89
1985-03-30,MIL,106,53,22,ATL,95,30,44,83,66
1985-03-30,HOU,106,42,30,UTH,96,37,38,79,68
1985-03-30,KCK,137,29,45,GOS,121,20,54,49,99
1985-03-30,DEN,129,47,26,POR,117,37,37,84,63
1985-03-30,CLE,117,30,43,IND,94,20,53,50,96
1985-03-30,NYK,114,24,50,NJN,123,36,38,60,88
1985-03-30,CHI,117,35,39,PHL,122,53,20,88,59
1985-03-31,DET,113,41,34,BOS,105,59,14,100,48
1985-03-31,IND,105,20,54,WAS,111,36,38,56,92
1985-03-31,LAC,115,27,48,SAN,126,37,38,64,86
1985-03-31,LAL,123,54,19,PHX,98,32,42,86,61
1985-04-01,DET,100,41,33,ATL,114,29,44,70,77
1985-04-01,SEA,116,30,44,HOU,127,43,30,73,74
1985-04-02,IND,121,20,55,DET,124,42,34,62,89
1985-04-02,DEN,104,48,26,LAL,118,55,19,103,45
1985-04-02,MIL,109,54,22,BOS,103,59,15,113,37
1985-04-02,ATL,91,30,45,PHL,102,54,20,84,65
1985-04-02,CLE,122,31,43,WAS,107,37,38,68,81
1985-04-02,PHX,119,32,43,SEA,109,30,45,62,88
1985-04-02,POR,127,37,38,HOU,113,44,30,81,68
1985-04-02,GOS,121,20,55,DAL,127,41,34,61,89
1985-04-02,CHI,108,35,40,NJN,94,37,38,72,78
1985-04-03,NJN,113,37,39,NYK,100,24,51,61,90
1985-04-03,PHL,110,55,20,CLE,113,32,43,87,63
1985-04-03,WAS,91,37,39,CHI,100,36,40,73,79
1985-04-03,LAC,124,27,49,KCK,122,30,45,57,94
1985-04-03,SAN,122,38,38,LAL,108,56,19,94,57
1985-04-03,BOS,119,59,16,IND,103,20,56,79,72
1985-04-04,NYK,79,24,52,ATL,100,30,46,54,98
1985-04-04,UTH,118,37,39,SEA,119,30,46,67,85
1985-04-04,MIL,130,55,22,DET,121,43,34,98,56
1985-04-04,PHX,103,33,43,DEN,110,48,27,81,70
1985-04-04,GOS,113,20,56,HOU,108,44,31,64,87
1985-04-05,POR,145,38,38,SEA,120,31,46,69,84
1985-04-05,DET,118,43,35,CLE,119,33,43,76,78
1985-04-05,DAL,122,42,34,LAC,126,28,49,70,83
1985-04-05,DEN,118,49,27,SAN,109,39,38,88,65
1985-04-05,LAL,132,56,20,KCK,125,30,46,86,66
1985-04-05,BOS,115,60,16,WAS,104,37,40,97,56
1985-04-05,PHL,116,55,21,CHI,113,37,40,92,61
1985-04-06,UTH,105,37,40,PHX,94,33,44,70,84
1985-04-06,ATL,114,31,46,CHI,117,37,41,68,87
1985-04-06,DAL,127,42,35,HOU,139,44,32,86,67
1985-04-06,IND,121,20,57,PHL,117,56,21,76,78
1985-04-06,GOS,141,21,56,KCK,125,30,47,51,103
1985-04-06,WAS,109,37,41,CLE,101,34,43,71,84
1985-04-06,NJN,108,38,39,MIL,104,56,22,94,61
1985-04-07,DET,113,33,27,MIL,91,41,19,74,46
1985-04-07,DEN,130,50,27,GOS,125,22,56,72,83
1985-04-07,SEA,110,31,47,PHX,125,33,45,64,92
1985-04-07,SAN,126,39,39,HOU,105,45,32,84,71
1985-04-07,BOS,114,61,16,NYK,102,24,53,85,69
1985-04-07,LAL,135,57,20,POR,133,39,38,96,58
1985-04-08,IND,107,21,57,CHI,103,38,41,59,98
1985-04-09,NYK,97,24,54,DET,107,43,36,67,90
1985-04-09,WAS,130,38,41,ATL,110,31,47,69,88
1985-04-09,LAL,148,58,20,DEN,119,51,27,109,47
1985-04-09,CLE,114,34,44,NJN,100,39,39,73,83
1985-04-09,POR,116,39,39,PHX,100,34,45,73,84
1985-04-09,HOU,124,45,33,SAN,103,40,39,85,72
1985-04-09,KCK,117,30,48,DAL,105,42,36,72,84
1985-04-09,PHL,113,56,22,BOS,104,62,16,118,38
1985-04-09,UTH,123,38,40,LAC,104,29,49,67,89
1985-04-10,ATL,98,31,48,NYK,94,24,55,55,103
1985-04-10,DET,116,44,36,IND,114,22,57,66,93
1985-04-10,NJN,125,39,40,PHL,100,57,22,96,62
1985-04-10,MIL,106,56,23,WAS,97,39,41,95,64
1985-04-10,LAC,129,29,50,DEN,127,51,28,80,78
1985-04-11,GOS,130,22,57,LAL,137,59,20,81,77
1985-04-11,SEA,80,31,48,DAL,124,42,37,73,85
1985-04-11,KCK,123,31,48,HOU,125,46,33,77,81
1985-04-11,CLE,115,35,44,BOS,121,62,17,97,61
1985-04-11,UTH,145,39,40,POR,107,40,39,79,79
1985-04-12,DET,102,38,29,WAS,96,34,33,72,62
1985-04-12,PHL,111,57,23,IND,105,22,58,79,81
1985-04-12,LAL,145,60,20,SEA,131,31,49,91,69
1985-04-12,POR,131,40,40,DAL,111,43,37,83,77
1985-04-12,BOS,113,63,17,MIL,115,57,23,120,40
1985-04-12,SAN,117,40,40,KCK,112,31,49,71,89
1985-04-12,PHX,96,34,46,UTH,92,40,40,74,86
1985-04-12,NYK,108,24,56,CLE,109,35,45,59,101
1985-04-12,CHI,108,38,42,ATL,119,32,48,70,90
1985-04-12,HOU,110,47,33,LAC,115,30,50,77,83
1985-04-13,GOS,120,22,58,DEN,127,51,29,73,87
1985-04-13,ATL,122,33,48,IND,117,22,59,55,107
1985-04-13,MIL,88,58,23,NYK,84,24,57,82,80
1985-04-13,WAS,118,39,42,PHL,106,58,23,97,65
1985-04-13,NJN,123,40,40,CHI,111,38,43,78,83
1985-04-14,HOU,121,47,34,SEA,98,31,50,78,84
1985-04-14,SAN,102,41,40,UTH,104,40,41,81,81
1985-04-14,CLE,113,36,45,DET,116,45,36,81,81
1985-04-14,BOS,118,63,18,NJN,129,41,40,104,58
1985-04-14,KCK,116,31,50,LAL,122,61,20,92,70
1985-04-14,LAC,92,31,50,DAL,96,43,38,74,88
1985-04-14,POR,117,41,40,DEN,112,52,29,93,69
1985-04-14,PHX,124,35,46,GOS,111,22,59,57,105
1985-10-25,NJN,113,0,0,BOS,109,0,0,0,0
1985-10-25,ATL,91,0,0,WAS,100,0,0,0,0
1985-10-25,SAC,104,0,0,LAC,108,0,0,0,0
1985-10-25,CHI,116,0,0,CLE,115,0,0,0,0
1985-10-25,GOS,105,1,0,DEN,119,0,0,1,0
1985-10-25,POR,128,0,0,PHX,123,1,1,1,1
1985-10-25,DET,118,0,0,MIL,116,1,0,1,0
1985-10-25,UTH,108,0,1,HOU,112,0,0,0,1
1985-10-26,NYK,89,0,0,PHL,99,0,0,0,0
1985-10-26,MIL,117,1,1,ATL,91,0,1,1,2
1985-10-26,CHI,121,1,0,DET,118,1,0,2,0
1985-10-26,LAC,130,1,0,HOU,129,1,0,2,0
1985-10-26,CLE,100,0,1,BOS,105,0,1,0,2
1985-10-26,DAL,101,0,0,SEA,95,0,1,0,1
1985-10-26,DEN,123,1,0,SAC,112,0,1,1,1
1985-10-26,SAN,116,0,0,LAL,121,0,0,0,0
1985-10-26,IND,119,0,0,NJN,92,1,0,1,0
1985-10-27,POR,116,1,0,GOS,99,1,1,2,1
1985-10-29,HOU,111,1,1,SEA,99,0,2,1,3
1985-10-29,GOS,105,1,2,CHI,111,2,0,3,2
1985-10-29,DAL,115,1,0,LAL,133,1,0,2,0
1985-10-29,LAC,119,2,0,POR,113,2,0,4,0
1985-10-29,PHX,127,1,2,DEN,142,2,0,3,2
1985-10-29,SAN,124,0,1,UTH,112,0,2,0,3
1985-10-29,MIL,119,2,1,PHL,117,1,0,3,1
1985-10-29,DET,124,1,1,NJN,107,1,1,2,2
1985-10-29,ATL,102,0,2,NYK,87,0,1,0,3
1985-10-29,CLE,90,6,9,WAS,97,5,10,11,19
1985-10-30,NJN,147,1,2,IND,138,1,0,2,2
1985-10-30,PHL,132,1,1,DET,125,2,1,3,2
1985-10-30,BOS,117,1,1,MIL,106,3,1,4,2
1985-10-30,UTH,102,0,3,SAN,100,1,1,1,4
1985-10-31,DEN,90,3,0,SEA,73,0,3,3,3
1985-10-31,GOS,111,1,3,NYK,104,0,2,1,5
1985-10-31,SAC,122,0,2,HOU,116,2,1,2,3
1985-10-31,WAS,107,1,0,CLE,114,0,2,1,2
1985-10-31,LAC,120,3,0,CHI,112,3,0,6,0
1985-10-31,PHX,107,1,3,LAL,144,2,0,3,3
1985-11-01,UTH,121,1,3,PHX,110,1,4,2,7
1985-11-01,SAN,116,1,2,DAL,107,1,1,2,3
1985-11-01,DET,124,2,2,IND,116,1,1,3,3
1985-11-01,NJN,106,2,2,PHL,102,2,1,4,3
1985-11-01,BOS,109,2,1,ATL,105,1,2,3,3
1985-11-02,GOS,116,2,3,LAL,120,3,0,5,3
1985-11-02,HOU,111,2,2,SAN,98,2,2,4,4
1985-11-02,SEA,118,0,4,CHI,100,3,1,3,5
1985-11-02,MIL,136,3,2,NJN,113,3,2,6,4
1985-11-02,POR,128,2,1,UTH,108,2,3,4,4
1985-11-02,WAS,73,1,1,BOS,88,3,1,4,2
1985-11-02,LAC,103,4,0,NYK,95,0,3,4,3
1985-11-02,IND,117,1,2,DET,128,3,2,4,4
1985-11-02,ATL,114,1,3,PHL,113,2,2,3,5
1985-11-02,DAL,119,1,2,SAC,113,1,2,2,4
1985-11-03,CLE,110,1,2,MIL,120,4,2,5,4
1985-11-03,POR,110,3,1,NYK,96,0,4,3,5
1985-11-05,NJN,112,3,3,WAS,106,1,2,4,5
1985-11-05,HOU,127,3,2,POR,113,4,1,7,3
1985-11-05,DEN,128,4,0,ATL,113,2,3,6,3
1985-11-05,LAL,111,4,0,CLE,129,1,3,5,3
1985-11-05,MIL,126,5,2,SAN,97,2,3,7,5
1985-11-05,SEA,84,1,4,NYK,80,0,5,1,9
1985-11-05,UTH,118,41,40,GOS,99,30,51,71,91
1985-11-06,DET,122,4,2,CHI,105,3,2,7,4
1985-11-06,WAS,80,1,3,SAN,81,2,4,3,7
1985-11-06,DAL,109,2,2,POR,111,4,2,6,4
1985-11-06,GOS,105,2,4,SEA,101,2,4,4,8
1985-11-06,PHL,105,2,3,IND,97,1,3,3,6
1985-11-06,PHX,106,1,5,ATL,114,2,4,3,9
1985-11-07,NYK,88,0,6,MIL,92,6,2,6,8
1985-11-07,DEN,131,5,0,DAL,99,2,3,7,3
1985-11-07,SAC,94,1,3,CLE,95,2,3,3,6
1985-11-07,NJN,106,4,3,CHI,97,3,3,7,6
1985-11-07,UTH,106,2,4,LAL,116,4,1,6,5
1985-11-07,HOU,137,4,2,LAC,115,5,0,9,2
1985-11-08,GOS,130,3,4,ATL,119,3,4,6,8
1985-11-08,LAL,128,5,1,DEN,99,6,0,11,1
1985-11-08,BOS,125,4,1,PHX,101,1,6,5,7
1985-11-08,PHL,95,3,3,SAN,107,3,4,6,7
1985-11-08,WAS,110,1,4,DET,117,5,2,6,6
1985-11-08,POR,92,5,2,SEA,88,2,5,7,7
1985-11-09,IND,127,1,4,PHX,105,1,7,2,11
1985-11-09,NJN,126,5,3,MIL,123,7,2,12,5
1985-11-09,DAL,110,2,4,HOU,115,5,2,7,6
1985-11-09,LAC,94,5,1,ATL,97,3,5,8,6
1985-11-09,SAC,98,1,4,SEA,93,2,6,3,10
1985-11-09,NYK,94,0,7,CHI,97,3,4,3,11
1985-11-09,UTH,121,2,5,CLE,114,3,3,5,8
1985-11-09,DET,105,6,2,BOS,124,5,1,11,3
1985-11-10,POR,110,6,2,CLE,107,3,4,9,6
1985-11-10,GOS,117,4,4,SAC,111,2,4,6,8
1985-11-10,PHL,105,3,4,MIL,97,7,3,10,7
1985-11-11,SAN,111,4,4,NJN,104,6,3,10,7
1985-11-12,CHI,103,4,4,MIL,132,7,4,11,8
1985-11-12,DET,124,6,3,WAS,122,1,5,7,8
1985-11-12,HOU,127,6,2,DEN,119,6,1,12,3
1985-11-12,GOS,127,5,4,LAC,115,5,2,10,6
1985-11-12,NYK,103,0,8,PHX,93,1,8,1,16
1985-11-12,LAL,119,6,1,UTH,110,3,5,9,6
1985-11-12,POR,126,7,2,SAC,115,2,5,9,7
1985-11-12,SEA,109,2,7,DAL,90,2,5,4,12
1985-11-13,LAC,89,5,3,SEA,93,3,7,8,10
1985-11-13,ATL,108,4,5,PHX,101,1,9,5,14
1985-11-13,BOS,118,6,1,IND,114,2,4,8,5
1985-11-13,UTH,100,3,6,DAL,115,2,6,5,12
1985-11-13,MIL,137,8,4,DET,118,7,3,15,7
1985-11-13,PHL,110,4,4,CHI,106,4,5,8,9
1985-11-14,DEN,112,6,2,SAN,109,5,4,11,6
1985-11-14,HOU,112,7,2,NJN,107,6,4,13,6
1985-11-14,SAC,112,2,6,GOS,103,6,4,8,10
1985-11-14,LAL,114,7,1,POR,102,8,2,15,3
1985-11-14,IND,104,2,5,CLE,112,3,5,5,10
1985-11-15,PHX,117,0,0,SEA,99,0,0,0,0
1985-11-15,BOS,118,7,1,WAS,114,1,6,8,7
1985-11-15,MIL,118,9,4,CHI,103,4,6,13,10
1985-11-15,DAL,110,3,6,NJN,98,6,5,9,11
1985-11-15,UTH,133,3,7,POR,118,8,3,11,10
1985-11-15,ATL,122,5,5,DET,118,7,4,12,9
1985-11-15,LAC,96,5,4,LAL,127,8,1,13,5
1985-11-16,NYK,103,1,8,ATL,96,6,5,7,13
1985-11-16,SAC,96,3,6,UTH,100,4,7,7,13
1985-11-16,IND,111,2,6,BOS,109,8,1,10,7
1985-11-16,GOS,118,6,5,PHX,105,1,10,7,15
1985-11-16,HOU,122,8,2,DAL,117,4,6,12,8
1985-11-16,CHI,128,4,7,CLE,132,4,5,8,12
1985-11-16,WAS,118,1,7,PHL,97,5,4,6,11
1985-11-16,SAN,97,5,5,SEA,95,4,7,9,12
1985-11-16,DEN,113,7,2,LAC,109,5,5,12,7
1985-11-17,LAL,138,9,1,NJN,119,6,6,15,7
1985-11-17,POR,104,8,4,MIL,117,10,4,18,8
1985-11-19,POR,102,8,5,NJN,108,6,7,14,12
1985-11-19,CLE,104,5,5,GOS,110,7,5,12,10
1985-11-19,DAL,123,4,7,PHX,119,1,11,5,18
1985-11-19,DEN,127,8,2,HOU,113,9,2,17,4
1985-11-19,SAN,99,6,5,SAC,103,3,7,9,12
1985-11-19,CHI,121,4,8,IND,114,3,6,7,14
1985-11-19,NYK,98,2,8,WAS,94,2,7,4,15
1985-11-20,DET,109,7,5,NYK,98,3,8,10,13
1985-11-20,PHL,117,5,5,GOS,113,8,5,13,10
1985-11-20,BOS,115,8,2,UTH,106,5,7,13,9
1985-11-20,PHX,121,1,12,SAN,100,6,6,7,18
1985-11-20,ATL,116,6,6,CHI,101,5,8,11,14
1985-11-20,SEA,106,4,8,MIL,116,11,4,15,12
1985-11-20,LAL,122,10,1,LAC,107,5,6,15,7
1985-11-20,WAS,101,2,8,CLE,98,5,6,7,14
1985-11-20,HOU,126,9,3,IND,97,3,7,12,10
1985-11-21,SAC,97,4,7,MIL,131,12,4,16,11
1985-11-21,DEN,121,9,2,LAL,120,11,1,20,3
1985-11-21,LAC,108,5,7,POR,112,8,6,13,13
1985-11-22,DET,115,8,5,GOS,96,8,6,16,11
1985-11-22,SAN,108,6,7,IND,96,3,8,9,15
1985-11-22,BOS,110,9,2,PHL,103,6,5,15,7
1985-11-22,SEA,122,4,9,HOU,103,10,3,14,12
1985-11-22,CLE,113,5,7,UTH,121,5,8,10,15
1985-11-22,PHX,96,2,12,NJN,104,7,7,9,19
1985-11-22,WAS,102,3,8,NYK,94,3,9,6,17
1985-11-23,NYK,104,3,10,BOS,113,10,2,13,12
1985-11-23,DAL,117,5,7,IND,104,3,9,8,16
1985-11-23,PHL,114,6,6,DET,119,9,5,15,11
1985-11-23,CHI,135,5,9,GOS,108,8,7,13,16
1985-11-23,LAC,116,5,8,MIL,112,13,4,18,12
1985-11-23,ATL,106,7,6,UTH,116,6,8,13,14
1985-11-23,POR,113,9,6,LAL,130,11,2,20,8
1985-11-23,DEN,122,17,11,SAC,118,9,20,26,31
1985-11-24,PHX,138,1,0,MIL,140,0,0,1,0
1985-11-24,LAL,118,12,2,SAN,102,7,7,19,9
1985-11-24,WAS,115,4,8,CHI,106,6,9,10,17
1985-11-24,SEA,110,5,9,DEN,84,10,2,15,11
1985-11-24,CLE,98,5,8,ATL,90,7,7,12,15
1985-11-24,POR,125,9,7,HOU,118,10,4,19,11
1985-11-24,SAC,103,4,8,NJN,118,8,7,12,15
1985-11-25,IND,101,3,10,UTH,102,7,8,10,18
1985-11-26,SAC,111,4,9,PHX,107,2,13,6,22
1985-11-26,SEA,131,6,9,LAC,99,6,8,12,17
1985-11-26,PHL,91,6,7,BOS,98,11,2,17,9
1985-11-26,HOU,130,10,5,GOS,108,8,8,18,13
1985-11-26,DAL,112,6,7,WAS,99,5,8,11,15
1985-11-26,ATL,104,7,8,NYK,94,3,11,10,19
1985-11-26,DEN,123,10,3,CHI,128,6,10,16,13
1985-11-26,DET,113,10,5,CLE,98,6,8,16,13
1985-11-27,IND,77,3,11,NYK,80,3,12,6,23
1985-11-27,GOS,104,8,9,DEN,102,10,4,18,13
1985-11-27,MIL,114,13,5,ATL,96,8,8,21,13
1985-11-27,LAC,130,6,9,HOU,137,11,5,17,14
1985-11-27,SAN,104,7,8,WAS,97,5,9,12,17
1985-11-27,PHX,93,2,14,POR,110,10,7,12,21
1985-11-27,BOS,132,12,2,DET,124,11,5,23,7
1985-11-27,UTH,114,8,8,CHI,96,7,10,15,18
1985-11-27,NJN,100,9,7,PHL,111,6,8,15,15
1985-11-29,BOS,94,13,2,NYK,88,4,12,17,14
1985-11-29,LAL,108,14,2,SEA,107,7,9,21,11
1985-11-29,DET,111,11,6,MIL,102,14,5,25,11
1985-11-29,UTH,114,9,8,DEN,129,10,5,19,13
1985-11-29,IND,100,3,12,PHL,110,7,8,10,20
1985-11-29,DAL,133,7,7,SAC,111,5,10,12,17
1985-11-29,PHX,126,2,15,HOU,110,12,5,14,20
1985-11-29,NJN,107,9,8,ATL,97,8,9,17,17
1985-11-29,POR,122,11,7,CHI,107,7,11,18,18
1985-11-29,SAN,134,8,8,LAC,106,6,10,14,18
1985-11-30,NYK,95,4,13,PHL,115,8,8,12,21
1985-11-30,ATL,97,8,10,BOS,102,14,2,22,12
1985-11-30,HOU,131,12,6,SAC,114,5,11,17,17
1985-11-30,CLE,119,6,10,NJN,90,10,8,16,18
1985-11-30,GOS,88,9,9,UTH,89,9,9,18,18
1985-11-30,WAS,133,6,10,DET,119,12,6,18,16
1985-11-30,DEN,123,11,5,SEA,131,7,10,18,15
1985-11-30,MIL,111,14,6,IND,94,3,13,17,19
1985-11-30,DAL,124,8,7,LAC,115,6,11,14,18
1985-12-01,POR,106,12,7,SAN,117,9,8,21,15
1985-12-01,LAL,117,15,2,CHI,113,7,12,22,14
1985-12-02,UTH,103,10,9,GOS,100,9,10,19,19
1985-12-03,MIL,109,15,6,BOS,112,15,2,30,8
1985-12-03,SEA,123,8,10,SAN,103,10,8,18,18
1985-12-03,DET,107,12,7,PHL,127,10,8,22,15
1985-12-03,SAC,131,5,13,CHI,118,7,13,12,26
1985-12-03,GOS,100,9,11,DAL,107,9,7,18,18
1985-12-03,CLE,84,7,10,IND,98,3,14,10,24
1985-12-03,NYK,111,4,14,DEN,94,11,6,15,20
1985-12-03,HOU,118,13,6,PHX,112,3,15,16,21
1985-12-03,WAS,118,7,10,POR,115,12,8,19,18
1985-12-04,PHL,115,11,8,WAS,110,8,10,19,18
1985-12-04,PHX,100,3,16,CHI,99,7,14,10,30
1985-12-04,LAC,128,6,12,SAC,103,6,13,12,25
1985-12-04,UTH,127,11,9,LAL,131,16,2,27,11
1985-12-04,IND,105,4,14,DEN,119,11,7,15,21
1985-12-04,NJN,111,10,9,BOS,130,16,2,26,11
1985-12-04,ATL,109,8,11,POR,98,12,9,20,20
1985-12-05,GOS,121,9,12,LAC,104,7,12,16,24
1985-12-05,NYK,95,5,14,MIL,105,15,7,20,21
1985-12-05,DAL,116,10,7,SAN,120,10,9,20,16
1985-12-05,DET,113,12,8,NJN,111,10,10,22,18
1985-12-05,CLE,100,7,11,SEA,97,9,10,16,21
1985-12-06,IND,107,4,15,NYK,83,5,15,9,30
1985-12-06,PHL,121,12,8,DEN,123,12,7,24,15
1985-12-06,PHX,111,4,16,UTH,92,11,10,15,26
1985-12-06,ATL,94,9,11,MIL,93,16,7,25,18
1985-12-06,BOS,103,17,2,POR,121,12,10,29,12
1985-12-06,LAL,120,17,2,HOU,112,14,6,31,8
1985-12-06,SAN,123,11,9,CHI,131,7,15,18,24
1985-12-06,WAS,115,8,11,SEA,109,9,11,17,22
1985-12-07,HOU,116,14,7,CHI,104,8,15,22,22
1985-12-07,CLE,124,8,11,DEN,114,13,7,21,18
1985-12-07,NJN,118,10,11,POR,106,13,10,23,21
1985-12-07,LAC,91,7,13,UTH,131,11,11,18,24
1985-12-07,DET,112,13,8,SAC,122,6,14,19,22
1985-12-07,DAL,120,10,8,GOS,110,10,12,20,20
1985-12-08,SAN,121,11,10,GOS,114,10,13,21,23
1985-12-08,WAS,111,9,11,SAC,89,7,14,16,25
1985-12-08,LAL,125,18,2,DAL,119,11,8,29,10
1985-12-08,PHL,100,12,9,SEA,105,9,12,21,21
1985-12-10,NYK,82,5,16,IND,64,5,15,10,31
1985-12-10,LAC,120,7,14,DAL,118,11,9,18,23
1985-12-10,CHI,107,8,16,SAN,109,12,10,20,26
1985-12-10,MIL,117,16,8,SEA,98,10,12,26,20
1985-12-10,NJN,106,11,11,SAC,100,7,15,18,26
1985-12-10,POR,94,13,11,GOS,92,10,14,23,25
1985-12-10,HOU,134,15,7,UTH,105,12,11,27,18
1985-12-10,BOS,114,17,3,ATL,110,10,11,27,14
1985-12-10,CLE,120,9,11,DET,130,13,9,22,20
1985-12-11,PHL,125,12,10,CLE,110,9,12,21,22
1985-12-11,IND,114,5,16,SAN,101,13,10,18,26
1985-12-11,UTH,119,12,12,POR,111,14,11,26,23
1985-12-11,DEN,134,13,8,LAC,95,8,14,21,22
1985-12-11,ATL,105,10,12,SEA,97,10,13,20,25
1985-12-11,GOS,113,10,15,PHX,123,5,16,15,31
1985-12-11,BOS,118,18,3,SAC,101,7,16,25,19
1985-12-11,DET,100,46,35,WAS,108,38,43,84,78
1985-12-12,HOU,123,16,7,DAL,120,11,10,27,17
1985-12-12,NYK,85,6,16,NJN,108,12,11,18,27
1985-12-12,LAL,127,19,2,PHX,102,6,16,25,18
1985-12-12,WAS,110,10,11,MIL,108,17,8,27,19
1985-12-12,CHI,106,29,52,PHL,102,53,27,82,79
1985-12-13,MIL,124,17,9,CLE,128,9,13,26,22
1985-12-13,SEA,114,10,14,LAC,95,8,15,18,29
1985-12-13,DET,113,14,9,SAN,119,13,11,27,20
1985-12-13,IND,109,6,16,ATL,89,11,12,17,28
1985-12-13,DEN,124,14,8,LAL,120,20,2,34,10
1985-12-13,GOS,124,10,16,POR,127,14,12,24,28
1985-12-14,ATL,107,11,13,PHL,103,13,10,24,23
1985-12-14,CHI,103,8,17,SAC,108,7,17,15,34
1985-12-14,NYK,108,6,17,SAN,98,14,11,20,28
1985-12-14,UTH,114,13,12,HOU,100,17,7,30,19
1985-12-14,LAC,92,8,16,PHX,114,6,17,14,33
1985-12-14,CLE,109,10,13,BOS,99,19,3,29,16
1985-12-14,NJN,105,13,11,IND,99,7,16,20,27
1985-12-14,DAL,127,11,11,DEN,100,15,8,26,19
1985-12-15,GOS,112,10,17,SEA,105,11,14,21,31
1985-12-15,MIL,140,17,10,SAC,82,8,17,25,27
1985-12-15,LAL,132,20,3,DET,119,14,10,34,13
1985-12-15,BOS,109,19,4,CHI,104,8,18,27,22
1985-12-17,CHI,116,8,19,BOS,108,20,4,28,23
1985-12-17,SEA,99,11,15,PHX,104,7,17,18,32
1985-12-17,CLE,94,11,13,HOU,98,17,8,28,21
1985-12-17,IND,96,7,17,PHL,102,13,11,20,28
1985-12-17,DEN,122,15,9,GOS,114,11,17,26,26
1985-12-17,WAS,98,11,11,UTH,106,14,12,25,23
1985-12-17,SAC,132,8,18,DET,121,14,11,22,29
1985-12-17,SAN,126,14,12,POR,118,15,12,29,24
1985-12-17,NYK,99,7,17,LAL,105,21,3,28,20
1985-12-17,ATL,104,12,13,NJN,103,14,11,26,24
1985-12-18,LAC,103,8,17,GOS,99,11,18,19,35
1985-12-18,BOS,137,20,5,DAL,117,12,11,32,16
1985-12-18,NJN,113,14,12,UTH,98,15,12,29,24
1985-12-18,MIL,105,18,10,LAL,107,22,3,40,13
1985-12-18,PHL,126,53,28,HOU,108,51,30,104,58
1985-12-19,CHI,92,9,19,WAS,98,11,12,20,31
1985-12-19,SEA,97,11,16,DET,99,14,12,25,28
1985-12-19,NYK,105,7,18,CLE,109,11,14,18,32
1985-12-19,DEN,123,16,9,POR,118,15,13,31,22
1985-12-19,ATL,108,13,13,DAL,120,12,12,25,25
1985-12-19,PHX,107,8,17,SAC,106,9,18,17,35
1985-12-20,IND,114,7,18,MIL,102,18,11,25,29
1985-12-20,PHL,112,14,11,UTH,105,15,13,29,24
1985-12-20,NJN,122,15,12,HOU,112,18,8,33,20
1985-12-20,CLE,116,12,14,LAL,128,23,3,35,17
1985-12-20,LAC,104,9,17,SAN,119,15,12,24,29
1985-12-21,SAC,116,9,19,LAC,117,9,18,18,37
1985-12-21,MIL,132,18,12,DAL,107,13,12,31,24
1985-12-21,PHX,115,9,17,GOS,98,11,19,20,36
1985-12-21,SEA,97,11,17,POR,114,15,14,26,31
1985-12-21,IND,98,8,18,NJN,102,16,12,24,30
1985-12-21,CHI,117,9,20,UTH,104,15,14,24,34
1985-12-21,PHL,108,15,11,BOS,102,21,5,36,16
1985-12-21,DEN,118,17,9,SAN,128,16,12,33,21
1985-12-21,ATL,123,13,14,HOU,122,18,9,31,23
1985-12-21,NYK,112,7,19,DET,110,15,12,22,31
1985-12-21,WAS,84,12,12,LAL,96,24,3,36,15
1985-12-22,WAS,93,12,13,NYK,100,8,19,20,32
1985-12-22,CLE,119,12,15,DAL,105,13,13,25,28
1985-12-22,POR,121,16,14,DEN,114,17,10,33,24
1985-12-23,NJN,108,17,12,CLE,101,13,15,30,27
1985-12-25,POR,121,17,14,LAC,107,10,18,27,32
1985-12-25,NYK,113,9,19,BOS,104,21,6,30,25
1985-12-26,SAN,109,17,12,LAL,91,25,3,42,15
1985-12-26,GOS,131,11,20,SAC,121,9,21,20,41
1985-12-26,PHX,98,10,17,DAL,105,13,14,23,31
1985-12-26,MIL,105,19,12,IND,87,8,19,27,31
1985-12-26,NJN,124,18,12,DET,116,15,13,33,25
1985-12-26,CHI,96,10,20,NYK,113,10,19,20,39
1985-12-26,HOU,106,18,10,UTH,99,15,15,33,25
1985-12-26,LAC,108,10,19,PHL,117,16,11,26,30
1985-12-27,DAL,133,14,14,POR,142,18,14,32,28
1985-12-27,DET,105,15,14,CLE,119,13,16,28,30
1985-12-27,WAS,111,12,14,ATL,109,14,14,26,28
1985-12-27,SEA,114,11,18,GOS,102,12,20,23,38
1985-12-28,SAC,111,5,9,LAL,133,13,2,18,11
1985-12-28,PHX,98,10,18,PHL,100,17,11,27,29
1985-12-28,SAN,116,18,12,DEN,112,18,11,36,23
1985-12-28,CLE,112,14,16,MIL,114,20,12,34,28
1985-12-28,SEA,106,12,18,LAC,111,10,20,22,38
1985-12-28,NJN,93,19,12,WAS,98,13,14,32,26
1985-12-28,HOU,118,19,10,POR,108,19,14,38,24
1985-12-28,CHI,108,10,21,IND,104,8,20,18,41
1985-12-28,UTH,108,15,16,BOS,110,21,7,36,23
1985-12-28,NYK,80,11,19,ATL,100,14,15,25,34
1985-12-29,LAL,122,25,4,GOS,130,12,21,37,25
1985-12-30,SAC,84,5,12,PHL,87,9,8,14,20
1985-12-30,DEN,125,18,12,HOU,122,20,10,38,22
1985-12-30,POR,125,19,15,SAN,110,19,12,38,27
1985-12-30,WAS,80,14,14,IND,97,8,21,22,35
1985-12-30,LAC,103,11,20,BOS,125,22,7,33,27
1985-12-30,MIL,121,21,12,DET,110,15,15,36,27
1985-12-30,CLE,117,14,17,CHI,121,11,21,25,38
1985-12-30,NJN,123,19,13,NYK,111,11,20,30,33
1985-12-30,UTH,107,15,17,SEA,105,12,19,27,36
1986-01-01,POR,119,20,15,PHL,121,18,11,38,26
1986-01-02,SAC,114,9,22,SAN,106,19,13,28,35
1986-01-02,CHI,131,12,21,DET,122,15,16,27,37
1986-01-02,NYK,109,11,21,WAS,115,14,15,25,36
1986-01-02,GOS,115,13,21,HOU,120,20,11,33,32
1986-01-02,IND,104,9,21,BOS,122,23,7,32,28
1986-01-03,CLE,130,14,18,LAC,111,11,21,25,39
1986-01-03,SEA,117,12,20,DEN,107,19,12,31,32
1986-01-03,POR,133,20,16,PHX,104,10,19,30,35
1986-01-03,ATL,111,15,15,DET,101,15,17,30,32
1986-01-03,BOS,129,24,7,NJN,117,20,13,44,20
1986-01-03,LAL,110,25,5,UTH,101,16,17,41,22
1986-01-03,WAS,100,15,15,MIL,107,22,12,37,27
1986-01-04,IND,106,9,22,LAC,77,11,22,20,44
1986-01-04,GOS,116,13,22,SAN,122,19,14,32,36
1986-01-04,DAL,119,14,15,UTH,106,16,18,30,33
1986-01-04,NJN,125,20,14,CLE,106,15,18,35,32
1986-01-04,MIL,119,23,12,NYK,86,11,22,34,34
1986-01-04,SAC,112,10,22,DEN,107,19,13,29,35
1986-01-04,HOU,115,21,11,PHL,100,19,11,40,22
1986-01-04,CHI,100,13,21,ATL,111,16,15,29,36
1986-01-05,POR,136,21,16,GOS,120,13,23,34,39
1986-01-05,LAL,118,26,5,WAS,88,15,16,41,21
1986-01-06,SEA,97,13,20,PHX,114,10,20,23,40
1986-01-06,SAN,102,20,14,PHL,108,19,12,39,26
1986-01-06,SAC,106,11,22,WAS,87,15,17,26,39
1986-01-07,MIL,110,24,12,CLE,101,15,19,39,31
1986-01-07,CHI,105,13,22,NJN,110,21,14,34,36
1986-01-07,NYK,93,11,23,IND,85,10,22,21,45
1986-01-07,DEN,132,19,14,DAL,110,15,15,34,29
1986-01-07,SEA,91,13,21,UTH,84,16,19,29,40
1986-01-07,ATL,117,17,15,LAC,103,11,23,28,38
1986-01-07,DET,113,15,18,BOS,109,25,7,40,25
1986-01-07,HOU,124,22,11,GOS,115,13,24,35,35
1986-01-08,LAL,125,27,5,POR,121,22,16,49,21
1986-01-08,NJN,106,22,14,MIL,99,25,12,47,26
1986-01-08,IND,87,10,23,SAC,88,12,22,22,45
1986-01-08,PHL,116,20,12,LAC,114,11,24,31,36
1986-01-08,BOS,126,25,8,CLE,95,15,20,40,28
1986-01-08,PHX,109,11,20,WAS,97,15,18,26,38
1986-01-09,UTH,89,16,20,WAS,95,15,19,31,39
1986-01-09,DET,99,16,18,ATL,110,18,15,34,33
1986-01-09,HOU,120,23,11,SAN,110,20,15,43,26
1986-01-09,DEN,94,20,14,SEA,90,14,21,34,35
1986-01-10,DAL,117,15,16,PHX,104,12,20,27,36
1986-01-10,BOS,115,26,8,ATL,108,19,15,45,23
1986-01-10,SAN,124,20,16,GOS,97,13,25,33,41
1986-01-10,MIL,95,25,13,POR,89,22,17,47,30
1986-01-10,LAL,124,28,5,IND,102,10,24,38,29
1986-01-10,NJN,120,23,14,LAC,125,11,25,34,39
1986-01-10,PHL,113,21,12,SAC,102,13,22,34,34
1986-01-11,HOU,87,24,11,WAS,86,16,19,40,30
1986-01-11,SEA,105,14,22,LAL,99,29,5,43,27
1986-01-11,DEN,114,21,14,UTH,106,16,21,37,35
1986-01-11,CHI,132,13,23,LAC,123,12,25,25,48
1986-01-11,NYK,106,12,23,POR,109,22,18,34,41
1986-01-11,DAL,127,16,16,GOS,123,13,26,29,42
1986-01-11,PHX,128,12,21,IND,99,10,25,22,46
1986-01-11,DET,101,16,19,PHL,102,22,12,38,31
1986-01-12,SAN,102,21,16,UTH,106,16,22,37,38
1986-01-13,PHX,121,13,21,SAN,98,21,17,34,38
1986-01-13,SEA,89,15,22,DAL,90,17,16,32,38
1986-01-13,GOS,119,13,27,IND,108,10,26,23,53
1986-01-13,WAS,90,16,20,LAC,77,12,26,28,46
1986-01-13,NYK,115,12,24,SAC,97,13,23,25,47
1986-01-13,MIL,115,26,13,DEN,119,22,14,48,27
1986-01-14,CHI,113,14,23,WAS,117,17,20,31,43
1986-01-14,CLE,108,15,21,POR,120,23,18,38,39
1986-01-14,LAL,143,29,6,PHX,122,14,21,43,27
1986-01-14,ATL,115,19,16,SAC,104,13,24,32,40
1986-01-14,HOU,102,25,11,UTH,105,17,22,42,33
1986-01-14,NJN,105,23,15,PHL,123,23,12,46,27
1986-01-15,GOS,150,0,0,UTH,104,0,0,0,0
1986-01-15,BOS,123,27,8,DEN,100,23,14,50,22
1986-01-15,LAC,110,12,27,SEA,103,15,23,27,50
1986-01-15,SAN,113,21,18,HOU,119,25,12,46,30
1986-01-15,DET,123,16,20,CHI,115,14,24,30,44
1986-01-15,PHL,89,24,12,NJN,123,23,16,47,28
1986-01-15,IND,104,10,27,POR,109,24,18,34,45
1986-01-15,DAL,112,18,16,NYK,116,13,24,31,40
1986-01-16,LAL,112,30,6,LAC,96,13,27,43,33
1986-01-16,ATL,116,20,16,CLE,99,15,22,35,38
1986-01-16,MIL,114,26,14,WAS,98,18,20,44,34
1986-01-17,GOS,111,14,27,SAC,125,13,25,27,52
1986-01-17,SAN,113,21,19,NYK,100,14,24,35,43
1986-01-17,PHX,103,14,22,SEA,100,15,24,29,46
1986-01-17,CHI,118,14,25,PHL,120,24,13,38,38
1986-01-17,WAS,116,18,21,NJN,96,24,16,42,37
1986-01-17,DET,129,17,20,DEN,113,23,15,40,35
1986-01-17,IND,105,10,28,BOS,123,28,8,38,36
1986-01-17,UTH,139,18,22,DAL,112,18,17,36,39
1986-01-18,ATL,122,21,16,BOS,125,29,8,50,24
1986-01-18,HOU,104,26,12,NYK,95,14,25,40,37
1986-01-18,SAC,98,14,25,SEA,96,15,25,29,50
1986-01-18,POR,112,25,18,PHX,87,15,22,40,40
1986-01-18,NJN,124,24,17,DEN,113,23,16,47,33
1986-01-18,LAC,131,13,28,UTH,97,19,22,32,50
1986-01-18,CLE,108,15,23,IND,95,10,29,25,52
1986-01-19,POR,105,26,18,SAN,116,22,19,48,37
1986-01-19,DAL,131,18,18,HOU,96,27,12,45,30
1986-01-19,WAS,112,19,21,CHI,98,14,26,33,47
1986-01-19,DET,118,18,20,LAL,115,31,6,49,26
1986-01-19,MIL,122,27,14,GOS,109,14,28,41,42
1986-01-20,PHL,103,25,13,NYK,93,14,26,39,39
1986-01-20,CLE,108,16,23,PHX,93,15,23,31,46
1986-01-20,CHI,118,14,27,LAL,133,31,7,45,34
1986-01-20,ATL,101,21,17,MIL,98,28,14,49,31
1986-01-20,IND,105,10,30,DET,99,19,20,29,50
1986-01-21,SAN,96,23,19,LAC,97,14,28,37,47
1986-01-21,SEA,96,15,26,HOU,100,27,13,42,39
1986-01-21,UTH,117,19,23,DEN,114,23,17,42,40
1986-01-21,SAC,119,15,25,DAL,110,19,18,34,43
1986-01-21,NYK,121,14,27,GOS,114,14,29,28,56
1986-01-22,DAL,118,19,19,LAC,131,15,28,34,47
1986-01-22,ATL,131,22,17,GOS,100,14,30,36,47
1986-01-22,PHL,118,26,13,PHX,111,15,24,41,37
1986-01-22,CLE,104,17,23,DET,107,19,21,36,44
1986-01-22,DEN,137,23,18,NJN,124,25,17,48,35
1986-01-22,BOS,110,30,8,LAL,95,32,7,62,15
1986-01-23,HOU,124,28,13,SAC,107,16,25,44,38
1986-01-23,UTH,105,20,23,NJN,106,25,18,45,41
1986-01-23,POR,117,26,19,SEA,107,15,27,41,46
1986-01-23,WAS,114,20,21,PHX,112,15,25,35,46
1986-01-24,ATL,117,23,17,NYK,100,15,27,38,44
1986-01-24,BOS,135,31,8,GOS,114,14,31,45,39
1986-01-24,DAL,120,19,20,DET,129,20,21,39,41
1986-01-24,IND,92,11,30,MIL,117,28,15,39,45
1986-01-24,LAC,120,16,28,LAL,109,32,8,48,36
1986-01-24,DEN,98,24,18,SAN,113,23,20,47,38
1986-01-24,CLE,114,17,24,PHL,121,27,13,44,37
1986-01-25,NYK,88,15,28,MIL,104,29,15,44,43
1986-01-25,UTH,130,20,24,LAC,90,17,28,37,52
1986-01-25,CHI,133,14,28,PHX,114,15,26,29,54
1986-01-25,SEA,106,15,28,NJN,99,26,18,41,46
1986-01-25,HOU,117,29,13,DET,112,21,21,50,34
1986-01-25,LAL,115,32,9,DEN,127,24,19,56,28
1986-01-25,SAC,125,16,26,POR,129,27,19,43,45
1986-01-25,IND,124,11,31,GOS,101,14,32,25,63
1986-01-25,SAN,107,24,20,DAL,123,19,21,43,41
1986-01-25,WAS,111,21,21,ATL,103,24,17,45,38
1986-01-26,BOS,105,32,8,PHL,103,28,13,60,21
1986-01-26,POR,116,28,19,SAC,121,16,27,44,46
1986-01-27,SAN,117,24,21,DET,118,21,22,45,43
1986-01-27,DEN,124,25,19,CLE,103,17,25,42,44
1986-01-27,LAC,103,17,29,NJN,98,26,19,43,48
1986-01-27,DAL,124,20,21,CHI,116,15,28,35,49
1986-01-27,UTH,103,21,24,MIL,127,30,15,51,39
1986-01-28,PHX,136,15,27,POR,130,28,20,43,47
1986-01-28,NYK,118,15,29,CHI,111,15,29,30,58
1986-01-28,ATL,123,24,18,IND,92,12,31,36,49
1986-01-28,SAC,125,17,27,DEN,120,26,19,43,46
1986-01-28,LAL,125,32,10,MIL,115,31,15,63,25
1986-01-28,HOU,116,30,13,CLE,109,17,26,47,39
1986-01-28,GOS,113,14,33,NJN,117,26,20,40,53
1986-01-28,SEA,99,16,28,PHL,106,28,14,44,42
1986-01-29,DET,107,22,22,ATL,94,25,18,47,40
1986-01-29,UTH,107,21,25,PHL,86,29,14,50,39
1986-01-29,LAC,108,18,29,PHX,118,16,27,34,56
1986-01-29,DAL,126,21,21,SAN,114,24,22,45,43
1986-01-29,IND,92,12,32,WAS,88,22,21,34,53
1986-01-30,GOS,108,14,34,MIL,120,31,16,45,50
1986-01-30,SAC,109,18,27,HOU,111,31,13,49,40
1986-01-30,NJN,82,27,20,SEA,89,16,29,43,49
1986-01-30,CHI,91,15,30,BOS,101,33,8,48,38
1986-01-30,SAN,112,24,23,CLE,99,17,27,41,50
1986-01-30,POR,94,28,21,LAL,118,33,10,61,31
1986-01-30,DEN,102,26,20,NYK,97,16,29,42,49
1986-01-31,WAS,88,22,22,BOS,97,34,8,56,30
1986-01-31,IND,101,13,32,SEA,94,17,29,30,61
1986-01-31,LAL,134,34,10,PHL,100,29,15,63,25
1986-01-31,UTH,113,22,25,SAC,101,18,28,40,53
1986-01-31,PHX,112,17,27,NYK,117,16,30,33,57
1986-01-31,DAL,107,22,21,CLE,91,17,28,39,49
1986-01-31,ATL,116,25,19,DET,103,23,22,48,41
1986-02-01,DEN,116,27,20,MIL,113,32,16,59,36
1986-02-01,CHI,132,15,31,HOU,122,32,13,47,44
1986-02-01,NJN,108,27,21,ATL,100,26,19,53,40
1986-02-01,SAN,111,25,23,PHX,112,17,28,42,51
1986-02-01,DET,116,23,23,WAS,101,22,23,45,46
1986-02-01,POR,156,28,22,LAC,121,18,30,46,52
1986-02-01,GOS,125,14,35,PHL,121,29,16,43,51
1986-02-02,IND,131,14,32,CHI,106,16,31,30,63
1986-02-02,LAL,96,35,10,NYK,103,17,30,52,40
1986-02-02,BOS,114,35,8,SEA,101,17,30,52,38
1986-02-02,DAL,100,23,21,UTH,97,23,25,46,46
1986-02-03,UTH,104,23,26,SAN,112,25,24,48,50
1986-02-03,SAC,94,18,29,NYK,90,18,30,36,59
1986-02-03,HOU,104,32,14,DEN,102,28,20,60,34
1986-02-04,PHX,127,18,28,GOS,118,15,35,33,63
1986-02-04,LAL,110,35,11,DAL,102,24,21,59,32
1986-02-04,DEN,119,28,21,POR,118,29,22,57,43
1986-02-04,SAN,124,26,24,SEA,119,17,31,43,55
1986-02-04,CLE,104,17,29,ATL,105,26,20,43,49
1986-02-04,CHI,115,16,32,DET,117,24,23,40,55
1986-02-04,MIL,93,32,17,BOS,112,36,8,68,25
1986-02-04,IND,117,15,32,NJN,101,28,21,43,53
1986-02-05,PHL,142,29,17,NJN,107,28,22,57,39
1986-02-05,BOS,103,37,8,WAS,88,22,24,59,32
1986-02-06,HOU,95,33,14,LAL,117,36,11,69,25
1986-02-06,UTH,119,23,27,NYK,101,18,31,41,58
1986-02-06,MIL,117,32,18,CHI,97,16,33,48,51
1986-02-06,CLE,103,17,30,PHL,111,30,17,47,47
1986-02-06,WAS,109,22,25,DET,111,25,23,47,48
1986-02-06,SAC,115,19,29,SEA,106,17,32,36,61
1986-02-06,PHX,116,19,28,LAC,104,18,31,37,59
1986-02-06,POR,111,29,23,DAL,115,24,22,53,45
1986-02-06,IND,85,16,32,ATL,100,27,20,43,52
1986-02-06,SAN,95,27,24,DEN,100,29,21,56,45
1986-02-11,NJN,130,28,23,DET,122,26,23,54,46
1986-02-11,SEA,105,17,33,UTH,92,24,27,41,60
1986-02-11,POR,116,29,24,WAS,124,22,26,51,50
1986-02-11,LAC,120,18,32,PHX,112,20,28,38,60
1986-02-11,CLE,119,17,31,IND,97,16,33,33,64
1986-02-11,HOU,113,33,15,ATL,100,28,20,61,35
1986-02-11,SAN,107,27,25,DAL,121,25,22,52,47
1986-02-11,GOS,137,15,36,LAL,113,37,11,52,47
1986-02-11,SAC,105,20,29,BOS,100,38,8,58,37
1986-02-12,PHX,100,20,29,LAL,126,37,12,57,41
1986-02-12,DET,113,26,24,NYK,99,18,32,44,56
1986-02-12,DAL,117,26,22,DEN,110,30,21,56,43
1986-02-12,PHL,106,31,17,CHI,98,16,34,47,51
1986-02-12,IND,97,16,34,MIL,103,33,18,49,52
1986-02-13,SAC,114,21,29,ATL,123,28,21,49,50
1986-02-13,GOS,109,16,36,WAS,105,23,26,39,62
1986-02-13,CLE,135,18,31,NJN,117,29,23,47,54
1986-02-13,MIL,113,34,18,UTH,106,24,28,58,46
1986-02-13,LAC,118,19,32,POR,113,29,25,48,57
1986-02-13,SAN,119,27,26,HOU,115,34,15,61,41
1986-02-13,SEA,98,18,33,BOS,107,38,9,56,42
1986-02-13,NYK,92,18,33,PHL,95,32,17,50,50
1986-02-14,LAL,141,38,12,ATL,117,29,21,67,33
1986-02-14,PHX,112,20,30,DEN,95,30,22,50,52
1986-02-14,CHI,88,16,35,IND,104,16,35,32,70
1986-02-14,DET,119,27,24,DAL,110,27,22,54,46
1986-02-14,POR,119,29,26,BOS,120,39,9,68,35
1986-02-15,NYK,97,18,34,UTH,104,24,29,42,63
1986-02-15,LAC,108,20,32,HOU,101,34,16,54,48
1986-02-15,IND,105,17,35,CLE,99,19,31,36,66
1986-02-15,DEN,113,30,23,GOS,100,17,36,47,59
1986-02-15,DET,134,28,24,PHL,133,33,17,61,41
1986-02-15,MIL,112,35,18,NJN,94,29,24,64,42
1986-02-15,SEA,112,18,34,WAS,106,23,27,41,61
1986-02-16,CHI,114,16,36,DAL,120,27,23,43,59
1986-02-16,POR,101,29,27,ATL,110,29,22,58,49
1986-02-16,LAL,99,39,12,BOS,105,40,9,79,21
1986-02-16,SAN,113,28,26,SAC,94,21,30,49,56
1986-02-17,PHX,108,21,30,BOS,101,41,9,62,39
1986-02-17,GOS,110,17,37,HOU,116,34,17,51,54
1986-02-17,DET,117,29,24,UTH,96,25,29,54,53
1986-02-17,IND,124,18,35,CHI,110,16,37,34,72
1986-02-17,SEA,100,19,34,ATL,87,30,22,49,56
1986-02-17,PHL,106,33,18,MIL,111,36,18,69,36
1986-02-17,NJN,124,29,25,DAL,126,28,23,57,48
1986-02-17,CLE,111,19,32,NYK,97,18,35,37,67
1986-02-17,LAC,94,21,32,WAS,96,23,28,44,60
1986-02-18,DEN,101,31,23,WAS,90,24,28,55,51
1986-02-18,SAC,115,21,31,HOU,105,35,17,56,48
1986-02-18,SAN,120,29,26,PHX,114,22,30,51,56
1986-02-18,NYK,105,18,36,CLE,111,20,32,38,68
1986-02-19,UTH,109,25,30,ATL,105,30,23,55,53
1986-02-19,DET,118,30,24,SEA,113,20,34,50,58
1986-02-19,PHL,153,33,19,POR,133,29,28,62,47
1986-02-19,NJN,96,29,26,CHI,99,16,38,45,64
1986-02-19,GOS,100,17,38,BOS,115,41,10,58,48
1986-02-19,IND,81,19,35,LAL,90,39,13,58,48
1986-02-19,DAL,107,29,23,MIL,124,37,18,66,41
1986-02-20,CLE,107,21,32,DET,109,31,24,52,56
1986-02-20,HOU,113,35,18,MIL,120,38,18,73,36
1986-02-20,SAC,107,22,31,SAN,105,30,26,52,57
1986-02-20,DEN,102,32,23,BOS,100,42,10,74,33
1986-02-21,CHI,108,17,38,POR,96,29,29,46,67
1986-02-21,LAC,123,21,33,GOS,125,17,39,38,72
1986-02-21,PHX,110,22,31,SAC,118,23,31,45,62
1986-02-21,NYK,117,18,37,SEA,104,20,35,38,72
1986-02-21,NJN,121,29,27,LAL,106,40,13,69,40
1986-02-21,DAL,104,29,24,HOU,111,35,19,64,43
1986-02-21,ATL,106,30,24,IND,98,19,36,49,60
1986-02-21,PHL,97,34,19,WAS,87,24,29,58,48
1986-02-22,CHI,129,18,38,SEA,125,20,36,38,74
1986-02-22,CLE,102,21,33,WAS,110,24,30,45,63
1986-02-22,DEN,113,33,23,DAL,106,29,25,62,48
1986-02-22,SAN,115,30,27,MIL,120,39,18,69,45
1986-02-22,ATL,112,31,24,NJN,83,30,27,61,51
1986-02-22,DET,113,32,24,POR,106,29,30,61,54
1986-02-22,UTH,105,26,30,PHX,97,22,32,48,62
1986-02-23,BOS,113,42,11,IND,98,19,37,61,48
1986-02-23,PHL,111,35,19,LAL,117,40,14,75,33
1986-02-23,NYK,99,19,37,LAC,110,21,34,40,71
1986-02-23,SAC,127,24,31,GOS,124,18,39,42,70
1986-02-24,DET,110,33,24,CHI,100,19,38,52,62
1986-02-24,POR,113,29,31,DEN,119,34,23,63,54
1986-02-24,WAS,99,25,30,NJN,89,30,28,55,58
1986-02-24,ATL,102,32,24,LAL,93,41,14,73,38
1986-02-24,HOU,110,36,19,DAL,105,29,26,65,45
1986-02-24,CLE,124,21,34,SAN,114,30,28,51,62
1986-02-25,CHI,108,19,39,PHL,122,35,20,54,59
1986-02-25,MIL,114,40,18,LAC,99,22,34,62,52
1986-02-25,NJN,109,30,29,GOS,116,18,40,48,69
1986-02-25,NYK,74,19,38,BOS,91,43,11,62,49
1986-02-25,DEN,112,35,23,PHX,99,22,33,57,56
1986-02-25,IND,100,19,38,WAS,87,26,30,45,68
1986-02-25,UTH,100,27,30,HOU,97,37,19,64,49
1986-02-25,SEA,100,20,37,SAC,102,25,31,45,68
1986-02-26,PHX,113,22,34,POR,112,29,32,51,66
1986-02-26,DET,111,34,24,LAC,104,22,35,56,59
1986-02-26,BOS,120,44,11,SAN,100,30,29,74,40
1986-02-26,DAL,116,29,27,LAL,119,41,15,70,42
1986-02-26,ATL,129,33,24,CLE,109,22,34,55,58
1986-02-27,SEA,107,20,38,POR,94,29,33,49,71
1986-02-27,WAS,114,26,31,GOS,102,19,40,45,71
1986-02-27,UTH,109,28,30,IND,92,20,38,48,68
1986-02-27,HOU,117,37,20,DEN,111,36,23,73,43
1986-02-28,DET,115,35,24,ATL,103,34,24,69,48
1986-02-28,BOS,124,45,11,LAC,108,22,36,67,47
1986-02-28,DAL,120,29,28,PHL,123,36,20,65,48
1986-02-28,NJN,113,30,30,SAN,110,30,30,60,60
1986-02-28,SAC,121,26,31,IND,100,20,40,46,71
1986-02-28,LAL,115,42,15,PHX,103,23,34,65,49
1986-02-28,CHI,116,19,40,CLE,96,22,35,41,75
1986-02-28,MIL,102,41,18,WAS,84,27,31,68,49
1986-03-01,ATL,116,35,25,SAN,108,30,31,65,56
1986-03-01,DEN,107,36,24,PHL,118,37,20,73,44
1986-03-01,UTH,110,29,30,SAC,94,27,31,56,61
1986-03-01,POR,117,29,34,HOU,112,38,20,67,54
1986-03-01,NYK,100,19,39,NJN,102,31,30,50,69
1986-03-01,PHX,123,23,35,LAL,106,43,15,66,50
1986-03-01,DAL,119,29,29,GOS,110,19,41,48,70
1986-03-02,WAS,125,27,32,MIL,104,42,18,69,50
1986-03-02,BOS,129,46,11,DET,109,37,24,83,35
1986-03-02,LAC,112,22,37,IND,129,20,41,42,78
1986-03-03,LAL,127,43,16,GOS,117,19,42,62,58
1986-03-03,SEA,118,21,38,HOU,105,38,21,59,59
1986-03-03,MIL,115,42,19,NYK,108,19,40,61,59
1986-03-03,PHX,138,24,35,DAL,139,30,29,54,64
1986-03-04,DET,120,36,24,NJN,103,32,30,68,54
1986-03-04,CHI,94,20,40,BOS,106,47,11,67,51
1986-03-04,SAC,94,27,32,UTH,92,30,30,57,62
1986-03-04,NYK,119,19,41,WAS,83,28,32,47,73
1986-03-04,DEN,128,36,25,HOU,115,38,22,74,47
1986-03-04,GOS,129,19,43,SAN,126,30,32,49,75
1986-03-04,LAC,106,22,38,CLE,101,22,36,44,74
1986-03-04,POR,102,30,34,IND,99,21,41,51,75
1986-03-04,ATL,128,36,25,PHL,121,38,20,74,45
1986-03-05,BOS,108,48,11,CHI,97,20,41,68,52
1986-03-05,SEA,112,22,38,IND,120,21,42,43,80
1986-03-05,NJN,106,32,31,MIL,119,43,19,75,50
1986-03-05,PHX,100,24,36,CLE,115,22,37,46,73
1986-03-05,PHL,114,38,21,ATL,122,37,25,75,46
1986-03-05,LAL,130,44,16,UTH,84,30,31,74,47
1986-03-06,LAC,113,23,38,DAL,131,31,29,54,67
1986-03-06,GOS,111,20,43,LAL,112,45,16,65,59
1986-03-06,HOU,116,38,23,SAC,105,28,32,66,55
1986-03-06,WAS,113,28,33,NYK,111,20,41,48,74
1986-03-07,SAN,142,30,33,LAC,126,23,39,53,72
1986-03-07,CHI,108,20,42,ATL,112,38,25,58,67
1986-03-07,NJN,102,32,32,DET,104,37,25,69,57
1986-03-07,PHX,103,24,37,UTH,105,30,32,54,69
1986-03-07,MIL,125,44,19,PHL,95,38,22,82,41
1986-03-07,BOS,115,49,11,NYK,108,20,42,69,53
1986-03-07,SEA,120,22,39,CLE,106,23,37,45,76
1986-03-07,DEN,134,37,25,IND,117,22,42,59,67
1986-03-07,POR,125,31,34,DAL,114,32,29,63,63
1986-03-08,POR,104,32,34,UTH,90,31,32,63,66
1986-03-08,HOU,126,39,23,SAN,117,31,33,70,56
1986-03-08,ATL,111,39,25,MIL,109,45,19,84,44
1986-03-08,WAS,110,29,33,BOS,108,50,11,79,44
1986-03-08,GOS,138,20,44,CLE,128,23,38,43,82
1986-03-08,LAL,122,46,16,SAC,121,28,33,74,49
1986-03-09,SAC,102,28,34,DAL,117,32,30,60,64
1986-03-09,PHL,120,38,23,IND,102,22,43,60,66
1986-03-09,SEA,106,23,39,LAL,108,47,16,70,55
1986-03-09,LAC,121,23,40,DEN,123,38,25,61,65
1986-03-09,NJN,115,32,33,PHX,111,24,38,56,71
1986-03-09,CHI,114,20,43,NYK,101,20,43,40,86
1986-03-10,GOS,108,21,44,SEA,111,23,40,44,84
1986-03-10,DAL,116,33,30,BOS,115,50,12,83,42
1986-03-10,DET,109,38,25,PHX,120,24,39,62,64
1986-03-11,NYK,107,20,44,CLE,112,23,39,43,83
1986-03-11,IND,91,22,44,PHL,101,39,23,61,67
1986-03-11,LAL,129,48,16,LAC,108,24,41,72,57
1986-03-11,ATL,128,40,25,DEN,116,39,26,79,51
1986-03-11,HOU,104,40,23,BOS,116,50,13,90,36
1986-03-11,SAC,132,28,35,SAN,120,31,34,59,69
1986-03-11,CHI,113,21,43,NJN,100,33,33,54,76
1986-03-12,MIL,126,45,20,PHX,127,25,39,70,59
1986-03-12,UTH,111,31,33,GOS,118,21,45,52,78
1986-03-12,CLE,114,24,39,WAS,128,30,33,54,72
1986-03-12,LAC,100,24,42,SEA,96,24,40,48,82
1986-03-12,DET,111,38,26,IND,101,22,45,60,71
1986-03-12,PHL,105,40,23,NYK,95,20,45,60,68
1986-03-12,DAL,120,34,30,SAC,127,29,35,63,65
1986-03-12,NJN,97,33,34,ATL,113,41,25,74,59
1986-03-13,HOU,126,40,24,POR,118,33,34,73,58
1986-03-13,LAL,105,49,16,SEA,92,24,41,73,57
1986-03-13,CHI,112,22,43,DEN,102,39,27,61,70
1986-03-13,SAN,119,31,35,BOS,135,51,13,82,48
1986-03-14,ATL,114,42,25,BOS,121,52,13,94,38
1986-03-14,UTH,146,31,34,SAN,121,31,36,62,70
1986-03-14,MIL,104,45,21,IND,114,22,46,67,67
1986-03-14,LAC,105,25,42,SAC,104,30,35,55,77
1986-03-14,WAS,91,31,33,DEN,101,39,28,70,61
1986-03-14,PHL,109,41,23,CLE,100,24,40,65,63
1986-03-14,DET,112,39,26,NYK,89,20,46,59,72
1986-03-14,DAL,129,34,31,POR,118,33,35,67,66
1986-03-15,CHI,116,23,43,MIL,125,45,22,68,65
1986-03-15,HOU,148,41,24,LAC,116,26,42,67,66
1986-03-15,NYK,101,20,47,ATL,106,42,26,62,73
1986-03-15,IND,105,23,46,WAS,100,31,34,54,80
1986-03-15,DAL,108,35,31,UTH,98,32,34,67,65
1986-03-15,CLE,100,24,41,NJN,102,33,35,57,76
1986-03-16,GOS,130,22,45,PHX,112,26,39,48,84
1986-03-16,DEN,119,40,28,SAC,113,30,36,70,64
1986-03-16,POR,119,33,36,DET,109,40,26,73,62
1986-03-16,BOS,118,53,13,PHL,101,42,23,95,36
1986-03-16,LAL,116,50,16,HOU,111,42,24,92,40
1986-03-16,SEA,129,24,42,SAN,115,31,37,55,79
1986-03-17,CLE,112,24,42,PHL,118,42,24,66,66
1986-03-17,WAS,102,31,35,NJN,130,34,35,65,70
1986-03-17,UTH,107,32,35,DET,106,40,27,72,62
1986-03-17,ATL,106,43,26,CHI,96,23,44,66,70
1986-03-17,IND,112,24,46,NYK,92,20,48,44,94
1986-03-18,SEA,104,25,42,UTH,107,33,35,58,77
1986-03-18,GOS,126,23,45,LAC,122,26,43,49,88
1986-03-18,HOU,112,42,25,PHX,109,26,40,68,65
1986-03-18,BOS,126,54,13,CLE,96,24,43,78,56
1986-03-18,DAL,120,36,31,SAN,113,31,38,67,69
1986-03-18,SAC,117,30,37,DEN,113,41,28,71,65
1986-03-18,MIL,116,46,22,WAS,87,31,36,77,58
1986-03-18,NJN,103,35,35,NYK,107,20,49,55,84
1986-03-18,LAL,128,51,16,POR,122,34,36,85,52
1986-03-19,LAC,115,26,44,LAL,114,52,16,78,60
1986-03-19,DEN,114,41,29,DET,98,40,28,81,57
1986-03-19,PHL,118,43,24,CHI,112,23,45,66,69
1986-03-19,SAN,115,31,39,ATL,112,44,26,75,65
1986-03-19,PHX,108,26,41,SAC,104,31,37,57,78
1986-03-19,BOS,127,55,13,IND,108,25,46,80,59
1986-03-20,UTH,107,34,35,DAL,114,37,31,71,66
1986-03-20,CLE,87,24,44,NYK,93,21,49,45,93
1986-03-20,MIL,116,47,22,HOU,106,43,25,90,47
1986-03-20,SEA,116,25,43,GOS,104,24,45,49,88
1986-03-21,BOS,126,56,13,CHI,105,23,46,79,59
1986-03-21,DAL,103,38,31,ATL,107,44,27,82,58
1986-03-21,PHX,105,27,41,DET,103,40,29,67,70
1986-03-21,SAN,109,32,39,LAL,117,52,17,84,56
1986-03-21,POR,115,34,37,SEA,108,26,43,60,80
1986-03-21,DEN,115,42,29,LAC,104,27,44,69,73
1986-03-21,PHL,112,44,24,WAS,105,31,37,75,61
1986-03-22,UTH,119,34,36,PHX,109,28,41,62,77
1986-03-22,SAC,113,31,38,LAL,115,53,17,84,55
1986-03-22,PHL,123,45,24,NJN,115,35,36,80,60
1986-03-22,WAS,111,31,38,IND,110,25,47,56,85
1986-03-22,CLE,123,24,45,CHI,97,23,47,47,92
1986-03-22,LAC,99,27,45,DET,119,40,30,67,75
1986-03-22,MIL,113,48,22,ATL,98,45,27,93,49
1986-03-22,NYK,99,22,49,HOU,114,43,26,65,75
1986-03-23,POR,112,35,37,SAC,102,31,39,66,76
1986-03-23,SAN,104,32,40,SEA,107,26,44,58,84
1986-03-23,GOS,113,24,46,DEN,111,43,29,67,75
1986-03-24,BOS,114,57,13,HOU,107,44,26,101,39
1986-03-24,LAL,124,54,17,SAN,102,32,41,86,58
1986-03-24,WAS,100,32,38,PHL,93,46,24,78,62
1986-03-24,IND,120,25,48,DAL,126,38,32,63,80
1986-03-24,UTH,116,35,36,SEA,108,27,44,62,80
1986-03-25,MIL,118,49,22,NJN,105,35,37,84,59
1986-03-25,CHI,111,23,48,NYK,98,22,50,45,98
1986-03-25,GOS,125,25,46,DET,121,41,30,66,76
1986-03-25,DEN,115,43,30,LAL,121,55,17,98,47
1986-03-25,SAC,116,31,40,POR,99,36,37,67,77
1986-03-25,CLE,91,25,45,ATL,97,45,28,70,73
1986-03-26,IND,101,25,49,HOU,110,44,27,69,76
1986-03-26,LAC,97,27,46,SAN,105,32,42,59,88
1986-03-26,UTH,116,36,36,DEN,101,43,31,79,67
1986-03-26,BOS,121,58,13,MIL,115,50,22,108,35
1986-03-26,WAS,120,33,38,DAL,112,39,32,72,70
1986-03-26,PHX,120,28,42,SEA,107,27,45,55,87
1986-03-26,PHL,112,46,25,ATL,103,46,28,92,53
1986-03-26,NJN,108,35,38,CLE,110,25,46,60,84
1986-03-27,NYK,105,22,51,DAL,110,39,33,61,84
1986-03-27,SEA,101,27,46,SAC,103,32,40,59,86
1986-03-27,GOS,121,26,46,SAN,118,33,42,59,88
1986-03-28,IND,92,20,39,ATL,100,34,25,54,64
1986-03-28,PHL,94,47,25,MIL,116,50,23,97,48
1986-03-28,BOS,116,59,13,WAS,97,34,38,93,51
1986-03-28,NJN,118,35,39,CHI,107,24,48,59,87
1986-03-28,PHX,96,29,42,LAC,107,27,47,56,89
1986-03-28,DET,116,41,31,HOU,107,45,27,86,58
1986-03-28,DEN,128,43,32,UTH,120,37,36,80,68
1986-03-29,SAC,103,33,40,LAC,112,28,47,61,87
1986-03-29,SEA,88,27,47,LAL,87,56,17,83,64
1986-03-29,GOS,130,27,46,POR,129,36,38,63,84
1986-03-29,SAN,102,33,43,UTH,110,37,37,70,80
1986-03-29,NYK,96,22,52,CHI,106,24,49,46,101
1986-03-29,ATL,105,46,29,CLE,123,26,46,72,75
1986-03-29,WAS,109,34,39,HOU,114,45,28,79,67
1986-03-29,MIL,130,51,23,DET,121,42,31,93,54
1986-03-30,BOS,122,60,13,NJN,117,36,39,96,52
1986-03-30,SEA,103,28,47,PHX,89,29,43,57,90
1986-03-30,LAL,124,56,18,GOS,117,28,46,84,64
1986-03-30,PHL,114,47,26,DAL,113,40,33,87,59
1986-04-01,MIL,116,52,23,CHI,107,25,49,77,72
1986-04-01,DET,116,42,32,IND,108,25,50,67,82
1986-04-01,DAL,128,40,34,PHX,98,29,44,69,78
1986-04-01,SAN,99,33,44,SAC,109,33,41,66,85
1986-04-01,ATL,107,46,30,WAS,91,34,40,80,70
1986-04-01,HOU,125,46,28,GOS,121,28,47,74,75
1986-04-01,POR,127,36,39,DEN,110,44,32,80,71
1986-04-01,LAL,109,57,18,SEA,104,29,47,86,65
1986-04-01,UTH,109,38,37,LAC,113,29,47,67,84
1986-04-01,NYK,93,22,53,NJN,111,36,40,58,93
1986-04-01,CLE,105,27,46,BOS,123,61,13,88,59
1986-04-02,PHL,93,48,26,NYK,87,22,54,70,80
1986-04-02,PHX,110,29,45,GOS,101,28,48,57,93
1986-04-02,BOS,122,62,13,DET,106,43,32,105,45
1986-04-02,LAC,97,30,47,UTH,94,38,38,68,85
1986-04-02,SEA,109,29,48,POR,121,37,39,66,87
1986-04-03,SAN,110,33,45,HOU,136,47,28,80,73
1986-04-03,LAL,135,58,18,SAC,105,34,41,92,59
1986-04-03,DAL,115,41,34,DEN,114,44,33,85,67
1986-04-03,IND,108,25,51,CHI,109,25,50,50,101
1986-04-03,NJN,108,37,40,WAS,120,34,41,71,81
1986-04-03,MIL,114,53,23,CLE,93,27,47,80,70
1986-04-04,WAS,135,35,41,ATL,129,47,30,82,71
1986-04-04,PHX,89,30,45,HOU,112,48,28,78,73
1986-04-04,PHL,122,49,26,CLE,102,27,48,76,74
1986-04-04,DET,108,43,33,MIL,115,54,23,97,56
1986-04-04,BOS,119,63,13,NYK,98,22,55,85,68
1986-04-05,IND,106,25,52,DET,115,43,34,68,86
1986-04-05,NJN,107,37,41,NYK,93,22,56,59,97
1986-04-05,CHI,102,26,50,ATL,97,47,31,73,81
1986-04-05,UTH,114,38,39,POR,103,38,39,76,78
1986-04-05,SAC,119,34,42,PHX,100,30,46,64,88
1986-04-05,DAL,109,42,34,SEA,111,29,49,71,83
1986-04-05,LAC,106,31,47,GOS,107,28,49,59,96
1986-04-06,PHL,95,50,26,BOS,94,64,13,114,39
1986-04-06,WAS,106,36,41,CLE,95,27,49,63,90
1986-04-06,SAN,106,33,46,DEN,124,44,34,77,80
1986-04-06,HOU,109,49,28,LAL,103,59,18,108,46
1986-04-07,PHX,123,30,47,DEN,131,45,34,75,81
1986-04-07,NYK,106,22,57,IND,104,25,53,47,110
1986-04-07,SAC,122,35,42,DAL,115,42,35,77,77
1986-04-07,CHI,107,27,50,MIL,101,55,23,82,73
1986-04-07,DET,128,44,34,CLE,104,27,50,71,84
1986-04-08,WAS,104,37,41,IND,111,25,54,62,95
1986-04-08,MIL,114,55,24,BOS,126,64,14,119,38
1986-04-08,GOS,129,29,49,DAL,115,42,36,71,85
1986-04-08,ATL,131,47,32,CHI,118,28,50,75,82
1986-04-08,POR,114,38,40,LAL,120,59,19,97,59
1986-04-08,HOU,109,50,28,SEA,95,30,49,80,77
1986-04-08,PHL,116,51,26,DET,112,45,34,96,60
1986-04-09,LAC,132,23,41,DEN,127,39,25,62,66
1986-04-09,NJN,108,38,41,BOS,98,65,14,103,55
1986-04-09,UTH,108,39,39,SAC,113,36,42,75,81
1986-04-09,PHX,102,30,48,SAN,114,33,47,63,95
1986-04-10,DEN,115,46,34,PHX,113,30,49,76,83
1986-04-10,LAL,117,60,19,HOU,113,51,28,111,47
1986-04-10,POR,115,38,41,LAC,100,31,48,69,89
1986-04-10,SAC,108,37,42,UTH,119,39,40,76,82
1986-04-10,SEA,109,30,50,DAL,115,42,37,72,87
1986-04-10,CLE,101,27,51,MIL,102,55,25,82,76
1986-04-10,ATL,126,48,32,NJN,117,39,41,87,73
1986-04-11,GOS,130,30,49,POR,131,39,41,69,90
1986-04-11,CHI,105,28,51,WAS,103,37,42,65,93
1986-04-11,NYK,95,23,57,DET,108,45,35,68,92
1986-04-11,PHL,130,52,26,IND,122,26,54,78,80
1986-04-11,BOS,117,65,15,CLE,104,27,52,92,67
1986-04-12,LAC,115,31,49,DAL,108,43,37,74,86
1986-04-12,DEN,99,47,34,UTH,117,40,40,87,74
1986-04-12,SEA,121,30,51,GOS,101,30,50,60,101
1986-04-12,MIL,116,56,25,NYK,78,23,58,79,83
1986-04-12,SAC,92,37,43,LAL,105,61,19,98,62
1986-04-12,HOU,92,51,29,PHX,110,30,50,81,79
1986-04-12,ATL,108,49,32,IND,91,26,55,75,87
1986-04-13,WAS,98,37,43,PHL,97,53,26,90,69
1986-04-13,PHX,118,31,50,LAC,99,32,49,63,99
1986-04-13,BOS,135,66,15,NJN,107,39,42,105,57
1986-04-13,LAL,104,62,19,DAL,127,43,38,105,57
1986-04-13,SAN,123,34,47,POR,118,40,41,74,88
1986-04-13,CLE,104,27,53,CHI,97,29,51,56,104
1986-10-31,POR,110,0,0,SEA,127,0,0,0,0
1986-10-31,PHL,108,0,0,IND,104,0,0,0,0
1986-10-31,BOS,120,0,0,WAS,102,0,0,0,0
1986-10-31,NJN,108,0,0,NYK,97,0,0,0,0
1986-10-31,SAC,107,0,0,LAC,106,0,0,0,0
1986-10-31,DET,104,0,0,MIL,120,0,0,0,0
1986-10-31,DEN,134,0,0,SAN,104,0,0,0,0
1986-10-31,DAL,103,0,0,UTH,77,0,0,0,0
1986-10-31,PHX,127,0,0,GOS,123,0,0,0,0
1986-11-01,ATL,131,0,0,NJN,111,1,0,1,0
1986-11-01,SAN,108,0,1,DAL,105,1,0,1,1
1986-11-01,MIL,111,1,0,BOS,105,1,0,2,0
1986-11-01,UTH,119,0,1,POR,110,0,1,0,2
1986-11-01,NYK,103,0,1,CHI,108,0,0,0,1
1986-11-01,GOS,131,0,1,DEN,109,1,0,1,1
1986-11-01,LAC,117,0,1,PHX,111,1,0,1,1
1986-11-01,IND,92,0,1,DET,89,0,1,0,2
1986-11-01,HOU,112,0,0,LAL,102,0,0,0,0
1986-11-01,CLE,113,0,0,WAS,106,0,1,0,1
1986-11-01,SEA,114,1,0,SAC,103,1,0,2,0
1986-11-02,PHL,113,1,0,ATL,122,1,0,2,0
1986-11-02,CLE,89,1,0,CHI,94,1,0,2,0
1986-11-03,GOS,104,1,1,NYK,95,0,3,1,4
1986-11-04,DEN,118,1,1,NYK,103,0,2,1,3
1986-11-04,IND,125,1,1,PHL,121,1,1,2,2
1986-11-04,PHX,126,1,1,POR,120,0,2,1,3
1986-11-04,SEA,96,2,0,LAL,110,0,1,2,1
1986-11-04,ATL,107,2,0,MIL,98,2,0,4,0
1986-11-04,SAC,84,1,1,HOU,100,1,0,2,1
1986-11-04,DAL,118,1,1,LAC,86,1,1,2,2
1986-11-04,WAS,102,0,2,NJN,101,1,1,1,3
1986-11-04,CHI,111,2,0,SAN,104,1,1,3,1
1986-11-05,NJN,103,1,2,SAN,112,1,2,2,4
1986-11-05,GOS,102,2,1,POR,92,0,3,2,4
1986-11-05,DET,109,0,2,WAS,85,1,2,1,4
1986-11-05,BOS,133,1,1,IND,102,2,1,3,2
1986-11-05,PHL,107,1,2,MIL,101,2,1,3,3
1986-11-05,UTH,111,1,1,CLE,95,1,1,2,2
1986-11-06,DEN,135,2,1,UTH,121,2,1,4,2
1986-11-06,SEA,124,2,1,DAL,147,2,1,4,2
1986-11-06,SAC,95,1,2,NYK,106,0,4,1,6
1986-11-06,HOU,97,2,0,LAC,104,1,2,3,2
1986-11-07,LAL,138,1,1,DEN,116,3,1,4,2
1986-11-07,DET,115,1,2,CHI,109,3,0,4,2
1986-11-07,ATL,106,3,0,PHX,86,2,1,5,1
1986-11-07,NJN,94,1,3,MIL,115,2,2,3,5
1986-11-07,GOS,114,3,1,CLE,115,1,2,4,3
1986-11-07,PHL,114,2,2,SAN,97,2,2,4,4
1986-11-07,POR,120,0,4,DAL,113,3,1,3,5
1986-11-07,WAS,86,1,3,BOS,88,2,1,3,4
1986-11-08,ATL,110,4,0,WAS,91,1,4,5,4
1986-11-08,HOU,102,2,1,SAC,90,1,3,3,4
1986-11-08,LAC,93,2,2,CLE,100,2,2,4,4
1986-11-08,SEA,105,2,2,NYK,102,1,4,3,6
1986-11-08,IND,130,2,2,SAN,97,2,3,4,5
1986-11-08,CHI,101,3,1,PHX,96,2,2,5,3
1986-11-08,MIL,103,3,2,DET,89,2,2,5,4
1986-11-09,LAL,111,2,1,NYK,88,1,5,3,6
1986-11-09,POR,119,1,4,PHL,125,3,2,4,6
1986-11-11,UTH,104,2,2,DAL,103,3,2,5,4
1986-11-11,NYK,111,1,6,PHX,105,2,3,3,9
1986-11-11,HOU,116,3,1,SAN,95,2,4,5,5
1986-11-11,LAC,115,2,3,DEN,112,3,2,5,5
1986-11-11,POR,126,1,5,GOS,108,3,2,4,7
1986-11-11,CHI,112,4,1,ATL,110,5,0,9,1
1986-11-11,NJN,114,1,4,BOS,110,3,1,4,5
1986-11-11,MIL,102,4,2,IND,94,3,2,7,4
1986-11-11,SEA,114,3,2,PHL,121,4,2,7,4
1986-11-11,SAC,119,1,4,CLE,114,3,2,4,6
1986-11-12,WAS,101,1,5,CHI,99,5,1,6,6
1986-11-12,LAL,122,3,1,SEA,97,3,3,6,4
1986-11-12,BOS,124,3,2,MIL,116,5,2,8,4
1986-11-12,DAL,114,3,3,HOU,85,4,1,7,4
1986-11-12,DET,108,2,3,PHX,100,2,4,4,7
1986-11-12,DEN,108,3,3,SAC,110,2,4,5,7
1986-11-13,NJN,117,2,4,IND,120,3,3,5,7
1986-11-13,GOS,112,3,3,PHL,104,5,2,8,5
1986-11-13,UTH,130,3,2,LAC,113,3,3,6,5
1986-11-13,SAN,115,2,5,CLE,102,3,3,5,8
1986-11-14,DET,100,3,3,ATL,105,5,1,8,4
1986-11-14,CHI,98,5,2,BOS,110,4,2,9,4
1986-11-14,DEN,142,3,4,DAL,138,4,3,7,7
1986-11-14,PHX,127,2,5,PHL,97,5,3,7,8
1986-11-14,MIL,106,5,3,NYK,103,2,6,7,9
1986-11-14,POR,119,2,5,LAC,109,3,4,5,9
1986-11-15,DAL,111,4,4,CLE,96,3,4,7,8
1986-11-15,UTH,111,4,2,DEN,103,4,4,8,6
1986-11-15,DET,111,3,4,BOS,118,5,2,8,6
1986-11-15,GOS,121,4,3,SEA,127,3,4,7,7
1986-11-15,NYK,104,2,7,WAS,97,2,5,4,12
1986-11-15,SAN,109,3,5,PHX,116,3,5,6,10
1986-11-15,NJN,90,2,5,ATL,109,6,1,8,6
1986-11-15,IND,104,4,3,MIL,103,6,3,10,6
1986-11-16,LAL,113,4,1,SAC,111,3,4,7,5
1986-11-16,LAC,90,3,5,PHL,103,5,4,8,9
1986-11-16,HOU,134,4,2,CLE,106,3,5,7,7
1986-11-16,POR,124,3,5,UTH,103,5,2,8,7
1986-11-16,WAS,124,2,6,IND,111,5,3,7,9
1986-11-18,DEN,125,4,5,NJN,112,2,6,6,11
1986-11-18,DAL,110,5,4,LAL,114,5,1,10,5
1986-11-18,LAC,93,3,6,IND,98,5,4,8,10
1986-11-18,MIL,111,6,4,GOS,85,4,4,10,8
1986-11-18,HOU,111,5,2,POR,115,4,5,9,7
1986-11-18,SEA,119,4,4,SAC,105,3,5,7,9
1986-11-19,BOS,111,6,2,ATL,107,7,1,13,3
1986-11-19,SAN,108,3,6,LAL,117,6,1,9,7
1986-11-19,PHX,111,4,5,NJN,101,2,7,6,12
1986-11-19,PHL,98,6,4,NYK,94,3,7,9,11
1986-11-19,WAS,119,3,6,DET,105,3,5,6,11
1986-11-19,CLE,104,3,6,GOS,112,4,5,7,11
1986-11-20,LAC,108,3,7,DAL,113,5,5,8,12
1986-11-20,HOU,104,5,3,UTH,90,5,3,10,6
1986-11-20,ATL,108,7,2,CLE,89,3,7,10,9
1986-11-20,SEA,105,5,4,MIL,116,7,4,12,8
1986-11-20,SAC,92,3,6,IND,83,6,4,9,10
1986-11-20,DEN,142,5,5,POR,128,5,5,10,10
1986-11-21,WAS,115,4,6,HOU,99,6,3,10,9
1986-11-21,PHL,110,7,4,DET,120,3,6,10,10
1986-11-21,BOS,135,7,2,GOS,120,5,5,12,7
1986-11-21,CHI,101,5,3,NYK,99,3,8,8,11
1986-11-21,POR,127,5,6,SAN,114,3,7,8,13
1986-11-21,PHX,122,5,5,DAL,130,6,5,11,10
1986-11-21,LAL,111,7,1,NJN,95,2,8,9,9
1986-11-22,LAC,102,3,8,SAN,109,3,8,6,16
1986-11-22,ATL,97,8,2,BOS,96,8,2,16,4
1986-11-22,NYK,93,3,9,GOS,97,5,6,8,15
1986-11-22,DEN,132,6,5,PHX,120,5,6,11,11
1986-11-22,SAC,99,4,6,MIL,107,8,4,12,10
1986-11-22,CHI,93,6,3,WAS,84,5,6,11,9
1986-11-22,SEA,121,5,5,IND,111,6,5,11,10
1986-11-22,DET,93,4,6,CLE,84,3,8,7,14
1986-11-22,UTH,96,5,4,NJN,78,2,9,7,13
1986-11-23,LAL,127,8,1,MIL,117,9,4,17,5
1986-11-23,POR,108,6,6,IND,95,6,6,12,12
1986-11-23,PHL,114,7,5,HOU,104,6,4,13,9
1986-11-25,GOS,111,6,6,UTH,106,6,4,12,10
1986-11-25,PHL,102,8,5,BOS,100,8,3,16,8
1986-11-25,SAN,117,4,8,NJN,99,2,10,6,18
1986-11-25,LAL,107,9,1,ATL,113,9,2,18,3
1986-11-25,NYK,102,3,10,HOU,93,6,5,9,15
1986-11-25,WAS,111,5,7,POR,99,7,6,12,13
1986-11-25,SEA,113,6,5,LAC,103,3,9,9,14
1986-11-25,SAC,123,4,7,PHX,102,5,7,9,14
1986-11-26,UTH,127,6,5,SEA,91,7,5,13,10
1986-11-26,PHX,120,5,8,ATL,106,10,2,15,10
1986-11-26,IND,88,6,7,HOU,92,6,6,12,13
1986-11-26,LAC,92,3,10,LAL,126,9,2,12,12
1986-11-26,CLE,118,3,9,POR,114,7,7,10,16
1986-11-26,BOS,101,8,4,NYK,90,4,10,12,14
1986-11-26,DEN,109,7,5,CHI,107,7,3,14,8
1986-11-26,DAL,129,7,5,SAC,117,5,7,12,12
1986-11-26,MIL,122,9,5,WAS,103,6,7,15,12
1986-11-28,IND,126,6,8,DEN,102,8,5,14,13
1986-11-28,DET,120,5,6,MIL,99,10,5,15,11
1986-11-28,BOS,111,9,4,SAN,96,5,8,14,12
1986-11-28,LAL,110,10,2,CHI,103,7,4,17,6
1986-11-28,UTH,88,7,5,ATL,97,10,3,17,8
1986-11-28,DAL,119,8,5,NJN,94,2,11,10,16
1986-11-28,PHX,104,6,8,SEA,117,7,6,13,14
1986-11-28,PHL,116,9,5,POR,112,7,8,16,13
1986-11-28,SAC,97,5,8,GOS,103,7,6,12,14
1986-11-29,WAS,116,6,8,SAN,103,5,9,11,17
1986-11-29,MIL,131,10,6,DEN,99,8,6,18,12
1986-11-29,NYK,88,4,11,CLE,90,4,9,8,20
1986-11-29,DAL,118,9,5,UTH,107,7,6,16,11
1986-11-29,GOS,113,8,6,CHI,106,7,5,15,11
1986-11-29,HOU,97,7,6,NJN,102,2,12,9,18
1986-11-30,SAC,109,5,9,ATL,113,11,3,16,12
1986-11-30,IND,101,7,8,POR,118,7,9,14,17
1986-11-30,LAL,137,11,2,LAC,115,3,11,14,13
1986-12-02,POR,134,8,9,LAC,99,3,12,11,21
1986-12-02,PHX,124,6,9,NYK,100,4,12,10,21
1986-12-02,GOS,104,9,6,HOU,99,7,7,16,13
1986-12-02,SAC,124,5,10,DAL,127,10,5,15,15
1986-12-02,BOS,109,10,4,WAS,117,7,8,17,12
1986-12-02,ATL,116,12,3,DEN,100,8,7,20,10
1986-12-02,CLE,115,5,9,SAN,105,5,10,10,19
1986-12-02,MIL,95,11,6,IND,88,7,9,18,15
1986-12-02,SEA,109,8,6,CHI,115,7,6,15,12
1986-12-03,BOS,119,10,5,DEN,113,8,8,18,13
1986-12-03,IND,116,7,10,WAS,103,8,8,15,18
1986-12-03,NJN,106,3,12,DET,107,6,6,9,18
1986-12-03,PHL,115,10,5,MIL,110,12,6,22,11
1986-12-03,UTH,99,7,7,CHI,94,8,6,15,13
1986-12-04,CLE,113,6,9,DET,105,7,6,13,15
1986-12-04,HOU,93,7,8,ATL,109,13,3,20,11
1986-12-04,SAN,102,5,11,SEA,109,8,7,13,18
1986-12-04,SAC,102,5,11,POR,106,9,9,14,20
1986-12-04,LAC,91,3,13,NYK,95,4,13,7,26
1986-12-04,GOS,116,10,6,LAL,106,12,2,22,8
1986-12-05,WAS,87,8,9,MIL,91,12,7,20,16
1986-12-05,UTH,123,8,7,NYK,96,5,13,13,20
1986-12-05,BOS,108,11,5,PHL,106,11,5,22,10
1986-12-05,IND,119,8,10,ATL,113,14,3,22,13
1986-12-05,PHX,114,7,9,CHI,112,8,7,15,16
1986-12-05,LAL,112,12,3,DAL,104,11,5,23,8
1986-12-05,NJN,100,3,13,DEN,113,8,9,11,22
1986-12-06,PHL,105,11,6,NJN,100,3,14,14,20
1986-12-06,GOS,104,11,6,DAL,109,11,6,22,12
1986-12-06,HOU,80,7,9,SEA,136,9,7,16,16
1986-12-06,CLE,88,7,9,BOS,86,12,5,19,14
1986-12-06,SAN,106,5,12,CHI,97,8,8,13,20
1986-12-06,DET,128,7,7,DEN,113,9,9,16,16
1986-12-06,LAC,109,3,14,PHX,111,8,9,11,23
1986-12-06,SAC,111,5,12,UTH,114,9,7,14,19
1986-12-07,LAL,132,13,3,GOS,100,11,7,24,10
1986-12-07,POR,107,10,9,NYK,104,5,14,15,23
1986-12-09,SAN,104,6,12,POR,120,11,9,17,21
1986-12-09,NYK,87,5,15,LAL,113,14,3,19,18
1986-12-09,NJN,107,3,15,SAC,120,5,13,8,28
1986-12-09,CLE,98,8,9,ATL,122,14,4,22,13
1986-12-09,CHI,106,8,9,DEN,100,9,10,17,19
1986-12-09,GOS,94,11,8,PHX,109,9,9,20,17
1986-12-10,WAS,106,8,10,NYK,105,5,16,13,26
1986-12-10,PHX,109,10,9,HOU,117,7,10,17,19
1986-12-10,ATL,123,15,4,CHI,95,9,9,24,13
1986-12-10,DEN,110,9,11,UTH,112,10,7,19,18
1986-12-10,MIL,116,13,7,LAL,93,15,3,28,10
1986-12-10,BOS,108,12,6,NJN,98,3,16,15,22
1986-12-10,DET,108,8,7,SAC,101,6,13,14,20
1986-12-10,PHL,122,12,6,IND,112,9,10,21,16
1986-12-10,LAC,101,3,15,SEA,94,10,7,13,22
1986-12-10,DAL,130,12,6,POR,129,12,9,24,15
1986-12-11,HOU,104,8,10,GOS,111,11,9,19,19
1986-12-11,IND,115,9,11,CLE,94,8,10,17,21
1986-12-11,UTH,103,11,7,DAL,99,13,6,24,13
1986-12-11,SEA,113,10,8,SAN,107,6,13,16,21
1986-12-12,MIL,93,14,7,CHI,106,9,10,23,17
1986-12-12,BOS,110,13,6,LAL,117,15,4,28,10
1986-12-12,DET,115,9,7,WAS,116,9,10,18,17
1986-12-12,ATL,130,16,4,SAC,120,6,14,22,18
1986-12-12,LAC,112,4,15,POR,113,12,10,16,25
1986-12-12,DEN,128,9,12,PHX,116,10,10,19,22
1986-12-12,NJN,123,3,17,PHL,90,13,6,16,23
1986-12-13,IND,95,10,11,NJN,91,4,17,14,28
1986-12-13,HOU,119,8,11,SAC,106,6,15,14,26
1986-12-13,UTH,115,12,7,LAC,100,4,16,16,23
1986-12-13,SAN,102,6,14,GOS,117,12,9,18,23
1986-12-13,DET,119,9,8,LAL,114,16,4,25,12
1986-12-13,SEA,109,11,8,DAL,126,13,7,24,15
1986-12-13,CHI,90,10,10,MIL,113,14,8,24,18
1986-12-13,PHX,123,10,11,DEN,110,10,12,20,23
1986-12-13,NYK,110,5,17,ATL,122,17,4,22,21
1986-12-13,CLE,123,8,11,PHL,120,13,7,21,18
1986-12-13,WAS,98,10,10,BOS,105,13,7,23,17
1986-12-14,POR,134,13,10,DAL,100,14,7,27,17
1986-12-16,HOU,102,9,11,PHX,106,11,11,20,22
1986-12-16,CLE,116,9,11,LAL,121,16,5,25,16
1986-12-16,SAC,119,6,16,DEN,120,10,13,16,29
1986-12-16,ATL,100,18,4,DET,111,10,8,28,12
1986-12-16,LAC,117,4,17,GOS,119,13,9,17,26
1986-12-16,CHI,99,10,11,NJN,98,4,18,14,29
1986-12-16,WAS,106,10,11,UTH,109,13,7,23,18
1986-12-16,NYK,96,5,18,BOS,107,14,7,19,25
1986-12-16,MIL,103,15,8,PHL,91,13,8,28,16
1986-12-16,POR,126,14,10,SEA,118,11,9,25,19
1986-12-16,DAL,101,14,8,SAN,98,6,15,20,23
1986-12-17,PHL,107,13,9,CLE,110,9,12,22,21
1986-12-17,SAN,94,6,16,PHX,81,12,11,18,27
1986-12-17,DET,122,11,8,UTH,107,14,7,25,15
1986-12-17,BOS,113,15,7,IND,101,11,11,26,18
1986-12-18,LAL,131,17,5,POR,115,15,10,32,15
1986-12-18,GOS,110,14,9,WAS,128,10,12,24,21
1986-12-18,MIL,104,16,8,ATL,95,18,5,34,13
1986-12-18,LAC,113,4,18,SAC,117,6,17,10,35
1986-12-18,SEA,114,11,10,HOU,100,9,12,20,22
1986-12-18,IND,88,11,12,CHI,97,11,11,22,23
1986-12-18,NYK,93,5,19,NJN,94,4,19,9,38
1986-12-19,CLE,128,10,12,UTH,134,14,8,24,20
1986-12-19,PHX,106,12,12,SEA,108,12,10,24,22
1986-12-19,PHL,122,13,10,BOS,100,16,7,29,17
1986-12-19,DAL,141,15,8,DEN,118,11,13,26,21
1986-12-19,POR,115,15,11,HOU,112,9,13,24,24
1986-12-19,DET,114,12,8,SAN,84,7,16,19,24
1986-12-20,NYK,99,5,20,IND,123,11,13,16,33
1986-12-20,MIL,120,17,8,BOS,100,16,8,33,16
1986-12-20,ATL,111,18,6,SAN,96,7,17,25,23
1986-12-20,LAC,101,4,19,WAS,113,11,12,15,31
1986-12-20,DEN,128,11,14,GOS,112,14,10,25,24
1986-12-20,DAL,130,16,8,LAL,119,18,5,34,13
1986-12-20,PHL,88,14,10,DET,98,13,8,27,18
1986-12-20,SAC,122,7,17,PHX,114,12,13,19,30
1986-12-20,CHI,89,12,11,UTH,91,15,8,27,19
1986-12-21,HOU,96,9,14,LAL,103,18,6,27,20
1986-12-21,SEA,112,13,10,GOS,121,14,11,27,21
1986-12-21,POR,128,16,11,WAS,101,12,12,28,23
1986-12-21,CLE,104,10,13,IND,94,12,13,22,26
1986-12-22,NYK,103,5,21,SAN,99,7,18,12,39
1986-12-22,PHL,111,14,11,UTH,114,16,8,30,19
1986-12-23,SEA,127,13,11,DEN,116,12,14,25,25
1986-12-23,HOU,121,9,15,LAC,96,4,20,13,35
1986-12-23,SAC,117,8,17,LAL,127,19,6,27,23
1986-12-23,MIL,110,18,8,SAN,108,7,19,25,27
1986-12-23,GOS,112,15,11,POR,111,17,11,32,22
1986-12-23,CHI,108,12,12,CLE,92,11,13,23,25
1986-12-23,PHX,120,12,14,DAL,119,17,8,29,22
1986-12-23,NJN,119,5,19,UTH,96,17,8,22,27
1986-12-23,IND,111,12,14,DET,98,14,8,26,22
1986-12-25,PHL,97,14,12,WAS,102,12,13,26,25
1986-12-25,NYK,86,6,21,CHI,85,13,12,19,33
1986-12-26,SEA,113,14,11,LAC,107,4,21,18,32
1986-12-26,CLE,121,11,14,NJN,112,6,19,17,33
1986-12-26,PHX,112,13,14,BOS,122,16,9,29,23
1986-12-26,LAL,134,20,6,HOU,111,10,15,30,21
1986-12-26,DEN,121,12,15,DAL,123,17,9,29,24
1986-12-26,DET,121,14,9,GOS,106,16,11,30,20
1986-12-27,LAC,101,4,22,BOS,114,17,9,21,31
1986-12-27,NJN,120,6,20,CLE,111,12,14,18,34
1986-12-27,UTH,103,17,9,HOU,96,10,16,27,25
1986-12-27,DAL,123,18,9,PHX,97,13,15,31,24
1986-12-27,SAC,95,8,18,PHL,99,14,13,22,31
1986-12-27,NYK,114,7,21,MIL,100,19,8,26,29
1986-12-27,SAN,106,7,20,DEN,108,12,16,19,36
1986-12-27,ATL,119,19,6,GOS,108,16,12,35,18
1986-12-27,CHI,105,13,13,IND,93,13,14,26,27
1986-12-27,WAS,105,13,13,DET,107,15,9,28,22
1986-12-28,LAL,111,21,6,PHL,85,15,13,36,19
1986-12-28,SEA,118,15,11,POR,127,17,12,32,23
1986-12-29,NJN,122,7,20,MIL,117,19,9,26,29
1986-12-29,CLE,107,12,15,ATL,106,20,6,32,21
1986-12-29,WAS,125,13,14,GOS,105,16,13,29,27
1986-12-29,SAC,102,8,19,BOS,119,18,9,26,28
1986-12-29,UTH,109,18,9,SAN,101,7,21,25,30
1986-12-30,DEN,108,13,16,PHL,111,15,14,28,30
1986-12-30,MIL,99,19,10,DET,103,16,9,35,19
1986-12-30,IND,111,13,15,CLE,99,13,15,26,30
1986-12-30,NYK,103,8,21,WAS,97,14,14,22,35
1986-12-30,CHI,99,14,13,GOS,102,16,14,30,27
1986-12-30,POR,120,18,12,PHX,105,13,16,31,28
1986-12-30,SAN,115,7,22,UTH,109,19,9,26,31
1986-12-30,LAC,102,4,23,HOU,105,10,17,14,40
1986-12-30,SEA,102,15,12,BOS,104,19,9,34,21
1987-01-01,POR,104,19,12,LAL,140,22,6,41,18
1987-01-02,IND,116,14,15,LAC,106,4,24,18,39
1987-01-02,UTH,99,19,10,PHL,104,16,14,35,24
1987-01-02,DET,129,17,9,NJN,128,8,20,25,29
1987-01-02,WAS,101,14,15,ATL,118,20,7,34,22
1987-01-02,LAL,155,23,6,PHX,118,13,17,36,23
1987-01-02,CLE,84,13,16,MIL,91,19,11,32,27
1987-01-02,DEN,111,13,17,HOU,114,11,17,24,34
1987-01-02,DAL,117,19,9,SEA,107,15,13,34,22
1987-01-02,GOS,115,17,14,SAC,109,8,20,25,34
1987-01-02,BOS,113,20,9,CHI,99,14,14,34,23
1987-01-03,NJN,118,8,21,LAC,97,4,25,12,46
1987-01-03,HOU,138,12,17,SEA,114,15,14,27,31
1987-01-03,MIL,104,20,11,CLE,95,13,17,33,28
1987-01-03,CHI,124,14,15,DET,119,18,9,32,24
1987-01-03,ATL,114,21,7,NYK,92,9,21,30,28
1987-01-03,POR,116,19,13,DEN,108,13,18,32,31
1987-01-03,SAN,89,8,22,DAL,106,20,9,28,31
1987-01-04,POR,128,20,13,SAC,111,8,21,28,34
1987-01-04,LAL,121,24,6,UTH,113,19,11,43,17
1987-01-04,GOS,101,18,14,PHX,104,13,18,31,32
1987-01-05,DAL,135,21,9,IND,144,15,15,36,24
1987-01-05,PHL,108,17,14,LAC,102,4,26,21,40
1987-01-06,NYK,118,9,22,ATL,86,22,7,31,29
1987-01-06,CLE,95,13,18,CHI,99,15,15,28,33
1987-01-06,GOS,118,18,15,HOU,100,13,17,31,32
1987-01-06,WAS,112,14,16,LAC,97,4,27,18,43
1987-01-06,SAN,99,8,23,IND,101,16,15,24,38
1987-01-06,SEA,138,15,15,PHX,108,14,18,29,33
1987-01-06,MIL,124,21,11,NJN,112,9,21,30,32
1987-01-06,SAC,112,8,22,DEN,104,13,19,21,41
1987-01-07,BOS,119,21,9,MIL,92,22,11,43,20
1987-01-07,LAL,147,25,6,DEN,109,13,20,38,26
1987-01-07,DET,122,18,10,NYK,111,10,22,28,32
1987-01-07,DAL,108,21,10,SAN,103,8,24,29,34
1987-01-07,NJN,118,9,22,WAS,96,15,16,24,38
1987-01-07,ATL,102,22,8,PHL,109,18,14,40,22
1987-01-08,CHI,121,16,15,POR,117,21,13,37,28
1987-01-08,GOS,108,19,15,SEA,115,16,15,35,30
1987-01-08,CLE,103,13,19,LAC,93,4,28,17,47
1987-01-08,UTH,107,19,12,LAL,101,26,6,45,18
1987-01-08,HOU,110,13,18,IND,96,17,15,30,33
1987-01-09,PHX,100,14,19,SAN,115,8,25,22,44
1987-01-09,BOS,109,22,9,SAC,99,9,22,31,31
1987-01-09,MIL,92,22,12,WAS,100,15,17,37,29
1987-01-09,DAL,113,22,10,DEN,116,13,21,35,31
1987-01-09,NJN,120,10,22,POR,127,21,14,31,36
1987-01-09,DET,131,19,10,LAC,123,4,29,23,39
1987-01-09,PHL,84,19,14,NYK,94,10,23,29,37
1987-01-10,WAS,117,16,17,PHL,111,19,15,35,32
1987-01-10,CHI,119,17,15,NJN,109,10,23,27,38
1987-01-10,DET,118,20,10,BOS,101,23,9,43,19
1987-01-10,UTH,105,20,12,IND,96,17,16,37,28
1987-01-10,DEN,127,14,21,PHX,120,14,20,28,41
1987-01-10,ATL,129,22,9,CLE,104,14,19,36,28
1987-01-10,GOS,124,19,16,LAL,109,26,7,45,23
1987-01-10,NYK,119,11,23,SAC,115,9,23,20,46
1987-01-10,HOU,106,14,18,DAL,96,22,11,36,29
1987-01-11,LAL,111,26,8,SAN,109,9,25,35,33
1987-01-11,MIL,91,22,13,POR,103,22,14,44,27
1987-01-11,SEA,127,17,15,UTH,111,21,12,38,27
1987-01-12,ATL,125,23,9,LAC,115,4,30,27,39
1987-01-12,WAS,113,17,17,SAC,109,9,24,26,41
1987-01-13,CLE,101,14,20,DET,103,21,10,35,30
1987-01-13,DEN,117,15,21,SEA,109,18,15,33,36
1987-01-13,NYK,103,12,23,DAL,108,22,12,34,35
1987-01-13,MIL,113,22,14,SAC,89,9,25,31,39
1987-01-13,POR,121,23,14,UTH,113,21,13,44,27
1987-01-13,IND,94,17,17,PHL,101,19,16,36,33
1987-01-13,NJN,117,10,24,BOS,123,23,10,33,34
1987-01-13,HOU,118,15,18,PHX,100,14,21,29,39
1987-01-13,GOS,111,20,16,SAN,109,9,26,29,42
1987-01-14,LAC,123,4,31,DEN,105,16,21,20,52
1987-01-14,PHL,96,20,16,ATL,93,24,9,44,25
1987-01-14,WAS,118,18,17,NJN,100,10,25,28,42
1987-01-14,BOS,117,24,10,DAL,108,23,12,47,22
1987-01-14,SEA,130,18,16,SAN,104,9,27,27,43
1987-01-14,DET,104,22,10,CLE,87,14,21,36,31
1987-01-15,SAC,120,9,26,POR,118,24,14,33,40
1987-01-15,IND,113,17,18,WAS,105,19,17,36,35
1987-01-15,LAL,129,27,8,GOS,109,21,16,48,24
1987-01-15,CHI,96,18,15,HOU,107,16,18,34,33
1987-01-15,ATL,130,24,10,MIL,91,23,14,47,24
1987-01-15,PHX,123,14,22,UTH,107,21,14,35,36
1987-01-16,BOS,133,25,10,CLE,128,14,22,39,32
1987-01-16,SEA,134,19,16,DEN,100,16,22,35,38
1987-01-16,MIL,122,23,15,DAL,124,23,13,46,28
1987-01-16,DET,106,23,10,HOU,112,17,18,40,28
1987-01-16,GOS,118,21,17,LAC,106,5,31,26,48
1987-01-17,SAC,125,10,26,SEA,115,20,16,30,42
1987-01-17,PHX,132,15,22,LAC,101,5,32,20,54
1987-01-17,NJN,113,10,26,DET,123,23,11,33,37
1987-01-17,SAN,102,9,28,UTH,91,21,15,30,43
1987-01-17,CLE,116,14,23,NYK,110,12,24,26,47
1987-01-17,CHI,105,18,16,PHL,89,21,16,39,32
1987-01-17,IND,119,18,18,DAL,115,24,13,42,31
1987-01-18,WAS,101,19,18,LAL,115,28,8,47,26
1987-01-18,MIL,100,23,16,ATL,91,25,10,48,26
1987-01-18,BOS,122,26,10,HOU,99,18,18,44,28
1987-01-18,POR,103,24,15,GOS,116,22,17,46,32
1987-01-19,CLE,103,15,23,HOU,127,18,19,33,42
1987-01-19,SAN,113,10,28,LAC,106,5,33,15,61
1987-01-19,PHL,107,21,17,PHX,104,16,22,37,39
1987-01-19,NJN,115,10,27,LAL,126,29,8,39,35
1987-01-19,DET,108,24,11,ATL,98,25,11,49,22
1987-01-19,IND,109,19,18,CHI,95,19,16,38,34
1987-01-19,DEN,118,16,23,POR,116,24,16,40,39
1987-01-19,NYK,111,12,25,BOS,109,27,10,39,35
1987-01-20,CHI,103,19,17,MIL,90,24,16,43,33
1987-01-20,SAC,123,11,26,GOS,114,23,17,34,43
1987-01-21,PHL,129,22,17,SEA,123,20,17,42,34
1987-01-21,ATL,109,25,12,LAL,112,30,8,55,20
1987-01-21,NJN,120,10,28,PHX,114,16,23,26,51
1987-01-21,CLE,107,15,24,MIL,111,24,17,39,41
1987-01-21,UTH,112,21,16,DET,108,25,11,46,27
1987-01-21,SAN,91,11,28,HOU,111,19,19,30,47
1987-01-21,DEN,129,17,23,GOS,112,23,18,40,41
1987-01-21,BOS,130,27,11,IND,100,20,18,47,29
1987-01-21,DAL,113,24,14,NYK,93,13,25,37,39
1987-01-22,IND,108,20,19,LAL,118,31,8,51,27
1987-01-23,WAS,109,19,19,PHX,90,16,24,35,43
1987-01-23,BOS,126,28,11,ATL,106,25,13,53,24
1987-01-23,CHI,117,20,17,CLE,96,15,25,35,42
1987-01-23,NJN,120,11,28,SEA,125,20,18,31,46
1987-01-23,UTH,123,22,16,GOS,100,23,19,45,35
1987-01-23,LAC,97,5,34,DET,100,25,12,30,46
1987-01-23,POR,109,24,17,SAC,89,12,26,36,43
1987-01-23,HOU,109,20,19,NYK,95,13,26,33,45
1987-01-24,DAL,132,25,14,LAL,117,32,8,57,22
1987-01-24,HOU,115,21,19,WAS,92,20,19,41,38
1987-01-24,SAN,108,11,29,NYK,101,13,27,24,56
1987-01-24,SAC,138,12,27,DET,113,26,12,38,39
1987-01-24,IND,103,20,20,PHX,104,16,25,36,45
1987-01-24,ATL,97,25,14,SEA,87,21,18,46,32
1987-01-24,DEN,132,18,23,MIL,122,25,17,43,40
1987-01-24,CLE,114,15,26,CHI,84,21,17,36,43
1987-01-25,BOS,111,29,11,PHL,96,23,17,52,28
1987-01-26,PHX,120,17,25,DET,118,26,13,43,38
1987-01-26,POR,145,25,17,DEN,141,19,23,44,40
1987-01-26,LAC,94,5,35,MIL,114,25,18,30,53
1987-01-26,UTH,95,23,16,SEA,108,21,19,44,35
1987-01-27,SAC,118,13,27,NJN,115,11,29,24,56
1987-01-27,DAL,113,26,14,WAS,118,20,20,46,34
1987-01-27,GOS,115,23,20,MIL,119,26,18,49,38
1987-01-27,HOU,88,22,19,UTH,92,23,17,45,36
1987-01-27,CHI,97,21,18,BOS,105,30,11,51,29
1987-01-27,ATL,114,26,14,IND,98,20,21,46,35
1987-01-27,LAL,107,32,9,POR,100,26,17,58,26
1987-01-27,SAN,118,12,29,DET,107,26,14,38,43
1987-01-27,NYK,103,13,28,PHL,108,23,18,36,46
1987-01-28,PHX,131,18,25,GOS,104,23,21,41,46
1987-01-28,PHL,109,24,18,CLE,107,16,26,40,44
1987-01-28,LAC,98,5,36,NJN,91,11,30,16,66
1987-01-28,SEA,125,22,19,LAL,101,33,9,55,28
1987-01-28,BOS,132,31,11,CHI,103,21,19,52,30
1987-01-29,SAC,107,14,27,SAN,113,13,29,27,56
1987-01-29,DEN,102,19,24,DAL,132,26,15,45,39
1987-01-29,DET,112,26,15,WAS,101,21,20,47,35
1987-01-29,CLE,102,16,27,ATL,91,27,14,43,41
1987-01-29,UTH,120,24,17,POR,114,26,18,50,35
1987-01-29,HOU,93,22,20,MIL,99,27,18,49,38
1987-01-30,POR,125,26,19,NJN,107,11,31,37,50
1987-01-30,LAC,120,6,36,SAN,124,14,29,20,65
1987-01-30,DAL,133,27,15,MIL,117,28,18,55,33
1987-01-30,GOS,127,23,22,SEA,119,23,19,46,41
1987-01-30,PHL,121,25,18,CHI,112,21,20,46,38
1987-01-30,IND,94,20,22,BOS,100,32,11,52,33
1987-01-30,ATL,106,27,15,NYK,98,13,29,40,44
1987-01-30,PHX,102,19,25,LAL,114,33,10,52,35
1987-01-31,DEN,142,19,25,SAC,113,14,28,33,53
1987-01-31,SEA,118,23,20,PHX,112,19,26,42,46
1987-01-31,UTH,113,25,17,LAC,114,6,37,31,54
1987-01-31,WAS,106,21,21,PHL,105,26,18,47,39
1987-01-31,CLE,102,17,27,IND,100,20,23,37,50
1987-01-31,NYK,113,13,30,DET,114,27,15,40,45
1987-02-01,GOS,150,24,22,NJN,147,11,32,35,54
1987-02-01,ATL,104,28,15,HOU,106,22,21,50,36
1987-02-01,SAC,113,14,29,UTH,121,25,18,39,47
1987-02-01,DET,94,28,15,CHI,92,21,21,49,36
1987-02-01,SAN,120,15,29,MIL,116,28,19,43,48
1987-02-01,POR,133,27,19,DAL,117,28,15,55,34
1987-02-02,DEN,140,20,25,LAC,112,7,37,27,62
1987-02-02,SEA,108,24,20,NJN,100,11,33,35,53
1987-02-02,LAL,99,34,10,DAL,103,28,16,62,26
1987-02-02,WAS,104,22,21,NYK,98,13,31,35,52
1987-02-03,POR,117,28,19,PHX,103,19,27,47,46
1987-02-03,MIL,109,28,20,NYK,110,13,32,41,52
1987-02-03,IND,94,20,24,PHL,99,26,19,46,43
1987-02-03,UTH,101,26,18,SAC,95,14,30,40,48
1987-02-03,ATL,126,28,16,BOS,123,33,11,61,27
1987-02-03,HOU,105,23,21,DEN,107,21,25,44,46
1987-02-03,SAN,111,16,29,GOS,103,25,22,41,51
1987-02-03,CHI,98,21,22,WAS,91,23,21,44,43
1987-02-04,DAL,124,29,16,SEA,94,25,20,54,36
1987-02-04,BOS,104,33,12,CLE,102,18,28,51,40
1987-02-04,LAL,128,34,11,SAC,92,14,31,48,42
1987-02-04,NJN,95,12,34,PHL,121,27,19,39,53
1987-02-05,WAS,94,23,22,CLE,85,18,29,41,51
1987-02-05,HOU,120,23,22,GOS,110,25,23,48,45
1987-02-05,SAN,117,17,29,SEA,111,25,21,42,50
1987-02-05,LAC,103,7,38,UTH,126,27,18,34,56
1987-02-05,POR,105,29,19,LAL,104,35,11,64,30
1987-02-05,DET,93,29,15,IND,98,20,25,49,40
1987-02-05,PHX,113,19,28,DEN,100,22,25,41,53
1987-02-05,MIL,120,28,21,CHI,105,22,22,50,43
1987-02-05,NYK,135,14,32,NJN,118,12,35,26,67
1987-02-10,GOS,125,25,24,IND,126,21,25,46,49
1987-02-10,UTH,98,28,18,PHX,102,20,28,48,46
1987-02-10,SEA,113,25,22,ATL,125,29,16,54,38
1987-02-10,DEN,105,22,26,BOS,119,34,12,56,38
1987-02-10,CHI,104,22,23,PHL,99,28,19,50,42
1987-02-10,HOU,115,24,22,SAN,92,18,29,42,51
1987-02-10,DAL,135,30,16,POR,115,30,19,60,35
1987-02-10,CLE,100,18,30,NYK,95,15,32,33,62
1987-02-10,SAC,98,14,32,LAL,114,35,12,49,44
1987-02-11,PHL,113,28,20,DET,123,29,16,57,36
1987-02-11,SAN,108,18,30,WAS,133,24,22,42,52
1987-02-11,PHX,105,21,28,IND,121,22,25,43,53
1987-02-11,LAC,82,7,39,ATL,109,30,16,37,55
1987-02-11,NYK,104,15,33,MIL,127,29,21,44,54
1987-02-12,SAC,129,14,33,DAL,125,31,16,45,49
1987-02-12,GOS,112,25,25,BOS,134,35,12,60,37
1987-02-12,NJN,99,12,36,HOU,121,25,22,37,58
1987-02-12,CLE,109,19,30,DET,113,30,16,49,46
1987-02-12,MIL,106,30,21,SEA,104,25,23,55,44
1987-02-12,DEN,115,22,27,WAS,121,25,22,47,49
1987-02-13,SAN,96,18,31,LAC,110,7,40,25,71
1987-02-13,CHI,106,23,23,SEA,98,25,24,48,47
1987-02-13,POR,116,30,20,BOS,131,36,12,66,32
1987-02-13,PHX,105,21,29,UTH,98,28,19,49,48
1987-02-13,LAL,113,36,12,IND,108,23,25,59,37
1987-02-14,DAL,138,31,17,LAC,107,8,40,39,57
1987-02-14,NYK,108,15,34,CHI,112,24,23,39,57
1987-02-14,DET,125,31,16,PHL,107,28,21,59,37
1987-02-14,DEN,129,22,28,IND,113,23,26,45,54
1987-02-14,UTH,108,28,20,SAN,95,18,32,46,52
1987-02-14,GOS,103,25,26,ATL,96,31,16,56,42
1987-02-14,SAC,136,15,33,WAS,111,26,22,41,55
1987-02-14,MIL,116,31,21,HOU,101,26,22,57,43
1987-02-15,NJN,120,11,34,CLE,104,18,27,29,61
1987-02-15,LAL,106,37,12,BOS,103,37,12,74,24
1987-02-15,POR,98,30,21,ATL,93,31,17,61,38
1987-02-16,NYK,101,15,35,PHL,111,28,22,43,57
1987-02-16,CLE,105,19,31,SEA,94,25,25,44,56
1987-02-16,PHX,110,22,29,WAS,124,26,23,48,52
1987-02-16,MIL,128,32,21,NJN,124,12,37,44,58
1987-02-16,LAC,105,8,41,POR,110,31,21,39,62
1987-02-16,CHI,120,25,23,SAC,124,16,33,41,56
1987-02-16,HOU,105,26,23,DAL,100,32,17,58,40
1987-02-16,UTH,109,29,20,BOS,89,37,13,66,33
1987-02-16,IND,112,23,27,GOS,93,26,26,49,53
1987-02-17,SAN,131,18,33,DEN,126,23,28,41,61
1987-02-17,ATL,107,31,18,DET,103,32,16,63,34
1987-02-17,LAL,99,38,12,WAS,114,27,23,65,35
1987-02-18,PHL,114,29,22,GOS,103,26,27,55,49
1987-02-18,UTH,109,30,20,MIL,113,33,21,63,41
1987-02-18,DAL,96,32,18,BOS,113,37,14,69,32
1987-02-18,IND,105,24,27,SEA,88,25,26,49,53
1987-02-18,CLE,129,20,31,SAC,119,17,33,37,64
1987-02-18,DEN,122,23,29,LAL,128,38,13,61,42
1987-02-19,NYK,120,15,36,CLE,105,21,31,36,67
1987-02-19,PHX,108,22,30,POR,124,32,21,54,51
1987-02-19,NJN,106,12,38,GOS,110,26,28,38,66
1987-02-19,HOU,92,27,23,BOS,99,38,14,65,37
1987-02-19,DET,117,32,17,SEA,105,25,27,57,44
1987-02-20,LAC,121,8,42,DEN,107,23,30,31,72
1987-02-20,DAL,122,32,19,SAN,107,19,33,51,52
1987-02-20,CHI,100,25,24,LAL,110,39,13,64,37
1987-02-20,PHL,123,30,22,SAC,91,17,34,47,56
1987-02-20,UTH,113,30,21,WAS,118,28,23,58,44
1987-02-20,ATL,105,32,18,IND,107,25,27,57,45
1987-02-21,DAL,122,33,19,GOS,111,27,28,60,47
1987-02-21,DET,102,33,17,ATL,97,32,19,65,36
1987-02-21,PHX,107,22,31,MIL,115,34,21,56,52
1987-02-21,HOU,94,27,24,UTH,81,30,22,57,46
1987-02-21,NJN,111,12,39,NYK,107,16,36,28,75
1987-02-21,SEA,110,25,28,WAS,93,29,23,54,51
1987-02-21,SAN,113,19,34,BOS,121,39,14,58,48
1987-02-22,IND,103,26,27,SAC,101,17,35,43,62
1987-02-22,PHL,110,31,22,LAL,112,40,13,71,35
1987-02-22,DET,122,34,17,NYK,110,16,37,50,54
1987-02-22,CHI,102,25,25,CLE,98,21,32,46,57
1987-02-22,POR,124,33,21,MIL,120,35,21,68,42
1987-02-23,GOS,95,27,29,DAL,121,34,19,61,48
1987-02-23,CLE,109,21,33,WAS,105,29,24,50,57
1987-02-23,HOU,124,28,24,DEN,108,23,31,51,55
1987-02-23,SEA,124,26,28,LAC,112,9,42,35,70
1987-02-23,BOS,116,40,14,NJN,103,14,39,54,53
1987-02-23,ATL,112,32,20,PHL,103,31,23,63,43
1987-02-24,PHX,93,22,32,LAL,97,41,13,63,45
1987-02-24,CHI,113,26,25,ATL,103,33,20,59,45
1987-02-24,DEN,134,23,32,HOU,105,29,24,52,56
1987-02-24,SAN,106,19,35,SAC,112,17,36,36,71
1987-02-24,UTH,133,30,23,SEA,103,27,28,57,51
1987-02-24,MIL,120,35,22,IND,114,27,28,62,50
1987-02-24,NYK,109,16,38,POR,122,34,21,50,59
1987-02-24,NJN,112,14,40,DET,120,35,17,49,57
1987-02-25,BOS,122,41,14,POR,116,35,21,76,35
1987-02-25,DAL,108,35,19,SAC,101,18,36,53,55
1987-02-25,DET,106,36,17,CLE,105,22,33,58,50
1987-02-25,LAL,99,42,13,PHX,91,22,33,64,46
1987-02-26,UTH,84,31,23,HOU,85,29,25,60,48
1987-02-26,GOS,129,27,30,LAC,108,9,43,36,73
1987-02-26,SEA,106,27,29,DEN,100,24,32,51,61
1987-02-26,SAN,96,19,36,PHL,94,31,24,50,60
1987-02-26,CHI,128,27,25,NJN,113,14,41,41,66
1987-02-26,WAS,100,29,25,IND,94,27,29,56,54
1987-02-27,NJN,125,13,39,IND,115,27,27,40,66
1987-02-27,DET,111,37,17,POR,123,35,22,72,39
1987-02-27,ATL,115,33,21,BOS,105,42,14,75,35
1987-02-27,DAL,123,36,19,PHL,110,31,25,67,44
1987-02-27,LAL,121,43,13,GOS,109,28,30,71,43
1987-02-28,UTH,107,31,24,LAL,100,44,13,75,37
1987-02-28,PHX,105,22,34,SEA,112,28,29,50,63
1987-02-28,SAN,123,20,36,DAL,98,37,19,57,55
1987-02-28,DEN,117,24,33,CLE,119,22,34,46,67
1987-02-28,CHI,107,28,25,MIL,104,36,22,64,47
1987-02-28,LAC,111,9,44,SAC,106,18,37,27,81
1987-02-28,ATL,123,34,21,POR,102,36,22,70,43
1987-02-28,WAS,137,30,25,NYK,117,16,39,46,64
1987-03-01,NJN,105,14,42,CHI,95,29,25,43,67
1987-03-01,IND,122,27,30,NYK,115,16,40,43,70
1987-03-01,BOS,112,42,15,DET,102,37,18,79,33
1987-03-01,HOU,97,30,25,PHL,102,31,26,61,51
1987-03-02,SAN,100,21,36,HOU,105,30,26,51,62
1987-03-02,DEN,114,24,34,SAC,117,18,38,42,72
1987-03-02,ATL,121,35,21,WAS,99,31,25,66,46
1987-03-02,SEA,123,29,29,CLE,107,23,34,52,63
1987-03-02,DAL,135,37,20,PHX,112,22,35,59,55
1987-03-03,NYK,99,16,41,UTH,86,32,24,48,65
1987-03-03,IND,108,28,30,ATL,109,36,21,64,51
1987-03-03,CHI,114,29,26,LAC,80,10,44,39,70
1987-03-03,POR,127,36,23,CLE,122,23,35,59,58
1987-03-03,GOS,109,28,31,LAL,114,44,14,72,45
1987-03-04,PHL,99,32,26,NYK,102,17,41,49,67
1987-03-04,DET,120,37,19,CHI,125,30,26,67,45
1987-03-04,BOS,123,43,15,UTH,105,32,25,75,40
1987-03-04,MIL,110,36,23,LAC,100,10,45,46,68
1987-03-04,LAL,138,45,14,SEA,124,30,29,75,43
1987-03-04,DAL,115,38,20,DEN,107,24,35,62,55
1987-03-04,SAC,102,19,38,HOU,108,31,26,50,64
1987-03-04,WAS,117,31,26,NJN,114,15,42,46,68
1987-03-05,DEN,121,24,36,SAN,104,21,37,45,73
1987-03-05,GOS,105,28,32,HOU,96,32,26,60,58
1987-03-05,SEA,127,30,30,POR,122,37,23,67,53
1987-03-05,PHX,126,22,36,CLE,102,23,36,45,72
1987-03-06,NJN,83,15,43,ATL,111,37,21,52,64
1987-03-06,BOS,132,44,15,LAC,111,10,46,54,61
1987-03-06,PHL,123,32,27,WAS,113,32,26,64,53
1987-03-06,CHI,109,31,26,NYK,110,18,41,49,67
1987-03-06,DET,125,37,20,DAL,115,39,20,76,40
1987-03-06,MIL,123,37,23,UTH,124,32,26,69,49
1987-03-06,SAN,130,21,38,SAC,119,19,39,40,77
1987-03-07,NYK,115,19,41,LAC,93,10,47,29,88
1987-03-07,LAL,122,46,14,CLE,118,23,37,69,51
1987-03-07,ATL,122,38,21,UTH,97,33,26,71,47
1987-03-07,PHX,105,23,36,SAC,102,19,40,42,76
1987-03-07,SEA,118,31,30,HOU,115,32,27,63,57
1987-03-07,IND,120,28,31,MIL,124,37,24,65,55
1987-03-07,PHL,102,33,27,NJN,114,15,44,48,71
1987-03-08,POR,119,37,24,HOU,93,32,28,69,52
1987-03-08,DET,122,38,20,BOS,119,45,15,83,35
1987-03-08,CHI,115,31,27,DAL,105,39,21,70,48
1987-03-08,GOS,137,29,32,SAN,111,22,38,51,70
1987-03-09,MIL,118,38,24,PHX,110,24,36,62,60
1987-03-09,IND,107,28,32,UTH,102,33,27,61,59
1987-03-09,ATL,108,39,21,CHI,103,32,27,71,48
1987-03-09,LAC,114,10,48,LAL,136,47,14,57,62
1987-03-10,SAN,106,22,39,ATL,113,40,21,62,60
1987-03-10,NYK,93,20,41,DET,116,39,20,59,61
1987-03-10,HOU,127,32,29,SEA,136,32,30,64,59
1987-03-10,NJN,121,16,44,WAS,79,32,27,48,71
1987-03-10,CLE,91,23,38,PHL,100,33,28,56,66
1987-03-10,GOS,125,30,32,SAC,114,19,41,49,73
1987-03-10,LAL,143,48,14,DEN,107,25,36,73,50
1987-03-11,LAC,111,10,49,GOS,121,31,32,41,81
1987-03-11,DAL,130,39,22,SEA,117,33,30,72,52
1987-03-11,IND,98,29,32,DET,107,40,20,69,52
1987-03-11,BOS,118,45,16,PHX,109,24,37,69,53
1987-03-11,WAS,107,32,28,MIL,115,39,24,71,52
1987-03-11,DEN,122,25,37,UTH,116,33,28,58,65
1987-03-11,PHL,117,34,28,CHI,108,32,28,66,56
1987-03-12,LAL,125,49,14,POR,116,38,24,87,38
1987-03-12,NJN,123,17,44,MIL,106,40,24,57,68
1987-03-12,HOU,121,32,30,SAN,112,22,40,54,70
1987-03-12,SAC,109,19,42,UTH,113,33,29,52,71
1987-03-12,CLE,116,23,39,PHX,109,24,38,47,77
1987-03-13,DAL,105,40,22,ATL,113,41,21,81,43
1987-03-13,LAC,108,10,50,SEA,104,33,31,43,81
1987-03-13,CHI,99,32,29,DET,100,41,20,73,49
1987-03-13,IND,116,29,33,BOS,109,46,16,75,49
1987-03-13,NYK,121,20,42,NJN,126,18,44,38,86
1987-03-14,DAL,118,40,23,HOU,109,33,30,73,53
1987-03-14,MIL,111,40,25,CLE,104,24,39,64,64
1987-03-14,UTH,123,34,29,SAC,116,19,43,53,72
1987-03-14,WAS,106,32,29,CHI,105,32,30,64,59
1987-03-14,DET,98,42,20,PHL,95,35,28,77,48
1987-03-14,SAN,121,22,41,PHX,108,24,39,46,80
1987-03-15,SAC,107,19,44,SEA,106,33,32,52,76
1987-03-15,IND,123,30,33,NJN,99,19,44,49,77
1987-03-15,POR,119,38,25,GOS,108,32,32,70,57
1987-03-15,BOS,113,46,17,NYK,104,20,43,66,60
1987-03-15,WAS,97,33,29,CLE,89,24,40,57,69
1987-03-15,LAL,115,50,14,LAC,101,11,50,61,64
1987-03-15,DEN,100,26,37,ATL,104,42,21,68,58
1987-03-16,DET,115,43,20,IND,95,31,33,74,53
1987-03-16,HOU,97,33,31,CHI,96,32,31,65,62
1987-03-16,SEA,122,33,33,SAN,111,23,41,56,74
1987-03-17,SAC,106,20,44,SAN,108,23,42,43,86
1987-03-17,UTH,118,35,29,GOS,103,32,33,67,62
1987-03-17,NJN,91,19,45,CLE,110,24,41,43,86
1987-03-17,DAL,114,41,23,CHI,96,32,32,73,55
1987-03-17,LAC,123,11,51,POR,134,39,25,50,76
1987-03-17,NYK,111,20,44,DEN,133,26,38,46,82
1987-03-17,ATL,118,43,21,WAS,98,34,29,77,50
1987-03-17,MIL,123,41,25,BOS,115,47,17,88,42
1987-03-18,BOS,120,47,18,MIL,102,42,25,89,43
1987-03-18,DET,112,44,20,NJN,113,19,46,63,66
1987-03-18,PHX,91,24,40,HOU,113,34,31,58,71
1987-03-18,PHL,109,35,29,ATL,107,44,21,79,50
1987-03-18,LAL,111,51,14,UTH,97,36,29,87,43
1987-03-18,CLE,100,25,41,DEN,104,27,38,52,79
1987-03-19,NYK,111,20,45,IND,105,31,34,51,79
1987-03-19,GOS,125,32,34,POR,124,40,25,72,59
1987-03-19,LAC,97,11,52,CHI,114,32,33,43,85
1987-03-19,WAS,110,34,30,SEA,106,34,33,68,63
1987-03-19,SAC,104,20,45,DAL,105,42,23,62,68
1987-03-20,LAL,147,52,14,SAN,115,24,42,76,56
1987-03-20,ATL,114,44,22,MIL,97,42,26,86,48
1987-03-20,PHL,116,36,29,DEN,106,28,38,64,67
1987-03-20,POR,134,40,26,PHX,105,24,41,64,67
1987-03-20,HOU,126,35,31,LAC,98,11,53,46,84
1987-03-20,BOS,112,48,18,SEA,108,34,34,82,52
1987-03-20,CLE,106,25,42,NJN,105,20,46,45,88
1987-03-21,WAS,107,35,30,DEN,117,28,39,63,69
1987-03-21,DAL,122,43,23,DET,118,44,21,87,44
1987-03-21,IND,77,31,35,CLE,76,26,42,57,77
1987-03-21,UTH,125,36,30,HOU,108,36,31,72,61
1987-03-21,PHX,102,24,42,GOS,105,33,34,57,76
1987-03-21,NYK,85,21,45,ATL,97,45,22,66,67
1987-03-21,MIL,102,42,27,PHL,105,37,29,79,56
1987-03-21,SAC,97,20,46,CHI,112,33,33,53,79
1987-03-22,LAL,129,53,14,SAC,121,20,47,73,61
1987-03-22,LAC,112,11,54,SAN,116,24,43,35,97
1987-03-22,BOS,116,49,18,NJN,104,20,47,69,65
1987-03-22,POR,115,41,26,CHI,113,34,33,75,59
1987-03-23,UTH,122,37,30,DEN,118,29,39,66,69
1987-03-23,PHL,100,38,29,DAL,103,44,23,82,52
1987-03-23,IND,101,32,35,WAS,92,35,31,67,66
1987-03-23,NYK,121,21,46,SEA,126,34,35,55,81
1987-03-23,HOU,110,36,32,DET,114,44,22,80,54
1987-03-24,PHX,108,24,43,LAL,93,54,14,78,57
1987-03-24,BOS,111,50,18,CLE,88,26,43,76,61
1987-03-24,SAN,103,25,43,HOU,97,36,33,61,76
1987-03-24,DEN,128,29,40,LAC,119,11,55,40,95
1987-03-24,MIL,135,42,28,NYK,96,21,47,63,75
1987-03-24,WAS,87,35,32,ATL,96,46,22,81,54
1987-03-24,CHI,93,34,34,PHL,91,38,30,72,64
1987-03-24,SAC,128,20,48,POR,116,42,26,62,74
1987-03-24,NJN,107,20,48,DAL,119,45,23,65,71
1987-03-25,GOS,127,34,34,DET,115,45,22,79,56
1987-03-25,LAC,111,11,56,UTH,101,38,30,49,86
1987-03-25,IND,125,33,35,MIL,108,43,28,76,63
1987-03-26,WAS,106,35,33,BOS,103,51,18,86,51
1987-03-26,NJN,109,20,49,CHI,107,35,34,55,83
1987-03-26,ATL,120,47,22,DAL,112,46,23,93,45
1987-03-26,LAL,128,54,15,DET,111,45,23,99,38
1987-03-26,DEN,123,30,40,SEA,113,35,35,65,75
1987-03-26,SAC,124,21,48,PHX,115,25,43,46,91
1987-03-26,HOU,119,36,34,POR,104,42,27,78,61
1987-03-27,UTH,144,38,31,SAN,133,26,43,64,74
1987-03-27,SEA,105,35,36,GOS,106,35,34,70,70
1987-03-27,CHI,106,35,35,BOS,111,51,19,86,54
1987-03-27,IND,100,34,35,NYK,91,21,48,55,83
1987-03-27,PHL,110,38,31,NJN,99,21,49,59,80
1987-03-27,PHX,130,25,44,LAC,117,12,56,37,100
1987-03-27,CLE,116,26,44,MIL,113,43,29,69,73
1987-03-28,WAS,107,36,33,DAL,114,46,24,82,57
1987-03-28,GOS,116,36,34,UTH,110,39,31,75,65
1987-03-28,ATL,114,48,22,IND,120,35,35,83,57
1987-03-28,HOU,109,37,34,LAL,123,55,15,92,49
1987-03-28,SAC,113,22,48,LAC,91,12,57,34,105
1987-03-28,DEN,109,31,40,DET,121,45,24,76,64
1987-03-29,CHI,115,35,36,NYK,96,21,49,56,85
1987-03-29,SEA,107,35,37,DET,108,46,24,81,61
1987-03-29,SAN,113,26,44,POR,135,42,28,68,72
1987-03-29,BOS,118,52,19,PHL,100,39,31,91,50
1987-03-29,CLE,98,27,44,DAL,101,47,24,74,68
1987-03-31,SEA,132,35,38,SAC,129,23,48,58,86
1987-03-31,POR,113,43,28,DET,111,47,24,90,52
1987-03-31,DAL,118,48,24,LAC,102,12,58,60,82
1987-03-31,LAL,111,56,15,HOU,96,37,35,93,50
1987-03-31,UTH,110,39,32,PHX,95,26,44,65,76
1987-03-31,NYK,128,21,50,BOS,120,53,19,74,69
1987-03-31,CHI,101,36,36,WAS,75,36,34,72,70
1987-03-31,DEN,111,31,41,SAN,106,26,45,57,86
1987-03-31,CLE,105,27,45,PHL,116,39,32,66,77
1987-04-01,IND,99,36,35,CHI,94,37,36,73,71
1987-04-01,BOS,103,53,20,WAS,86,36,35,89,55
1987-04-01,PHL,108,40,32,CLE,99,27,46,67,78
1987-04-01,MIL,104,43,30,ATL,92,48,23,91,53
1987-04-01,SAN,104,26,46,UTH,107,40,32,66,78
1987-04-01,PHX,117,26,45,HOU,104,37,36,63,81
1987-04-01,NJN,121,21,50,NYK,120,22,50,43,100
1987-04-02,DEN,132,32,41,GOS,96,37,34,69,75
1987-04-02,LAC,115,12,59,SAC,125,23,49,35,108
1987-04-02,DET,119,47,25,IND,73,37,35,84,60
1987-04-02,SEA,114,36,38,LAL,117,57,15,93,53
1987-04-03,ATL,126,48,24,NYK,89,22,51,70,75
1987-04-03,NJN,113,22,50,PHL,109,41,32,63,82
1987-04-03,BOS,119,54,20,DET,115,48,25,102,45
1987-04-03,POR,121,44,28,LAL,127,58,15,102,43
1987-04-03,PHX,112,27,45,UTH,98,41,32,68,77
1987-04-03,DAL,136,49,24,GOS,116,37,35,86,59
1987-04-03,SAN,106,26,47,DEN,116,33,41,59,88
1987-04-03,WAS,122,36,36,CHI,118,37,37,73,73
1987-04-04,MIL,112,44,30,NJN,102,23,50,67,80
1987-04-04,CLE,111,27,47,WAS,127,37,36,64,83
1987-04-04,SAC,120,24,49,HOU,108,37,37,61,86
1987-04-04,LAC,123,12,60,PHX,128,28,45,40,105
1987-04-04,NYK,112,22,52,IND,108,37,36,59,88
1987-04-04,SEA,123,36,39,POR,126,44,29,80,68
1987-04-04,DAL,121,50,24,UTH,107,41,33,91,57
1987-04-04,ATL,110,49,24,CHI,97,37,38,86,62
1987-04-05,DET,125,48,26,MIL,107,45,30,93,56
1987-04-05,DEN,118,34,41,LAL,126,59,15,93,56
1987-04-05,PHL,106,41,33,BOS,104,55,20,96,53
1987-04-05,SAN,119,26,48,GOS,120,37,36,63,84
1987-04-06,PHX,118,29,45,DAL,110,51,24,80,69
1987-04-06,ATL,110,50,24,CLE,105,27,48,77,72
1987-04-06,LAL,135,60,15,LAC,112,12,61,72,76
1987-04-06,UTH,104,41,34,SAC,110,25,49,66,83
1987-04-06,POR,108,45,29,HOU,114,37,38,82,67
1987-04-06,NYK,108,23,52,PHL,101,42,33,65,85
1987-04-07,SEA,125,36,40,PHX,127,30,45,66,85
1987-04-07,IND,128,37,37,NJN,114,23,51,60,88
1987-04-07,CHI,116,37,39,DET,86,49,26,86,65
1987-04-07,GOS,126,38,36,DEN,129,34,42,72,78
1987-04-07,WAS,94,38,36,MIL,95,45,31,83,67
1987-04-07,LAC,84,12,62,HOU,102,38,38,50,100
1987-04-07,CLE,107,27,49,BOS,83,55,21,82,70
1987-04-08,SAN,110,26,49,SAC,111,26,49,52,98
1987-04-08,UTH,103,41,35,DAL,90,51,25,92,60
1987-04-08,ATL,110,51,24,PHL,92,42,34,93,58
1987-04-08,NJN,109,23,52,WAS,118,38,37,61,89
1987-04-09,CLE,111,28,49,IND,99,38,37,66,86
1987-04-09,HOU,112,39,38,SAC,102,27,49,66,87
1987-04-09,PHX,128,31,45,POR,122,45,30,76,75
1987-04-09,GOS,100,38,37,DAL,125,51,26,89,63
1987-04-09,LAC,100,12,63,LAL,118,61,15,73,78
1987-04-10,WAS,101,39,37,IND,115,38,38,77,75
1987-04-10,UTH,106,42,35,DEN,103,35,42,77,77
1987-04-10,NJN,117,23,53,BOS,108,55,22,78,75
1987-04-10,PHL,98,42,35,CHI,96,38,39,80,74
1987-04-10,POR,121,45,31,SEA,115,36,41,81,72
1987-04-10,ATL,101,52,24,DET,99,49,27,101,51
1987-04-10,NYK,93,24,52,MIL,132,46,31,70,83
1987-04-10,LAL,131,62,15,SAN,121,26,50,88,65
1987-04-11,MIL,121,47,31,CLE,93,29,49,76,80
1987-04-11,HOU,113,40,38,DEN,103,35,43,75,81
1987-04-11,SAC,118,27,50,GOS,124,38,38,65,88
1987-04-11,LAC,100,12,64,DAL,129,52,26,64,90
1987-04-11,PHX,136,32,45,SAN,116,26,51,58,96
1987-04-12,WAS,103,39,38,DET,98,49,28,88,66
1987-04-12,CHI,116,38,40,IND,95,39,38,77,78
1987-04-12,GOS,107,39,38,UTH,109,43,35,82,73
1987-04-12,POR,113,46,31,LAC,100,12,65,58,96
1987-04-12,BOS,119,55,23,NYK,107,24,53,79,76
1987-04-12,NJN,88,24,53,ATL,115,53,24,77,77
1987-04-12,LAL,119,63,15,PHX,104,33,45,96,60
1987-04-13,MIL,107,48,31,CHI,114,39,40,87,71
1987-04-13,SAC,123,27,51,SAN,118,26,52,53,103
1987-04-13,NYK,100,24,54,DET,120,49,29,73,83
1987-04-13,PHL,113,43,35,WAS,105,40,38,83,73
1987-04-13,IND,101,39,39,ATL,102,54,24,93,63
1987-04-14,LAC,108,12,66,GOS,117,39,39,51,105
1987-04-14,CLE,113,29,50,NJN,95,24,54,53,104
1987-04-14,PHX,132,33,46,SAC,123,28,51,61,97
1987-04-14,DEN,142,35,44,POR,114,47,31,82,75
1987-04-14,SEA,103,36,42,UTH,102,44,35,80,77
1987-04-15,DAL,113,53,26,HOU,107,41,38,94,64
1987-04-15,DET,118,50,29,NYK,114,24,55,74,84
1987-04-15,SAN,123,26,53,POR,112,47,32,73,85
1987-04-15,MIL,128,48,32,PHL,95,44,35,92,67
1987-04-15,IND,85,39,40,BOS,108,56,23,95,63
1987-04-15,ATL,136,55,24,NJN,116,24,55,79,79
1987-04-15,GOS,116,40,39,PHX,119,34,46,74,85
1987-04-15,WAS,110,40,39,CLE,101,30,50,70,89
1987-04-16,CHI,114,40,40,ATL,117,56,24,96,64
1987-04-16,UTH,97,44,36,LAL,110,64,15,108,51
1987-04-16,SAC,123,28,52,DEN,117,36,44,64,96
1987-04-16,LAC,87,12,67,SEA,118,37,42,49,109
1987-04-17,NYK,110,24,56,WAS,142,41,39,65,95
1987-04-17,SAN,115,27,53,LAL,103,65,15,92,68
1987-04-17,BOS,108,57,23,CHI,105,40,41,97,64
1987-04-17,HOU,121,41,39,DAL,99,54,26,95,65
1987-04-17,DET,130,51,29,NJN,117,24,56,75,85
1987-04-17,PHL,111,44,36,IND,115,39,41,83,77
1987-04-17,POR,111,47,33,UTH,101,44,37,91,70
1987-04-18,NJN,103,24,57,IND,112,40,41,64,98
1987-04-18,SEA,127,38,42,GOS,132,40,40,78,82
1987-04-18,CLE,122,30,51,NYK,113,24,57,54,108
1987-04-18,MIL,124,49,32,DET,110,52,29,101,61
1987-04-18,PHX,121,35,46,LAC,106,12,68,47,114
1987-04-18,DEN,126,36,45,HOU,117,42,39,78,84
1987-04-18,DAL,125,54,27,SAC,121,29,52,83,79
1987-04-19,WAS,102,42,39,PHL,108,44,37,86,76
1987-04-19,LAL,104,65,16,SEA,110,38,43,103,59
1987-04-19,POR,144,48,33,SAN,134,28,53,76,86
1987-04-19,GOS,105,41,40,LAC,85,12,69,53,109
1987-04-19,BOS,118,58,23,ATL,107,57,24,115,47
1987-11-06,SAC,134,0,0,GOS,106,0,0,0,0
1987-11-06,DAL,95,0,0,UTH,93,0,0,0,0
1987-11-06,PHL,108,0,0,IND,95,0,0,0,0
1987-11-06,LAL,113,0,0,SEA,109,0,0,0,0
1987-11-06,DEN,139,0,0,LAC,93,0,0,0,0
1987-11-06,NJN,108,0,0,CLE,114,0,0,0,0
1987-11-06,ATL,114,0,0,WAS,97,0,0,0,0
1987-11-06,BOS,125,0,0,MIL,108,0,0,0,0
1987-11-06,HOU,108,0,0,SAN,102,0,0,0,0
1987-11-06,DET,110,0,0,NYK,99,0,0,0,0
1987-11-06,POR,118,0,0,PHX,104,0,0,0,0
1987-11-07,MIL,119,0,1,DET,105,1,0,1,1
1987-11-07,IND,108,0,1,NYK,95,0,1,0,2
1987-11-07,ATL,113,1,0,CLE,105,1,0,2,0
1987-11-07,LAC,99,0,1,POR,124,1,0,1,1
1987-11-07,CHI,104,0,0,PHL,94,1,0,1,0
1987-11-07,SAN,130,0,1,DAL,106,1,0,1,1
1987-11-07,SEA,112,0,1,PHX,96,0,1,0,2
1987-11-07,GOS,99,0,1,DEN,103,1,0,1,1
1987-11-07,WAS,139,0,1,BOS,140,1,0,1,1
1987-11-07,UTH,121,0,1,SAC,100,1,0,1,1
1987-11-08,LAL,101,1,0,HOU,92,1,0,2,0
1987-11-09,NYK,87,0,2,BOS,96,2,0,2,2
1987-11-10,SEA,101,1,1,DAL,117,1,1,2,2
1987-11-10,LAC,100,0,2,UTH,88,1,1,1,3
1987-11-10,MIL,115,1,1,WAS,100,0,2,1,3
1987-11-10,SAC,134,1,1,DEN,123,2,0,3,1
1987-11-10,IND,121,1,1,DET,118,1,1,2,2
1987-11-10,ATL,95,2,0,CHI,105,1,0,3,0
1987-11-10,SAN,124,1,1,LAL,133,2,0,3,1
1987-11-10,PHX,123,0,2,GOS,109,0,2,0,4
1987-11-10,POR,111,2,0,HOU,118,1,1,3,1
1987-11-11,BOS,120,3,0,IND,106,2,1,5,1
1987-11-11,NYK,93,0,3,ATL,94,2,1,2,4
1987-11-11,CLE,101,1,1,MIL,109,2,1,3,2
1987-11-11,GOS,130,0,3,PHX,115,1,2,1,5
1987-11-11,UTH,121,1,2,DAL,92,2,1,3,3
1987-11-11,NJN,96,0,1,CHI,105,2,0,2,1
1987-11-12,DEN,126,2,1,POR,113,2,1,4,2
1987-11-12,LAL,111,3,0,LAC,82,1,2,4,2
1987-11-12,SAN,123,1,2,SEA,118,1,2,2,4
1987-11-12,SAC,114,2,1,HOU,116,2,1,4,2
1987-11-13,WAS,108,1,3,NYK,101,0,4,1,7
1987-11-13,CHI,103,3,0,NJN,85,0,2,3,2
1987-11-13,BOS,128,4,0,CLE,114,1,2,5,2
1987-11-13,DAL,95,2,2,SEA,103,1,3,3,5
1987-11-13,LAC,97,1,3,GOS,94,1,3,2,6
1987-11-13,UTH,109,2,2,PHX,92,1,3,3,5
1987-11-13,PHL,94,1,2,DET,113,1,2,2,4
1987-11-14,CHI,110,4,0,IND,111,2,2,6,2
1987-11-14,CLE,113,1,3,DET,128,2,2,3,5
1987-11-14,DAL,127,2,3,POR,116,2,2,4,5
1987-11-14,NYK,93,0,5,MIL,89,3,1,3,6
1987-11-14,ATL,104,3,1,PHL,83,1,3,4,4
1987-11-14,PHX,124,1,4,SAN,113,2,2,3,6
1987-11-14,GOS,110,1,4,LAL,118,4,0,5,4
1987-11-14,HOU,101,3,1,UTH,93,3,2,6,3
1987-11-14,DEN,130,3,1,SAC,109,2,2,5,3
1987-11-15,NJN,109,0,3,WAS,113,2,3,2,6
1987-11-15,HOU,108,4,1,SEA,106,2,3,6,4
1987-11-15,MIL,112,3,2,ATL,103,4,1,7,3
1987-11-15,LAL,147,5,0,SAN,130,2,3,7,3
1987-11-15,IND,98,3,2,BOS,103,5,0,8,2
1987-11-17,SAC,111,2,3,IND,126,3,3,5,6
1987-11-17,CLE,109,1,4,BOS,88,6,0,7,4
1987-11-17,MIL,120,4,2,GOS,108,1,5,5,7
1987-11-17,UTH,120,3,3,DEN,110,4,1,7,4
1987-11-17,NJN,114,0,4,HOU,111,5,1,5,5
1987-11-17,CHI,105,4,1,WAS,101,3,3,7,4
1987-11-17,SAN,122,2,4,LAC,121,2,3,4,7
1987-11-17,LAL,142,6,0,POR,115,2,3,8,3
1987-11-18,SEA,120,2,4,POR,114,2,4,4,8
1987-11-18,ATL,95,4,2,GOS,92,1,6,5,8
1987-11-18,DET,109,3,2,PHL,113,1,4,4,6
1987-11-18,DEN,106,4,2,IND,117,4,3,8,5
1987-11-18,BOS,111,6,1,NYK,109,1,5,7,6
1987-11-18,PHX,90,2,4,UTH,80,4,3,6,7
1987-11-18,WAS,82,3,4,CHI,84,5,1,8,5
1987-11-18,DAL,97,3,3,LAC,87,2,4,5,7
1987-11-19,SAC,113,2,4,MIL,117,5,2,7,6
1987-11-19,CLE,97,2,4,HOU,105,5,2,7,6
1987-11-19,NJN,108,1,4,NYK,107,1,6,2,10
1987-11-20,DEN,156,4,3,SAN,142,3,4,7,7
1987-11-20,POR,120,2,5,WAS,101,3,5,5,10
1987-11-20,PHL,116,2,4,BOS,85,7,1,9,5
1987-11-20,PHX,96,3,4,LAC,112,2,5,5,9
1987-11-20,SEA,99,3,4,MIL,97,6,2,9,6
1987-11-20,DET,131,3,3,GOS,108,1,7,4,10
1987-11-20,UTH,112,4,4,IND,81,5,3,9,7
1987-11-20,LAL,119,7,0,DAL,116,4,3,11,3
1987-11-20,CHI,94,6,1,ATL,92,5,2,11,3
1987-11-21,LAC,91,3,5,DEN,97,5,3,8,8
1987-11-21,NYK,99,1,7,GOS,91,1,8,2,15
1987-11-21,CLE,101,2,5,PHL,88,3,4,5,9
1987-11-21,SEA,124,4,4,WAS,103,3,6,7,10
1987-11-21,ATL,104,5,3,HOU,94,6,2,11,5
1987-11-21,SAC,96,2,5,DAL,103,4,4,6,9
1987-11-21,NJN,97,2,4,BOS,107,7,2,9,6
1987-11-21,SAN,120,3,5,UTH,119,5,4,8,9
1987-11-21,CHI,132,7,1,DET,144,4,3,11,4
1987-11-22,POR,120,3,5,IND,110,5,4,8,9
1987-11-22,LAL,116,8,0,MIL,124,6,3,14,3
1987-11-23,BOS,102,8,2,CHI,107,7,2,15,4
1987-11-23,NYK,112,2,7,SAN,117,4,5,6,12
1987-11-24,HOU,83,6,3,DET,97,5,3,11,6
1987-11-24,SEA,103,5,4,LAL,85,8,1,13,5
1987-11-24,POR,98,4,5,SAC,94,2,6,6,11
1987-11-24,UTH,100,5,5,WAS,83,3,7,8,12
1987-11-24,PHL,108,3,5,CLE,104,3,5,6,10
1987-11-24,GOS,120,1,9,LAC,123,3,6,4,15
1987-11-24,DEN,132,6,3,NJN,104,2,5,8,8
1987-11-25,IND,133,5,5,SAN,102,5,5,10,10
1987-11-25,LAC,96,4,6,WAS,101,3,8,7,14
1987-11-25,BOS,117,8,3,ATL,102,6,3,14,6
1987-11-25,MIL,101,7,3,CHI,103,8,2,15,5
1987-11-25,DAL,113,5,4,DET,107,6,3,11,7
1987-11-25,PHX,103,3,5,HOU,109,6,4,9,9
1987-11-25,CLE,101,3,6,NYK,104,2,8,5,14
1987-11-26,SAC,110,2,7,NJN,102,2,6,4,13
1987-11-27,GOS,109,1,10,PHL,103,4,5,5,15
1987-11-27,POR,97,5,5,LAC,87,4,7,9,12
1987-11-27,LAL,127,8,2,DEN,119,7,3,15,5
1987-11-27,BOS,117,9,3,SEA,112,6,4,15,7
1987-11-27,PHX,113,3,6,NJN,107,2,7,5,13
1987-11-27,DAL,94,6,4,CHI,93,9,2,15,6
1987-11-27,UTH,118,6,5,HOU,96,7,4,13,9
1987-11-27,IND,88,6,5,ATL,86,6,4,12,9
1987-11-27,DET,143,6,4,SAN,111,5,6,11,10
1987-11-28,DEN,106,7,4,DAL,98,7,4,14,8
1987-11-28,WAS,124,4,8,DET,102,7,4,11,12
1987-11-28,MIL,112,7,4,BOS,97,10,3,17,7
1987-11-28,HOU,86,7,5,CHI,98,9,3,16,8
1987-11-28,IND,131,7,5,SEA,115,6,5,13,10
1987-11-28,NYK,105,3,8,CLE,93,3,7,6,15
1987-11-28,SAC,115,3,7,PHL,114,4,6,7,13
1987-11-28,ATL,124,6,5,SAN,100,5,7,11,12
1987-11-29,POR,125,6,5,NJN,104,2,8,8,13
1987-11-30,UTH,100,7,5,PHL,106,4,7,11,12
1987-11-30,MIL,104,8,4,IND,94,8,5,16,9
1987-12-01,SAC,120,4,7,LAL,125,9,2,13,9
1987-12-01,HOU,106,7,6,DEN,101,8,4,15,10
1987-12-01,GOS,97,2,10,CHI,98,10,3,12,13
1987-12-01,NYK,109,4,8,SEA,112,6,6,10,14
1987-12-01,POR,102,7,5,PHX,100,4,6,11,11
1987-12-01,NJN,115,2,9,DET,124,7,5,9,14
1987-12-01,ATL,120,7,5,BOS,106,10,4,17,9
1987-12-02,SAN,97,5,8,HOU,93,8,6,13,14
1987-12-02,BOS,130,10,5,NJN,99,2,10,12,15
1987-12-02,LAC,88,4,8,PHL,85,5,7,9,15
1987-12-02,IND,108,8,6,WAS,102,5,8,13,14
1987-12-02,CLE,104,3,8,SEA,102,7,6,10,14
1987-12-02,DET,115,8,5,MIL,105,9,4,17,9
1987-12-02,DEN,147,8,5,SAC,120,4,8,12,13
1987-12-02,UTH,101,7,6,CHI,105,11,3,18,9
1987-12-02,LAL,104,10,2,POR,117,8,5,18,7
1987-12-03,WAS,94,5,9,ATL,102,8,5,13,14
1987-12-03,PHX,120,4,7,NYK,114,4,9,8,16
1987-12-04,DAL,116,7,5,GOS,95,2,11,9,16
1987-12-04,DEN,105,9,5,CHI,89,12,3,21,8
1987-12-04,ATL,139,9,5,NJN,102,2,11,11,16
1987-12-04,LAC,98,5,8,SAC,84,4,9,9,17
1987-12-04,DET,128,9,5,BOS,105,11,5,20,10
1987-12-04,PHL,118,5,8,SEA,105,7,7,12,15
1987-12-04,MIL,85,9,5,LAL,83,10,3,19,8
1987-12-04,IND,90,9,6,CLE,108,4,8,13,14
1987-12-04,UTH,104,7,7,NYK,92,4,10,11,17
1987-12-05,PHX,115,5,7,POR,133,9,5,14,12
1987-12-05,SAC,117,4,10,UTH,126,8,7,12,17
1987-12-05,WAS,99,5,10,SEA,115,7,8,12,18
1987-12-05,DAL,109,8,5,DEN,96,10,5,18,10
1987-12-05,CLE,97,5,8,LAL,95,10,4,15,12
1987-12-05,SAN,110,6,8,CHI,101,12,4,18,12
1987-12-05,HOU,121,8,7,GOS,96,2,12,10,19
1987-12-06,POR,117,10,5,NYK,99,4,11,14,16
1987-12-06,LAC,96,6,8,PHX,97,5,8,11,16
1987-12-08,SEA,107,8,8,CLE,96,6,8,14,16
1987-12-08,IND,103,9,7,MIL,101,10,5,19,12
1987-12-08,CHI,96,12,5,PHL,109,6,8,18,13
1987-12-08,NYK,116,4,12,WAS,92,5,11,9,23
1987-12-08,SAN,105,7,8,UTH,100,9,7,16,15
1987-12-08,NJN,81,2,12,LAL,98,10,5,12,17
1987-12-08,LAC,79,6,9,ATL,90,10,5,16,14
1987-12-08,HOU,106,9,7,SAC,97,4,11,13,18
1987-12-08,DET,127,10,5,POR,117,11,5,21,10
1987-12-09,DAL,125,9,5,SAC,98,4,12,13,17
1987-12-09,WAS,120,5,12,LAL,112,11,5,16,17
1987-12-09,PHX,117,6,8,ATL,105,11,5,17,13
1987-12-09,BOS,119,11,6,DEN,124,10,6,21,12
1987-12-09,GOS,113,2,13,CLE,112,6,9,8,22
1987-12-09,PHL,94,7,8,POR,86,11,6,18,14
1987-12-10,NJN,91,2,13,IND,108,10,7,12,20
1987-12-10,HOU,98,10,7,UTH,93,9,8,19,15
1987-12-10,CHI,111,12,6,MIL,105,10,6,22,12
1987-12-10,NYK,113,5,12,DEN,97,11,6,16,18
1987-12-10,LAC,113,6,10,SEA,96,9,8,15,18
1987-12-11,MIL,125,10,7,POR,112,11,7,21,14
1987-12-11,DET,114,11,5,WAS,108,6,12,17,17
1987-12-11,GOS,93,3,13,ATL,109,11,6,14,19
1987-12-11,SAC,113,4,13,CLE,115,6,10,10,23
1987-12-11,DAL,108,10,5,PHX,104,7,8,17,13
1987-12-11,BOS,114,11,7,LAL,115,11,6,22,13
1987-12-12,PHL,121,8,8,DEN,131,11,7,19,15
1987-12-12,CHI,112,13,6,HOU,103,11,7,24,13
1987-12-12,SEA,116,9,9,LAC,95,7,10,16,19
1987-12-12,UTH,127,9,9,GOS,93,3,14,12,23
1987-12-12,DET,124,12,5,NYK,96,6,12,18,17
1987-12-12,SAN,129,8,8,PHX,110,7,9,15,17
1987-12-12,IND,101,11,7,POR,108,11,8,22,15
1987-12-12,NJN,107,2,14,WAS,122,6,13,8,27
1987-12-13,MIL,99,11,7,DAL,113,11,5,22,12
1987-12-13,LAL,90,12,6,CLE,89,7,10,19,16
1987-12-13,SAC,100,4,14,ATL,106,12,6,16,20
1987-12-14,UTH,116,10,9,SEA,95,10,9,20,18
1987-12-15,ATL,93,13,6,IND,91,11,8,24,14
1987-12-15,NYK,98,6,13,MIL,103,11,8,17,21
1987-12-15,SAC,128,4,15,LAC,108,7,11,11,26
1987-12-15,WAS,102,7,13,BOS,122,11,8,18,21
1987-12-15,DET,127,13,5,CHI,123,14,6,27,11
1987-12-15,POR,128,12,8,SEA,109,10,10,22,18
1987-12-15,CLE,106,7,11,DAL,93,12,5,19,16
1987-12-15,LAL,122,13,6,PHX,97,7,10,20,16
1987-12-15,NJN,104,2,15,SAN,98,9,8,11,23
1987-12-16,DEN,132,12,7,HOU,113,11,8,23,15
1987-12-16,BOS,121,12,8,UTH,111,11,9,23,17
1987-12-16,PHL,114,8,9,SAN,102,9,9,17,18
1987-12-16,NJN,105,3,15,DAL,109,12,6,15,21
1987-12-17,LAC,98,7,12,HOU,92,11,9,18,21
1987-12-17,CHI,111,14,7,CLE,100,8,11,22,18
1987-12-17,SEA,114,10,11,SAC,109,5,15,15,26
1987-12-17,WAS,115,7,14,IND,111,11,9,18,23
1987-12-17,GOS,106,3,15,LAL,113,14,6,17,21
1987-12-17,NYK,96,6,14,PHL,106,9,9,15,23
1987-12-18,IND,121,11,10,UTH,97,11,10,22,20
1987-12-18,PHX,114,7,11,POR,129,13,8,20,19
1987-12-18,MIL,87,12,8,ATL,94,14,6,26,14
1987-12-18,SAN,133,9,10,DEN,114,13,7,22,17
1987-12-18,CLE,103,8,12,NJN,94,3,16,11,28
1987-12-18,DET,117,14,5,DAL,112,13,6,27,11
1987-12-19,LAC,97,8,12,LAL,108,15,6,23,18
1987-12-19,HOU,117,11,10,DEN,121,13,8,24,18
1987-12-19,PHL,95,10,9,DAL,90,13,7,23,16
1987-12-19,NYK,125,6,15,NJN,93,3,17,9,32
1987-12-19,GOS,102,3,16,SEA,129,11,11,14,27
1987-12-19,WAS,109,8,14,CHI,96,15,7,23,21
1987-12-19,ATL,130,15,6,UTH,124,11,11,26,17
1987-12-20,LAL,103,16,6,SEA,94,12,11,28,17
1987-12-20,BOS,124,13,8,PHL,87,11,9,24,17
1987-12-20,POR,148,14,8,SAN,126,10,10,24,18
1987-12-20,CLE,127,9,12,IND,116,12,10,21,22
1987-12-20,SAC,109,5,16,PHX,120,7,12,12,28
1987-12-21,NJN,106,3,18,UTH,95,11,12,14,30
1987-12-22,DEN,119,14,8,PHX,104,8,12,22,20
1987-12-22,WAS,102,9,14,CLE,106,10,12,19,26
1987-12-22,POR,136,15,8,GOS,91,3,17,18,25
1987-12-22,MIL,122,12,9,NYK,105,7,15,19,24
1987-12-22,PHL,115,11,10,BOS,118,14,8,25,18
1987-12-22,SAC,120,5,17,SAN,96,10,11,15,28
1987-12-22,HOU,122,11,11,ATL,103,16,6,27,17
1987-12-22,CHI,100,15,8,DAL,111,13,8,28,16
1987-12-23,PHX,102,8,13,SEA,103,12,12,20,25
1987-12-23,CLE,83,11,12,UTH,91,11,13,22,25
1987-12-23,NYK,90,7,16,CHI,89,15,9,22,25
1987-12-23,GOS,129,3,18,DEN,117,15,8,18,26
1987-12-23,LAC,97,8,13,SAN,111,10,12,18,25
1987-12-23,NJN,106,4,18,PHL,110,11,11,15,29
1987-12-23,LAL,117,17,6,SAC,103,6,17,23,23
1987-12-23,IND,109,12,11,DAL,110,14,8,26,19
1987-12-25,NYK,87,8,16,DET,91,15,5,23,21
1987-12-25,PHL,100,12,11,ATL,106,16,7,28,18
1987-12-26,DAL,105,15,8,HOU,100,12,11,27,19
1987-12-26,ATL,125,17,7,NYK,98,8,17,25,24
1987-12-26,MIL,102,13,9,WAS,97,9,15,22,24
1987-12-26,IND,106,12,12,CHI,92,15,10,27,22
1987-12-26,CLE,120,11,13,POR,117,16,8,27,21
1987-12-26,SAN,105,11,12,GOS,96,4,18,15,30
1987-12-26,PHX,110,8,14,SAC,112,6,18,14,32
1987-12-26,DET,110,16,5,NJN,75,4,19,20,24
1987-12-26,UTH,109,12,13,LAL,117,18,6,30,19
1987-12-26,LAC,97,8,14,BOS,106,15,8,23,22
1987-12-26,DEN,115,15,9,SEA,111,13,12,28,21
1987-12-27,SAC,102,7,18,BOS,114,16,8,23,26
1987-12-27,NJN,101,4,20,CLE,83,12,13,16,33
1987-12-28,PHX,117,8,15,PHL,101,12,12,20,27
1987-12-28,SEA,108,13,13,DEN,100,16,9,29,22
1987-12-29,DEN,97,16,10,UTH,98,12,14,28,24
1987-12-29,DET,91,17,5,HOU,101,12,12,29,17
1987-12-29,NJN,88,5,20,MIL,106,14,9,19,29
1987-12-29,LAL,131,19,6,PHL,115,12,13,31,19
1987-12-29,NYK,123,8,18,POR,110,16,9,24,27
1987-12-29,CHI,98,15,11,ATL,108,18,7,33,18
1987-12-29,DAL,126,16,8,SAC,117,7,19,23,27
1987-12-30,IND,95,13,12,DET,105,17,6,30,18
1987-12-30,WAS,112,9,16,POR,117,16,10,25,26
1987-12-30,LAC,102,8,15,PHX,121,9,15,17,30
1987-12-30,MIL,93,15,9,HOU,102,13,12,28,21
1987-12-30,CLE,110,12,14,ATL,117,19,7,31,21
1987-12-30,SEA,111,14,13,BOS,105,17,8,31,21
1987-12-30,UTH,104,13,14,GOS,103,4,19,17,33
1987-12-30,SAN,140,12,12,SAC,108,7,20,19,32
1988-01-01,POR,127,17,10,PHL,125,12,14,29,24
1988-01-01,NYK,115,9,18,LAC,96,8,16,17,34
1988-01-01,WAS,109,9,17,DEN,124,16,11,25,28
1988-01-02,CLE,120,12,15,PHX,107,10,15,22,30
1988-01-02,CHI,116,15,12,NJN,93,5,21,20,33
1988-01-02,SAN,109,13,12,DAL,116,17,8,30,20
1988-01-02,SEA,116,15,13,PHL,114,12,15,27,28
1988-01-02,SAC,107,7,21,UTH,105,14,14,21,35
1988-01-02,GOS,110,4,20,BOS,115,17,9,21,29
1988-01-02,DET,142,18,6,DEN,151,17,11,35,17
1988-01-02,WAS,100,9,18,HOU,111,14,12,23,30
1988-01-02,MIL,97,15,10,IND,99,13,13,28,23
1988-01-03,ATL,121,20,7,LAC,84,8,17,28,24
1988-01-03,POR,81,18,10,LAL,98,20,6,38,16
1988-01-04,CLE,122,13,15,DEN,101,18,11,31,26
1988-01-04,LAL,133,21,6,SAN,115,13,13,34,19
1988-01-04,PHL,122,12,16,PHX,114,10,16,22,32
1988-01-04,HOU,117,15,12,DAL,107,18,8,33,20
1988-01-04,UTH,99,14,15,BOS,107,18,9,32,24
1988-01-05,POR,126,18,11,SEA,114,16,13,34,24
1988-01-05,GOS,129,4,21,SAN,119,13,14,17,35
1988-01-05,MIL,98,15,11,LAC,82,8,18,23,29
1988-01-05,CHI,93,16,12,IND,77,14,13,30,25
1988-01-05,WAS,101,9,19,NJN,97,5,22,14,41
1988-01-05,NYK,95,10,18,PHX,100,10,17,20,35
1988-01-05,ATL,81,21,7,DET,71,18,7,39,14
1988-01-06,CLE,116,14,15,LAC,100,8,19,22,34
1988-01-06,SEA,110,16,14,HOU,95,16,12,32,26
1988-01-06,BOS,117,19,9,NYK,108,10,19,29,28
1988-01-06,NJN,93,5,23,DEN,98,18,12,23,35
1988-01-06,LAL,103,22,6,DAL,89,18,9,40,15
1988-01-06,PHL,116,13,16,UTH,93,14,16,27,32
1988-01-06,DET,90,18,8,ATL,87,22,7,40,15
1988-01-07,CHI,100,17,12,DEN,96,19,12,36,24
1988-01-07,PHX,91,11,17,DAL,105,18,10,29,27
1988-01-07,SAC,119,8,21,SAN,124,13,15,21,36
1988-01-07,IND,114,14,14,MIL,108,16,11,30,25
1988-01-07,GOS,113,5,21,HOU,120,16,13,21,34
1988-01-08,POR,98,19,11,SAC,91,8,22,27,33
1988-01-08,MIL,107,16,12,UTH,111,14,17,30,29
1988-01-08,BOS,125,20,9,WAS,109,10,19,30,28
1988-01-08,DET,104,19,8,LAL,106,23,6,42,14
1988-01-08,ATL,101,22,8,CLE,97,15,15,37,23
1988-01-08,PHL,117,14,16,LAC,103,8,20,22,36
1988-01-08,NJN,118,5,24,NYK,111,10,20,15,44
1988-01-09,GOS,99,5,22,DAL,115,19,10,24,32
1988-01-09,NYK,106,10,21,BOS,98,21,9,31,30
1988-01-09,CHI,113,18,12,UTH,91,15,17,33,29
1988-01-09,ATL,113,23,8,DEN,105,19,13,42,21
1988-01-09,WAS,108,10,20,LAC,76,8,21,18,41
1988-01-09,IND,98,15,14,LAL,101,24,6,39,20
1988-01-09,PHL,126,15,16,CLE,110,15,16,30,32
1988-01-09,SEA,141,17,14,SAN,133,14,15,31,29
1988-01-09,HOU,104,17,13,PHX,98,11,18,28,31
1988-01-10,MIL,105,16,13,NJN,87,6,24,22,37
1988-01-10,SAC,109,8,23,SEA,108,18,14,26,37
1988-01-11,IND,111,15,15,LAC,90,8,22,23,37
1988-01-11,PHX,127,11,19,DEN,115,19,14,30,33
1988-01-12,LAL,117,25,6,GOS,113,5,23,30,29
1988-01-12,CLE,119,15,17,NYK,111,11,21,26,38
1988-01-12,CHI,97,19,12,BOS,104,21,10,40,22
1988-01-12,MIL,106,17,13,PHL,103,16,16,33,29
1988-01-13,BOS,143,22,10,DET,105,19,9,41,19
1988-01-13,PHL,104,16,17,NJN,95,6,25,22,42
1988-01-13,SAN,110,14,16,ATL,120,24,8,38,24
1988-01-13,DAL,110,20,10,IND,108,16,15,36,25
1988-01-13,UTH,116,15,18,POR,104,20,11,35,29
1988-01-13,SEA,144,18,15,GOS,115,5,24,23,39
1988-01-13,LAC,110,8,23,LAL,109,26,6,34,29
1988-01-13,PHX,117,12,19,HOU,106,18,13,30,32
1988-01-14,WAS,136,11,20,MIL,107,18,13,29,33
1988-01-14,HOU,103,18,14,POR,98,20,12,38,26
1988-01-14,CLE,91,16,17,CHI,88,19,13,35,30
1988-01-14,DEN,115,19,15,ATL,112,25,8,44,23
1988-01-14,NJN,90,6,26,SAC,87,9,23,15,49
1988-01-15,PHL,119,17,17,NYK,104,11,22,28,39
1988-01-15,GOS,123,5,25,LAC,116,9,23,14,48
1988-01-15,BOS,122,23,10,SAC,86,9,24,32,34
1988-01-15,DET,97,19,10,CLE,93,17,17,36,27
1988-01-15,SAN,108,14,17,IND,112,16,16,30,33
1988-01-15,SEA,124,19,15,UTH,105,16,18,35,33
1988-01-16,HOU,132,19,14,IND,102,17,16,36,30
1988-01-16,DAL,98,21,10,ATL,101,25,9,46,19
1988-01-16,NYK,110,11,23,PHL,96,18,17,29,40
1988-01-16,DEN,115,20,15,GOS,94,6,25,26,40
1988-01-16,NJN,96,7,26,BOS,103,24,10,31,36
1988-01-16,PHX,96,13,19,LAL,107,26,7,39,26
1988-01-16,LAC,112,9,24,SEA,114,20,15,29,39
1988-01-16,SAN,120,14,18,POR,121,20,13,34,31
1988-01-16,CHI,115,19,14,DET,99,20,10,39,24
1988-01-17,WAS,130,12,20,SAC,113,9,25,21,45
1988-01-17,MIL,111,18,14,CLE,93,17,18,35,32
1988-01-18,LAC,87,9,25,DAL,99,21,11,30,36
1988-01-18,NJN,117,7,27,PHX,113,13,20,20,47
1988-01-18,BOS,121,25,10,GOS,101,6,26,31,36
1988-01-18,DEN,116,21,15,DET,123,20,11,41,26
1988-01-18,LAL,121,27,7,HOU,110,20,14,47,21
1988-01-18,SEA,115,21,15,IND,105,17,17,38,32
1988-01-18,NYK,110,12,23,ATL,102,26,9,38,32
1988-01-18,CHI,117,20,14,WAS,103,13,20,33,34
1988-01-19,POR,116,21,13,DAL,120,22,11,43,24
1988-01-19,SAN,110,14,19,MIL,104,19,14,33,33
1988-01-19,SAC,107,9,26,HOU,104,20,15,29,41
1988-01-19,ATL,106,26,10,CHI,94,21,14,47,24
1988-01-20,SEA,108,22,15,NYK,96,13,23,35,38
1988-01-20,PHL,98,18,18,WAS,110,13,21,31,39
1988-01-20,UTH,117,16,19,DET,120,21,11,37,30
1988-01-20,BOS,131,26,10,PHX,115,13,21,39,31
1988-01-20,NJN,101,8,27,GOS,103,6,27,14,54
1988-01-20,LAC,104,9,26,IND,97,17,18,26,44
1988-01-21,CLE,93,17,19,ATL,101,27,10,44,29
1988-01-21,HOU,116,20,16,MIL,103,19,15,39,31
1988-01-21,DEN,115,21,16,LAL,113,28,7,49,23
1988-01-22,UTH,119,16,20,SAN,106,15,19,31,39
1988-01-22,SEA,109,23,15,DET,106,22,11,45,26
1988-01-22,CHI,118,21,15,PHX,108,13,22,34,37
1988-01-22,LAL,113,28,8,NYK,112,13,24,41,32
1988-01-22,IND,113,17,19,NJN,104,8,28,25,47
1988-01-22,POR,126,21,14,DEN,106,22,16,43,30
1988-01-22,BOS,124,27,10,ATL,106,28,10,55,20
1988-01-22,WAS,115,14,21,GOS,91,7,27,21,48
1988-01-22,DAL,110,23,11,LAC,87,10,26,33,37
1988-01-23,SAC,97,10,26,NYK,94,13,25,23,51
1988-01-23,SAN,106,15,20,LAC,100,10,27,25,47
1988-01-23,CHI,121,22,15,GOS,94,7,28,29,43
1988-01-23,DAL,113,24,11,MIL,97,19,16,43,27
1988-01-23,CLE,119,17,20,BOS,100,28,10,45,30
1988-01-24,WAS,131,15,21,PHL,99,18,19,33,40
1988-01-24,SEA,109,24,15,LAL,116,29,8,53,23
1988-01-24,ATL,118,28,11,NJN,111,8,29,36,40
1988-01-24,POR,119,22,14,DET,111,22,12,44,26
1988-01-24,IND,128,18,19,PHX,109,13,23,31,42
1988-01-25,WAS,118,0,3,PHL,117,1,1,1,4
1988-01-25,UTH,119,17,20,CLE,96,18,20,35,40
1988-01-25,GOS,105,7,29,MIL,108,19,17,26,46
1988-01-26,HOU,124,21,16,LAC,104,10,28,31,44
1988-01-26,SAC,100,11,26,SEA,116,24,16,35,42
1988-01-26,DAL,128,25,11,SAN,111,16,20,41,31
1988-01-26,LAL,111,30,8,UTH,100,18,20,48,28
1988-01-26,ATL,97,29,11,BOS,102,28,11,57,22
1988-01-26,IND,97,19,19,CHI,93,23,15,42,34
1988-01-26,NYK,122,13,26,NJN,101,8,30,21,56
1988-01-26,POR,112,23,14,MIL,106,20,17,43,31
1988-01-27,BOS,106,29,11,WAS,100,16,21,45,32
1988-01-27,SAN,102,16,21,CLE,112,18,21,34,42
1988-01-27,DET,103,22,13,IND,86,20,19,42,32
1988-01-27,PHL,109,18,20,CHI,119,23,16,41,36
1988-01-27,GOS,115,7,30,POR,110,24,14,31,44
1988-01-27,PHX,102,13,24,DAL,121,26,11,39,35
1988-01-28,DEN,122,22,17,MIL,113,20,18,42,35
1988-01-28,WAS,104,16,22,NYK,90,14,26,30,48
1988-01-28,SAC,94,11,27,LAL,115,31,8,42,35
1988-01-28,HOU,85,22,16,CLE,109,19,21,41,37
1988-01-29,PHL,94,18,21,IND,89,20,20,38,41
1988-01-29,LAL,117,32,8,ATL,107,29,12,61,20
1988-01-29,CHI,120,24,16,NJN,93,8,31,32,47
1988-01-29,LAC,88,10,29,MIL,97,20,19,30,48
1988-01-29,GOS,102,8,30,UTH,100,18,21,26,51
1988-01-29,DET,125,23,13,BOS,108,30,11,53,24
1988-01-29,DAL,117,27,11,SEA,109,25,16,52,27
1988-01-29,POR,128,24,15,PHX,119,13,25,37,40
1988-01-30,CLE,128,20,21,WAS,126,17,22,37,43
1988-01-30,PHX,120,13,26,SAC,126,11,28,24,54
1988-01-30,CHI,97,25,16,NYK,95,14,27,39,43
1988-01-30,DEN,124,23,17,LAC,106,10,30,33,47
1988-01-30,SAN,112,16,22,SEA,102,25,17,41,39
1988-01-30,DAL,92,28,11,HOU,108,22,17,50,28
1988-01-30,UTH,115,18,22,ATL,109,29,13,47,35
1988-01-30,NJN,116,8,32,DET,104,24,13,32,45
1988-01-31,BOS,100,30,12,PHL,85,19,21,49,33
1988-02-01,CLE,94,21,21,DET,83,24,14,45,35
1988-02-01,IND,90,20,21,GOS,88,9,30,29,51
1988-02-01,SAC,97,12,28,CHI,95,26,16,38,44
1988-02-01,DAL,103,28,12,NJN,108,9,32,37,44
1988-02-01,UTH,105,19,22,SEA,100,25,18,44,40
1988-02-02,POR,121,25,15,ATL,118,29,14,54,29
1988-02-02,SAN,118,17,22,NJN,106,10,32,27,54
1988-02-02,NYK,110,14,28,WAS,106,17,23,31,51
1988-02-02,MIL,97,21,19,DET,99,24,15,45,34
1988-02-02,HOU,109,23,17,PHX,99,13,27,36,44
1988-02-02,LAL,110,33,8,CHI,101,26,17,59,25
1988-02-03,BOS,118,31,12,IND,103,21,21,52,33
1988-02-03,UTH,123,20,22,SAC,91,13,28,33,50
1988-02-03,PHL,96,19,22,GOS,84,9,31,28,53
1988-02-03,WAS,106,17,24,CLE,107,22,21,39,45
1988-02-03,DEN,115,24,17,DAL,105,28,13,52,30
1988-02-04,MIL,111,21,20,BOS,101,32,12,53,32
1988-02-04,SAC,118,13,29,DAL,101,28,14,41,43
1988-02-04,HOU,115,24,17,NJN,87,10,33,34,50
1988-02-04,SAN,123,18,22,DEN,129,25,17,43,39
1988-02-04,PHX,101,13,28,CHI,113,26,18,39,46
1988-02-04,CLE,90,23,21,GOS,96,9,32,32,53
1988-02-04,LAC,86,10,31,LAL,117,34,8,44,39
1988-02-04,POR,123,26,15,UTH,126,21,22,47,37
1988-02-04,IND,109,21,22,PHL,95,20,22,41,44
1988-02-04,NYK,100,15,28,DET,93,25,15,40,43
1988-02-04,SEA,109,25,19,ATL,119,29,15,54,34
1988-02-09,POR,139,26,16,SEA,123,25,20,51,36
1988-02-09,DAL,124,28,15,UTH,93,22,22,50,37
1988-02-09,MIL,112,22,20,CLE,104,23,22,45,42
1988-02-09,PHX,106,13,29,LAC,100,10,32,23,61
1988-02-09,HOU,129,25,17,BOS,120,32,13,57,30
1988-02-09,CHI,74,27,18,DET,89,25,16,52,34
1988-02-09,ATL,112,30,15,PHL,110,20,23,50,38
1988-02-09,LAL,108,35,8,IND,110,22,22,57,30
1988-02-09,DEN,136,26,17,SAN,108,18,23,44,40
1988-02-09,GOS,117,10,32,SAC,99,14,29,24,61
1988-02-09,WAS,126,17,25,NJN,117,10,34,27,59
1988-02-10,DET,98,26,16,NYK,87,16,28,42,44
1988-02-10,SAN,120,18,24,BOS,136,32,14,50,38
1988-02-10,UTH,93,22,23,DAL,80,29,15,51,38
1988-02-10,CLE,118,23,23,WAS,102,18,25,41,48
1988-02-10,NJN,93,10,35,CHI,84,27,19,37,54
1988-02-10,LAC,101,10,33,PHX,95,14,29,24,62
1988-02-11,SEA,120,25,21,HOU,115,26,17,51,38
1988-02-11,GOS,107,11,32,IND,108,23,22,34,54
1988-02-11,PHL,119,20,24,MIL,113,23,20,43,44
1988-02-11,SAC,123,14,30,POR,113,27,16,41,46
1988-02-11,DEN,108,27,17,LAL,120,35,9,62,26
1988-02-12,PHX,102,14,30,IND,107,24,22,38,52
1988-02-12,MIL,93,23,21,CHI,95,27,20,50,41
1988-02-12,LAC,105,11,33,HOU,112,26,18,37,51
1988-02-12,DET,108,27,16,ATL,92,31,15,58,31
1988-02-12,DAL,104,29,16,BOS,105,33,14,62,30
1988-02-12,CLE,98,24,23,NJN,96,11,35,35,58
1988-02-12,POR,120,27,17,DEN,105,27,18,54,35
1988-02-12,SAN,132,18,25,LAL,133,36,9,54,34
1988-02-13,GOS,109,11,33,SEA,95,26,21,37,54
1988-02-13,ATL,105,31,16,WAS,103,18,26,49,42
1988-02-13,DET,82,28,16,CHI,73,28,20,56,36
1988-02-13,NYK,120,16,29,CLE,103,25,23,41,52
1988-02-13,SAC,114,15,30,PHX,116,14,31,29,61
1988-02-14,POR,103,28,17,HOU,115,27,18,55,35
1988-02-14,NJN,109,11,36,PHL,105,21,24,32,60
1988-02-14,LAC,100,11,34,DAL,110,29,17,40,51
1988-02-14,DEN,107,27,19,UTH,93,23,23,50,42
1988-02-14,LAL,115,37,9,BOS,106,34,14,71,23
1988-02-15,CLE,104,25,24,SAC,95,15,31,40,55
1988-02-15,SEA,122,26,22,DAL,128,30,17,56,39
1988-02-15,CHI,126,28,21,ATL,107,32,16,60,37
1988-02-15,SAN,122,18,26,GOS,126,12,33,30,59
1988-02-15,NYK,97,17,29,NJN,96,12,36,29,65
1988-02-15,PHX,106,15,31,BOS,107,34,15,49,46
1988-02-15,WAS,110,18,27,MIL,114,23,22,41,49
1988-02-15,UTH,112,23,24,POR,94,28,18,51,42
1988-02-15,DET,102,29,16,PHL,95,21,25,50,41
1988-02-16,HOU,121,28,18,GOS,116,13,33,41,51
1988-02-16,ATL,115,32,17,SAC,118,15,32,47,49
1988-02-16,LAL,119,38,9,LAC,100,11,35,49,44
1988-02-16,IND,117,25,22,NYK,104,18,29,43,51
1988-02-17,MIL,115,24,22,SEA,93,26,23,50,45
1988-02-17,DAL,123,31,17,WAS,108,18,28,49,45
1988-02-17,DEN,138,28,19,BOS,125,35,15,63,34
1988-02-17,UTH,108,24,24,PHX,103,15,32,39,56
1988-02-17,PHL,107,21,26,CLE,115,26,24,47,50
1988-02-17,LAC,96,11,36,POR,110,28,19,39,55
1988-02-18,NYK,108,18,30,SAC,104,16,32,34,62
1988-02-18,IND,88,26,22,CLE,83,27,24,53,46
1988-02-18,PHX,114,15,33,SAN,122,18,27,33,60
1988-02-18,DET,108,30,16,SEA,95,26,24,56,40
1988-02-18,HOU,96,29,18,LAL,111,39,9,68,27
1988-02-19,SAN,102,19,27,WAS,106,18,29,37,56
1988-02-19,LAC,88,11,37,UTH,98,25,24,36,61
1988-02-19,PHL,115,21,27,NJN,100,12,37,33,64
1988-02-19,DAL,113,32,17,GOS,100,13,34,45,51
1988-02-19,POR,104,29,19,BOS,124,35,16,64,35
1988-02-19,MIL,119,25,22,DET,108,31,16,56,38
1988-02-19,ATL,119,32,18,LAL,126,40,9,72,27
1988-02-19,CHI,111,29,21,SAC,90,16,33,45,54
1988-02-20,PHX,128,15,34,DEN,108,29,19,44,53
1988-02-20,HOU,115,29,19,WAS,109,19,29,48,48
1988-02-20,NJN,101,12,38,SEA,113,26,25,38,63
1988-02-20,UTH,120,26,24,LAC,103,11,38,37,62
1988-02-21,CLE,113,27,25,CHI,111,30,21,57,46
1988-02-21,ATL,129,32,19,SEA,113,27,25,59,44
1988-02-21,LAL,117,41,9,DET,110,31,17,72,26
1988-02-21,MIL,120,26,22,PHL,115,22,27,48,49
1988-02-21,POR,117,29,20,SAN,112,19,28,48,48
1988-02-21,IND,130,27,22,SAC,112,16,34,43,56
1988-02-22,BOS,95,36,16,NYK,93,19,30,55,46
1988-02-22,GOS,123,13,35,SAN,111,19,29,32,64
1988-02-22,DAL,114,33,17,PHX,107,16,34,49,51
1988-02-22,HOU,119,30,19,PHL,106,22,28,52,47
1988-02-22,DEN,100,29,20,WAS,87,19,30,48,50
1988-02-23,NYK,89,19,31,MIL,87,27,22,46,53
1988-02-23,SAC,105,16,35,DET,121,31,18,47,53
1988-02-23,NJN,102,12,39,POR,114,30,20,42,59
1988-02-23,ATL,131,33,19,IND,111,28,22,61,41
1988-02-23,CHI,104,30,22,SEA,97,27,26,57,48
1988-02-23,LAL,111,42,9,WAS,100,19,31,61,40
1988-02-24,UTH,120,27,24,DEN,123,30,20,57,44
1988-02-24,DAL,93,34,17,CLE,89,28,25,62,42
1988-02-24,GOS,93,14,35,DET,107,32,18,46,53
1988-02-24,BOS,113,37,16,POR,112,31,20,68,36
1988-02-24,SAN,123,19,30,PHL,121,22,29,41,59
1988-02-24,IND,94,28,23,MIL,97,27,23,55,46
1988-02-25,SAC,110,16,36,WAS,129,19,32,35,68
1988-02-25,LAC,96,11,39,NYK,106,20,31,31,70
1988-02-25,PHX,109,16,35,CLE,103,28,26,44,61
1988-02-25,HOU,106,31,19,DAL,108,35,17,66,36
1988-02-26,CHI,96,31,22,POR,104,31,21,62,43
1988-02-26,DEN,120,31,20,PHL,104,22,30,53,50
1988-02-26,BOS,132,38,16,MIL,96,28,23,66,39
1988-02-26,IND,101,28,24,ATL,116,34,19,62,43
1988-02-26,GOS,119,14,36,NYK,125,21,31,35,67
1988-02-26,SAN,111,20,30,HOU,107,31,20,51,50
1988-02-26,DET,137,33,18,NJN,109,12,40,45,58
1988-02-26,SEA,133,27,27,SAC,130,16,37,43,64
1988-02-26,LAL,112,43,9,UTH,105,27,25,70,34
1988-02-27,NJN,98,12,41,IND,106,28,25,40,66
1988-02-27,DAL,100,36,17,PHL,91,22,31,58,48
1988-02-27,ATL,120,35,19,POR,123,32,21,67,40
1988-02-27,SEA,114,28,27,GOS,111,14,37,42,64
1988-02-27,LAC,97,11,40,CLE,96,28,27,39,67
1988-02-27,PHX,106,17,35,WAS,116,20,32,37,67
1988-02-27,CHI,91,31,23,MIL,94,28,24,59,47
1988-02-28,LAL,111,44,9,PHX,97,17,36,61,45
1988-02-28,DET,106,34,18,BOS,101,39,16,73,34
1988-02-28,HOU,108,31,21,SAN,95,21,30,52,51
1988-02-28,DEN,109,32,20,NYK,100,22,31,54,51
1988-02-29,PHL,102,22,32,CHI,101,31,24,53,56
1988-02-29,GOS,105,14,38,WAS,110,21,32,35,70
1988-02-29,POR,107,33,21,CLE,94,28,28,61,49
1988-02-29,SAC,110,16,38,UTH,115,27,26,43,64
1988-02-29,DAL,123,37,17,DEN,96,33,20,70,37
1988-03-01,ATL,104,35,20,DET,117,35,18,70,38
1988-03-01,MIL,117,29,24,BOS,116,39,17,68,41
1988-03-01,SEA,114,29,27,LAL,100,45,9,74,36
1988-03-01,UTH,113,28,26,HOU,112,32,21,60,47
1988-03-01,NJN,104,12,42,LAC,75,12,40,24,82
1988-03-01,NYK,98,22,32,IND,96,29,25,51,57
1988-03-01,SAN,114,21,31,PHX,109,17,37,38,68
1988-03-02,GOS,101,14,39,HOU,108,32,22,46,61
1988-03-02,DAL,115,38,17,SAC,90,16,39,54,56
1988-03-02,DEN,99,33,21,CLE,81,28,29,61,50
1988-03-02,DET,103,36,18,LAC,90,12,41,48,59
1988-03-02,WAS,111,22,32,IND,102,29,26,51,58
1988-03-02,BOS,107,39,18,NJN,117,13,42,52,60
1988-03-03,CHI,97,31,25,PHL,93,23,32,54,57
1988-03-03,PHX,112,17,38,POR,135,34,21,51,59
1988-03-04,BOS,121,39,19,LAC,90,12,42,51,61
1988-03-04,LAL,120,45,10,GOS,107,14,40,59,50
1988-03-04,DEN,116,34,21,PHX,108,17,39,51,60
1988-03-04,SEA,110,30,27,UTH,125,29,26,59,53
1988-03-04,IND,88,29,27,WAS,95,23,32,52,59
1988-03-04,DAL,118,39,17,HOU,110,33,22,72,39
1988-03-04,SAN,132,22,31,SAC,134,16,40,38,71
1988-03-04,NYK,110,23,32,PHL,108,23,33,46,65
1988-03-05,WAS,101,24,32,DET,97,37,18,61,50
1988-03-05,UTH,125,30,26,SAN,106,22,32,52,58
1988-03-05,POR,123,35,21,GOS,117,14,41,49,62
1988-03-05,NJN,94,14,42,NYK,85,24,32,38,74
1988-03-05,CHI,100,32,25,LAC,76,12,43,44,68
1988-03-05,HOU,105,33,23,SAC,94,17,40,50,63
1988-03-05,SEA,102,30,28,DEN,115,35,21,65,49
1988-03-05,ATL,101,35,21,MIL,104,30,24,65,45
1988-03-06,BOS,127,40,19,CLE,98,28,30,68,49
1988-03-06,IND,100,29,28,PHL,105,23,34,52,62
1988-03-06,DET,109,37,19,MIL,99,31,24,68,43
1988-03-06,DAL,97,40,17,LAL,108,46,10,86,27
1988-03-07,SAC,116,17,41,DEN,114,36,21,53,62
1988-03-07,UTH,105,31,26,NJN,81,15,42,46,68
1988-03-07,NYK,110,24,33,CHI,98,33,25,57,58
1988-03-07,PHL,104,24,34,LAL,110,47,10,71,44
1988-03-08,ATL,143,35,22,PHX,113,17,40,52,62
1988-03-08,DEN,103,36,22,HOU,113,34,23,70,45
1988-03-08,IND,117,29,29,DET,104,38,19,67,48
1988-03-08,MIL,119,31,25,SAN,101,22,33,53,58
1988-03-08,GOS,116,14,42,SEA,121,30,29,44,71
1988-03-08,DAL,110,40,18,POR,112,36,21,76,39
1988-03-09,LAC,93,12,44,NJN,97,15,43,27,87
1988-03-09,WAS,115,25,32,PHX,111,17,41,42,73
1988-03-09,NYK,99,25,33,LAL,104,48,10,73,43
1988-03-09,BOS,119,41,19,SAN,118,22,34,63,53
1988-03-09,CLE,117,28,31,MIL,91,32,25,60,56
1988-03-09,SAC,97,18,41,SEA,106,31,29,49,70
1988-03-09,DET,103,38,20,UTH,98,32,26,70,46
1988-03-10,CHI,128,33,26,LAL,107,49,10,82,36
1988-03-10,GOS,128,14,43,NJN,112,16,43,30,86
1988-03-10,HOU,109,35,23,POR,112,37,21,72,44
1988-03-11,BOS,122,42,19,IND,112,30,29,72,48
1988-03-11,MIL,132,32,26,DEN,93,36,23,68,49
1988-03-11,WAS,107,26,32,UTH,109,32,27,58,59
1988-03-11,CLE,117,29,31,SAN,107,22,35,51,66
1988-03-11,PHL,124,24,35,SAC,118,18,42,42,77
1988-03-11,ATL,122,36,22,NYK,115,25,34,61,56
1988-03-11,LAC,96,12,45,GOS,101,15,43,27,88
1988-03-11,DET,116,39,20,PHX,88,17,42,56,62
1988-03-12,LAL,101,49,11,DAL,110,40,19,89,30
1988-03-12,DET,104,40,20,CLE,100,30,31,70,51
1988-03-12,CHI,112,34,26,SAN,92,22,36,56,62
1988-03-12,NYK,108,25,35,UTH,105,33,27,58,62
1988-03-13,SEA,115,32,29,NJN,102,16,44,48,73
1988-03-13,BOS,117,43,19,ATL,100,37,22,80,41
1988-03-13,POR,121,38,21,LAC,100,12,46,50,67
1988-03-13,HOU,125,35,24,GOS,112,16,43,51,67
1988-03-13,PHL,104,25,35,WAS,96,26,33,51,68
1988-03-13,IND,100,30,30,DEN,108,36,24,66,54
1988-03-13,MIL,117,33,26,PHX,107,17,43,50,69
1988-03-14,DEN,115,37,24,UTH,116,33,28,70,52
1988-03-14,LAL,115,49,12,NJN,105,16,45,65,57
1988-03-14,DAL,121,41,19,GOS,101,16,44,57,63
1988-03-14,DET,109,41,20,SAC,97,18,43,59,63
1988-03-14,WAS,112,26,34,SAN,106,22,37,48,71
1988-03-14,NYK,104,26,35,CLE,102,30,32,56,67
1988-03-15,CHI,108,35,26,CLE,89,30,33,65,59
1988-03-15,HOU,116,36,24,LAC,110,12,47,48,71
1988-03-15,MIL,108,34,26,SAC,97,18,44,52,70
1988-03-15,ATL,104,37,23,PHL,90,26,35,63,58
1988-03-15,PHX,111,17,44,SEA,90,33,29,50,73
1988-03-15,IND,113,30,31,BOS,119,44,19,74,50
1988-03-15,POR,112,39,21,LAL,95,50,12,89,33
1988-03-16,WAS,106,27,34,CHI,103,36,26,63,60
1988-03-16,GOS,112,16,45,PHX,118,18,44,34,89
1988-03-16,PHL,115,26,36,NYK,108,27,35,53,71
1988-03-16,SAN,113,22,38,LAC,110,12,48,34,86
1988-03-16,UTH,120,34,28,DAL,105,42,19,76,47
1988-03-16,NJN,83,16,46,MIL,79,35,26,51,72
1988-03-17,IND,99,30,32,WAS,95,28,34,58,66
1988-03-17,DEN,116,37,25,POR,115,40,21,77,46
1988-03-17,CLE,99,30,34,DET,102,42,20,72,54
1988-03-17,HOU,115,37,24,SEA,106,33,30,70,54
1988-03-18,SAN,110,23,38,SEA,118,33,31,56,69
1988-03-18,CHI,113,36,27,BOS,103,45,19,81,46
1988-03-18,PHL,129,27,36,IND,109,31,32,58,68
1988-03-18,NJN,104,17,46,ATL,106,38,23,55,69
1988-03-18,LAC,98,12,49,DAL,106,42,20,54,69
1988-03-18,GOS,116,16,46,POR,121,40,22,56,68
1988-03-18,UTH,118,35,28,DEN,111,38,25,73,53
1988-03-19,SAN,113,23,39,UTH,110,36,28,59,67
1988-03-19,PHX,102,19,44,LAL,95,50,13,69,57
1988-03-19,WAS,89,28,35,PHL,94,28,36,56,71
1988-03-19,NYK,116,27,36,ATL,110,39,23,66,59
1988-03-19,MIL,101,35,27,CLE,100,30,35,65,62
1988-03-19,SAC,121,18,45,HOU,104,38,24,56,69
1988-03-20,POR,105,41,22,DAL,99,43,20,84,42
1988-03-20,BOS,137,45,20,CHI,107,37,27,82,47
1988-03-20,GOS,127,16,47,LAL,130,50,14,66,61
1988-03-20,DEN,108,38,26,SEA,95,34,31,72,57
1988-03-20,DET,118,43,20,WAS,110,28,36,71,56
1988-03-20,LAC,116,12,50,SAC,112,19,45,31,95
1988-03-20,NJN,96,17,47,IND,102,31,33,48,80
1988-03-21,SAN,121,24,39,NYK,133,28,36,52,75
1988-03-21,ATL,115,39,24,MIL,105,36,27,75,51
1988-03-21,PHX,107,20,44,LAC,99,13,50,33,94
1988-03-22,NJN,102,17,48,PHL,90,29,36,46,84
1988-03-22,DET,123,44,20,IND,104,32,33,76,53
1988-03-22,DAL,124,43,21,NYK,105,29,36,72,57
1988-03-22,MIL,111,36,28,ATL,98,40,24,76,52
1988-03-22,LAL,117,51,14,HOU,95,38,25,89,39
1988-03-22,DEN,136,39,26,SAN,109,24,40,63,66
1988-03-22,UTH,103,36,29,PHX,96,21,44,57,73
1988-03-23,PHL,102,29,37,CHI,118,37,28,66,65
1988-03-23,GOS,126,16,48,SAC,118,19,46,35,94
1988-03-23,LAC,108,13,51,DEN,118,40,26,53,77
1988-03-23,CLE,105,30,36,NJN,96,18,48,48,84
1988-03-23,SEA,118,34,32,POR,108,42,22,76,54
1988-03-23,BOS,104,46,20,WAS,89,28,37,74,57
1988-03-24,HOU,134,38,26,NYK,117,29,37,67,63
1988-03-24,UTH,117,37,29,SAC,97,19,47,56,76
1988-03-24,WAS,94,28,38,ATL,91,40,25,68,63
1988-03-24,PHX,119,21,45,MIL,114,37,28,58,73
1988-03-25,CLE,110,31,36,CHI,111,38,28,69,64
1988-03-25,LAC,113,13,52,GOS,98,17,48,30,100
1988-03-25,IND,101,32,34,NJN,100,18,49,50,83
1988-03-25,SAN,107,24,41,DET,106,45,20,69,61
1988-03-25,BOS,93,47,20,PHL,97,29,38,76,58
1988-03-25,LAL,119,52,14,DEN,120,41,26,93,40
1988-03-25,DAL,106,44,21,POR,101,42,23,86,44
1988-03-26,WAS,99,29,38,NJN,88,18,50,47,88
1988-03-26,NYK,106,29,38,BOS,118,47,21,76,59
1988-03-26,PHX,103,22,45,DET,108,45,21,67,66
1988-03-26,SEA,131,35,32,LAC,98,14,52,49,84
1988-03-26,UTH,105,38,29,MIL,107,37,29,75,58
1988-03-26,HOU,115,39,26,POR,109,42,24,81,50
1988-03-26,CHI,109,39,28,IND,100,33,34,72,62
1988-03-26,DAL,131,45,21,SAN,112,25,41,70,62
1988-03-26,GOS,108,17,49,DEN,131,42,26,59,75
1988-03-26,ATL,109,40,26,CLE,102,31,37,71,63
1988-03-26,SAC,114,19,48,LAL,92,52,15,71,63
1988-03-28,NJN,105,18,51,BOS,106,48,21,66,72
1988-03-28,NYK,114,29,39,DAL,106,46,21,75,60
1988-03-28,PHL,108,30,38,HOU,98,40,26,70,64
1988-03-28,LAC,102,14,53,DET,100,46,21,60,74
1988-03-29,LAL,122,52,16,UTH,111,38,30,90,46
1988-03-29,SEA,106,36,32,CHI,103,40,28,76,60
1988-03-29,SAC,103,20,48,DEN,107,43,26,63,74
1988-03-29,SAN,113,25,42,POR,136,42,25,67,67
1988-03-29,CLE,108,31,38,NYK,103,30,39,61,77
1988-03-29,ATL,120,41,26,DAL,106,46,22,87,48
1988-03-30,BOS,117,49,21,HOU,110,40,27,89,48
1988-03-30,PHL,134,31,38,MIL,109,38,29,69,67
1988-03-30,WAS,96,30,38,CLE,107,32,38,62,76
1988-03-30,LAC,94,15,53,CHI,111,40,29,55,82
1988-03-30,DET,102,46,22,ATL,103,42,26,88,48
1988-03-30,PHX,123,22,46,GOS,105,17,50,39,96
1988-03-31,MIL,103,38,30,NYK,113,30,40,68,70
1988-03-31,IND,100,33,35,HOU,102,40,28,73,63
1988-03-31,SEA,115,37,32,SAN,117,25,43,62,75
1988-03-31,DEN,121,44,26,SAC,111,20,49,64,75
1988-03-31,UTH,115,38,31,GOS,92,17,51,55,82
1988-04-01,BOS,121,50,21,DET,110,46,23,96,44
1988-04-01,PHL,93,32,38,ATL,105,43,26,75,64
1988-04-01,POR,101,43,25,CHI,116,41,29,84,54
1988-04-01,WAS,118,30,39,DAL,103,46,23,76,62
1988-04-01,LAC,91,15,54,SAN,105,26,43,41,97
1988-04-02,SEA,151,37,33,PHX,107,23,46,60,79
1988-04-02,NYK,104,31,40,HOU,98,41,28,72,68
1988-04-02,MIL,125,38,31,NJN,111,18,52,56,83
1988-04-02,DEN,123,45,26,GOS,107,17,52,62,78
1988-04-02,SAC,103,20,50,LAC,105,15,55,35,105
1988-04-02,UTH,106,39,31,LAL,92,53,16,92,47
1988-04-02,CLE,108,33,38,IND,94,33,36,66,74
1988-04-03,LAL,108,53,17,SAC,104,20,51,73,68
1988-04-03,IND,100,33,37,ATL,102,44,26,77,63
1988-04-03,DET,110,46,24,CHI,112,42,29,88,53
1988-04-03,POR,110,43,26,SAN,107,27,43,70,69
1988-04-03,NJN,103,18,53,WAS,105,31,39,49,92
1988-04-03,BOS,110,51,21,DAL,101,46,24,97,45
1988-04-05,LAL,94,54,17,SEA,90,38,33,92,50
1988-04-05,POR,141,44,26,LAC,119,16,55,60,81
1988-04-05,CHI,94,43,29,WAS,105,32,39,75,68
1988-04-05,NJN,95,18,54,DET,107,46,25,64,79
1988-04-05,IND,106,33,38,CLE,105,34,38,67,76
1988-04-05,GOS,104,17,53,SAN,117,27,44,44,97
1988-04-05,HOU,97,41,29,DEN,110,46,26,87,55
1988-04-05,PHL,119,32,39,NYK,136,32,40,64,79
1988-04-05,ATL,121,45,26,MIL,110,39,31,84,57
1988-04-05,PHX,111,23,47,UTH,106,40,31,63,78
1988-04-06,SEA,114,38,34,GOS,102,17,54,55,88
1988-04-06,DAL,119,46,25,PHX,93,24,47,70,72
1988-04-06,LAC,103,16,56,POR,111,45,26,61,82
1988-04-06,SAC,115,20,52,SAN,109,28,44,48,96
1988-04-06,CLE,98,34,39,WAS,87,33,39,67,78
1988-04-06,MIL,110,39,32,CHI,119,43,30,82,62
1988-04-07,HOU,113,41,30,UTH,107,40,32,81,62
1988-04-07,ATL,120,46,26,NJN,94,18,55,64,81
1988-04-08,BOS,127,52,21,NJN,90,18,56,70,77
1988-04-08,LAL,126,55,17,LAC,107,16,57,71,74
1988-04-08,SEA,114,39,34,POR,100,46,26,85,60
1988-04-08,CLE,104,35,39,MIL,85,39,33,74,72
1988-04-08,WAS,107,33,40,IND,100,34,38,67,78
1988-04-08,DAL,118,47,25,UTH,95,40,33,87,58
1988-04-08,PHL,86,32,40,DET,96,47,25,79,65
1988-04-08,CHI,131,44,30,NYK,122,33,40,77,70
1988-04-08,SAN,124,28,45,DEN,129,47,26,75,71
1988-04-08,GOS,112,17,55,PHX,111,24,48,41,103
1988-04-09,SEA,104,40,34,HOU,108,42,30,82,64
1988-04-09,ATL,102,47,26,DET,115,48,25,95,51
1988-04-09,PHX,95,24,49,SAC,92,21,52,45,101
1988-04-09,MIL,105,39,34,IND,100,34,39,73,73
1988-04-09,DAL,135,48,25,DEN,109,48,26,96,51
1988-04-09,POR,119,46,27,LAL,109,56,17,102,44
1988-04-10,LAC,122,16,58,HOU,105,43,30,59,88
1988-04-10,PHL,108,32,41,BOS,117,53,21,85,62
1988-04-10,WAS,98,34,40,NYK,118,33,41,67,81
1988-04-10,SAC,121,21,53,GOS,115,18,55,39,108
1988-04-10,NJN,105,18,57,CLE,119,36,39,54,96
1988-04-11,PHX,119,25,49,DEN,123,48,27,73,76
1988-04-11,NYK,114,34,41,DET,111,49,25,83,66
1988-04-11,GOS,102,18,56,UTH,113,40,34,58,90
1988-04-11,IND,95,34,40,NJN,93,18,58,52,98
1988-04-11,MIL,102,40,34,PHL,115,32,42,72,76
1988-04-11,ATL,85,47,27,WAS,86,34,41,81,68
1988-04-12,SAN,127,28,46,HOU,119,43,31,71,77
1988-04-12,UTH,100,41,34,LAC,93,17,58,58,92
1988-04-12,SAC,96,22,53,DAL,104,49,25,71,78
1988-04-12,CLE,116,37,39,ATL,103,47,28,84,67
1988-04-12,LAL,109,56,18,POR,103,47,27,103,45
1988-04-13,NYK,127,35,41,IND,107,35,40,70,81
1988-04-13,SEA,113,40,35,LAC,92,17,59,57,94
1988-04-13,BOS,123,54,21,MIL,104,40,35,94,56
1988-04-13,PHX,123,25,50,SAN,116,29,46,54,96
1988-04-13,DEN,120,49,27,LAL,106,57,18,106,45
1988-04-13,DET,115,49,26,CLE,98,38,39,87,65
1988-04-13,PHL,98,33,42,WAS,97,35,41,68,83
1988-04-13,GOS,112,18,57,DAL,110,50,25,68,82
1988-04-14,UTH,123,42,34,POR,128,47,28,89,62
1988-04-14,HOU,123,43,32,SAC,105,22,54,65,86
1988-04-14,IND,110,35,41,CHI,116,45,30,80,71
1988-04-15,LAL,117,57,19,PHX,114,26,50,83,69
1988-04-15,DET,92,50,26,MIL,91,40,36,90,62
1988-04-15,NJN,99,18,59,CHI,100,46,30,64,89
1988-04-15,POR,147,48,28,GOS,113,19,57,67,85
1988-04-15,CLE,120,38,40,BOS,109,55,21,93,61
1988-04-15,NYK,97,36,41,WAS,106,35,42,71,83
1988-04-15,DEN,132,50,27,HOU,125,44,32,94,59
1988-04-15,SAN,116,29,47,SAC,112,22,55,51,102
1988-04-15,PHL,101,34,42,ATL,103,47,29,81,71
1988-04-15,SEA,115,41,35,DAL,88,50,26,91,61
1988-04-16,ATL,93,48,29,NYK,95,36,42,84,71
1988-04-16,UTH,107,42,35,SAN,82,30,47,72,82
1988-04-16,IND,126,35,42,PHL,92,34,43,69,85
1988-04-16,DET,114,51,26,NJN,96,18,60,69,86
1988-04-16,GOS,113,19,58,LAC,110,17,60,36,118
1988-04-16,PHX,121,26,51,SEA,119,42,35,68,86
1988-04-17,WAS,98,36,42,BOS,92,55,22,91,64
1988-04-17,DEN,133,51,27,DAL,122,50,27,101,54
1988-04-17,POR,112,49,28,SAC,102,22,56,71,84
1988-04-17,HOU,127,44,33,LAL,119,58,19,102,52
1988-04-17,CHI,105,47,30,MIL,97,40,37,87,67
1988-04-18,CLE,112,39,40,IND,107,36,42,75,82
1988-04-19,PHL,115,34,44,MIL,102,40,38,74,82
1988-04-19,HOU,96,45,33,DAL,104,50,28,95,61
1988-04-19,BOS,121,55,23,DET,110,52,26,107,49
1988-04-19,POR,122,50,28,UTH,129,43,35,93,63
1988-04-19,PHX,122,27,51,GOS,107,20,58,47,109
1988-04-19,SAC,120,22,57,LAC,105,17,61,39,118
1988-04-19,NJN,109,18,61,ATL,119,48,30,66,91
1988-04-19,DEN,134,52,27,SEA,114,42,36,94,63
1988-04-19,NYK,118,37,42,CHI,121,48,30,85,72
1988-04-19,SAN,126,30,48,LAL,133,58,20,88,68
1988-04-20,MIL,132,40,39,WAS,94,37,42,77,81
1988-04-20,DAL,107,51,28,LAL,114,59,20,110,48
1988-04-20,GOS,117,20,59,POR,131,50,29,70,88
1988-04-20,SEA,121,42,37,PHX,98,28,51,70,88
1988-04-20,ATL,98,49,30,IND,116,36,43,85,73
1988-04-20,LAC,106,17,62,UTH,112,44,35,61,97
1988-04-21,PHL,104,35,44,NJN,101,18,62,53,106
1988-04-21,BOS,126,56,23,CHI,119,49,30,105,53
1988-04-21,HOU,116,45,34,SAN,117,30,49,75,83
1988-04-21,WAS,87,37,43,DET,99,52,27,89,70
1988-04-22,DAL,127,51,29,SAN,96,31,49,82,78
1988-04-22,DET,98,53,27,IND,103,37,43,90,70
1988-04-22,GOS,109,20,60,SAC,117,23,57,43,117
1988-04-22,POR,141,51,29,DEN,135,53,27,104,56
1988-04-22,MIL,118,41,39,NYK,109,37,43,78,82
1988-04-22,PHX,112,28,52,LAL,117,60,20,88,72
1988-04-22,CHI,103,49,31,CLE,107,40,40,89,71
1988-04-22,SEA,109,43,37,UTH,110,45,35,88,72
1988-04-22,ATL,133,49,31,BOS,106,57,23,106,54
1988-04-23,DEN,134,53,28,LAC,109,17,63,70,91
1988-04-23,WAS,106,37,44,ATL,96,50,31,87,75
1988-04-23,CLE,104,41,40,PHL,99,36,44,77,84
1988-04-23,UTH,125,46,35,HOU,107,45,35,91,70
1988-04-23,IND,86,38,43,NYK,88,37,44,75,87
1988-04-23,NJN,118,18,63,MIL,105,42,39,60,102
1988-04-23,SAC,110,24,57,POR,124,52,29,76,86
1988-04-24,DET,128,53,28,PHL,118,36,45,89,73
1988-04-24,LAL,136,61,20,GOS,100,20,61,81,81
1988-04-24,CHI,115,49,32,BOS,108,57,24,106,56
1988-04-24,HOU,127,45,36,PHX,119,28,53,73,89
1988-04-24,LAC,100,17,64,SEA,109,43,38,60,102
1988-04-24,SAN,109,31,50,DAL,119,52,29,83,79
1988-11-04,IND,103,0,0,MIL,117,0,0,0,0
1988-11-04,DAL,113,0,0,LAL,116,0,0,0,0
1988-11-04,PHL,129,0,0,LAC,110,0,0,0,0
1988-11-04,DEN,120,0,0,HOU,117,0,0,0,0
1988-11-04,POR,120,0,0,PHX,105,0,0,0,0
1988-11-04,UTH,97,0,0,SEA,104,0,0,0,0
1988-11-04,BOS,122,0,0,NYK,115,0,0,0,0
1988-11-04,CHH,93,0,0,CLE,133,0,0,0,0
1988-11-04,CHI,94,0,0,DET,107,0,0,0,0
1988-11-04,NJN,105,0,0,ATL,113,0,0,0,0
1988-11-05,NJN,112,0,1,NYK,102,0,1,0,2
1988-11-05,PHL,129,1,0,BOS,115,1,0,2,0
1988-11-05,SEA,142,1,0,DEN,141,1,0,2,0
1988-11-05,MIA,91,0,0,LAC,111,0,1,0,1
1988-11-05,DET,94,1,0,CHH,85,0,1,1,1
1988-11-05,HOU,113,0,1,DAL,114,0,1,0,2
1988-11-05,SAN,122,0,0,LAL,107,1,0,1,0
1988-11-05,MIL,94,1,0,ATL,107,1,0,2,0
1988-11-05,IND,99,0,1,CLE,105,1,0,1,1
1988-11-05,POR,121,1,0,SAC,103,0,0,1,0
1988-11-05,GOS,117,0,0,PHX,104,0,1,0,1
1988-11-05,WAS,98,0,0,CHI,111,0,1,0,1
1988-11-08,NJN,109,1,1,WAS,101,0,1,1,2
1988-11-08,CHH,117,0,2,LAC,105,1,1,1,3
1988-11-08,PHL,109,2,0,DET,116,2,0,4,0
1988-11-08,SAC,75,0,1,SEA,97,2,0,2,1
1988-11-08,DAL,92,1,1,MIA,88,0,1,1,2
1988-11-08,ATL,112,2,0,IND,107,0,2,2,2
1988-11-08,GOS,102,1,0,LAL,114,1,1,2,1
1988-11-08,NYK,126,0,2,CHI,117,1,1,1,3
1988-11-08,HOU,120,0,2,SAN,102,1,0,1,2
1988-11-09,MIL,114,1,1,PHL,103,2,1,3,2
1988-11-09,BOS,104,1,1,CHI,110,1,2,2,3
1988-11-09,DET,101,3,0,ATL,95,3,0,6,0
1988-11-09,WAS,110,0,2,NYK,117,1,2,1,4
1988-11-09,LAL,128,2,1,DEN,110,1,1,3,2
1988-11-09,SAN,117,1,1,MIA,93,0,2,1,3
1988-11-09,PHX,111,0,2,DAL,103,2,1,2,3
1988-11-09,SEA,108,3,0,GOS,113,1,1,4,1
1988-11-09,CLE,108,2,0,LAC,91,1,2,3,2
1988-11-09,UTH,105,0,1,SAC,81,0,2,0,3
1988-11-10,DEN,135,1,2,POR,115,2,0,3,2
1988-11-10,HOU,106,1,2,UTH,99,1,1,2,3
1988-11-11,DAL,115,2,2,SAN,102,2,1,4,3
1988-11-11,BOS,107,1,2,DET,116,4,0,5,2
1988-11-11,CHI,97,2,2,NJN,85,2,1,4,3
1988-11-11,PHL,107,2,2,ATL,105,3,1,5,3
1988-11-11,IND,120,0,3,NYK,121,2,2,2,5
1988-11-11,PHX,141,1,2,GOS,103,2,1,3,3
1988-11-11,LAL,114,3,1,SEA,103,3,1,6,2
1988-11-11,MIA,100,0,3,HOU,121,2,2,2,5
1988-11-11,WAS,96,0,3,CHH,87,1,2,1,5
1988-11-12,SAN,96,2,2,UTH,105,1,2,3,4
1988-11-12,CLE,121,3,0,IND,96,0,4,3,4
1988-11-12,DAL,111,3,2,SAC,71,0,3,3,5
1988-11-12,MIL,108,2,1,BOS,100,1,3,3,4
1988-11-12,LAC,138,1,3,PHX,127,2,2,3,5
1988-11-12,GOS,107,2,2,POR,100,2,1,4,3
1988-11-12,DEN,141,2,2,SEA,129,3,2,5,4
1988-11-12,NJN,97,2,2,CHI,91,3,2,5,4
1988-11-12,NYK,111,3,2,WAS,101,1,3,4,5
1988-11-12,ATL,132,3,2,CHH,111,1,3,4,5
1988-11-13,POR,132,2,2,DEN,143,3,2,5,4
1988-11-13,HOU,129,3,2,SAC,127,0,4,3,6
1988-11-14,NJN,96,3,2,GOS,100,3,2,6,4
1988-11-15,CLE,95,4,0,ATL,97,4,2,8,2
1988-11-15,CHI,120,3,3,PHL,107,3,2,6,5
1988-11-15,UTH,108,2,2,IND,96,0,5,2,7
1988-11-15,POR,125,2,3,LAC,103,2,3,4,6
1988-11-15,MIA,65,0,4,BOS,84,1,4,1,8
1988-11-15,CHH,99,1,4,NJN,106,3,3,4,7
1988-11-15,DAL,99,4,2,DET,108,5,0,9,2
1988-11-15,HOU,121,4,2,NYK,126,4,2,8,4
1988-11-15,DEN,146,4,2,LAL,148,4,1,8,3
1988-11-15,SAC,89,0,5,PHX,119,2,3,2,8
1988-11-16,LAC,112,2,4,SAC,101,0,6,2,10
1988-11-16,SAN,88,2,3,DET,94,6,0,8,3
1988-11-16,BOS,107,2,4,GOS,104,4,2,6,6
1988-11-16,PHX,123,3,3,IND,104,0,6,3,9
1988-11-16,PHL,123,3,3,CHI,110,4,3,7,6
1988-11-17,DEN,139,4,3,SAN,112,2,4,6,7
1988-11-17,HOU,113,4,3,MIA,107,0,5,4,8
1988-11-17,MIL,96,3,1,NJN,105,4,3,7,4
1988-11-17,DAL,105,4,3,CHH,93,1,5,5,8
1988-11-17,UTH,123,3,2,POR,99,3,3,6,5
1988-11-17,SEA,101,3,3,LAL,98,5,1,8,4
1988-11-18,PHL,137,4,3,NYK,135,5,2,9,5
1988-11-18,MIA,117,0,6,GOS,123,4,3,4,9
1988-11-18,CHI,115,4,4,ATL,112,5,2,9,6
1988-11-18,PHX,105,4,3,DET,121,7,0,11,3
1988-11-18,LAL,106,5,2,POR,105,3,4,8,6
1988-11-18,LAC,113,3,4,IND,110,0,7,3,11
1988-11-18,BOS,114,3,4,WAS,108,1,4,4,8
1988-11-18,NJN,94,5,3,CLE,95,4,1,9,4
1988-11-19,WAS,108,1,5,BOS,104,4,4,5,9
1988-11-19,ATL,111,5,3,GOS,92,5,3,10,6
1988-11-19,SAC,107,0,7,IND,96,0,8,0,15
1988-11-19,DEN,134,5,3,LAC,107,4,4,9,7
1988-11-19,HOU,109,5,3,DET,98,8,0,13,3
1988-11-19,SAN,105,2,5,CHH,107,1,6,3,11
1988-11-19,NYK,141,5,3,PHL,122,5,3,10,6
1988-11-19,CLE,106,5,1,MIL,99,3,2,8,3
1988-11-19,UTH,134,4,2,PHX,121,4,4,8,6
1988-11-19,SEA,106,4,3,DAL,112,5,3,9,6
1988-11-20,POR,117,3,5,NJN,106,5,4,8,9
1988-11-21,HOU,117,6,3,ATL,113,6,3,12,6
1988-11-21,UTH,117,5,2,LAC,98,4,5,9,7
1988-11-22,IND,105,0,9,MIL,91,3,3,3,12
1988-11-22,SAC,98,1,7,CHI,114,5,4,6,11
1988-11-22,BOS,102,4,5,CLE,114,6,1,10,6
1988-11-22,SEA,104,4,4,POR,125,4,5,8,9
1988-11-22,NYK,98,6,3,LAL,110,6,2,12,5
1988-11-22,WAS,103,2,5,PHL,130,5,4,7,9
1988-11-22,DEN,141,6,3,NJN,106,5,5,11,8
1988-11-22,CHH,93,2,6,DET,99,8,1,10,7
1988-11-23,PHL,104,6,4,CLE,91,7,1,13,5
1988-11-23,BOS,114,4,6,CHH,109,2,7,6,13
1988-11-23,MIA,91,0,7,LAL,138,7,2,7,9
1988-11-23,GOS,85,5,4,SEA,93,4,5,9,9
1988-11-23,DAL,125,6,3,DEN,106,7,3,13,6
1988-11-23,SAN,119,2,6,ATL,109,6,4,8,10
1988-11-23,MIL,124,3,4,WAS,102,2,6,5,10
1988-11-23,LAC,105,4,6,CHI,97,6,4,10,10
1988-11-23,PHX,129,4,5,NJN,133,5,6,9,11
1988-11-23,UTH,111,6,2,HOU,108,7,3,13,5
1988-11-23,DET,111,9,1,NYK,133,6,4,15,5
1988-11-25,DAL,100,7,3,ATL,95,6,5,13,8
1988-11-25,LAC,100,5,6,NJN,93,6,6,11,12
1988-11-25,IND,101,1,9,WAS,106,2,7,3,16
1988-11-25,UTH,115,7,2,SAN,95,3,6,10,8
1988-11-25,PHX,110,4,6,SEA,105,5,5,9,11
1988-11-25,BOS,115,5,6,MIL,96,4,4,9,10
1988-11-25,PHL,123,7,4,CHH,116,2,8,9,12
1988-11-25,POR,111,5,5,HOU,94,7,4,12,9
1988-11-26,DET,102,9,2,LAL,99,8,2,17,4
1988-11-26,PHL,122,8,4,IND,114,1,10,9,14
1988-11-26,SAC,97,1,8,NJN,98,6,7,7,15
1988-11-26,DEN,128,7,4,CHI,123,6,5,13,9
1988-11-26,MIL,103,4,5,MIA,93,0,8,4,13
1988-11-26,CHH,113,2,9,WAS,120,3,7,5,16
1988-11-26,SAN,117,3,7,PHX,104,5,6,8,13
1988-11-26,ATL,104,6,6,BOS,91,6,6,12,12
1988-11-26,NYK,127,7,4,CLE,112,7,2,14,6
1988-11-26,GOS,109,5,5,HOU,119,7,5,12,10
1988-11-26,DAL,113,8,3,UTH,93,8,2,16,5
1988-11-27,CLE,109,7,3,MIA,80,0,9,7,12
1988-11-27,POR,109,6,5,GOS,94,5,6,11,11
1988-11-28,PHL,104,9,4,LAL,109,8,3,17,7
1988-11-29,CHH,99,2,10,MIA,84,0,10,2,20
1988-11-29,GOS,109,5,7,CHI,99,6,6,11,13
1988-11-29,SEA,109,5,6,UTH,102,8,3,13,9
1988-11-29,ATL,120,7,6,SAN,104,4,7,11,13
1988-11-29,DEN,139,8,4,NYK,119,8,4,16,8
1988-11-29,HOU,107,8,5,PHX,124,5,7,13,12
1988-11-29,NJN,93,7,7,BOS,100,6,7,13,14
1988-11-29,MIL,119,5,5,POR,114,7,5,12,10
1988-11-29,IND,107,1,11,DET,98,10,2,11,13
1988-11-29,SAC,123,1,9,LAC,95,6,6,7,15
1988-11-30,PHL,114,9,5,POR,106,7,6,16,11
1988-11-30,UTH,107,8,4,CHI,93,6,7,14,11
1988-11-30,LAC,128,6,7,NYK,135,8,5,14,12
1988-11-30,DAL,89,9,3,HOU,101,8,6,17,9
1988-11-30,MIA,101,0,11,SAN,105,4,8,4,19
1988-11-30,DET,114,10,3,IND,111,2,11,12,14
1988-11-30,LAL,110,9,3,SEA,106,6,6,15,9
1988-11-30,BOS,133,7,7,NJN,100,7,8,14,15
1988-12-01,MIL,96,6,5,CLE,99,8,3,14,8
1988-12-01,CHH,109,3,10,PHL,107,10,5,13,15
1988-12-01,ATL,127,8,6,WAS,115,4,7,12,13
1988-12-01,SAC,126,2,9,DEN,133,9,4,11,13
1988-12-02,WAS,114,4,8,DET,120,11,3,15,11
1988-12-02,NJN,92,7,9,MIL,103,6,6,13,15
1988-12-02,SEA,154,6,7,LAC,104,6,8,12,15
1988-12-02,MIA,102,0,12,POR,105,7,7,7,19
1988-12-02,DEN,129,10,4,GOS,102,6,7,16,11
1988-12-02,PHX,110,6,7,HOU,95,9,6,15,13
1988-12-02,DAL,101,9,4,NYK,104,9,5,18,9
1988-12-02,LAL,113,10,3,UTH,92,9,4,19,7
1988-12-02,CLE,112,9,3,BOS,84,8,7,17,10
1988-12-03,SEA,136,7,7,GOS,106,6,8,13,15
1988-12-03,DAL,100,9,5,CHI,113,6,8,15,13
1988-12-03,HOU,108,9,7,CHH,104,4,10,13,17
1988-12-03,SAC,73,2,10,UTH,107,9,5,11,15
1988-12-03,ATL,115,9,6,POR,97,8,7,17,13
1988-12-03,SAN,122,5,8,NYK,109,10,5,15,13
1988-12-03,IND,100,2,12,PHL,107,10,6,12,18
1988-12-03,PHX,114,7,7,LAC,106,6,9,13,16
1988-12-04,LAL,119,11,3,WAS,112,4,9,15,12
1988-12-04,NJN,99,7,10,DET,102,12,3,19,13
1988-12-04,CLE,122,10,3,DEN,103,11,4,21,7
1988-12-06,ATL,123,10,6,SAC,113,2,11,12,17
1988-12-06,NYK,124,10,6,DEN,123,11,5,21,11
1988-12-06,NJN,93,7,11,POR,97,8,8,15,19
1988-12-06,LAC,102,6,10,LAL,111,12,3,18,13
1988-12-06,MIL,109,7,6,DET,84,13,3,20,9
1988-12-06,HOU,106,10,7,CLE,105,11,3,21,10
1988-12-06,GOS,114,6,9,UTH,103,10,5,16,14
1988-12-06,SAN,107,6,8,SEA,112,8,7,14,15
1988-12-06,CHI,105,7,8,BOS,100,8,8,15,16
1988-12-06,PHX,130,8,7,WAS,92,4,10,12,17
1988-12-07,LAL,125,13,3,PHX,111,9,7,22,10
1988-12-07,BOS,103,8,9,ATL,106,11,6,19,15
1988-12-07,UTH,111,10,6,WAS,94,4,11,14,17
1988-12-07,DET,102,13,4,CHI,89,8,8,21,12
1988-12-07,PHL,134,11,6,DEN,109,11,6,22,12
1988-12-07,MIA,94,0,13,SAC,96,2,12,2,25
1988-12-07,DAL,102,9,6,SEA,98,9,7,18,13
1988-12-07,IND,129,2,13,POR,120,9,8,11,21
1988-12-08,NYK,113,11,6,MIL,109,8,6,19,12
1988-12-08,SAN,95,6,9,CLE,104,11,4,17,13
1988-12-08,LAC,120,6,11,HOU,116,11,7,17,18
1988-12-09,IND,112,3,13,SAC,105,3,12,6,25
1988-12-09,POR,93,9,9,WAS,90,4,12,13,21
1988-12-09,UTH,89,11,6,DAL,97,10,6,21,12
1988-12-09,ATL,82,12,6,DET,92,14,4,26,10
1988-12-09,CHI,118,8,9,MIL,100,8,7,16,16
1988-12-09,PHX,110,9,8,GOS,105,7,9,16,17
1988-12-09,CHH,96,4,11,NJN,95,7,12,11,23
1988-12-09,MIA,110,0,14,DEN,121,11,7,11,21
1988-12-09,BOS,121,8,10,PHL,107,12,6,20,16
1988-12-10,NJN,121,7,13,CHH,112,5,11,12,24
1988-12-10,IND,105,4,13,LAL,112,14,3,18,16
1988-12-10,HOU,110,11,8,SEA,91,9,8,20,16
1988-12-10,LAC,102,7,11,UTH,110,11,7,18,18
1988-12-10,NYK,124,12,6,SAC,111,3,13,15,19
1988-12-10,ATL,130,12,7,DEN,133,12,7,24,14
1988-12-10,DET,106,15,4,PHL,100,12,7,27,11
1988-12-10,CHI,111,9,9,MIA,88,0,15,9,24
1988-12-10,GOS,109,7,10,WAS,102,4,13,11,23
1988-12-10,DAL,98,11,6,CLE,102,12,4,23,10
1988-12-11,MIL,95,8,8,LAL,94,15,3,23,11
1988-12-11,POR,128,10,9,SAN,123,6,10,16,19
1988-12-12,UTH,110,12,7,MIA,94,0,16,12,23
1988-12-13,IND,115,4,14,CHH,104,5,12,9,26
1988-12-13,DAL,117,11,7,GOS,111,8,10,19,17
1988-12-13,POR,113,11,9,LAC,92,7,12,18,21
1988-12-13,WAS,115,4,14,BOS,105,9,10,13,24
1988-12-13,SEA,126,9,9,PHX,116,10,8,19,17
1988-12-13,CLE,102,13,4,LAL,111,15,4,28,8
1988-12-13,CHI,88,10,9,ATL,106,12,8,22,17
1988-12-13,SAC,108,3,14,SAN,89,6,11,9,25
1988-12-13,PHL,91,12,8,MIL,109,9,8,21,16
1988-12-13,NYK,121,13,6,NJN,100,8,13,21,19
1988-12-13,DEN,126,13,7,HOU,101,12,8,25,15
1988-12-14,NJN,118,8,14,LAL,113,16,4,24,18
1988-12-14,DET,110,16,4,MIL,119,10,8,26,12
1988-12-14,CHH,115,5,13,IND,106,5,14,10,27
1988-12-14,BOS,112,9,11,UTH,104,13,7,22,18
1988-12-14,LAC,88,7,13,MIA,89,0,17,7,30
1988-12-14,ATL,103,13,8,PHL,96,12,9,25,17
1988-12-15,SEA,122,10,9,SAN,107,6,12,16,21
1988-12-15,HOU,124,12,9,GOS,115,8,11,20,20
1988-12-15,CLE,119,13,5,DET,98,16,5,29,10
1988-12-15,NYK,117,14,6,UTH,116,13,8,27,14
1988-12-15,SAC,94,4,14,MIA,90,1,17,5,31
1988-12-16,LAC,121,7,14,DEN,118,14,7,21,21
1988-12-16,CHH,98,6,13,DAL,107,12,7,18,20
1988-12-16,ATL,115,14,8,MIL,112,11,8,25,16
1988-12-16,BOS,110,10,11,LAL,96,16,5,26,16
1988-12-16,CHI,100,10,10,IND,93,5,15,15,25
1988-12-16,PHX,132,10,9,POR,125,12,9,22,18
1988-12-16,NJN,106,9,14,PHL,114,12,10,21,24
1988-12-17,SAN,113,6,13,GOS,123,8,12,14,25
1988-12-17,MIA,87,1,18,DAL,104,13,7,14,25
1988-12-17,POR,115,12,10,PHX,97,11,9,23,19
1988-12-17,DEN,114,14,8,LAC,99,8,14,22,22
1988-12-17,PHL,119,13,10,UTH,107,13,9,26,19
1988-12-17,IND,92,5,16,NJN,100,9,15,14,31
1988-12-17,DET,100,16,6,CHH,91,6,14,22,20
1988-12-17,SEA,141,11,9,SAC,111,5,14,16,23
1988-12-17,NYK,117,15,6,WAS,102,5,14,20,20
1988-12-17,MIL,93,11,9,CHI,112,11,10,22,19
1988-12-17,CLE,120,14,5,ATL,94,15,8,29,13
1988-12-18,BOS,117,11,11,NYK,104,16,6,27,17
1988-12-18,HOU,120,13,9,SAN,109,6,14,19,23
1988-12-18,WAS,115,5,15,LAL,110,16,6,21,21
1988-12-20,CHI,116,12,10,LAL,103,16,7,28,17
1988-12-20,GOS,113,9,12,LAC,111,8,15,17,27
1988-12-20,PHX,128,11,10,SAN,110,6,15,17,25
1988-12-20,DEN,124,15,8,POR,127,13,10,28,18
1988-12-20,CLE,110,15,5,UTH,94,13,10,28,15
1988-12-20,PHL,102,14,10,DAL,108,14,7,28,17
1988-12-20,HOU,105,14,9,SAC,104,5,15,19,24
1988-12-20,MIL,125,11,10,CHH,115,6,15,17,25
1988-12-20,ATL,121,15,9,SEA,118,12,9,27,18
1988-12-20,DET,116,17,6,MIA,100,1,19,18,25
1988-12-20,NYK,141,16,7,IND,113,5,17,21,24
1988-12-21,BOS,114,12,11,CLE,115,16,5,28,16
1988-12-21,MIA,101,1,20,SEA,109,12,10,13,30
1988-12-21,SAN,125,6,16,SAC,107,5,16,11,32
1988-12-21,CHH,100,6,16,MIL,112,12,10,18,26
1988-12-21,WAS,82,6,15,UTH,98,13,11,19,26
1988-12-21,NJN,122,10,15,DAL,120,15,7,25,22
1988-12-22,GOS,109,10,12,POR,117,14,10,24,22
1988-12-22,HOU,125,15,9,LAC,109,8,16,23,25
1988-12-22,DEN,118,15,9,PHX,126,12,10,27,19
1988-12-22,NYK,88,17,7,DET,85,18,6,35,13
1988-12-23,CHH,103,6,17,CHI,101,13,10,19,27
1988-12-23,LAL,120,16,8,SAC,102,5,17,21,25
1988-12-23,SAN,108,7,16,LAC,114,8,17,15,33
1988-12-23,MIA,101,1,21,UTH,80,14,11,15,32
1988-12-23,ATL,131,16,9,IND,114,5,18,21,27
1988-12-23,POR,111,15,10,GOS,107,10,13,25,23
1988-12-23,PHX,119,13,10,DEN,107,15,10,28,20
1988-12-23,MIL,113,13,10,DAL,101,15,8,28,18
1988-12-23,CLE,119,17,5,SEA,107,13,10,30,15
1988-12-25,UTH,101,14,12,LAL,87,17,8,31,20
1988-12-25,PHL,125,14,11,WAS,110,6,16,20,27
1988-12-26,PHX,111,14,10,LAL,96,17,9,31,19
1988-12-26,MIA,111,2,21,SAN,109,7,17,9,38
1988-12-26,NJN,108,11,15,WAS,120,6,17,17,32
1988-12-26,CHH,95,7,17,HOU,97,16,9,23,26
1988-12-27,MIL,120,14,10,IND,107,5,19,19,29
1988-12-27,DEN,130,15,11,BOS,109,12,12,27,23
1988-12-27,LAC,104,9,17,SEA,100,13,11,22,28
1988-12-27,GOS,119,10,14,PHL,112,15,11,25,25
1988-12-27,CHI,96,13,11,CLE,107,18,5,31,16
1988-12-27,SAC,112,5,18,POR,111,16,10,21,28
1988-12-27,DAL,110,15,9,SAN,101,7,18,22,27
1988-12-27,MIA,93,3,21,HOU,101,17,9,20,30
1988-12-27,ATL,128,17,9,NYK,126,18,7,35,16
1988-12-28,LAL,128,17,10,PHL,123,15,12,32,22
1988-12-28,UTH,96,15,12,SAC,80,6,18,21,30
1988-12-28,NJN,118,11,16,IND,101,5,20,16,36
1988-12-28,DET,106,18,7,PHX,100,15,10,33,17
1988-12-28,CLE,122,19,5,CHH,98,7,18,26,23
1988-12-29,CHI,108,13,12,NYK,106,18,8,31,20
1988-12-29,WAS,126,7,17,HOU,109,18,9,25,26
1988-12-29,DAL,131,16,9,BOS,115,12,13,28,22
1988-12-29,SEA,129,13,12,MIA,99,3,22,16,34
1988-12-30,MIL,113,15,10,ATL,117,18,9,33,19
1988-12-30,NJN,109,12,16,PHX,116,15,11,27,27
1988-12-30,LAL,124,18,10,LAC,109,10,17,28,27
1988-12-30,CLE,127,20,5,WAS,110,8,17,28,22
1988-12-30,CHH,122,7,19,NYK,111,18,9,25,28
1988-12-30,DEN,109,16,11,MIA,83,3,23,19,34
1988-12-30,SAN,99,7,19,BOS,112,12,14,19,33
1988-12-30,IND,85,5,21,CHI,101,14,12,19,33
1988-12-30,DET,95,19,7,HOU,83,18,10,37,17
1988-12-30,UTH,102,16,12,PHL,95,15,13,31,25
1989-01-02,WAS,122,8,18,PHX,125,16,11,24,29
1989-01-03,SEA,116,14,12,LAL,106,19,10,33,22
1989-01-03,SAN,129,7,20,DEN,105,17,11,24,31
1989-01-03,CHI,126,15,12,LAC,121,10,18,25,30
1989-01-03,CHH,106,8,19,NJN,109,12,17,20,36
1989-01-03,CLE,119,21,5,IND,98,5,22,26,27
1989-01-03,NYK,109,18,10,BOS,107,13,14,31,24
1989-01-03,SAC,123,6,19,DAL,96,17,9,23,28
1989-01-03,HOU,104,18,11,UTH,102,17,12,35,23
1989-01-03,ATL,123,19,9,DET,104,20,7,39,16
1989-01-03,POR,119,16,11,MIA,95,3,24,19,35
1989-01-04,IND,116,5,23,ATL,113,20,9,25,32
1989-01-04,MIL,110,15,11,LAC,102,10,19,25,30
1989-01-04,NJN,96,13,17,NYK,105,19,10,32,27
1989-01-04,LAL,133,19,11,POR,120,17,11,36,22
1989-01-04,WAS,109,8,19,CHH,86,8,20,16,39
1989-01-04,BOS,104,13,15,PHX,106,17,11,30,26
1989-01-04,GOS,109,11,14,MIA,100,3,25,14,39
1989-01-05,SAN,119,8,20,PHL,104,15,14,23,34
1989-01-05,SEA,120,15,12,SAC,106,7,19,22,31
1989-01-05,CLE,103,22,5,CHI,98,16,12,38,17
1989-01-05,DEN,131,17,12,GOS,129,12,14,29,26
1989-01-06,DET,111,20,8,ATL,88,20,10,40,18
1989-01-06,BOS,115,13,16,CHH,92,8,21,21,37
1989-01-06,IND,123,6,23,LAC,88,10,20,16,43
1989-01-06,POR,147,17,12,SAC,142,7,20,24,32
1989-01-06,LAL,118,20,11,MIA,86,3,26,23,37
1989-01-06,WAS,121,9,19,MIL,128,16,11,25,30
1989-01-06,PHX,120,18,11,DAL,111,17,10,35,21
1989-01-06,CHI,92,16,13,UTH,106,17,13,33,26
1989-01-07,PHX,107,19,11,MIA,99,3,27,22,38
1989-01-07,MIL,107,17,11,UTH,89,18,13,35,24
1989-01-07,ATL,103,20,11,NJN,93,13,18,33,29
1989-01-07,DEN,115,18,12,DAL,94,17,11,35,23
1989-01-07,CHH,107,8,22,WAS,104,9,20,17,42
1989-01-07,IND,113,7,23,DET,99,21,8,28,31
1989-01-07,HOU,95,19,11,PHL,96,15,15,34,26
1989-01-07,CLE,104,23,5,NYK,96,20,10,43,15
1989-01-07,GOS,102,12,15,SAN,104,9,20,21,35
1989-01-07,SEA,129,16,12,POR,123,18,12,34,24
1989-01-08,NYK,134,20,11,LAC,100,10,21,30,32
1989-01-08,LAL,126,21,11,SAN,96,10,20,31,31
1989-01-09,CHH,92,9,22,UTH,114,18,14,27,36
1989-01-09,BOS,119,14,16,LAC,84,10,22,24,38
1989-01-09,SEA,105,17,12,CLE,103,24,5,41,17
1989-01-09,GOS,130,12,16,PHX,124,20,11,32,27
1989-01-09,DAL,103,17,12,PHL,121,16,15,33,27
1989-01-10,SAC,106,7,21,LAL,97,22,11,29,32
1989-01-10,WAS,120,9,21,DEN,117,19,12,28,33
1989-01-10,MIA,88,3,28,UTH,92,19,14,22,42
1989-01-10,ATL,101,21,11,CHI,104,16,14,37,25
1989-01-10,POR,125,18,13,SEA,109,18,12,36,25
1989-01-11,BOS,108,15,16,IND,127,8,23,23,39
1989-01-11,DET,93,21,9,NYK,100,21,11,42,20
1989-01-11,LAC,104,10,23,SAC,106,8,21,18,44
1989-01-11,GOS,107,13,16,DAL,106,17,13,30,29
1989-01-11,PHX,121,20,12,CLE,124,24,6,44,18
1989-01-11,SAN,117,10,21,HOU,122,19,12,29,33
1989-01-11,CHH,101,9,23,CHI,106,17,14,26,37
1989-01-11,MIL,123,18,11,DEN,106,19,13,37,24
1989-01-11,PHL,103,17,15,NJN,94,13,19,30,34
1989-01-12,SEA,130,18,13,DAL,95,17,14,35,27
1989-01-12,NJN,103,13,20,BOS,106,15,17,28,37
1989-01-12,HOU,116,20,12,POR,106,19,13,39,25
1989-01-12,NYK,106,22,11,CHH,89,9,24,31,35
1989-01-12,UTH,115,20,14,SAN,91,10,22,30,36
1989-01-12,WAS,106,10,21,MIA,100,3,29,13,50
1989-01-13,LAC,113,10,24,GOS,127,14,16,24,40
1989-01-13,DET,119,21,10,WAS,103,11,21,32,31
1989-01-13,MIA,101,3,30,MIL,107,19,11,22,41
1989-01-13,PHL,114,18,15,ATL,101,21,12,39,27
1989-01-13,LAL,116,22,12,CLE,95,25,6,47,18
1989-01-13,PHX,111,20,13,SAC,90,9,21,29,34
1989-01-13,CHI,104,18,14,DEN,99,19,14,37,28
1989-01-14,GOS,131,15,16,UTH,105,21,14,36,30
1989-01-14,SAN,99,10,23,POR,103,19,14,29,37
1989-01-14,SAC,93,9,22,SEA,102,19,13,28,35
1989-01-14,NYK,132,23,11,ATL,122,21,13,44,24
1989-01-14,HOU,110,21,12,DAL,98,17,15,38,27
1989-01-14,DEN,104,19,15,CLE,116,25,7,44,22
1989-01-14,IND,97,9,23,NJN,106,13,21,22,44
1989-01-15,DAL,111,17,16,POR,108,20,14,37,30
1989-01-15,MIL,120,20,11,DET,112,22,10,42,21
1989-01-15,LAC,95,10,25,LAL,116,23,12,33,37
1989-01-15,MIA,118,3,31,IND,117,9,24,12,55
1989-01-15,CHH,109,9,25,PHL,116,19,15,28,40
1989-01-15,CHI,110,19,14,BOS,104,16,17,35,31
1989-01-16,LAL,124,24,12,HOU,113,22,12,46,24
1989-01-16,WAS,106,11,22,ATL,117,21,14,32,36
1989-01-16,NYK,116,24,11,SAN,106,10,24,34,35
1989-01-16,DET,96,22,11,BOS,87,16,18,38,29
1989-01-16,DEN,116,19,16,SAC,110,9,23,28,39
1989-01-16,CLE,126,26,7,PHX,110,21,13,47,20
1989-01-16,GOS,146,16,16,SEA,117,20,13,36,29
1989-01-16,PHL,122,20,15,CHH,127,9,26,29,41
1989-01-17,SEA,130,20,14,LAC,107,10,26,30,40
1989-01-17,SAC,123,9,24,HOU,109,22,13,31,37
1989-01-17,CHI,103,20,14,IND,96,9,25,29,39
1989-01-17,POR,110,20,15,UTH,111,21,15,41,30
1989-01-17,ATL,111,22,14,MIL,98,21,11,43,25
1989-01-17,NJN,117,14,21,SAN,112,10,25,24,46
1989-01-18,GOS,133,17,16,NYK,119,25,11,42,27
1989-01-18,DET,103,23,11,NJN,90,15,21,38,32
1989-01-18,DAL,102,18,16,DEN,92,20,16,38,32
1989-01-18,LAL,111,25,12,LAC,90,10,27,35,39
1989-01-18,MIL,118,21,12,CHH,106,10,26,31,38
1989-01-18,PHL,115,20,16,BOS,104,16,19,36,35
1989-01-19,MIA,108,4,32,CHI,112,21,14,25,46
1989-01-19,SAC,112,10,24,NYK,106,25,12,35,36
1989-01-19,WAS,115,11,23,SAN,112,10,26,21,49
1989-01-19,SEA,124,21,14,HOU,108,22,14,43,28
1989-01-19,IND,106,9,26,CLE,113,27,7,36,33
1989-01-19,CHH,112,10,27,PHX,126,22,14,32,41
1989-01-20,GOS,121,18,16,HOU,114,22,15,40,31
1989-01-20,LAL,115,26,12,DAL,99,19,16,45,28
1989-01-20,UTH,98,22,15,MIL,96,22,12,44,27
1989-01-20,BOS,117,16,20,PHL,109,21,16,37,36
1989-01-20,DET,132,24,11,IND,99,9,27,33,38
1989-01-21,CLE,115,28,7,NJN,103,15,22,43,29
1989-01-21,ATL,137,23,14,CHH,113,10,28,33,42
1989-01-21,SEA,121,22,14,NYK,119,25,13,47,27
1989-01-21,WAS,107,12,23,PHL,105,21,17,33,40
1989-01-21,CHI,107,22,14,PHX,116,23,14,45,28
1989-01-21,DEN,107,20,17,MIL,116,22,13,42,30
1989-01-21,SAC,111,11,24,GOS,136,19,16,30,40
1989-01-22,BOS,112,17,20,DET,99,25,11,42,31
1989-01-22,POR,116,20,16,NYK,120,25,14,45,30
1989-01-23,IND,117,9,28,DEN,102,20,18,29,46
1989-01-23,SAN,119,10,27,MIA,101,4,33,14,60
1989-01-23,CLE,142,29,7,GOS,109,20,16,49,23
1989-01-24,HOU,118,22,16,MIA,93,4,34,26,50
1989-01-24,ATL,121,24,14,CLE,105,30,7,54,21
1989-01-24,NJN,117,15,23,DEN,115,20,19,35,42
1989-01-24,SAC,110,11,25,MIL,114,23,13,34,38
1989-01-24,POR,100,20,17,SEA,103,23,14,43,31
1989-01-24,CHI,109,22,15,DAL,91,19,17,41,32
1989-01-24,PHX,106,24,14,CHH,103,10,29,34,43
1989-01-24,LAL,117,27,12,NYK,122,26,14,53,26
1989-01-25,DET,105,25,12,GOS,104,20,17,45,29
1989-01-25,PHL,120,21,18,CHI,108,23,15,44,33
1989-01-25,SAN,103,11,27,UTH,107,23,15,34,42
1989-01-25,DAL,117,19,18,LAC,98,10,28,29,46
1989-01-25,IND,103,10,28,BOS,94,18,20,28,48
1989-01-26,WAS,126,13,23,IND,106,11,28,24,51
1989-01-26,POR,109,20,18,MIL,127,24,13,44,31
1989-01-26,MIA,108,4,35,DEN,129,20,20,24,55
1989-01-26,HOU,106,23,16,LAC,100,10,29,33,45
1989-01-26,NJN,109,16,23,SAC,112,11,26,27,49
1989-01-26,UTH,88,24,15,CHH,89,10,30,34,45
1989-01-27,LAL,114,27,13,CHH,97,11,30,38,43
1989-01-27,BOS,128,18,21,SAC,116,12,26,30,47
1989-01-27,CHI,117,23,16,WAS,106,14,23,37,39
1989-01-27,PHX,132,25,14,NYK,130,27,14,52,28
1989-01-27,SEA,119,24,14,ATL,112,25,14,49,28
1989-01-27,DAL,126,20,18,SAN,82,11,28,31,46
1989-01-27,DET,79,26,12,CLE,80,30,8,56,20
1989-01-27,PHL,113,22,18,GOS,112,20,18,42,36
1989-01-28,SAN,91,11,29,HOU,96,24,16,35,45
1989-01-28,UTH,127,24,16,NYK,104,27,15,51,31
1989-01-28,NJN,105,16,24,PHL,123,23,18,39,42
1989-01-28,DEN,142,21,20,PHX,138,26,14,47,34
1989-01-28,IND,112,11,29,GOS,114,20,19,31,48
1989-01-28,LAC,84,10,30,MIL,105,25,13,35,43
1989-01-28,POR,110,20,19,ATL,94,25,15,45,34
1989-01-29,WAS,122,14,24,CLE,117,31,8,45,32
1989-01-29,BOS,121,19,21,MIA,103,4,36,23,57
1989-01-29,DET,122,26,13,SAC,97,12,27,38,40
1989-01-29,SEA,112,25,14,MIL,106,26,13,51,27
1989-01-29,DAL,93,21,18,LAL,118,28,13,49,31
1989-01-30,MIA,98,4,37,GOS,105,21,19,25,56
1989-01-30,LAC,101,10,31,ATL,130,25,16,35,47
1989-01-30,PHX,126,26,15,DEN,100,22,20,48,35
1989-01-30,POR,130,21,19,CHH,118,11,31,32,50
1989-01-31,HOU,114,25,16,LAL,125,29,13,54,29
1989-01-31,SEA,112,26,14,NJN,118,16,25,42,39
1989-01-31,DAL,84,21,19,UTH,99,25,16,46,35
1989-01-31,CLE,118,31,9,PHL,103,24,18,55,27
1989-01-31,CHI,98,24,16,DET,104,27,13,51,29
1989-01-31,WAS,110,15,24,BOS,103,20,21,35,45
1989-01-31,NYK,120,27,16,IND,111,11,30,38,46
1989-01-31,SAN,117,11,30,DEN,111,22,21,33,51
1989-01-31,MIL,117,26,14,SAC,104,12,28,38,42
1989-02-01,PHL,114,24,19,WAS,110,16,24,40,43
1989-02-01,UTH,93,26,16,ATL,94,26,16,52,32
1989-02-01,PHX,114,27,15,LAL,97,30,13,57,28
1989-02-01,CHH,94,11,32,BOS,107,20,22,31,54
1989-02-01,LAC,107,10,32,POR,108,22,19,32,51
1989-02-02,GOS,127,22,19,NJN,113,17,25,39,44
1989-02-02,CHI,109,24,17,SAC,98,12,29,36,46
1989-02-02,NYK,125,28,16,CLE,109,32,9,60,25
1989-02-02,DEN,112,22,22,ATL,103,27,16,49,38
1989-02-02,MIA,93,4,38,SEA,100,26,15,30,53
1989-02-03,IND,91,11,31,MIL,109,27,14,38,45
1989-02-03,LAL,140,30,14,POR,129,23,19,53,33
1989-02-03,DAL,121,21,20,PHX,117,28,15,49,35
1989-02-03,BOS,117,21,22,WAS,108,16,25,37,47
1989-02-03,LAC,101,10,33,SAN,106,12,30,22,63
1989-02-03,CLE,110,32,10,SAC,94,12,30,44,40
1989-02-03,HOU,105,25,17,CHI,98,25,17,50,34
1989-02-03,UTH,129,26,17,NJN,101,17,26,43,43
1989-02-03,PHL,106,25,19,DET,124,28,13,53,32
1989-02-03,CHH,108,11,33,SEA,106,27,15,38,48
1989-02-04,WAS,102,16,26,MIL,113,28,14,44,40
1989-02-04,GOS,116,23,19,LAC,107,10,34,33,53
1989-02-04,POR,137,23,20,SAN,100,13,30,36,50
1989-02-04,DEN,127,23,22,UTH,126,27,17,50,39
1989-02-04,IND,106,11,32,NYK,113,29,16,40,48
1989-02-04,PHX,116,28,16,ATL,118,27,17,55,33
1989-02-05,LAL,134,31,14,NJN,116,17,27,48,41
1989-02-05,BOS,87,22,22,SEA,89,27,16,49,38
1989-02-05,MIA,102,4,39,SAC,98,12,31,16,70
1989-02-05,HOU,124,26,17,DEN,112,24,22,50,39
1989-02-05,DET,113,29,13,CHI,102,25,18,54,31
1989-02-05,CHH,91,12,33,CLE,110,33,10,45,43
1989-02-06,LAC,111,10,35,DAL,129,22,20,32,55
1989-02-06,PHX,104,28,17,UTH,87,27,18,55,35
1989-02-07,NYK,117,30,16,WAS,105,16,27,46,43
1989-02-07,MIL,115,29,14,CLE,106,34,10,63,24
1989-02-07,UTH,96,27,19,MIA,77,5,39,32,58
1989-02-07,CHI,118,25,19,CHH,93,12,34,37,53
1989-02-07,POR,134,24,20,DAL,125,23,20,47,40
1989-02-07,NJN,109,17,28,SEA,99,28,16,45,44
1989-02-07,SAC,114,12,32,SAN,99,13,31,25,63
1989-02-08,BOS,109,22,23,IND,102,11,33,33,56
1989-02-08,LAC,114,10,36,HOU,111,27,17,37,53
1989-02-08,DET,107,30,13,MIL,96,30,14,60,27
1989-02-08,ATL,101,28,17,NYK,113,31,16,59,33
1989-02-08,PHL,109,25,20,SEA,102,28,17,53,37
1989-02-08,LAL,118,32,14,GOS,121,24,19,56,33
1989-02-09,SAN,103,13,32,CHI,108,26,19,39,51
1989-02-09,SAC,142,13,32,GOS,117,25,19,38,51
1989-02-09,DEN,117,24,23,MIA,92,5,40,29,63
1989-02-09,UTH,87,28,19,DAL,94,23,21,51,40
1989-02-09,CHH,110,12,35,ATL,108,28,18,40,53
1989-02-09,POR,110,25,20,HOU,113,27,18,52,38
1989-02-09,PHX,120,29,17,LAC,113,11,36,40,53
1989-02-09,CLE,108,34,11,IND,99,11,34,45,45
1989-02-09,WAS,110,16,28,NJN,103,18,28,34,56
1989-02-14,CHI,98,27,19,ATL,106,28,19,55,38
1989-02-14,UTH,119,28,20,DEN,105,25,23,53,43
1989-02-14,IND,108,11,35,PHL,113,26,20,37,55
1989-02-14,DAL,117,24,21,LAC,98,11,37,35,58
1989-02-14,SAC,99,14,32,WAS,107,17,28,31,60
1989-02-14,SEA,129,28,18,SAN,113,13,33,41,51
1989-02-14,HOU,137,28,18,BOS,123,23,23,51,41
1989-02-14,CHH,117,13,35,NYK,129,32,16,45,51
1989-02-14,MIL,132,30,15,NJN,91,18,29,48,44
1989-02-14,LAL,103,32,15,DET,111,31,13,63,28
1989-02-14,MIA,98,5,41,CLE,109,35,11,40,52
1989-02-15,NJN,112,18,30,ATL,119,29,19,47,49
1989-02-15,PHL,113,27,20,IND,98,11,36,38,56
1989-02-15,PHX,135,30,17,SEA,112,29,18,59,35
1989-02-15,CLE,129,36,11,NYK,107,33,16,69,27
1989-02-15,DEN,117,25,24,WAS,106,18,28,43,52
1989-02-15,GOS,133,25,20,SAN,96,13,34,38,54
1989-02-16,CHI,117,27,20,MIL,116,31,15,58,35
1989-02-16,LAC,138,11,38,GOS,143,26,20,37,58
1989-02-16,UTH,129,29,20,BOS,114,23,24,52,44
1989-02-16,POR,101,25,21,LAL,110,32,16,57,37
1989-02-16,SAC,84,14,33,DET,95,32,13,46,46
1989-02-16,DAL,93,25,21,MIA,80,5,42,30,63
1989-02-17,PHX,135,31,17,BOS,126,23,25,54,42
1989-02-17,ATL,108,30,19,CLE,100,37,11,67,30
1989-02-17,MIA,103,5,43,CHH,102,13,36,18,79
1989-02-17,SEA,126,29,19,WAS,112,18,29,47,48
1989-02-17,HOU,121,29,18,DEN,111,26,24,55,42
1989-02-17,PHL,127,28,20,NJN,129,18,31,46,51
1989-02-18,CLE,118,37,12,PHL,100,28,21,65,33
1989-02-18,GOS,121,27,20,DET,119,33,13,60,33
1989-02-18,CHH,119,13,37,IND,114,11,37,24,74
1989-02-18,UTH,107,30,20,SAN,93,13,35,43,55
1989-02-18,POR,115,25,22,SEA,116,30,19,55,41
1989-02-18,DAL,94,26,21,HOU,105,30,18,56,39
1989-02-18,SAC,101,14,34,PHX,120,32,17,46,51
1989-02-18,NYK,125,33,17,NJN,115,19,31,52,48
1989-02-18,LAC,93,11,39,WAS,98,18,30,29,69
1989-02-19,MIA,124,6,43,ATL,115,31,19,37,62
1989-02-19,LAL,119,33,16,BOS,110,23,26,56,42
1989-02-19,MIL,106,31,16,CHI,108,28,20,59,36
1989-02-20,CHI,102,29,20,POR,98,25,23,54,43
1989-02-20,NJN,117,19,32,MIA,109,7,43,26,75
1989-02-20,SAN,93,13,36,DAL,105,26,22,39,58
1989-02-20,UTH,118,31,20,PHX,92,33,17,64,37
1989-02-20,DEN,103,26,25,DET,101,33,14,59,39
1989-02-20,CLE,110,38,12,HOU,90,31,18,69,30
1989-02-20,ATL,114,31,20,LAC,100,11,40,42,60
1989-02-20,SAC,97,14,35,LAL,100,34,16,48,51
1989-02-21,NYK,120,34,17,HOU,115,31,19,65,36
1989-02-21,MIL,116,31,17,IND,90,11,38,42,55
1989-02-21,PHX,139,33,18,GOS,121,28,20,61,38
1989-02-21,SEA,96,31,19,BOS,91,23,27,54,46
1989-02-21,WAS,123,19,30,LAC,109,11,41,30,71
1989-02-22,UTH,105,32,20,LAL,79,35,16,67,36
1989-02-22,CLE,130,39,12,NJN,111,20,32,59,44
1989-02-22,SAC,91,14,36,BOS,99,23,28,37,64
1989-02-22,MIA,108,7,44,PHL,139,28,22,35,66
1989-02-22,DET,105,33,15,POR,94,25,24,58,39
1989-02-22,DEN,109,27,25,DAL,106,27,22,54,47
1989-02-22,CHH,102,14,37,CHI,130,30,20,44,57
1989-02-22,SAN,107,13,37,GOS,118,28,21,41,58
1989-02-23,NYK,139,35,17,CHH,114,14,38,49,55
1989-02-23,ATL,100,32,20,IND,97,11,39,43,59
1989-02-23,NJN,111,20,33,LAC,100,11,42,31,75
1989-02-24,WAS,130,20,30,NYK,127,36,17,56,47
1989-02-24,CHI,106,31,20,HOU,97,31,20,62,40
1989-02-24,IND,112,11,40,SAN,93,13,38,24,78
1989-02-24,DAL,92,27,23,GOS,127,29,21,56,44
1989-02-24,CLE,128,40,12,POR,91,25,25,65,37
1989-02-24,PHX,120,34,18,PHL,95,29,22,63,40
1989-02-24,LAL,115,35,17,SAC,103,14,37,49,54
1989-02-24,MIA,111,7,45,LAC,91,11,43,18,88
1989-02-24,DEN,121,28,25,UTH,102,33,20,61,45
1989-02-24,BOS,125,24,28,MIL,112,32,17,56,45
1989-02-25,MIL,121,32,18,HOU,105,31,21,63,39
1989-02-25,DAL,127,27,24,WAS,93,21,30,48,54
1989-02-25,NJN,95,21,33,DET,113,34,15,55,48
1989-02-25,CHH,124,14,39,SAN,113,13,39,27,78
1989-02-25,ATL,125,33,20,CHI,95,32,20,65,40
1989-02-25,SEA,94,32,19,SAC,97,14,38,46,57
1989-02-26,NYK,122,36,18,BOS,110,25,28,61,46
1989-02-26,MIA,102,8,45,POR,124,25,26,33,71
1989-02-26,DEN,122,29,25,PHL,115,29,23,58,48
1989-02-26,IND,128,12,40,UTH,89,33,21,45,61
1989-02-26,LAL,134,36,17,PHX,122,35,18,71,35
1989-02-26,DET,110,35,15,LAC,98,11,44,46,59
1989-02-27,SAC,107,15,38,SEA,116,32,20,47,58
1989-02-27,HOU,98,31,22,WAS,104,21,31,52,53
1989-02-27,MIL,105,33,18,SAN,96,13,40,46,58
1989-02-27,GOS,141,30,21,DEN,132,30,25,60,46
1989-02-27,NJN,96,21,34,UTH,109,33,22,54,56
1989-02-27,ATL,105,34,20,DAL,83,28,24,62,44
1989-02-28,SEA,106,33,20,IND,108,13,40,46,60
1989-02-28,CHI,121,32,21,SAN,102,13,41,45,62
1989-02-28,CLE,115,41,12,DET,99,36,15,77,27
1989-02-28,MIA,110,8,46,DAL,111,28,25,36,71
1989-02-28,LAC,105,11,45,PHL,123,29,24,40,69
1989-02-28,CHH,87,15,39,BOS,112,25,29,40,68
1989-02-28,POR,139,26,26,PHX,134,35,19,61,45
1989-03-01,SAC,111,15,39,PHL,114,30,24,45,63
1989-03-01,DET,96,36,16,UTH,85,34,22,70,38
1989-03-01,WAS,120,22,31,NJN,105,21,35,43,66
1989-03-01,MIL,121,34,18,NYK,111,37,18,71,36
1989-03-01,LAL,142,37,17,GOS,121,31,21,68,38
1989-03-01,BOS,104,26,29,ATL,90,35,20,61,49
1989-03-02,GOS,127,31,22,IND,131,14,40,45,62
1989-03-02,CLE,112,42,12,SAN,84,13,42,55,54
1989-03-02,LAC,113,11,46,POR,119,27,26,38,72
1989-03-02,NYK,132,37,19,MIA,123,8,47,45,66
1989-03-02,DEN,113,30,26,HOU,103,31,23,61,49
1989-03-02,NJN,114,21,36,CHH,103,15,40,36,76
1989-03-02,PHX,110,35,20,SAC,90,15,40,50,60
1989-03-03,ATL,133,35,21,CHH,109,15,41,50,62
1989-03-03,POR,129,28,26,PHL,121,31,24,59,50
1989-03-03,SEA,118,33,21,HOU,108,31,24,64,45
1989-03-03,MIA,95,8,48,UTH,107,34,23,42,71
1989-03-03,CHI,102,33,21,MIL,96,35,18,68,39
1989-03-03,LAL,139,38,17,IND,117,15,40,53,57
1989-03-03,DET,96,37,16,CLE,90,43,12,80,28
1989-03-03,BOS,107,27,29,DAL,106,29,25,56,54
1989-03-04,NJN,98,22,36,BOS,95,28,29,50,65
1989-03-04,PHX,133,36,20,LAC,91,11,47,47,67
1989-03-04,GOS,155,31,23,SAC,143,15,41,46,64
1989-03-04,SEA,118,34,21,PHL,104,31,25,65,46
1989-03-04,WAS,119,23,31,DAL,105,29,26,52,57
1989-03-04,SAN,106,13,43,DEN,89,31,26,44,69
1989-03-04,NYK,122,38,19,CHI,104,34,21,72,40
1989-03-05,POR,118,29,26,IND,121,15,41,44,67
1989-03-05,WAS,114,24,31,CHH,101,15,42,39,73
1989-03-05,ATL,83,36,21,UTH,85,35,23,71,44
1989-03-05,MIA,100,8,49,DET,109,38,16,46,65
1989-03-05,SAC,110,15,42,GOS,96,32,23,47,65
1989-03-05,CLE,98,43,13,MIL,103,35,19,78,32
1989-03-05,HOU,88,31,25,LAL,83,39,17,70,42
1989-03-06,DAL,105,29,27,NJN,99,23,36,52,63
1989-03-06,DET,129,39,16,DEN,112,31,27,70,43
1989-03-06,PHL,106,31,26,PHX,110,37,20,68,46
1989-03-07,CHI,88,34,22,PHL,90,31,27,65,49
1989-03-07,SAC,95,16,42,CLE,105,43,14,59,56
1989-03-07,IND,92,16,41,SEA,110,35,21,51,62
1989-03-07,GOS,138,32,24,LAC,112,11,48,43,72
1989-03-07,NYK,124,39,19,PHX,119,38,20,77,39
1989-03-07,SAN,103,14,43,POR,116,29,27,43,70
1989-03-07,ATL,97,36,22,LAL,106,39,18,75,40
1989-03-07,MIL,121,36,19,WAS,101,25,31,61,50
1989-03-08,BOS,104,28,30,CHI,95,34,23,62,53
1989-03-08,DAL,99,30,27,POR,92,30,27,60,54
1989-03-08,CHH,99,15,43,DEN,112,31,28,46,71
1989-03-08,UTH,117,36,23,HOU,80,32,25,68,48
1989-03-08,DET,112,40,16,SEA,96,36,21,76,37
1989-03-08,MIA,87,8,50,LAL,127,40,18,48,68
1989-03-08,WAS,119,25,32,ATL,111,36,23,61,55
1989-03-09,SAN,112,14,44,NJN,98,23,37,37,81
1989-03-09,PHL,106,32,27,SAC,96,16,43,48,70
1989-03-09,GOS,120,33,24,CLE,114,44,14,77,38
1989-03-10,MIA,131,8,51,DEN,130,32,28,40,79
1989-03-10,UTH,126,37,23,GOS,112,34,24,71,47
1989-03-10,IND,121,16,42,PHX,116,38,21,54,63
1989-03-10,MIL,102,37,19,SEA,90,36,22,73,41
1989-03-10,CHH,90,15,44,LAL,123,41,18,56,62
1989-03-10,WAS,114,26,32,SAC,97,16,44,42,76
1989-03-10,LAC,105,11,49,CLE,103,44,15,55,64
1989-03-10,HOU,96,32,26,DAL,86,31,27,63,53
1989-03-11,NYK,114,40,19,IND,95,17,42,57,61
1989-03-11,SAN,97,15,44,DAL,90,31,28,46,72
1989-03-11,PHL,106,33,27,DET,111,41,16,74,43
1989-03-11,CHI,105,34,24,SEA,88,36,23,70,47
1989-03-11,ATL,111,36,24,MIA,78,9,51,45,75
1989-03-11,HOU,124,33,26,NJN,94,23,38,56,64
1989-03-11,MIL,100,38,19,PHX,93,38,22,76,41
1989-03-12,BOS,121,29,30,DEN,115,32,29,61,59
1989-03-12,GOS,115,34,25,LAL,126,42,18,76,43
1989-03-12,DET,110,42,16,WAS,104,27,32,69,48
1989-03-12,POR,110,30,28,CLE,123,44,16,74,44
1989-03-12,CHH,105,15,45,SAC,114,16,45,31,90
1989-03-13,CHI,122,35,24,IND,90,17,43,52,67
1989-03-13,UTH,98,38,23,CLE,83,45,16,83,39
1989-03-13,DAL,95,31,29,MIL,111,39,19,70,48
1989-03-13,BOS,114,30,30,NJN,91,23,39,53,69
1989-03-13,LAL,97,43,18,HOU,96,34,26,77,44
1989-03-13,WAS,106,27,33,SEA,101,36,24,63,57
1989-03-13,MIA,104,9,52,PHX,112,38,23,47,75
1989-03-13,SAN,103,16,44,LAC,115,12,49,28,93
1989-03-14,SAC,95,17,45,HOU,90,34,27,51,72
1989-03-14,IND,117,17,44,DET,129,43,16,60,60
1989-03-14,POR,139,30,29,GOS,110,34,26,64,55
1989-03-14,ATL,112,37,24,PHX,114,39,23,76,47
1989-03-14,DEN,125,32,30,CHH,102,15,46,47,76
1989-03-14,NYK,116,41,19,SEA,110,36,25,77,44
1989-03-15,UTH,102,39,23,POR,95,31,29,70,52
1989-03-15,GOS,113,34,27,DAL,100,31,30,65,57
1989-03-15,LAC,103,13,49,MIA,109,9,53,22,102
1989-03-15,SAN,110,16,45,MIL,108,40,19,56,64
1989-03-15,CLE,115,45,17,CHI,91,36,24,81,41
1989-03-15,PHL,100,33,28,NJN,96,23,40,56,68
1989-03-16,IND,99,17,45,BOS,111,31,30,48,75
1989-03-16,DEN,119,33,30,SAN,102,17,45,50,75
1989-03-16,SAC,103,18,45,ATL,119,37,25,55,70
1989-03-16,SEA,108,36,26,CHH,88,15,47,51,73
1989-03-16,NYK,112,42,19,PHL,121,34,28,76,47
1989-03-16,HOU,120,34,28,MIL,104,40,20,74,48
1989-03-17,CHI,129,36,25,NYK,124,42,20,78,45
1989-03-17,LAC,105,13,50,CHH,108,15,48,28,98
1989-03-17,PHX,129,40,23,POR,124,31,30,71,53
1989-03-17,LAL,106,44,18,DAL,103,31,31,75,49
1989-03-17,UTH,118,40,23,MIA,96,10,53,50,76
1989-03-17,DET,106,44,16,BOS,98,32,30,76,46
1989-03-17,GOS,127,35,27,ATL,118,38,25,73,52
1989-03-17,NJN,121,23,41,WAS,124,28,33,51,74
1989-03-18,SAC,100,18,46,DAL,90,31,32,49,78
1989-03-18,IND,114,17,46,CHI,103,37,25,54,71
1989-03-18,MIL,117,40,21,DET,100,45,16,85,37
1989-03-18,SAN,114,17,46,UTH,98,41,23,58,69
1989-03-18,PHX,122,41,23,SEA,104,37,26,78,49
1989-03-18,DEN,111,34,30,MIA,105,10,54,44,84
1989-03-18,WAS,123,29,33,PHL,114,35,28,64,61
1989-03-18,HOU,127,35,28,POR,113,31,31,66,59
1989-03-19,NJN,91,23,42,CLE,101,46,17,69,59
1989-03-19,NYK,128,42,21,MIL,104,41,21,83,42
1989-03-19,GOS,124,36,27,CHH,117,16,48,52,75
1989-03-19,LAL,111,45,18,ATL,113,38,26,83,44
1989-03-20,PHL,109,35,29,NYK,129,43,21,78,50
1989-03-20,PHX,115,42,23,MIA,97,10,55,52,78
1989-03-20,POR,112,31,32,DAL,91,31,33,62,65
1989-03-20,SAC,110,19,46,CHH,117,16,49,35,95
1989-03-20,CLE,103,47,17,WAS,97,30,33,77,50
1989-03-20,BOS,119,32,31,SAN,108,18,46,50,77
1989-03-21,SEA,101,37,27,UTH,96,41,24,78,51
1989-03-21,MIL,98,41,22,BOS,86,33,31,74,53
1989-03-21,HOU,110,36,28,DEN,112,35,30,71,58
1989-03-21,ATL,95,39,26,DET,110,45,17,84,43
1989-03-21,GOS,151,37,27,POR,127,32,32,69,59
1989-03-21,NJN,89,23,43,IND,92,18,46,41,89
1989-03-21,LAL,103,45,19,CHI,104,37,26,82,45
1989-03-22,MIA,107,10,56,NYK,103,44,21,54,77
1989-03-22,PHX,111,43,23,CHI,112,38,26,81,49
1989-03-22,LAC,116,13,51,DAL,112,31,34,44,85
1989-03-22,IND,101,19,46,WAS,92,30,34,49,80
1989-03-22,DET,115,46,17,SAN,94,18,47,64,64
1989-03-22,PHL,100,35,30,CLE,97,48,17,83,47
1989-03-23,CLE,102,48,18,MIL,88,42,22,90,40
1989-03-23,GOS,124,38,27,PHX,154,43,24,81,51
1989-03-23,SAC,92,19,47,LAL,115,45,20,64,67
1989-03-23,CHH,97,17,49,WAS,102,30,35,47,84
1989-03-23,SEA,115,38,27,LAC,112,14,51,52,78
1989-03-24,HOU,99,36,29,UTH,102,41,25,77,54
1989-03-24,POR,113,32,33,CHI,128,39,26,71,59
1989-03-24,DET,112,47,17,NJN,96,23,44,70,61
1989-03-24,BOS,115,33,32,NYK,111,44,22,77,54
1989-03-24,DAL,105,31,35,DEN,114,36,30,67,65
1989-03-24,PHL,135,36,30,SAN,122,18,48,54,78
1989-03-25,CHH,101,17,50,DET,113,48,17,65,67
1989-03-25,LAC,103,14,52,PHX,123,44,24,58,76
1989-03-25,SAC,106,19,48,POR,105,32,34,51,82
1989-03-25,UTH,112,42,25,DEN,90,37,30,79,55
1989-03-25,MIL,113,42,23,CLE,105,49,18,91,41
1989-03-25,WAS,111,31,35,IND,108,20,46,51,81
1989-03-25,NYK,108,44,23,ATL,115,39,27,83,50
1989-03-25,MIA,107,11,56,SAN,105,18,49,29,105
1989-03-25,HOU,144,36,30,GOS,104,38,28,74,58
1989-03-25,SEA,110,39,27,CHI,111,40,26,79,53
1989-03-26,BOS,105,34,32,PHL,103,37,30,71,62
1989-03-26,LAL,118,46,20,PHX,116,45,24,91,44
1989-03-27,IND,104,20,47,CLE,102,49,19,69,66
1989-03-27,LAC,119,14,53,DEN,118,37,31,51,84
1989-03-27,DET,90,49,17,DAL,77,31,36,80,53
1989-03-27,MIA,100,12,56,NJN,79,23,45,35,101
1989-03-27,UTH,124,43,25,SEA,105,39,28,82,53
1989-03-27,MIL,121,43,23,GOS,109,38,29,81,52
1989-03-27,CHH,105,17,51,NYK,121,44,24,61,75
1989-03-28,SAN,130,18,50,WAS,114,32,35,50,85
1989-03-28,NJN,111,23,46,ATL,108,40,27,63,73
1989-03-28,CLE,102,49,20,DAL,90,31,37,80,57
1989-03-28,HOU,120,37,30,SEA,117,39,29,76,59
1989-03-28,PHL,117,37,31,BOS,115,35,32,72,63
1989-03-28,CHI,115,41,26,GOS,106,38,30,79,56
1989-03-28,PHX,127,45,25,LAL,104,47,20,92,45
1989-03-28,NYK,128,45,24,POR,124,32,35,77,59
1989-03-29,UTH,104,44,25,DET,108,50,17,94,42
1989-03-29,LAC,114,15,53,SAC,108,20,48,35,101
1989-03-29,ATL,120,40,28,WAS,102,32,36,72,64
1989-03-29,BOS,106,35,33,POR,97,32,36,67,69
1989-03-29,IND,96,21,47,MIA,89,13,56,34,103
1989-03-29,MIL,102,44,23,CHI,106,42,26,86,49
1989-03-30,LAL,138,47,21,SAN,98,19,50,66,71
1989-03-30,CHH,104,17,52,GOS,113,38,31,55,83
1989-03-30,SAC,135,20,49,PHX,123,46,25,66,74
1989-03-30,NYK,99,46,24,DAL,98,31,38,77,62
1989-03-30,NJN,101,24,46,HOU,109,38,30,62,76
1989-03-30,DEN,123,37,32,SEA,116,39,30,76,62
1989-03-31,CHI,100,43,26,CLE,109,50,20,93,46
1989-03-31,ATL,116,41,28,NJN,99,24,47,65,75
1989-03-31,IND,102,22,47,DAL,105,31,39,53,86
1989-03-31,NYK,114,47,24,GOS,134,39,31,86,55
1989-03-31,WAS,107,32,37,POR,105,32,37,64,74
1989-03-31,PHX,122,46,26,MIL,104,44,24,90,50
1989-03-31,BOS,126,36,33,HOU,109,39,30,75,63
1989-03-31,PHL,114,38,31,MIA,93,13,57,51,88
1989-03-31,LAC,109,16,53,SAN,106,19,51,35,104
1989-03-31,SEA,108,39,31,DET,111,51,17,90,48
1989-04-01,DEN,114,38,32,LAL,108,48,21,86,53
1989-04-01,CHH,121,17,53,POR,125,32,38,49,91
1989-04-01,SAC,117,21,49,UTH,97,44,26,65,75
1989-04-02,CHI,106,43,27,NJN,95,24,48,67,75
1989-04-02,CLE,117,51,20,BOS,100,37,33,88,53
1989-04-02,WAS,120,33,37,GOS,103,40,31,73,68
1989-04-02,IND,109,22,48,ATL,132,42,28,64,76
1989-04-02,LAC,101,17,53,DET,117,52,17,69,70
1989-04-02,LAL,118,48,22,MIL,117,44,25,92,47
1989-04-02,PHL,108,39,31,HOU,99,39,31,78,62
1989-04-02,DAL,98,32,39,MIA,96,13,58,45,97
1989-04-04,DEN,128,39,32,SAC,124,22,49,61,81
1989-04-04,CHI,121,44,27,CHH,101,17,54,61,81
1989-04-04,UTH,95,44,27,DAL,80,33,39,77,66
1989-04-04,WAS,104,34,37,NJN,96,24,49,58,86
1989-04-04,SEA,97,39,32,LAL,115,49,22,88,54
1989-04-04,IND,88,22,49,HOU,90,39,32,61,81
1989-04-04,CLE,105,52,20,ATL,91,43,28,95,48
1989-04-04,POR,118,33,38,DET,100,53,17,86,55
1989-04-04,NYK,113,47,25,PHL,124,40,31,87,56
1989-04-04,LAC,108,17,54,BOS,124,37,34,54,88
1989-04-04,SAN,109,19,52,MIA,87,13,59,32,111
1989-04-04,GOS,118,40,32,MIL,124,44,26,84,58
1989-04-05,PHX,114,47,26,UTH,104,45,27,92,53
1989-04-05,ATL,135,43,29,PHL,93,41,31,84,60
1989-04-06,GOS,132,40,33,BOS,118,38,34,78,67
1989-04-06,DET,115,53,18,CHI,108,45,27,98,45
1989-04-06,SAN,122,20,52,SAC,116,22,50,42,102
1989-04-06,DEN,132,40,32,IND,118,22,50,62,82
1989-04-06,SEA,119,39,33,PHX,126,48,26,87,59
1989-04-06,LAC,133,17,55,POR,123,34,38,51,93
1989-04-06,MIA,93,13,60,WAS,101,35,37,48,97
1989-04-06,MIL,99,45,26,NYK,112,47,26,92,52
1989-04-07,CHH,108,17,55,PHL,118,41,32,58,87
1989-04-07,WAS,107,36,37,CLE,96,53,20,89,57
1989-04-07,LAL,97,50,22,UTH,99,45,28,95,50
1989-04-07,ATL,120,44,29,HOU,112,40,32,84,61
1989-04-07,POR,113,34,39,BOS,100,38,35,72,74
1989-04-07,DAL,115,33,40,SAC,102,22,51,55,91
1989-04-07,CHI,112,45,28,DET,114,54,18,99,46
1989-04-07,NJN,115,24,50,NYK,105,48,26,72,76
1989-04-08,SAN,126,21,52,IND,128,22,51,43,103
1989-04-08,DEN,110,41,32,UTH,106,46,28,87,60
1989-04-08,DAL,90,34,40,SEA,114,39,34,73,74
1989-04-08,MIL,113,45,27,PHL,103,42,32,87,59
1989-04-08,MIA,107,13,61,HOU,104,40,33,53,94
1989-04-08,LAC,97,18,55,PHX,115,49,26,67,81
1989-04-08,GOS,122,41,33,LAL,116,50,23,91,56
1989-04-09,DET,100,55,18,MIL,91,46,27,101,45
1989-04-09,WAS,92,37,37,NYK,94,48,27,85,64
1989-04-09,ATL,108,45,29,CHI,100,45,29,90,58
1989-04-09,POR,120,35,39,DEN,114,42,32,77,71
1989-04-09,CLE,122,53,21,CHH,116,17,56,70,77
1989-04-10,SAN,89,21,53,SEA,102,40,34,61,87
1989-04-10,SAC,108,22,52,MIA,69,14,61,36,113
1989-04-10,LAL,133,50,24,LAC,116,18,56,68,80
1989-04-10,CHH,105,17,57,ATL,112,46,29,63,86
1989-04-10,DAL,103,34,41,IND,110,23,51,57,92
1989-04-10,BOS,113,38,36,NJN,112,25,50,63,86
1989-04-10,WAS,100,37,38,DET,124,56,18,93,56
1989-04-11,MIL,125,46,28,NJN,93,25,51,71,79
1989-04-11,CLE,92,54,21,PHL,90,42,33,96,54
1989-04-11,GOS,114,42,33,MIA,98,14,62,56,95
1989-04-11,POR,126,36,39,LAC,102,18,57,54,96
1989-04-11,HOU,108,40,34,IND,99,24,51,64,85
1989-04-12,DAL,94,34,42,PHX,109,50,26,84,68
1989-04-12,DET,107,57,18,CLE,95,55,21,112,39
1989-04-12,NYK,99,49,27,CHH,104,17,58,66,85
1989-04-12,WAS,111,37,39,MIL,107,47,28,84,67
1989-04-12,UTH,107,46,29,DEN,102,42,33,88,62
1989-04-12,SAN,100,21,54,LAL,107,51,24,72,78
1989-04-13,LAC,128,18,58,GOS,126,43,33,61,91
1989-04-13,ATL,132,47,29,BOS,118,39,36,86,65
1989-04-13,SEA,116,41,34,MIA,111,14,63,55,97
1989-04-13,HOU,111,41,34,PHX,119,51,26,92,60
1989-04-13,IND,109,24,52,CHI,105,45,30,69,82
1989-04-13,SAC,121,23,52,DEN,112,42,34,65,86
1989-04-14,NJN,123,25,52,CHI,111,45,31,70,83
1989-04-14,PHL,115,42,34,CHH,119,18,58,60,92
1989-04-14,BOS,113,39,37,CLE,104,55,22,94,59
1989-04-14,UTH,122,47,29,HOU,96,41,35,88,64
1989-04-14,NYK,104,49,28,DET,100,58,18,107,46
1989-04-14,SAN,110,21,55,DAL,118,34,43,55,98
1989-04-14,POR,97,37,39,MIA,86,14,64,51,103
1989-04-15,PHX,137,52,26,SAN,91,21,56,73,82
1989-04-15,POR,95,38,39,UTH,99,48,29,86,68
1989-04-15,ATL,125,48,29,MIL,100,47,29,95,58
1989-04-15,SEA,125,42,34,DEN,92,42,35,84,69
1989-04-15,IND,115,25,52,CHH,105,19,58,44,110
1989-04-15,LAC,119,19,58,LAL,107,52,24,71,82
1989-04-15,GOS,110,43,34,SAC,114,24,52,67,86
1989-04-16,LAL,121,52,25,MIA,108,14,65,66,90
1989-04-16,NJN,96,26,52,MIL,100,47,30,73,82
1989-04-16,CLE,111,55,23,CHI,92,45,32,100,55
1989-04-16,DAL,112,35,43,HOU,114,41,36,76,79
1989-04-16,DET,104,58,19,WAS,98,38,39,96,58
1989-04-16,PHL,115,42,35,NYK,112,50,28,92,63
1989-04-17,LAC,102,20,58,UTH,108,49,29,69,87
1989-04-17,GOS,109,43,35,SEA,116,43,34,86,69
1989-04-17,PHX,140,53,26,SAC,85,25,52,78,78
1989-04-17,HOU,99,42,36,SAN,91,21,57,63,93
1989-04-17,CHH,108,19,59,BOS,113,40,37,59,96
1989-04-17,CHI,104,45,33,NYK,100,50,29,95,62
1989-04-18,SAC,120,25,53,POR,118,38,40,63,93
1989-04-18,CLE,102,56,23,DET,118,59,19,115,42
1989-04-18,BOS,113,41,37,WAS,121,38,40,79,77
1989-04-18,SEA,122,44,34,GOS,118,43,36,87,70
1989-04-18,MIA,99,14,66,DAL,103,35,44,49,110
1989-04-18,NJN,105,26,53,CHH,121,19,60,45,113
1989-04-18,IND,114,26,52,ATL,121,49,29,75,81
1989-04-18,LAL,142,53,25,DEN,118,42,36,95,61
1989-04-18,PHL,124,43,35,MIL,102,48,30,91,65
1989-04-18,UTH,92,50,29,LAC,95,20,59,70,88
1989-04-19,MIA,91,4,31,PHX,117,21,14,25,45
1989-04-19,DET,115,60,19,IND,105,26,53,86,72
1989-04-19,SAN,84,21,58,HOU,99,43,36,64,94
1989-04-19,MIL,92,48,31,ATL,100,50,29,98,60
1989-04-20,LAL,118,54,25,SAC,115,26,53,80,78
1989-04-20,WAS,100,39,40,CHI,98,46,33,85,73
1989-04-20,SEA,124,45,34,POR,118,38,41,83,75
1989-04-20,NYK,137,50,30,BOS,117,41,38,91,68
1989-04-20,DEN,136,42,37,SAN,113,21,59,63,96
1989-04-20,NJN,92,26,54,PHL,105,44,35,70,89
1989-04-21,DAL,91,36,44,UTH,89,50,30,86,74
1989-04-21,CHI,115,46,34,WAS,113,40,40,86,74
1989-04-21,LAC,136,21,59,SEA,139,46,34,67,93
1989-04-21,GOS,121,43,37,DEN,139,43,37,86,74
1989-04-21,POR,114,38,42,LAL,121,55,25,93,67
1989-04-21,DET,100,61,19,PHL,91,45,35,106,54
1989-04-21,ATL,92,51,29,CLE,89,56,24,107,53
1989-04-21,CHH,110,20,60,MIL,117,48,32,68,92
1989-04-21,PHX,101,54,26,HOU,112,44,36,98,62
1989-04-21,IND,120,26,54,BOS,110,41,39,67,93
1989-04-22,SAC,104,26,54,LAC,89,21,60,47,114
1989-04-22,NYK,109,51,30,NJN,99,26,55,77,85
1989-04-22,HOU,89,45,36,MIA,91,14,67,59,103
1989-04-22,UTH,111,50,31,GOS,95,43,38,93,69
1989-04-22,SAN,111,21,60,PHX,121,54,27,75,87
1989-04-22,MIL,110,49,32,IND,117,27,54,76,86
1989-04-23,BOS,120,41,40,CHH,110,20,61,61,101
1989-04-23,CHI,84,47,34,CLE,90,56,25,103,59
1989-04-23,POR,126,38,43,SAC,120,27,54,65,97
1989-04-23,DET,99,62,19,ATL,81,52,29,114,48
1989-04-23,LAL,121,56,25,SEA,117,47,34,103,59
1989-04-23,DEN,96,44,37,DAL,113,37,44,81,81
1989-04-23,PHL,115,45,36,WAS,106,40,41,85,77
1989-11-03,LAC,102,0,0,HOU,88,0,0,0,0
1989-11-03,ATL,103,0,0,IND,126,0,0,0,0
1989-11-03,PHX,136,0,0,GOS,106,0,0,0,0
1989-11-03,DAL,94,0,0,LAL,102,0,0,0,0
1989-11-03,DET,106,0,0,NYK,103,0,0,0,0
1989-11-03,MIA,90,0,0,NJN,110,0,0,0,0
1989-11-03,UTH,122,0,0,DEN,113,0,0,0,0
1989-11-03,BOS,127,0,0,MIL,114,0,0,0,0
1989-11-03,CHI,124,0,0,CLE,119,0,0,0,0
1989-11-03,CHH,96,0,0,WAS,116,0,0,0,0
1989-11-03,POR,114,0,0,SAC,96,0,0,0,0
1989-11-03,SEA,106,0,0,MIN,94,0,0,0,0
1989-11-04,NYK,119,0,1,MIA,99,0,1,0,2
1989-11-04,GOS,105,0,1,HOU,132,0,1,0,2
1989-11-04,IND,106,1,0,CLE,98,0,1,1,1
1989-11-04,SAC,107,0,1,SEA,100,1,0,1,1
1989-11-04,PHL,96,0,0,MIL,102,0,1,0,1
1989-11-04,WAS,93,1,0,DET,95,1,0,2,0
1989-11-04,SAN,106,0,0,LAL,98,1,0,1,0
1989-11-04,DEN,135,0,1,PHX,132,1,0,1,1
1989-11-04,CHI,100,1,0,BOS,102,1,0,2,0
1989-11-04,ORL,106,0,0,NJN,111,1,0,1,0
1989-11-05,POR,93,1,0,MIN,83,0,1,1,1
1989-11-06,ORL,118,0,1,NYK,110,1,1,1,2
1989-11-07,ATL,114,0,1,WAS,118,1,1,1,2
1989-11-07,SAC,96,1,1,DAL,94,0,1,1,2
1989-11-07,HOU,109,1,1,POR,86,2,0,3,1
1989-11-07,CHI,117,1,1,DET,114,2,0,3,1
1989-11-07,MIL,106,1,1,BOS,100,2,0,3,1
1989-11-07,GOS,118,0,2,LAC,94,1,0,1,2
1989-11-07,SEA,128,1,1,CHH,88,0,1,1,2
1989-11-07,LAL,111,1,1,PHX,107,1,1,2,2
1989-11-07,NJN,77,2,0,MIA,83,0,2,2,2
1989-11-08,LAC,99,1,1,DAL,123,0,2,1,3
1989-11-08,MIN,84,0,2,CHI,96,2,1,2,3
1989-11-08,IND,95,2,0,DET,74,2,1,4,1
1989-11-08,CLE,110,0,2,ORL,117,1,1,1,3
1989-11-08,PHL,115,0,1,MIA,91,1,2,1,3
1989-11-08,UTH,102,1,0,CHH,86,0,2,1,2
1989-11-08,SAN,104,1,0,POR,108,2,1,3,1
1989-11-08,WAS,112,2,1,BOS,103,2,1,4,2
1989-11-08,DEN,102,1,1,SAC,84,2,1,3,2
1989-11-09,GOS,95,1,2,LAL,106,2,1,3,3
1989-11-09,HOU,127,2,1,DEN,128,2,1,4,2
1989-11-09,MIL,155,2,1,SEA,154,2,1,4,2
1989-11-09,NYK,107,1,2,NJN,105,2,1,3,3
1989-11-10,IND,102,3,0,MIA,98,1,3,4,3
1989-11-10,WAS,100,3,1,CLE,92,0,3,3,4
1989-11-10,NJN,117,2,2,CHI,107,3,1,5,3
1989-11-10,ORL,121,2,1,DET,125,2,2,4,3
1989-11-10,PHX,130,1,2,SAC,109,2,2,3,4
1989-11-10,DAL,91,1,2,POR,99,3,1,4,3
1989-11-10,UTH,106,2,0,SAN,92,1,1,3,1
1989-11-10,BOS,117,2,2,ATL,106,0,2,2,4
1989-11-10,MIN,125,0,3,PHL,118,1,1,1,4
1989-11-10,LAL,106,3,1,CHH,100,0,3,3,4
1989-11-11,MIA,88,1,4,DET,84,3,2,4,6
1989-11-11,HOU,100,2,2,UTH,92,3,0,5,2
1989-11-11,CLE,104,0,4,BOS,101,3,2,3,6
1989-11-11,CHI,109,3,2,SEA,102,2,2,5,4
1989-11-11,MIL,96,3,1,PHL,104,1,2,4,3
1989-11-11,GOS,115,1,3,CHH,104,0,4,1,7
1989-11-11,SAN,122,1,2,DEN,108,3,1,4,3
1989-11-11,ATL,148,0,3,ORL,109,2,2,2,5
1989-11-11,LAC,111,1,2,NYK,112,2,2,3,4
1989-11-12,LAL,107,4,1,DAL,98,1,3,5,4
1989-11-12,MIN,97,1,3,SEA,108,2,3,3,6
1989-11-12,POR,95,4,1,WAS,104,4,1,8,2
1989-11-13,UTH,106,3,1,WAS,93,5,1,8,2
1989-11-13,ORL,104,2,3,ATL,112,1,3,3,6
1989-11-14,MIL,108,3,2,SAN,97,2,2,5,4
1989-11-14,SAC,94,2,3,CHI,96,4,2,6,5
1989-11-14,MIN,101,1,4,GOS,98,2,3,3,7
1989-11-14,BOS,96,3,3,PHL,94,2,2,5,5
1989-11-14,LAC,129,1,3,DEN,121,3,2,4,5
1989-11-14,NJN,92,3,2,CLE,103,1,4,4,6
1989-11-14,SEA,109,3,3,DAL,113,1,4,4,7
1989-11-14,MIA,101,2,4,HOU,99,3,2,5,6
1989-11-14,CHH,130,0,5,ORL,116,2,4,2,9
1989-11-14,POR,118,4,2,NYK,117,3,2,7,4
1989-11-15,UTH,108,4,1,CHI,107,5,2,9,3
1989-11-15,LAL,117,5,1,IND,94,4,0,9,1
1989-11-15,PHL,109,2,3,CHH,96,1,5,3,8
1989-11-15,PHX,109,2,2,POR,107,5,2,7,4
1989-11-15,CLE,129,2,4,GOS,104,2,4,4,8
1989-11-15,DET,130,3,3,MIA,94,3,4,6,7
1989-11-15,DEN,109,3,3,WAS,98,5,2,8,5
1989-11-15,MIN,76,2,4,SAN,86,2,3,4,7
1989-11-15,BOS,126,4,3,NJN,92,3,3,7,6
1989-11-16,SAC,102,2,4,NYK,121,3,3,5,7
1989-11-16,SEA,111,3,4,WAS,98,5,3,8,7
1989-11-16,MIL,132,4,2,ORL,113,2,5,6,7
1989-11-16,HOU,94,3,3,LAC,82,2,3,5,6
1989-11-17,UTH,114,5,1,IND,100,4,1,9,2
1989-11-17,DET,106,4,3,MIL,79,5,2,9,5
1989-11-17,CLE,131,3,4,ATL,125,2,3,5,7
1989-11-17,DAL,122,2,4,LAC,105,2,4,4,8
1989-11-17,LAL,119,6,1,DEN,105,4,3,10,4
1989-11-17,CHH,99,1,6,GOS,98,2,5,3,11
1989-11-17,BOS,116,5,3,MIN,99,2,5,7,8
1989-11-17,PHL,108,3,3,SAN,101,3,3,6,6
1989-11-17,POR,110,5,3,PHX,109,3,2,8,5
1989-11-18,DET,103,5,3,BOS,86,6,3,11,6
1989-11-18,SAC,107,2,5,IND,102,4,2,6,7
1989-11-18,ORL,116,2,6,PHL,103,4,3,6,9
1989-11-18,ATL,112,2,4,GOS,96,2,6,4,10
1989-11-18,DAL,100,3,4,MIA,99,3,5,6,9
1989-11-18,NYK,111,4,3,MIN,96,2,6,6,9
1989-11-18,NJN,95,3,4,SAN,110,3,4,6,8
1989-11-18,PHX,118,3,3,WAS,107,5,4,8,7
1989-11-18,SEA,119,4,4,CHI,110,5,3,9,7
1989-11-18,DEN,141,4,4,HOU,111,4,3,8,7
1989-11-19,POR,119,6,3,SEA,109,5,4,11,7
1989-11-19,HOU,132,4,4,MIA,94,3,6,7,10
1989-11-19,LAL,120,7,1,WAS,115,5,5,12,6
1989-11-21,SAC,113,3,5,ORL,115,3,6,6,11
1989-11-21,DET,96,6,3,ATL,103,3,4,9,7
1989-11-21,DEN,111,5,4,DAL,95,4,4,9,8
1989-11-21,WAS,97,5,6,MIL,91,5,3,10,9
1989-11-21,NYK,114,5,3,HOU,106,5,4,10,7
1989-11-21,CHH,87,2,6,MIA,98,3,7,5,13
1989-11-21,SEA,114,5,5,NJN,84,3,5,8,10
1989-11-21,IND,119,4,3,BOS,111,6,4,10,7
1989-11-21,SAN,107,4,4,PHX,98,4,3,8,7
1989-11-21,POR,121,7,3,CHI,110,5,4,12,7
1989-11-21,MIN,101,2,7,UTH,103,6,1,8,8
1989-11-22,LAC,106,2,5,NJN,97,3,6,5,11
1989-11-22,BOS,109,6,5,HOU,97,5,5,11,10
1989-11-22,CLE,97,4,4,NYK,85,6,3,10,7
1989-11-22,MIA,103,4,7,PHL,113,4,4,8,11
1989-11-22,GOS,133,2,7,SAC,109,3,6,5,13
1989-11-22,MIL,118,5,4,ATL,100,4,4,9,8
1989-11-22,MIN,93,2,8,DEN,96,6,4,8,12
1989-11-22,PHX,90,4,4,CHI,95,5,5,9,9
1989-11-22,UTH,97,7,1,ORL,119,4,6,11,7
1989-11-24,BOS,111,7,5,IND,118,5,3,12,8
1989-11-24,PHX,121,4,5,ORL,94,5,6,9,11
1989-11-24,LAC,89,3,5,SAN,90,5,4,8,9
1989-11-24,MIA,87,4,8,ATL,103,4,5,8,13
1989-11-24,DAL,99,4,5,MIN,89,2,9,6,14
1989-11-24,DET,101,6,4,CLE,82,5,4,11,8
1989-11-24,CHH,81,2,7,HOU,85,5,6,7,13
1989-11-24,DEN,122,7,4,SEA,109,6,5,13,9
1989-11-24,PHL,121,5,4,WAS,108,6,6,11,10
1989-11-24,POR,125,8,3,NJN,99,3,7,11,10
1989-11-25,CHH,81,2,8,MIN,73,2,10,4,18
1989-11-25,WAS,107,6,7,MIA,88,4,9,10,16
1989-11-25,ATL,108,5,5,BOS,100,7,6,12,11
1989-11-25,SAC,112,3,7,NJN,98,3,8,6,15
1989-11-25,GOS,91,3,7,CHI,104,6,5,9,12
1989-11-25,IND,103,6,3,PHL,111,6,4,12,7
1989-11-25,NYK,125,6,4,MIL,108,6,4,12,8
1989-11-25,UTH,86,7,2,LAL,92,8,1,15,3
1989-11-25,CLE,75,5,5,HOU,85,6,6,11,11
1989-11-25,DAL,70,5,5,SEA,117,6,6,11,11
1989-11-26,LAL,132,9,1,SAN,112,6,4,15,5
1989-11-26,POR,102,9,3,DET,82,7,4,16,7
1989-11-26,LAC,120,3,6,CHI,96,7,5,10,11
1989-11-27,NYK,119,7,4,CHH,108,3,8,10,12
1989-11-27,UTH,105,7,3,NJN,68,3,9,10,12
1989-11-27,MIL,97,6,5,IND,101,6,4,12,9
1989-11-28,ORL,104,5,7,MIA,99,4,10,9,17
1989-11-28,SAN,117,6,5,SEA,104,7,6,13,11
1989-11-28,HOU,110,7,6,LAL,104,10,1,17,7
1989-11-28,CHI,113,7,6,ATL,98,6,5,13,11
1989-11-28,SAC,81,4,7,DET,93,7,5,11,12
1989-11-28,CLE,92,5,6,WAS,91,7,7,12,13
1989-11-28,POR,116,10,3,LAC,94,4,6,14,9
1989-11-28,DEN,141,8,4,GOS,120,3,8,11,12
1989-11-29,GOS,111,3,9,NYK,129,8,4,11,13
1989-11-29,LAC,103,4,7,MIL,117,6,6,10,13
1989-11-29,PHX,103,5,5,DET,111,8,5,13,10
1989-11-29,PHL,114,7,4,CLE,84,6,6,13,10
1989-11-29,WAS,104,7,8,ATL,111,6,6,13,14
1989-11-29,MIA,100,4,11,MIN,105,2,11,6,22
1989-11-29,IND,100,7,4,UTH,88,8,3,15,7
1989-11-29,NJN,95,3,10,BOS,118,7,7,10,17
1989-11-29,DAL,102,5,6,CHH,83,3,9,8,15
1989-11-30,SAC,93,4,8,LAL,109,10,2,14,10
1989-11-30,SAN,93,7,5,DAL,89,6,6,13,11
1989-11-30,DEN,103,9,4,MIL,102,7,6,16,10
1989-11-30,HOU,113,8,6,CHH,101,3,10,11,16
1989-11-30,SEA,127,7,7,NYK,122,9,4,16,11
1989-11-30,ORL,103,6,7,MIN,96,3,11,9,18
1989-12-01,WAS,107,7,9,PHL,90,8,4,15,13
1989-12-01,IND,125,8,4,ORL,110,7,7,15,11
1989-12-01,ATL,114,7,6,UTH,103,8,4,15,10
1989-12-01,NJN,101,3,11,MIA,77,4,12,7,23
1989-12-01,BOS,102,8,7,CLE,89,6,7,14,14
1989-12-01,POR,123,11,3,GOS,110,3,10,14,13
1989-12-01,LAL,97,11,2,DET,108,9,5,20,7
1989-12-01,PHX,111,5,6,LAC,90,4,8,9,14
1989-12-02,GOS,101,3,11,MIL,98,7,7,10,18
1989-12-02,DEN,146,10,4,POR,113,12,3,22,7
1989-12-02,HOU,103,9,6,DAL,106,6,7,15,13
1989-12-02,CLE,74,6,8,MIN,101,3,12,9,20
1989-12-02,ATL,100,8,6,PHL,92,8,5,16,11
1989-12-02,LAC,114,4,9,SAC,84,4,9,8,18
1989-12-02,SEA,120,8,7,DET,95,10,5,18,12
1989-12-02,PHX,112,6,6,NYK,122,9,5,15,11
1989-12-02,SAN,118,8,5,CHH,110,3,11,11,16
1989-12-02,MIA,107,4,13,CHI,114,8,6,12,19
1989-12-02,WAS,98,8,9,UTH,100,8,5,16,14
1989-12-03,LAL,115,11,3,NYK,104,10,5,21,8
1989-12-04,ORL,95,7,8,POR,121,12,4,19,12
1989-12-05,SEA,133,9,7,HOU,123,9,7,18,14
1989-12-05,LAL,111,12,3,LAC,103,5,9,17,12
1989-12-05,CLE,80,6,9,UTH,94,9,5,15,14
1989-12-05,MIA,107,4,14,POR,113,13,4,17,18
1989-12-05,DAL,107,7,7,GOS,88,4,11,11,18
1989-12-05,MIN,92,4,12,NJN,90,4,11,8,23
1989-12-05,SAC,118,4,10,MIL,103,7,8,11,18
1989-12-05,NYK,110,10,6,PHL,103,8,6,18,12
1989-12-05,CHH,101,3,12,BOS,114,9,7,12,19
1989-12-05,CHI,119,9,6,DEN,99,11,4,20,10
1989-12-06,DET,115,10,6,WAS,107,8,10,18,16
1989-12-06,IND,136,9,4,DEN,117,11,5,20,9
1989-12-06,PHL,121,8,7,MIA,98,4,15,12,22
1989-12-06,ORL,110,7,9,ATL,118,9,6,16,15
1989-12-06,SAN,121,9,5,GOS,119,4,12,13,17
1989-12-06,BOS,113,10,7,NYK,98,11,6,21,13
1989-12-07,LAC,105,5,10,CLE,88,6,10,11,20
1989-12-07,CHH,86,3,13,POR,96,14,4,17,17
1989-12-07,UTH,107,10,5,DAL,97,8,7,18,12
1989-12-07,LAL,100,13,3,PHX,96,6,7,19,10
1989-12-08,ATL,127,10,6,POR,120,15,4,25,10
1989-12-08,GOS,121,4,13,SAC,126,5,10,9,23
1989-12-08,MIA,122,4,16,ORL,114,7,10,11,26
1989-12-08,BOS,102,11,7,DEN,103,11,6,22,13
1989-12-08,PHX,123,6,8,MIL,98,7,9,13,17
1989-12-08,HOU,94,9,8,NJN,99,4,12,13,20
1989-12-08,IND,106,10,4,CHI,104,10,6,20,10
1989-12-08,PHL,107,9,7,DET,101,11,6,20,13
1989-12-08,DAL,93,8,8,SAN,99,10,5,18,13
1989-12-09,SEA,104,10,7,LAC,100,6,10,16,17
1989-12-09,UTH,104,11,5,HOU,90,9,9,20,14
1989-12-09,DET,121,11,7,IND,93,11,4,22,11
1989-12-09,NYK,124,11,7,BOS,92,11,8,22,15
1989-12-09,SAN,109,11,5,NJN,92,5,12,16,17
1989-12-09,CHH,93,3,14,DEN,106,12,6,15,20
1989-12-09,SAC,101,6,10,CLE,108,6,11,12,21
1989-12-09,CHI,125,10,7,PHL,105,10,7,20,14
1989-12-09,ATL,104,11,6,MIN,91,5,12,16,18
1989-12-09,WAS,103,8,11,LAL,101,14,3,22,14
1989-12-10,MIL,107,7,10,POR,104,15,5,22,15
1989-12-10,ORL,108,7,11,LAL,103,14,4,21,15
1989-12-11,UTH,110,12,5,CLE,113,7,11,19,16
1989-12-12,SAC,103,6,11,GOS,118,4,14,10,25
1989-12-12,ATL,102,12,6,SAN,94,12,5,24,11
1989-12-12,CHI,105,11,7,DAL,97,8,9,19,16
1989-12-12,HOU,105,9,10,PHX,83,7,8,16,18
1989-12-12,CHH,89,3,15,LAL,103,14,5,17,20
1989-12-12,DEN,108,13,6,DET,121,12,7,25,13
1989-12-12,NJN,97,5,13,PHL,82,10,8,15,21
1989-12-12,MIL,106,8,10,ORL,103,8,11,16,21
1989-12-12,IND,113,11,5,MIN,112,5,13,16,18
1989-12-12,POR,99,15,6,LAC,92,6,11,21,17
1989-12-13,MIA,75,5,16,LAL,102,15,5,20,21
1989-12-13,MIN,87,5,14,DAL,90,8,10,13,24
1989-12-13,LAC,83,6,12,DET,79,13,7,19,19
1989-12-13,UTH,102,12,6,PHX,95,7,9,19,15
1989-12-13,GOS,134,5,14,DEN,114,13,7,18,21
1989-12-13,BOS,109,11,9,SEA,97,11,7,22,16
1989-12-13,CLE,99,8,11,MIL,93,9,10,17,21
1989-12-13,PHL,112,10,9,ATL,103,13,6,23,15
1989-12-14,NJN,78,6,13,IND,102,12,5,18,18
1989-12-14,CHI,124,12,7,ORL,113,8,12,20,19
1989-12-14,WAS,105,9,11,CHH,101,3,16,12,27
1989-12-14,SAN,104,12,6,HOU,100,10,10,22,16
1989-12-15,POR,111,16,6,GOS,116,6,14,22,20
1989-12-15,IND,98,13,5,MIL,103,9,11,22,16
1989-12-15,ATL,109,13,7,NYK,113,12,7,25,14
1989-12-15,PHL,88,11,9,DAL,95,9,10,20,19
1989-12-15,DEN,121,13,8,SAC,112,6,12,19,20
1989-12-15,MIN,84,5,15,MIA,95,5,17,10,32
1989-12-15,PHX,121,7,10,HOU,96,10,11,17,21
1989-12-15,CLE,120,9,11,SEA,101,11,8,20,19
1989-12-15,BOS,110,12,9,LAL,119,16,5,28,14
1989-12-15,UTH,94,13,6,DET,91,13,8,26,14
1989-12-16,SAN,125,13,6,ORL,116,8,13,21,19
1989-12-16,GOS,104,7,14,DET,92,13,9,20,23
1989-12-16,NJN,92,6,14,LAL,99,17,5,23,19
1989-12-16,LAC,114,7,12,DEN,108,14,8,21,20
1989-12-16,MIL,96,10,11,MIA,99,6,17,16,28
1989-12-16,WAS,112,10,11,DAL,108,10,10,20,21
1989-12-16,NYK,118,13,7,SEA,97,11,9,24,16
1989-12-16,CHI,115,13,7,CHH,104,3,17,16,24
1989-12-17,MIN,112,5,16,UTH,122,14,6,19,22
1989-12-17,SAC,113,6,13,PHX,125,8,10,14,23
1989-12-17,POR,121,16,7,IND,113,13,6,29,13
1989-12-17,HOU,109,10,12,ORL,94,8,14,18,26
1989-12-19,CHI,93,14,7,LAL,83,18,5,32,12
1989-12-19,NYK,115,14,7,UTH,107,15,6,29,13
1989-12-19,DET,94,13,10,SEA,77,11,10,24,20
1989-12-19,MIL,86,10,12,BOS,95,12,10,22,22
1989-12-19,WAS,112,11,11,MIN,99,5,17,16,28
1989-12-19,ATL,115,13,8,SAC,112,6,14,19,22
1989-12-19,POR,119,17,7,HOU,100,11,12,28,19
1989-12-19,MIA,98,7,17,NJN,100,6,15,13,32
1989-12-19,CHH,102,3,18,DAL,97,10,11,13,29
1989-12-19,LAC,128,8,12,IND,102,13,7,21,19
1989-12-20,BOS,113,13,10,UTH,109,15,7,28,17
1989-12-20,ORL,110,8,15,CHI,109,15,7,23,22
1989-12-20,NJN,78,7,15,DAL,84,10,12,17,27
1989-12-20,PHL,118,11,10,WAS,111,12,11,23,21
1989-12-20,CLE,89,10,11,DEN,104,14,9,24,20
1989-12-20,SAN,103,14,6,SAC,100,6,15,20,21
1989-12-20,PHX,130,9,10,IND,131,13,8,22,18
1989-12-20,GOS,118,8,14,HOU,112,11,13,19,27
1989-12-20,MIN,97,5,18,LAL,106,18,6,23,24
1989-12-21,SEA,123,11,11,POR,102,18,7,29,18
1989-12-21,MIA,115,7,18,ATL,117,14,8,21,26
1989-12-22,GOS,150,9,14,IND,124,14,8,23,22
1989-12-22,ATL,113,15,8,CHI,125,15,8,30,16
1989-12-22,ORL,125,9,15,DEN,137,15,9,24,24
1989-12-22,HOU,103,11,14,SAC,92,6,16,17,30
1989-12-22,BOS,88,14,10,PHL,89,12,10,26,20
1989-12-22,DAL,101,11,12,LAC,92,9,12,20,24
1989-12-22,WAS,112,12,12,NYK,122,15,7,27,19
1989-12-22,PHX,115,9,11,SAN,119,15,6,24,17
1989-12-22,MIL,112,10,13,CLE,100,10,12,20,25
1989-12-22,NJN,90,7,16,DET,96,14,10,21,26
1989-12-22,CHH,100,4,18,UTH,114,15,8,19,26
1989-12-23,NYK,94,16,7,NJN,85,7,17,23,24
1989-12-23,SAN,115,16,6,UTH,98,16,8,32,14
1989-12-23,DET,106,15,10,ORL,100,9,16,24,26
1989-12-23,MIA,104,7,19,DEN,135,16,9,23,28
1989-12-23,PHX,104,9,12,LAC,100,9,13,18,25
1989-12-23,PHL,131,13,10,CHI,104,16,8,29,18
1989-12-23,DAL,102,12,12,SAC,95,6,17,18,29
1989-12-23,MIN,90,5,19,MIL,94,11,13,16,32
1989-12-23,SEA,95,12,11,IND,98,14,9,26,20
1989-12-25,ATL,115,15,9,CLE,104,10,13,25,22
1989-12-26,LAL,104,19,6,SAC,102,6,18,25,24
1989-12-26,LAC,111,9,14,BOS,112,14,11,23,25
1989-12-26,DEN,114,17,9,PHL,111,14,10,31,19
1989-12-26,MIL,103,12,13,HOU,96,12,14,24,27
1989-12-26,PHX,121,10,12,POR,105,18,8,28,20
1989-12-26,CHI,112,16,9,MIN,99,5,20,21,29
1989-12-26,CHH,82,4,19,SAN,107,17,6,21,25
1989-12-26,IND,98,15,9,ORL,90,9,17,24,26
1989-12-26,UTH,133,16,9,GOS,118,10,14,26,23
1989-12-26,NJN,101,7,18,WAS,94,12,13,19,31
1989-12-26,MIA,94,7,20,NYK,100,17,7,24,27
1989-12-27,CLE,82,10,14,DET,99,16,10,26,24
1989-12-27,DAL,114,13,12,ATL,101,16,9,29,21
1989-12-27,WAS,97,12,14,SAN,107,18,6,30,20
1989-12-27,MIN,108,5,21,HOU,91,12,15,17,36
1989-12-27,SEA,110,12,12,PHL,106,14,11,26,23
1989-12-27,SAC,112,6,19,BOS,115,15,11,21,30
1989-12-27,ORL,101,9,18,IND,106,16,9,25,27
1989-12-28,NJN,104,8,18,NYK,106,18,7,26,25
1989-12-28,DEN,132,18,9,MIA,107,7,21,25,30
1989-12-28,CHH,94,4,20,CLE,92,10,15,14,35
1989-12-28,UTH,113,17,9,POR,109,18,9,35,18
1989-12-28,LAC,139,9,15,GOS,119,10,15,19,30
1989-12-29,LAL,130,20,6,GOS,111,10,16,30,22
1989-12-29,SEA,89,13,12,BOS,96,16,11,29,23
1989-12-29,CHI,101,17,9,SAN,97,19,6,36,15
1989-12-29,SAC,105,6,20,PHL,95,14,12,20,32
1989-12-29,IND,103,17,9,HOU,97,12,16,29,25
1989-12-29,MIN,101,6,21,PHX,118,11,12,17,33
1989-12-29,DAL,140,14,12,POR,144,18,10,32,22
1989-12-29,DET,85,17,10,MIL,99,13,13,30,23
1989-12-30,DET,117,17,11,NJN,106,8,19,25,30
1989-12-30,CHH,111,5,20,HOU,92,12,17,17,37
1989-12-30,LAC,95,10,15,PHL,100,14,13,24,28
1989-12-30,NYK,113,19,7,ORL,107,9,19,28,26
1989-12-30,CLE,110,10,16,PHX,102,12,12,22,28
1989-12-30,DAL,116,14,13,DEN,109,19,9,33,22
1989-12-30,UTH,117,18,9,MIA,98,7,22,25,31
1989-12-30,IND,105,18,9,ATL,98,16,10,34,19
1989-12-30,WAS,112,12,15,CHI,117,18,9,30,24
1989-12-30,MIL,109,14,13,MIN,99,6,22,20,35
1990-01-02,DAL,110,15,13,IND,106,19,9,34,22
1990-01-02,ORL,113,9,20,DET,115,18,11,27,31
1990-01-02,ATL,113,16,11,MIL,107,15,13,31,24
1990-01-02,POR,119,19,10,MIA,95,7,23,26,33
1990-01-02,NYK,99,20,7,PHX,113,12,13,32,20
1990-01-02,WAS,110,12,16,NJN,96,8,20,20,36
1990-01-02,GOS,133,10,17,UTH,120,19,9,29,26
1990-01-02,MIN,79,6,23,LAC,87,10,16,16,39
1990-01-03,SAN,103,19,7,PHL,94,15,13,34,20
1990-01-03,NJN,96,8,21,MIL,110,15,14,23,35
1990-01-03,DET,84,19,11,LAC,80,11,16,30,27
1990-01-03,CLE,87,11,16,CHI,93,19,9,30,25
1990-01-03,HOU,117,12,18,IND,103,19,10,31,28
1990-01-03,LAL,114,21,6,DEN,98,19,10,40,16
1990-01-03,BOS,120,17,11,WAS,101,13,16,30,27
1990-01-03,SEA,108,13,13,UTH,119,19,10,32,23
1990-01-04,MIN,100,6,24,CHH,98,6,20,12,44
1990-01-04,PHX,119,13,13,DAL,102,16,13,29,26
1990-01-04,NYK,100,20,8,ATL,95,17,11,37,19
1990-01-04,GOS,119,11,17,MIA,117,7,24,18,41
1990-01-04,SAC,98,7,20,DEN,112,19,11,26,31
1990-01-05,POR,118,20,10,UTH,89,20,10,40,20
1990-01-05,DET,122,20,11,IND,99,19,11,39,22
1990-01-05,CLE,119,11,17,WAS,107,13,17,24,34
1990-01-05,SEA,140,13,14,MIA,110,7,25,20,39
1990-01-05,BOS,105,18,11,LAC,114,11,17,29,28
1990-01-05,DAL,79,16,14,PHL,104,15,14,31,28
1990-01-05,CHI,127,20,9,ORL,116,9,21,29,30
1990-01-06,CHH,117,6,21,IND,111,19,12,25,33
1990-01-06,SAC,121,7,21,POR,124,21,10,28,31
1990-01-06,ORL,112,9,22,CLE,123,12,17,21,39
1990-01-06,ATL,105,17,12,NJN,96,8,22,25,34
1990-01-06,GOS,133,12,17,LAL,131,22,6,34,23
1990-01-06,DEN,120,20,11,UTH,123,20,11,40,22
1990-01-06,SAN,109,20,7,MIN,96,7,24,27,31
1990-01-06,MIL,118,16,14,CHI,111,21,9,37,23
1990-01-06,HOU,124,13,18,PHL,119,16,14,29,32
1990-01-06,DET,117,21,11,NYK,106,21,8,42,19
1990-01-06,WAS,88,13,18,BOS,102,18,12,31,30
1990-01-06,SEA,120,14,14,PHX,110,14,13,28,27
1990-01-07,NJN,98,8,23,ATL,93,18,12,26,35
1990-01-07,LAL,132,22,7,MIA,93,7,26,29,33
1990-01-07,NYK,110,21,9,LAC,109,12,17,33,26
1990-01-08,MIL,126,17,14,CHH,113,7,21,24,35
1990-01-08,ORL,111,9,23,SAN,102,21,7,30,30
1990-01-08,PHL,120,16,15,IND,116,19,13,35,28
1990-01-08,GOS,139,13,17,DEN,122,20,12,33,29
1990-01-08,DAL,110,16,15,SEA,96,15,14,31,29
1990-01-08,POR,108,22,10,SAC,96,7,22,29,32
1990-01-09,HOU,97,14,18,SEA,90,15,15,29,33
1990-01-09,DET,100,22,11,CHI,90,21,10,43,21
1990-01-09,MIA,102,7,27,SAN,107,21,8,28,35
1990-01-09,NYK,131,22,9,WAS,127,13,19,35,28
1990-01-09,NJN,87,9,23,BOS,78,19,12,28,35
1990-01-09,CHH,98,7,22,LAC,108,12,18,19,40
1990-01-09,SAC,84,7,23,MIN,70,7,25,14,48
1990-01-09,PHX,121,14,14,LAL,118,23,7,37,21
1990-01-10,UTH,130,21,11,DEN,99,20,13,41,24
1990-01-10,ATL,109,18,13,LAC,115,13,18,31,31
1990-01-10,IND,120,19,14,CHI,113,21,11,40,25
1990-01-10,BOS,104,19,13,DET,97,23,11,42,24
1990-01-10,LAL,121,23,8,ORL,106,10,23,33,31
1990-01-10,CLE,100,13,17,MIL,116,18,14,31,31
1990-01-10,PHL,113,17,15,NYK,111,23,9,40,24
1990-01-10,GOS,123,14,17,DAL,119,17,15,31,32
1990-01-11,MIA,89,7,28,WAS,100,13,20,20,48
1990-01-11,DEN,141,20,14,ORL,105,10,24,30,38
1990-01-11,SAC,87,8,23,HOU,90,15,18,23,41
1990-01-11,NJN,109,10,23,CHH,101,7,23,17,46
1990-01-11,SEA,98,15,16,DAL,87,17,16,32,32
1990-01-11,MIN,80,7,26,POR,82,23,10,30,36
1990-01-12,MIL,94,19,14,LAC,95,14,18,33,32
1990-01-12,PHL,102,18,15,CLE,113,13,18,31,33
1990-01-12,CHH,95,7,24,CHI,107,21,12,28,36
1990-01-12,BOS,90,20,13,SAN,97,22,8,42,21
1990-01-12,LAL,107,24,8,HOU,98,16,18,40,26
1990-01-12,DET,97,23,12,MIN,86,7,27,30,39
1990-01-12,PHX,111,15,14,SAC,96,8,24,23,38
1990-01-12,IND,96,20,14,NYK,101,23,10,43,24
1990-01-13,NYK,107,24,10,SAN,101,23,8,47,18
1990-01-13,DAL,99,17,17,UTH,109,22,11,39,28
1990-01-13,DET,111,24,12,POR,106,24,10,48,22
1990-01-13,DEN,111,21,14,PHX,119,16,14,37,28
1990-01-13,WAS,101,14,20,PHL,120,18,16,32,36
1990-01-13,SEA,113,16,16,ATL,106,18,14,34,30
1990-01-13,GOS,138,15,17,ORL,127,10,25,25,42
1990-01-13,CLE,98,14,18,NJN,96,11,23,25,41
1990-01-13,MIA,96,7,29,BOS,105,20,14,27,43
1990-01-13,IND,111,20,15,MIL,109,19,15,39,30
1990-01-13,CHI,117,22,12,LAC,111,15,18,37,30
1990-01-14,NJN,90,11,24,POR,99,24,11,35,35
1990-01-15,SEA,105,17,16,HOU,101,16,19,33,35
1990-01-15,PHX,118,17,14,CHH,108,7,25,24,39
1990-01-15,IND,144,21,15,GOS,105,16,17,37,32
1990-01-15,WAS,105,14,21,MIA,111,7,30,21,51
1990-01-15,DEN,101,21,15,DAL,90,17,18,38,33
1990-01-15,NYK,109,25,10,CHI,106,23,12,48,22
1990-01-15,CLE,92,15,18,SAN,89,23,9,38,27
1990-01-15,LAL,111,25,8,SAC,91,8,25,33,33
1990-01-16,POR,120,25,11,DEN,115,22,15,47,26
1990-01-16,SAC,108,8,26,ATL,91,18,15,26,41
1990-01-16,LAC,106,15,19,CHH,98,7,26,22,45
1990-01-16,MIL,134,19,16,GOS,126,16,18,35,34
1990-01-17,LAL,100,26,8,SEA,90,18,16,44,24
1990-01-17,PHL,112,19,16,DET,108,25,12,44,28
1990-01-17,HOU,107,16,20,CLE,98,16,18,32,38
1990-01-17,NJN,115,11,25,WAS,106,14,22,25,47
1990-01-17,ORL,111,10,26,BOS,133,21,14,31,40
1990-01-17,UTH,95,23,11,ATL,88,18,16,41,27
1990-01-17,MIA,121,8,30,IND,111,22,15,30,45
1990-01-17,SAN,101,23,10,NYK,97,26,10,49,20
1990-01-17,DAL,88,17,19,PHX,108,18,14,35,33
1990-01-18,DEN,108,22,16,CHH,110,7,27,29,43
1990-01-18,PHX,113,19,14,MIN,96,7,28,26,42
1990-01-18,WAS,112,14,23,MIL,115,20,16,34,39
1990-01-18,LAC,105,16,19,SEA,95,18,17,34,36
1990-01-18,CHI,132,23,13,GOS,107,16,19,39,32
1990-01-19,ATL,84,18,17,CHI,92,24,13,42,30
1990-01-19,ORL,120,10,27,NJN,105,12,25,22,52
1990-01-19,BOS,109,22,14,IND,104,22,16,44,30
1990-01-19,MIA,95,9,30,PHL,102,20,16,29,46
1990-01-19,DAL,117,17,20,NYK,103,26,11,43,31
1990-01-19,MIL,103,21,16,LAL,102,27,8,48,24
1990-01-19,DET,125,25,13,GOS,118,16,20,41,33
1990-01-19,UTH,116,24,11,CHH,93,8,27,32,38
1990-01-19,SAN,104,24,10,CLE,101,16,19,40,29
1990-01-20,DAL,105,18,20,CLE,96,16,20,34,40
1990-01-20,SAC,81,9,26,UTH,94,25,11,34,37
1990-01-20,DEN,126,22,17,SAN,99,25,10,47,27
1990-01-20,PHX,117,20,14,SEA,98,18,18,38,32
1990-01-20,PHL,108,21,16,NJN,98,12,26,33,42
1990-01-20,HOU,127,17,20,WAS,107,14,24,31,44
1990-01-20,LAC,97,17,19,MIN,95,7,29,24,48
1990-01-21,MIL,127,22,16,MIA,101,9,31,31,47
1990-01-21,BOS,115,23,14,GOS,120,16,21,39,35
1990-01-21,CHI,117,25,13,NYK,109,26,12,51,25
1990-01-21,POR,115,26,11,CHH,100,8,28,34,39
1990-01-21,DET,97,26,13,LAL,107,27,9,53,22
1990-01-22,SAC,136,9,27,LAC,104,18,19,27,46
1990-01-22,ORL,103,11,27,PHX,126,21,14,32,41
1990-01-22,SAN,124,25,11,WAS,115,14,25,39,36
1990-01-22,HOU,116,18,20,DEN,104,23,17,41,37
1990-01-23,NYK,97,26,13,LAL,118,28,9,54,22
1990-01-23,CHH,101,8,29,ATL,106,18,18,26,47
1990-01-23,DAL,129,19,20,WAS,105,14,26,33,46
1990-01-23,MIA,99,9,32,PHX,118,22,14,31,46
1990-01-23,CHI,95,26,13,DET,107,26,14,52,27
1990-01-23,GOS,109,17,21,MIN,102,7,30,24,51
1990-01-23,POR,119,27,11,MIL,90,23,16,50,27
1990-01-23,UTH,102,26,11,HOU,94,19,20,45,31
1990-01-23,CLE,88,16,21,PHL,103,22,16,38,37
1990-01-24,SAC,129,10,27,GOS,99,18,21,28,48
1990-01-24,ATL,103,19,18,CLE,86,16,22,35,40
1990-01-24,BOS,116,23,15,MIA,95,9,33,32,48
1990-01-24,IND,111,22,17,LAL,120,29,9,51,26
1990-01-24,SAN,106,26,11,LAC,98,18,20,44,31
1990-01-24,PHL,125,23,16,ORL,103,11,28,34,44
1990-01-24,SEA,112,18,19,MIL,119,23,17,41,36
1990-01-25,NJN,112,12,27,ORL,117,11,29,23,56
1990-01-25,HOU,102,19,21,LAC,101,18,21,37,42
1990-01-25,UTH,115,27,11,NYK,89,26,14,53,25
1990-01-25,CHH,97,8,30,PHX,124,23,14,31,44
1990-01-25,WAS,99,14,27,BOS,98,24,15,38,42
1990-01-26,PHL,120,24,16,CHI,109,26,14,50,30
1990-01-26,GOS,114,18,22,SEA,102,18,20,36,42
1990-01-26,DAL,106,20,20,SAC,93,11,27,31,47
1990-01-26,IND,115,22,18,MIA,105,9,34,31,52
1990-01-26,MIN,84,7,31,CLE,85,16,23,23,54
1990-01-26,POR,109,28,11,SAN,103,27,11,55,22
1990-01-26,LAL,100,30,9,MIL,91,24,17,54,26
1990-01-26,DET,107,27,14,PHX,103,24,14,51,28
1990-01-27,ORL,96,12,29,ATL,114,20,18,32,47
1990-01-27,UTH,144,28,11,MIL,96,24,18,52,29
1990-01-27,SEA,109,18,21,SAN,98,27,12,45,33
1990-01-27,IND,84,23,18,CLE,91,17,23,40,41
1990-01-27,MIN,83,7,32,DET,85,28,14,35,46
1990-01-27,HOU,92,20,21,DAL,99,21,20,41,41
1990-01-27,CHH,85,8,31,SAC,92,11,28,19,59
1990-01-27,LAC,115,18,22,POR,118,29,11,47,33
1990-01-27,PHL,125,25,16,WAS,101,15,27,40,43
1990-01-27,DEN,96,23,18,NYK,110,26,15,49,33
1990-01-27,CHI,110,26,15,NJN,107,12,28,38,43
1990-01-28,BOS,126,24,16,PHX,118,24,15,48,31
1990-01-29,CHI,121,27,15,ATL,111,21,18,48,33
1990-01-29,MIN,109,7,33,SAC,91,12,28,19,61
1990-01-29,DAL,108,22,20,NJN,88,12,29,34,49
1990-01-29,LAL,84,31,9,SAN,86,27,13,58,22
1990-01-30,MIA,94,9,35,CLE,106,18,23,27,58
1990-01-30,MIL,109,24,19,SAC,102,12,29,36,48
1990-01-30,LAC,121,18,23,LAL,104,31,10,49,33
1990-01-30,PHX,120,24,16,NJN,95,12,30,36,46
1990-01-30,ATL,95,21,19,DET,112,29,14,50,33
1990-01-30,ORL,129,12,30,IND,111,23,19,35,49
1990-01-30,POR,122,30,11,UTH,98,29,11,59,22
1990-01-31,BOS,97,25,16,NYK,91,27,15,52,31
1990-01-31,GOS,135,19,22,POR,130,31,11,50,33
1990-01-31,DET,133,30,14,WAS,109,15,28,45,42
1990-01-31,UTH,120,29,12,LAC,101,19,23,48,35
1990-01-31,SAN,129,28,13,CHH,95,8,32,36,45
1990-01-31,DAL,98,23,20,HOU,91,20,22,43,42
1990-01-31,IND,108,23,20,PHL,112,26,16,49,36
1990-01-31,MIN,110,8,33,SEA,82,19,21,27,54
1990-02-01,NYK,96,27,16,SAC,89,12,30,39,46
1990-02-01,DEN,123,23,19,NJN,112,12,31,35,50
1990-02-01,HOU,139,20,23,CHI,112,28,15,48,38
1990-02-01,PHX,102,25,16,ATL,90,21,20,46,36
1990-02-01,MIL,129,25,19,ORL,111,13,30,38,49
1990-02-02,PHL,119,27,16,MIL,109,26,19,53,35
1990-02-02,LAL,112,31,11,ATL,106,21,21,52,32
1990-02-02,GOS,128,20,22,NJN,109,12,32,32,54
1990-02-02,CHH,107,8,33,SAN,118,29,13,37,46
1990-02-02,MIA,126,9,36,LAC,91,19,24,28,60
1990-02-02,MIN,116,9,33,BOS,105,26,16,35,49
1990-02-02,WAS,108,15,29,SAC,99,12,31,27,60
1990-02-02,IND,86,23,21,SEA,87,19,22,42,43
1990-02-02,UTH,105,30,12,DAL,92,24,20,54,32
1990-02-03,POR,131,31,12,DAL,100,24,21,55,33
1990-02-03,ORL,110,13,31,LAC,113,19,25,32,56
1990-02-03,SAN,112,30,13,CHI,111,28,16,58,29
1990-02-03,WAS,92,16,29,SEA,94,20,22,36,51
1990-02-03,CLE,100,19,23,DET,105,31,14,50,37
1990-02-03,PHX,130,26,16,HOU,105,21,23,47,39
1990-02-03,NYK,112,28,16,IND,98,23,22,51,38
1990-02-04,MIL,102,26,20,PHL,105,28,16,54,36
1990-02-04,LAL,121,32,11,NJN,105,12,33,44,44
1990-02-04,BOS,121,26,17,SAC,89,12,32,38,49
1990-02-04,DET,115,32,14,UTH,83,31,12,63,26
1990-02-04,MIN,95,10,33,GOS,105,21,22,31,55
1990-02-04,DEN,125,24,19,ATL,113,21,22,45,41
1990-02-04,POR,123,32,12,PHX,121,27,16,59,28
1990-02-05,NYK,116,29,16,MIA,107,10,36,39,52
1990-02-05,CLE,100,19,24,LAC,84,20,25,39,49
1990-02-05,CHH,100,8,34,SEA,101,21,22,29,56
1990-02-05,WAS,135,16,30,GOS,129,22,22,38,52
1990-02-05,PHL,114,29,16,UTH,89,31,13,60,29
1990-02-06,SAC,90,12,33,DAL,100,24,22,36,55
1990-02-06,BOS,106,27,17,MIL,119,26,21,53,38
1990-02-06,HOU,108,21,24,MIN,101,10,34,31,58
1990-02-06,SAN,105,31,13,ATL,94,21,23,52,36
1990-02-06,ORL,110,13,32,NYK,117,30,16,43,48
1990-02-06,POR,119,33,12,LAL,121,33,11,66,23
1990-02-06,DEN,130,25,19,IND,138,23,23,48,42
1990-02-06,MIA,100,10,37,WAS,118,17,30,27,67
1990-02-06,DET,105,33,14,CLE,96,20,24,53,38
1990-02-07,LAL,121,34,11,CHI,103,28,17,62,28
1990-02-07,BOS,146,27,18,CHH,125,8,35,35,53
1990-02-07,PHL,112,30,16,GOS,113,22,23,52,39
1990-02-07,SEA,124,22,22,PHX,128,27,17,49,39
1990-02-07,NJN,101,12,34,UTH,108,31,14,43,48
1990-02-08,NYK,122,31,16,GOS,118,23,23,54,39
1990-02-08,DEN,123,25,20,CHI,98,28,18,53,38
1990-02-08,DAL,90,25,22,MIN,77,10,35,35,57
1990-02-08,CLE,106,20,25,MIA,82,10,38,30,63
1990-02-08,ORL,101,13,33,PHL,99,30,17,43,50
1990-02-08,SAN,100,32,13,IND,105,24,23,56,36
1990-02-08,WAS,103,18,30,LAC,105,20,26,38,56
1990-02-08,HOU,108,22,24,ATL,110,21,24,43,48
1990-02-08,MIL,101,27,21,DET,104,34,14,61,35
1990-02-08,CHH,74,8,36,UTH,94,32,14,40,50
1990-02-13,ATL,109,22,24,NYK,114,32,16,54,40
1990-02-13,DAL,103,26,22,SAN,96,32,14,58,36
1990-02-13,IND,128,25,23,CHH,105,8,37,33,60
1990-02-13,SAC,106,12,34,WAS,98,18,31,30,65
1990-02-13,UTH,110,33,14,MIN,104,10,36,43,50
1990-02-13,HOU,94,22,25,BOS,107,28,18,50,43
1990-02-13,LAC,96,21,26,PHX,118,28,17,49,43
1990-02-13,MIA,95,10,39,CHI,107,28,19,38,58
1990-02-13,SEA,106,22,23,POR,110,33,13,55,36
1990-02-13,DET,106,35,14,DEN,96,26,20,61,34
1990-02-14,MIN,95,10,37,CHH,86,8,38,18,75
1990-02-14,MIL,127,27,22,DEN,117,26,21,53,43
1990-02-14,LAL,128,35,11,POR,132,34,13,69,24
1990-02-14,PHL,122,30,18,NJN,112,12,35,42,53
1990-02-14,ORL,135,14,33,CHI,129,29,19,43,52
1990-02-14,SAN,95,32,15,BOS,106,29,18,61,33
1990-02-14,CLE,131,21,25,IND,133,26,23,47,48
1990-02-14,PHX,114,29,17,UTH,103,34,14,63,31
1990-02-15,NJN,92,12,36,SEA,103,22,24,34,60
1990-02-15,HOU,124,22,26,NYK,105,33,16,55,42
1990-02-15,SAC,92,13,34,LAL,101,35,12,48,46
1990-02-15,ATL,130,22,25,ORL,123,15,33,37,58
1990-02-15,GOS,113,23,24,WAS,107,18,32,41,56
1990-02-16,POR,120,35,13,BOS,101,30,18,65,31
1990-02-16,CHI,119,29,20,MIA,105,10,40,39,60
1990-02-16,CLE,109,21,26,ATL,101,23,25,44,51
1990-02-16,LAC,112,21,27,WAS,118,18,33,39,60
1990-02-16,MIN,111,11,37,IND,105,27,23,38,60
1990-02-16,PHL,100,31,18,SEA,96,23,24,54,42
1990-02-16,PHX,135,30,17,GOS,114,24,24,54,41
1990-02-16,SAN,100,32,16,UTH,86,34,15,66,31
1990-02-16,CHH,113,8,39,DEN,107,26,22,34,61
1990-02-17,MIA,79,10,41,DET,97,36,14,46,55
1990-02-17,UTH,110,34,16,SAC,106,13,35,47,51
1990-02-17,DAL,135,27,22,ORL,108,15,34,42,56
1990-02-17,HOU,102,23,26,SAN,104,33,16,56,42
1990-02-17,NJN,117,12,37,DEN,126,26,23,38,60
1990-02-17,NYK,119,33,17,CLE,108,22,26,55,43
1990-02-18,LAL,116,36,12,BOS,110,30,19,66,31
1990-02-18,WAS,116,19,33,IND,97,27,24,46,57
1990-02-18,CHH,70,9,39,SEA,85,23,25,32,64
1990-02-18,MIL,88,28,22,CHI,111,30,20,58,42
1990-02-18,GOS,113,24,25,PHX,131,31,17,55,42
1990-02-18,MIN,108,12,37,ATL,98,23,26,35,63
1990-02-18,POR,109,36,13,PHL,110,32,18,68,31
1990-02-19,LAC,97,21,28,SAC,99,13,36,34,64
1990-02-19,CHI,107,31,20,HOU,102,23,27,54,47
1990-02-19,CLE,87,22,27,DAL,96,28,22,50,49
1990-02-19,UTH,115,35,16,PHL,102,33,18,68,34
1990-02-19,DEN,114,27,23,GOS,109,24,26,51,49
1990-02-19,DET,94,37,14,MIA,85,10,42,47,56
1990-02-20,ORL,102,15,35,SEA,117,24,25,39,60
1990-02-20,MIL,110,28,23,NJN,102,12,38,40,61
1990-02-20,MIN,97,13,37,HOU,92,23,28,36,65
1990-02-20,ATL,107,23,27,WAS,110,20,33,43,60
1990-02-20,CHH,94,9,40,POR,104,36,14,45,54
1990-02-20,SAN,114,34,16,LAL,115,37,12,71,28
1990-02-20,PHX,120,32,17,BOS,99,30,20,62,37
1990-02-20,SAC,99,14,36,LAC,90,21,29,35,65
1990-02-21,DEN,111,28,23,LAL,113,38,12,66,35
1990-02-21,NJN,95,12,39,MIN,93,14,37,26,76
1990-02-21,IND,123,27,25,ATL,96,23,28,50,53
1990-02-21,UTH,116,36,16,BOS,103,30,21,66,37
1990-02-21,MIA,85,10,43,SEA,92,25,25,35,68
1990-02-21,GOS,95,24,27,PHL,96,33,19,57,46
1990-02-21,DET,140,38,14,ORL,109,15,36,53,50
1990-02-21,CLE,121,22,28,POR,109,37,14,59,42
1990-02-22,LAC,102,21,30,UTH,116,37,16,58,46
1990-02-22,WAS,110,21,33,NYK,119,34,17,55,50
1990-02-22,MIL,109,29,23,DAL,97,29,22,58,45
1990-02-22,SAC,98,15,36,PHX,104,33,17,48,53
1990-02-23,GOS,111,24,28,BOS,123,30,22,54,50
1990-02-23,ATL,112,23,29,DET,103,39,14,62,43
1990-02-23,LAL,122,39,12,PHL,116,34,19,73,31
1990-02-23,CHH,100,9,41,MIL,104,30,23,39,64
1990-02-23,MIA,128,10,44,NYK,121,35,17,45,61
1990-02-23,CHI,113,32,20,POR,102,37,15,69,35
1990-02-23,NJN,115,13,39,HOU,125,23,29,36,68
1990-02-23,SEA,97,26,25,SAC,85,15,37,41,62
1990-02-23,SAN,105,34,17,MIN,95,14,38,48,55
1990-02-23,CLE,123,23,28,ORL,96,15,37,38,65
1990-02-23,IND,91,28,25,DAL,102,29,23,57,48
1990-02-23,DEN,121,28,24,LAC,112,21,31,49,55
1990-02-24,ATL,104,24,29,HOU,96,24,29,48,58
1990-02-24,WAS,141,21,34,ORL,124,15,38,36,72
1990-02-24,PHX,126,34,17,PHL,99,34,20,68,37
1990-02-25,NJN,106,13,40,CHI,107,33,20,46,60
1990-02-25,MIN,82,14,39,DAL,87,30,23,44,62
1990-02-25,CLE,102,24,28,CHH,86,9,42,33,70
1990-02-25,NYK,87,35,18,DET,98,39,15,74,33
1990-02-25,LAL,103,40,12,UTH,104,38,16,78,28
1990-02-25,LAC,106,21,32,SAN,107,35,17,56,49
1990-02-25,IND,117,28,26,POR,112,37,16,65,42
1990-02-25,SEA,110,27,25,GOS,102,24,29,51,54
1990-02-25,DEN,107,29,24,BOS,115,31,22,60,46
1990-02-25,MIA,108,11,44,MIL,113,31,23,42,67
1990-02-26,PHL,129,34,21,ORL,110,15,39,49,60
1990-02-26,ATL,123,25,29,MIA,114,11,45,36,74
1990-02-26,SAC,96,15,38,SAN,105,36,17,51,55
1990-02-27,PHX,120,35,17,DEN,101,29,25,64,42
1990-02-27,LAC,103,21,33,SEA,99,28,25,49,58
1990-02-27,MIN,104,14,40,WAS,88,22,34,36,74
1990-02-27,NYK,110,35,19,DAL,87,31,23,66,42
1990-02-27,POR,118,37,17,CLE,105,25,28,62,45
1990-02-27,IND,118,29,26,NJN,113,13,41,42,67
1990-02-27,ORL,115,15,40,CHH,109,9,43,24,83
1990-02-27,CHI,106,34,20,MIL,96,32,23,66,43
1990-02-27,DET,106,40,15,HOU,102,24,30,64,45
1990-02-28,GOS,144,24,30,SAN,135,37,17,61,47
1990-02-28,ATL,102,26,29,IND,99,30,26,56,55
1990-02-28,BOS,111,32,22,DAL,98,31,24,63,46
1990-02-28,MIA,113,11,46,SAC,92,15,39,26,85
1990-02-28,SEA,107,28,26,LAL,112,40,13,68,39
1990-03-01,CHH,118,9,44,LAC,109,22,33,31,77
1990-03-01,HOU,112,24,31,PHX,104,36,17,60,48
1990-03-01,WAS,85,22,35,DET,99,41,15,63,50
1990-03-01,ORL,100,16,40,SAC,114,15,40,31,80
1990-03-01,DEN,131,29,26,CLE,125,25,29,54,55
1990-03-01,UTH,119,39,16,POR,102,38,17,77,33
1990-03-01,NYK,100,36,19,PHL,105,35,21,71,40
1990-03-02,MIA,110,12,46,BOS,122,33,22,45,68
1990-03-02,DET,115,42,15,PHL,112,36,21,78,36
1990-03-02,DAL,108,31,25,PHX,102,36,18,67,43
1990-03-02,SEA,99,28,27,MIN,83,15,40,43,67
1990-03-02,LAL,124,41,13,CLE,93,25,30,66,43
1990-03-02,ATL,132,27,29,MIL,110,32,24,59,53
1990-03-02,CHI,112,35,20,NJN,91,13,42,48,62
1990-03-02,SAN,131,37,18,GOS,115,25,30,62,48
1990-03-03,DEN,106,30,26,DAL,89,32,25,62,51
1990-03-03,MIL,105,32,25,NYK,106,36,20,68,45
1990-03-03,NJN,114,13,43,ATL,109,28,29,41,72
1990-03-03,IND,105,30,27,LAC,107,22,34,52,61
1990-03-03,POR,110,38,18,SEA,98,29,27,67,45
1990-03-03,HOU,129,25,31,GOS,109,25,31,50,62
1990-03-03,CHH,103,10,44,SAC,104,16,40,26,84
1990-03-03,UTH,112,40,16,SAN,98,38,18,78,34
1990-03-03,ORL,128,16,41,WAS,132,22,36,38,77
1990-03-04,LAL,115,42,13,MIN,96,15,41,57,54
1990-03-04,BOS,114,34,22,CHI,118,36,20,70,42
1990-03-04,PHX,108,36,19,CLE,96,25,31,61,50
1990-03-04,DET,111,43,15,IND,105,30,28,73,43
1990-03-05,GOS,138,25,32,CHH,117,10,45,35,77
1990-03-05,NJN,128,14,43,SAC,111,17,40,31,83
1990-03-05,MIA,105,12,47,UTH,104,41,16,53,63
1990-03-05,PHL,128,36,22,LAC,105,23,34,59,56
1990-03-05,SAN,105,38,19,HOU,109,26,31,64,50
1990-03-06,ORL,101,16,42,UTH,111,41,17,57,59
1990-03-06,NYK,100,37,20,POR,112,39,18,76,38
1990-03-06,MIL,105,32,26,CHI,114,37,20,69,46
1990-03-06,DET,101,44,15,SAC,91,17,41,61,56
1990-03-06,IND,113,30,29,WAS,98,23,36,53,65
1990-03-06,SEA,95,29,28,CLE,90,25,32,54,60
1990-03-06,DEN,122,31,26,CHH,96,10,46,41,72
1990-03-06,ATL,111,28,30,PHX,113,37,19,65,49
1990-03-06,HOU,112,27,31,LAL,95,43,13,70,44
1990-03-07,BOS,117,34,23,POR,130,40,18,74,41
1990-03-07,MIA,122,13,47,ORL,105,16,43,29,90
1990-03-07,MIN,73,15,42,DEN,86,32,26,47,68
1990-03-07,NJN,115,15,43,LAC,119,23,35,38,78
1990-03-07,WAS,111,23,37,PHX,113,38,19,61,56
1990-03-07,DAL,91,32,26,LAL,103,43,14,75,40
1990-03-07,PHL,110,37,22,NYK,93,37,21,74,43
1990-03-08,CHI,94,38,20,UTH,98,42,17,80,37
1990-03-08,HOU,111,28,31,SEA,97,30,28,58,59
1990-03-08,MIN,111,15,43,LAC,94,24,35,39,78
1990-03-08,GOS,145,26,32,CLE,105,25,33,51,65
1990-03-08,SAC,111,17,42,CHH,102,10,47,27,89
1990-03-09,NJN,95,15,44,DET,99,45,15,60,59
1990-03-09,IND,130,31,29,PHX,134,39,19,70,48
1990-03-09,PHL,100,38,22,POR,104,41,18,79,40
1990-03-09,BOS,108,34,24,WAS,115,23,38,57,62
1990-03-09,ATL,107,28,31,SEA,97,30,29,58,60
1990-03-09,MIL,100,32,27,UTH,108,43,17,75,44
1990-03-09,LAL,131,44,14,GOS,115,27,32,71,46
1990-03-10,NYK,110,37,22,NJN,91,15,45,52,67
1990-03-10,CHI,117,38,21,IND,105,31,30,69,51
1990-03-10,HOU,105,29,31,DAL,95,32,27,61,58
1990-03-10,SAN,118,38,20,DEN,111,33,26,71,46
1990-03-10,MIN,98,16,43,PHX,101,40,19,56,62
1990-03-10,WAS,113,24,38,POR,116,42,18,66,56
1990-03-10,LAC,112,24,36,ORL,101,16,44,40,80
1990-03-11,BOS,107,34,25,PHL,105,38,23,72,48
1990-03-11,MIA,90,14,47,NYK,106,38,22,52,69
1990-03-11,GOS,123,27,33,SAC,116,18,42,45,75
1990-03-11,CHH,88,10,48,DET,98,46,15,56,63
1990-03-11,DEN,109,33,27,UTH,110,44,17,77,44
1990-03-11,MIL,96,32,28,CLE,107,25,34,57,62
1990-03-11,ATL,115,29,31,LAL,123,45,14,74,45
1990-03-12,CHH,102,10,49,LAL,107,46,14,56,63
1990-03-12,NJN,104,15,46,MIL,109,32,29,47,75
1990-03-12,SEA,130,30,30,ORL,105,16,45,46,75
1990-03-12,MIN,88,16,44,SAN,92,39,20,55,64
1990-03-12,LAC,109,25,36,GOS,112,28,33,53,69
1990-03-13,SAC,121,18,43,MIA,87,14,48,32,91
1990-03-13,IND,102,31,31,SAN,103,40,20,71,51
1990-03-13,DEN,117,33,28,HOU,114,30,31,63,59
1990-03-13,ATL,100,29,32,BOS,112,35,25,64,57
1990-03-13,CLE,119,26,34,PHL,102,38,24,64,58
1990-03-13,POR,142,43,18,ORL,117,16,46,59,64
1990-03-13,NYK,108,39,22,CHI,111,39,21,78,43
1990-03-13,UTH,106,45,17,PHX,114,41,19,86,36
1990-03-14,PHX,138,42,19,DEN,108,34,28,76,47
1990-03-14,LAC,108,25,37,MIA,113,14,49,39,86
1990-03-14,PHL,116,38,25,LAL,110,47,14,85,39
1990-03-14,DAL,113,32,28,BOS,102,36,25,68,53
1990-03-14,SEA,103,31,30,CHH,100,10,50,41,80
1990-03-15,MIN,102,16,45,NYK,82,39,23,55,68
1990-03-15,CLE,112,27,34,LAL,96,47,15,74,49
1990-03-15,DET,110,47,15,SAN,98,41,20,88,35
1990-03-15,SAC,86,19,43,HOU,92,30,32,49,75
1990-03-15,MIL,96,33,29,WAS,91,24,39,57,68
1990-03-15,GOS,121,29,33,POR,128,44,18,73,51
1990-03-15,UTH,117,45,18,SEA,95,32,30,77,48
1990-03-16,CHI,81,40,21,DET,106,48,15,88,36
1990-03-16,PHL,119,39,25,NJN,110,15,47,54,72
1990-03-16,PHX,129,43,19,MIA,103,15,49,58,68
1990-03-16,LAC,118,25,38,HOU,95,31,32,56,70
1990-03-16,IND,104,31,32,ATL,106,29,33,60,65
1990-03-16,DAL,104,33,28,DEN,97,34,29,67,57
1990-03-16,POR,124,45,18,CHH,109,10,51,55,69
1990-03-16,ORL,127,16,47,BOS,130,36,26,52,73
1990-03-17,SAC,122,19,44,UTH,109,46,18,65,62
1990-03-17,NYK,111,39,24,MIL,123,34,29,73,53
1990-03-17,CLE,118,28,34,IND,102,31,33,59,67
1990-03-17,MIN,99,17,45,LAL,101,47,16,64,61
1990-03-17,WAS,92,24,40,ATL,119,30,33,54,73
1990-03-17,SAN,111,41,21,MIA,98,15,50,56,71
1990-03-17,CHI,114,40,22,PHL,109,40,25,80,47
1990-03-18,DET,114,49,15,DAL,84,34,28,83,43
1990-03-18,POR,109,46,18,HOU,96,31,33,77,51
1990-03-18,ORL,103,16,48,CLE,120,29,34,45,82
1990-03-18,GOS,116,29,34,SEA,121,32,31,61,65
1990-03-18,LAC,97,26,38,CHH,108,10,52,36,90
1990-03-18,DEN,103,34,30,MIN,98,17,46,51,76
1990-03-18,BOS,122,37,26,NJN,106,15,48,52,74
1990-03-19,PHX,102,44,19,SAN,113,42,21,86,40
1990-03-19,UTH,105,46,19,SAC,97,20,44,66,63
1990-03-19,ATL,110,31,33,DAL,117,34,29,65,62
1990-03-19,NJN,94,15,49,PHL,108,40,26,55,75
1990-03-20,MIL,96,35,29,DET,117,50,15,85,44
1990-03-20,DEN,119,35,30,LAC,112,26,39,61,69
1990-03-20,LAL,109,48,16,CHH,97,11,52,59,68
1990-03-20,SEA,106,33,31,SAN,128,43,21,76,52
1990-03-20,NYK,118,39,25,ORL,121,16,49,55,74
1990-03-20,CHI,122,41,22,WAS,97,24,41,65,63
1990-03-20,HOU,110,31,34,POR,120,47,18,78,52
1990-03-20,MIA,98,15,51,IND,112,31,34,46,85
1990-03-20,GOS,105,29,35,MIN,101,17,47,46,82
1990-03-21,SAC,90,20,45,MIN,84,17,48,37,93
1990-03-21,BOS,123,38,26,CLE,114,30,34,68,60
1990-03-21,PHX,114,44,20,CHH,115,11,53,55,73
1990-03-21,IND,112,32,34,MIL,96,35,30,67,64
1990-03-21,WAS,136,24,42,NJN,106,15,50,39,92
1990-03-21,PHL,118,41,26,MIA,97,15,52,56,78
1990-03-21,UTH,118,47,19,LAC,102,26,40,73,59
1990-03-21,ATL,89,31,34,CHI,99,42,22,73,56
1990-03-22,HOU,115,31,35,DET,110,51,15,82,50
1990-03-22,ORL,106,17,49,DAL,116,35,29,52,78
1990-03-22,SEA,125,33,32,DEN,118,36,30,69,62
1990-03-22,SAN,107,44,21,POR,106,48,18,92,39
1990-03-23,LAL,110,49,16,LAC,102,26,41,75,57
1990-03-23,PHX,120,44,21,MIN,99,17,49,61,70
1990-03-23,BOS,101,39,26,ATL,98,31,35,70,61
1990-03-23,CHH,106,12,53,NYK,93,39,26,51,79
1990-03-23,IND,125,33,34,NJN,109,15,51,48,85
1990-03-23,MIA,103,15,53,DAL,106,36,29,51,82
1990-03-23,CHI,102,43,22,CLE,95,30,35,73,57
1990-03-23,UTH,106,48,19,GOS,91,30,35,78,54
1990-03-23,PHL,115,42,26,SAC,99,21,45,63,71
1990-03-24,CLE,115,30,36,NJN,108,15,52,45,88
1990-03-24,DEN,126,36,31,POR,140,48,19,84,50
1990-03-24,LAC,79,26,42,UTH,112,49,19,75,61
1990-03-24,PHX,121,45,21,SEA,95,34,32,79,53
1990-03-24,WAS,112,25,42,PHL,114,43,26,68,68
1990-03-24,NYK,110,39,27,BOS,115,40,26,79,53
1990-03-24,ATL,122,31,36,CHH,109,13,53,44,89
1990-03-24,CHI,113,44,22,SAC,116,21,46,65,68
1990-03-24,ORL,101,17,50,MIL,109,35,31,52,81
1990-03-24,HOU,97,32,35,GOS,102,30,36,62,71
1990-03-24,SAN,105,45,21,DET,98,51,16,96,37
1990-03-25,DAL,98,37,29,DET,96,51,17,88,46
1990-03-25,MIA,105,15,54,MIL,102,36,31,51,85
1990-03-25,POR,105,49,19,MIN,110,17,50,66,69
1990-03-25,LAL,116,50,16,SEA,94,34,33,84,49
1990-03-26,CHH,97,13,54,NJN,83,15,53,28,107
1990-03-26,HOU,113,32,36,SAN,95,46,21,78,57
1990-03-26,LAC,101,26,43,MIN,96,18,50,44,93
1990-03-26,CLE,116,31,36,SAC,95,22,46,53,82
1990-03-26,ATL,113,32,36,DEN,102,36,32,68,68
1990-03-26,CHI,121,44,23,PHX,92,46,21,90,44
1990-03-27,MIL,133,36,32,PHX,127,46,22,82,54
1990-03-27,NYK,119,39,28,WAS,100,25,43,64,71
1990-03-27,SAN,115,46,22,SEA,103,34,34,80,56
1990-03-27,POR,130,49,20,LAL,111,51,16,100,36
1990-03-27,IND,101,34,34,BOS,96,41,26,75,60
1990-03-27,DAL,118,38,29,GOS,108,31,36,69,65
1990-03-28,DET,106,51,18,CHH,97,14,54,65,72
1990-03-28,CLE,113,32,36,CHI,117,45,23,77,59
1990-03-28,PHL,122,44,26,BOS,104,41,27,85,53
1990-03-28,ORL,104,17,51,MIA,109,16,54,33,105
1990-03-28,MIN,93,18,51,SAC,88,22,47,40,98
1990-03-28,LAC,99,27,43,LAL,106,51,17,78,60
1990-03-28,NJN,106,15,54,NYK,101,40,28,55,82
1990-03-28,WAS,113,25,44,DEN,99,36,33,61,77
1990-03-29,HOU,120,33,36,MIL,94,37,32,70,68
1990-03-29,IND,111,35,34,SAC,101,22,48,57,82
1990-03-29,GOS,128,31,37,UTH,123,50,19,81,56
1990-03-29,SAN,105,47,22,DAL,109,39,29,86,51
1990-03-29,POR,112,50,20,ATL,106,33,36,83,56
1990-03-29,CHH,92,14,55,PHX,105,46,23,60,78
1990-03-30,NJN,119,16,54,PHX,126,47,23,63,77
1990-03-30,SEA,139,34,35,GOS,108,32,37,66,72
1990-03-30,CHI,107,46,23,NYK,106,40,29,86,52
1990-03-30,LAC,118,27,44,ATL,122,33,37,60,81
1990-03-30,BOS,123,41,28,DET,111,52,18,93,46
1990-03-30,PHL,149,45,26,DEN,131,36,34,81,60
1990-03-30,LAL,135,52,17,POR,106,51,20,103,37
1990-03-30,MIA,104,17,54,CLE,105,32,37,49,91
1990-03-30,DAL,82,40,29,MIN,84,19,51,59,80
1990-03-30,WAS,143,26,44,ORL,115,17,52,43,96
1990-03-31,NYK,115,40,30,DEN,118,36,35,76,65
1990-03-31,SAN,107,47,23,MIL,100,37,33,84,56
1990-03-31,SAC,103,22,49,CHH,115,14,56,36,105
1990-03-31,HOU,106,34,36,MIN,98,20,51,54,87
1990-04-01,BOS,133,42,28,ORL,125,17,53,59,81
1990-04-01,CHI,111,47,23,MIA,103,17,55,64,78
1990-04-01,DAL,86,40,30,MIL,72,37,34,77,64
1990-04-01,NJN,97,16,55,WAS,105,27,44,43,99
1990-04-01,PHL,141,46,26,PHX,112,48,23,94,49
1990-04-01,LAL,119,53,17,UTH,103,50,20,103,37
1990-04-01,LAC,104,27,45,SEA,103,35,35,62,80
1990-04-01,GOS,116,32,38,ATL,142,34,37,66,75
1990-04-01,CLE,121,33,37,IND,91,36,34,69,71
1990-04-03,NYK,106,40,31,CLE,97,34,37,74,68
1990-04-03,DET,93,52,19,BOS,82,43,28,95,47
1990-04-03,PHL,133,47,26,HOU,112,35,36,82,62
1990-04-03,SAN,90,48,23,MIN,92,20,52,68,75
1990-04-03,SAC,105,22,50,LAC,114,28,45,50,95
1990-04-03,CHI,109,48,23,IND,102,36,35,84,58
1990-04-03,ORL,126,17,54,GOS,127,32,39,49,93
1990-04-03,UTH,127,50,21,CHH,104,15,56,65,77
1990-04-03,PHX,117,48,24,DAL,111,41,30,89,54
1990-04-03,SEA,136,35,36,POR,134,51,21,86,57
1990-04-04,BOS,125,43,29,NJN,106,16,56,59,85
1990-04-04,CLE,101,34,38,ATL,95,35,37,69,75
1990-04-04,MIL,121,37,35,IND,116,36,36,73,71
1990-04-04,MIA,114,17,56,GOS,128,33,39,50,95
1990-04-04,DEN,112,37,35,CHH,116,15,57,52,92
1990-04-04,WAS,107,28,44,NYK,118,41,31,69,75
1990-04-04,DAL,104,41,31,SAN,98,48,24,89,55
1990-04-05,SEA,101,36,36,UTH,91,51,21,87,57
1990-04-05,CHI,111,49,23,ORL,104,17,55,66,78
1990-04-05,LAL,110,54,17,SAC,103,22,51,76,68
1990-04-05,ATL,99,35,38,DET,104,53,19,88,57
1990-04-06,DET,84,54,19,MIL,92,38,35,92,54
1990-04-06,WAS,121,28,45,HOU,110,35,37,63,82
1990-04-06,ORL,115,17,56,IND,123,36,37,53,93
1990-04-06,CLE,104,35,38,BOS,109,44,29,79,67
1990-04-06,POR,106,51,22,LAC,99,29,45,80,67
1990-04-06,CHH,108,16,57,MIN,93,21,52,37,109
1990-04-06,NJN,117,16,57,GOS,123,34,39,50,96
1990-04-06,NYK,114,42,31,PHL,104,48,26,90,57
1990-04-06,PHX,99,49,24,LAL,103,55,17,104,41
1990-04-06,DEN,119,37,36,SEA,103,37,36,74,72
1990-04-07,DAL,108,42,31,CHI,109,50,23,92,54
1990-04-07,ATL,108,35,39,PHL,112,48,27,83,66
1990-04-07,SAC,93,22,52,SAN,111,48,25,70,77
1990-04-07,MIA,105,17,57,BOS,115,45,29,62,86
1990-04-07,LAC,108,29,46,PHX,115,49,25,78,71
1990-04-07,MIL,110,39,35,WAS,100,29,45,68,80
1990-04-08,IND,99,37,37,NYK,97,43,31,80,68
1990-04-08,CLE,100,35,39,DET,97,54,20,89,59
1990-04-08,POR,112,52,22,SAN,105,49,25,101,47
1990-04-08,ORL,123,17,57,HOU,146,35,38,52,95
1990-04-08,NJN,102,16,58,MIA,101,17,58,33,116
1990-04-08,DEN,109,38,36,LAL,116,56,17,94,53
1990-04-08,CHH,110,17,57,GOS,109,35,39,52,96
1990-04-09,SEA,105,37,37,SAC,106,22,53,59,90
1990-04-09,LAL,113,57,17,DAL,106,42,32,99,49
1990-04-09,PHX,119,50,25,UTH,115,51,22,101,47
1990-04-10,SAC,113,23,53,DEN,121,38,37,61,90
1990-04-10,IND,107,38,37,WAS,105,29,46,67,83
1990-04-10,PHL,111,49,27,ATL,123,35,40,84,67
1990-04-10,NJN,96,17,58,BOS,112,46,29,63,87
1990-04-10,CHH,112,18,57,HOU,115,36,38,54,95
1990-04-10,GOS,122,35,40,SAN,132,49,26,84,66
1990-04-10,NYK,98,43,32,DET,108,54,21,97,53
1990-04-10,MIN,94,21,53,POR,106,53,22,74,75
1990-04-10,UTH,114,51,23,SEA,102,37,38,88,61
1990-04-10,ORL,127,17,58,MIL,130,40,35,57,93
1990-04-10,LAC,98,29,47,DAL,90,42,33,71,80
1990-04-11,CHI,107,51,23,CLE,86,36,39,87,62
1990-04-11,ATL,106,36,40,MIL,94,41,35,77,75
1990-04-11,DET,98,55,21,NJN,93,17,59,72,80
1990-04-12,SAC,114,23,54,PHX,116,51,25,74,79
1990-04-12,WAS,100,29,47,CLE,102,36,40,65,87
1990-04-12,UTH,107,52,23,LAL,104,58,17,110,40
1990-04-12,BOS,139,47,29,MIA,118,17,59,64,88
1990-04-12,SEA,113,37,39,DEN,103,39,37,76,76
1990-04-12,PHL,110,49,28,MIN,77,21,54,70,82
1990-04-12,GOS,133,35,41,DAL,140,42,34,77,75
1990-04-12,NYK,108,43,33,IND,100,39,37,82,70
1990-04-12,SAN,105,50,26,LAC,98,30,47,80,73
1990-04-12,HOU,117,37,38,CHH,110,18,58,55,96
1990-04-13,LAL,131,58,18,GOS,119,35,42,93,60
1990-04-13,MIN,117,21,55,ORL,102,17,59,38,114
1990-04-13,DET,111,56,21,ATL,115,37,40,93,61
1990-04-13,POR,124,54,22,DAL,92,43,34,97,56
1990-04-13,CHI,116,52,23,MIL,106,41,36,93,59
1990-04-14,NJN,113,17,60,IND,124,39,38,56,98
1990-04-14,CLE,93,37,40,MIA,85,17,60,54,100
1990-04-14,WAS,113,29,48,CHI,103,53,23,82,71
1990-04-14,CHH,102,18,59,PHL,109,50,28,68,87
1990-04-14,UTH,99,53,23,HOU,103,38,38,91,61
1990-04-14,SEA,96,38,39,PHX,89,52,25,90,64
1990-04-14,DET,111,56,22,ORL,107,17,60,73,82
1990-04-14,MIL,109,41,37,ATL,93,38,40,79,77
1990-04-14,SAN,105,51,26,SAC,94,23,55,74,81
1990-04-14,POR,127,55,22,DEN,136,39,38,94,60
1990-04-15,BOS,101,48,29,NYK,94,44,33,92,62
1990-04-15,LAL,113,59,18,HOU,102,39,38,98,56
1990-04-15,MIN,90,22,55,UTH,103,53,24,75,79
1990-04-16,IND,111,40,38,CHI,102,53,24,93,62
1990-04-16,GOS,129,35,43,PHX,141,52,26,87,69
1990-04-16,NYK,119,44,34,MIA,102,17,61,61,95
1990-04-16,LAC,85,30,48,POR,93,55,23,85,71
1990-04-16,CHH,101,18,60,SAN,110,52,26,70,86
1990-04-17,MIN,89,22,56,DEN,99,40,38,62,94
1990-04-17,DAL,97,43,35,UTH,96,54,24,97,59
1990-04-17,ATL,118,38,41,NJN,95,17,61,55,102
1990-04-17,SEA,101,39,39,LAL,102,60,18,99,57
1990-04-17,CHI,111,53,25,BOS,105,49,29,102,54
1990-04-17,HOU,112,39,39,SAC,97,23,56,62,95
1990-04-17,MIL,88,42,37,CLE,96,38,40,80,77
1990-04-17,ORL,127,17,61,WAS,129,30,48,47,109
1990-04-18,NJN,93,17,62,CLE,100,39,40,56,102
1990-04-18,SAN,102,53,26,UTH,93,54,25,107,51
1990-04-18,MIA,91,17,62,CHH,98,18,61,35,123
1990-04-18,PHL,124,51,28,IND,113,41,38,92,66
1990-04-18,PHX,120,53,26,POR,128,56,23,109,49
1990-04-18,BOS,133,49,30,ORL,112,17,62,66,92
1990-04-18,GOS,133,35,44,LAC,120,30,49,65,93
1990-04-19,MIL,96,42,38,NYK,95,45,34,87,72
1990-04-19,LAL,113,61,18,MIN,89,22,57,83,75
1990-04-19,SAC,118,23,57,SEA,130,39,40,62,97
1990-04-19,DET,97,57,22,PHL,107,52,28,109,50
1990-04-19,HOU,127,40,39,DEN,130,41,38,81,77
1990-04-19,CHH,102,19,61,DAL,111,44,35,63,96
1990-04-19,CHI,120,54,25,WAS,117,31,48,85,73
1990-04-20,NYK,112,45,35,ATL,126,39,41,84,76
1990-04-20,PHX,123,53,27,GOS,106,36,44,89,71
1990-04-20,DAL,121,45,35,HOU,120,40,40,85,75
1990-04-20,IND,115,41,39,DET,121,57,23,98,62
1990-04-20,UTH,97,54,26,MIN,89,22,58,76,84
1990-04-20,DEN,108,42,38,SAN,112,54,26,96,64
1990-04-20,MIA,117,17,63,WAS,112,31,49,48,112
1990-04-20,ORL,104,17,63,CLE,118,40,40,57,103
1990-04-20,SEA,121,40,40,LAC,99,30,50,70,90
1990-04-20,BOS,120,50,30,CHI,116,55,25,105,55
1990-04-21,SAC,110,23,58,POR,118,57,23,80,81
1990-04-21,LAC,115,30,51,LAL,125,62,18,92,69
1990-04-21,MIL,96,43,38,NJN,95,17,63,60,101
1990-04-21,ATL,130,40,41,MIA,109,18,63,58,104
1990-04-22,PHL,98,53,28,BOS,118,51,30,104,58
1990-04-22,NJN,102,17,64,ORL,110,17,64,34,128
1990-04-22,POR,130,58,23,LAL,88,63,18,121,41
1990-04-22,DET,111,58,23,CHI,106,55,26,113,49
1990-04-22,SAN,108,55,26,PHX,93,54,27,109,53
1990-04-22,GOS,124,36,45,SEA,122,41,40,77,85
1990-04-22,DEN,115,42,39,MIN,108,22,59,64,98
1990-04-22,DAL,118,46,35,CHH,107,19,62,65,97
1990-04-22,WAS,117,31,50,IND,127,41,40,72,90
1990-04-22,CLE,115,41,40,NYK,99,45,36,86,76
1990-04-22,HOU,100,40,41,UTH,88,55,26,95,67
1990-11-02,POR,90,0,0,HOU,89,0,0,0,0
1990-11-02,DEN,158,0,0,GOS,162,0,0,0,0
1990-11-02,CHH,130,0,0,NYK,134,0,0,0,0
1990-11-02,IND,100,0,0,NJN,81,0,0,0,0
1990-11-02,DET,115,0,0,MIL,104,0,0,0,0
1990-11-02,MIA,119,0,0,WAS,95,0,0,0,0
1990-11-02,MIN,98,0,0,DAL,85,0,0,0,0
1990-11-02,LAC,90,0,0,SAC,80,0,0,0,0
1990-11-02,CHI,116,0,0,PHL,124,0,0,0,0
1990-11-02,ATL,115,0,0,ORL,111,0,0,0,0
1990-11-02,UTH,96,0,0,PHX,119,0,0,0,0
1990-11-02,BOS,125,0,0,CLE,101,0,0,0,0
1990-11-03,DET,106,1,0,CLE,97,0,1,1,1
1990-11-03,PHL,112,1,0,NJN,110,0,1,1,1
1990-11-03,WAS,103,0,1,CHI,102,0,1,0,2
1990-11-03,ORL,97,0,1,CHH,104,0,1,0,2
1990-11-03,SAN,110,0,0,LAL,99,0,0,0,0
1990-11-03,DAL,140,0,1,DEN,110,0,1,0,2
1990-11-03,PHX,101,1,0,UTH,102,0,1,1,1
1990-11-03,NYK,103,1,0,BOS,106,1,0,2,0
1990-11-03,SAC,93,0,1,POR,95,1,0,1,1
1990-11-03,SEA,118,0,0,HOU,106,0,1,0,1
1990-11-03,MIL,111,0,1,MIN,93,1,0,1,1
1990-11-03,ATL,121,1,0,IND,120,1,0,2,0
1990-11-04,LAC,109,1,0,GOS,107,1,0,2,0
1990-11-06,IND,98,1,1,MIN,96,1,1,2,2
1990-11-06,SAC,85,0,2,ATL,102,2,0,2,2
1990-11-06,SEA,100,1,0,DET,92,2,0,3,0
1990-11-06,ORL,95,0,2,CLE,102,0,2,0,4
1990-11-06,HOU,145,0,2,DEN,135,0,2,0,4
1990-11-06,CHH,113,1,1,NJN,105,0,2,1,3
1990-11-06,NYK,91,1,1,DAL,96,1,1,2,2
1990-11-06,MIA,94,1,0,MIL,106,1,1,2,1
1990-11-06,GOS,130,1,1,LAC,109,2,0,3,1
1990-11-06,LAL,123,0,1,POR,125,2,0,2,1
1990-11-06,CHI,108,0,2,BOS,110,2,0,2,2
1990-11-07,PHX,126,1,1,GOS,119,2,1,3,2
1990-11-07,PHL,101,2,0,DAL,104,2,1,4,1
1990-11-07,MIN,91,1,2,CHI,96,0,3,1,5
1990-11-07,LAC,83,2,1,DET,110,2,1,4,2
1990-11-07,CLE,100,1,2,CHH,89,2,1,3,3
1990-11-07,SAN,161,1,0,DEN,153,0,3,1,3
1990-11-08,UTH,103,1,1,SAN,94,2,0,3,1
1990-11-08,HOU,103,1,2,ORL,99,0,3,1,5
1990-11-08,NJN,114,0,3,MIA,103,1,1,1,4
1990-11-08,MIL,141,2,1,PHL,111,2,1,4,2
1990-11-08,NYK,114,1,2,WAS,103,1,1,2,3
1990-11-09,GOS,143,2,2,ATL,128,3,0,5,2
1990-11-09,IND,122,2,1,CLE,107,2,2,4,3
1990-11-09,POR,113,3,0,DET,101,3,1,6,1
1990-11-09,WAS,100,1,2,MIL,108,3,1,4,3
1990-11-09,DEN,129,0,4,SEA,135,2,0,2,4
1990-11-09,BOS,100,3,0,CHI,120,1,3,4,3
1990-11-09,DAL,111,3,1,ORL,99,0,4,3,5
1990-11-09,MIN,106,1,3,CHH,77,2,2,3,5
1990-11-09,LAL,100,0,2,SAC,86,0,3,0,5
1990-11-10,SAN,111,2,1,HOU,110,2,2,4,3
1990-11-10,SAC,88,0,4,NYK,93,2,2,2,6
1990-11-10,NJN,91,1,3,BOS,105,3,1,4,4
1990-11-10,CLE,104,2,3,PHL,88,2,2,4,5
1990-11-10,LAC,94,2,2,ATL,112,3,1,5,3
1990-11-10,SEA,100,3,0,GOS,117,3,2,6,2
1990-11-10,MIA,120,1,2,IND,105,3,1,4,3
1990-11-10,CHI,105,2,3,CHH,86,2,3,4,6
1990-11-10,PHX,173,2,1,DEN,143,0,5,2,6
1990-11-11,MIN,108,2,3,ORL,81,0,5,2,8
1990-11-11,HOU,110,2,3,UTH,90,2,1,4,4
1990-11-11,LAL,103,1,2,NYK,109,3,2,4,4
1990-11-11,POR,138,4,0,LAC,107,2,3,6,3
1990-11-12,NJN,92,1,4,WAS,97,1,3,2,7
1990-11-13,HOU,90,3,3,MIN,88,3,3,6,6
1990-11-13,IND,100,3,2,PHL,108,2,3,5,5
1990-11-13,ORL,109,0,6,DAL,103,4,1,4,7
1990-11-13,DET,118,3,2,MIA,93,2,2,5,4
1990-11-13,CHH,120,2,4,WAS,105,2,3,4,7
1990-11-13,MIL,119,4,1,BOS,91,4,1,8,2
1990-11-13,POR,155,5,0,DEN,129,0,6,5,6
1990-11-13,GOS,128,4,2,SAN,124,3,1,7,3
1990-11-13,LAL,111,1,3,PHX,112,3,1,4,4
1990-11-13,SEA,110,3,1,NYK,116,4,2,7,3
1990-11-13,ATL,104,4,1,CLE,121,3,3,7,4
1990-11-13,UTH,82,2,2,CHI,84,3,3,5,5
1990-11-14,LAC,108,2,4,PHX,102,4,1,6,5
1990-11-14,NJN,112,1,5,MIL,95,5,1,6,6
1990-11-14,PHL,112,3,3,ATL,104,4,2,7,5
1990-11-14,BOS,135,4,2,CHH,126,3,4,7,6
1990-11-14,CLE,113,4,3,IND,95,3,3,7,6
1990-11-14,MIA,105,2,3,DAL,93,4,2,6,5
1990-11-15,GOS,103,5,2,CHI,93,4,3,9,5
1990-11-15,SAC,93,0,5,SAN,122,3,2,3,7
1990-11-15,DEN,121,0,7,MIN,108,3,4,3,11
1990-11-15,POR,141,6,0,NYK,125,5,2,11,2
1990-11-15,HOU,103,4,3,LAL,108,1,4,5,7
1990-11-15,ORL,102,1,6,UTH,99,2,3,3,9
1990-11-16,ATL,109,4,3,CHH,119,3,5,7,8
1990-11-16,NJN,96,2,5,DET,105,4,2,6,7
1990-11-16,PHL,115,4,3,WAS,102,2,4,6,7
1990-11-16,IND,106,3,4,MIA,80,3,3,6,7
1990-11-16,BOS,114,5,2,UTH,89,2,4,7,6
1990-11-16,DAL,99,4,3,LAL,86,2,4,6,7
1990-11-16,PHX,121,4,2,LAC,110,3,4,7,6
1990-11-16,CLE,99,5,3,MIL,94,5,2,10,5
1990-11-17,ORL,96,2,6,IND,89,4,4,6,10
1990-11-17,MIL,111,5,3,NJN,99,2,6,7,9
1990-11-17,NYK,106,5,3,PHL,79,5,3,10,6
1990-11-17,WAS,90,2,5,BOS,102,6,2,8,7
1990-11-17,HOU,117,4,4,MIA,100,3,4,7,8
1990-11-17,SAN,128,4,2,PHX,114,5,2,9,4
1990-11-17,GOS,112,6,2,SAC,111,0,6,6,8
1990-11-17,DEN,112,1,7,POR,143,7,0,8,7
1990-11-17,SEA,95,3,2,CHI,116,4,4,7,6
1990-11-17,CHH,112,4,5,CLE,100,6,3,10,8
1990-11-17,DET,91,5,2,ATL,83,4,4,9,6
1990-11-18,LAC,78,3,5,SEA,65,3,3,6,8
1990-11-18,LAL,115,2,5,GOS,93,7,2,9,7
1990-11-18,MIN,94,3,5,UTH,103,2,5,5,10
1990-11-18,POR,125,8,0,CHI,112,5,4,13,4
1990-11-19,MIL,114,6,3,UTH,104,3,5,9,8
1990-11-19,PHL,109,5,4,CHH,101,5,5,10,9
1990-11-19,DEN,105,1,8,LAL,122,3,5,4,13
1990-11-20,DAL,91,5,3,MIN,92,3,6,8,9
1990-11-20,GOS,123,7,3,ORL,120,3,6,10,9
1990-11-20,WAS,82,2,6,SAC,87,0,7,2,13
1990-11-20,CHH,128,5,6,ATL,121,4,5,9,11
1990-11-20,MIA,90,3,5,DET,106,6,2,9,7
1990-11-20,SEA,105,3,4,NJN,88,2,7,5,11
1990-11-20,NYK,88,6,3,HOU,115,5,4,11,7
1990-11-21,LAL,141,4,5,DEN,121,1,9,5,14
1990-11-21,UTH,106,3,6,ORL,91,3,7,6,13
1990-11-21,BOS,108,7,2,HOU,95,6,4,13,6
1990-11-21,IND,100,4,5,DET,108,7,2,11,7
1990-11-21,PHL,101,6,4,SAC,99,1,7,7,11
1990-11-21,SAN,114,5,2,MIN,100,4,6,9,8
1990-11-21,LAC,99,4,5,NJN,90,2,8,6,13
1990-11-21,PHX,109,5,3,CHI,107,5,5,10,8
1990-11-21,CLE,123,6,4,MIA,109,3,6,9,10
1990-11-21,MIL,105,7,3,ATL,93,4,6,11,9
1990-11-23,DAL,104,5,4,SAN,107,6,2,11,6
1990-11-23,DET,97,8,2,WAS,88,2,7,10,9
1990-11-23,UTH,97,4,6,SEA,96,4,4,8,10
1990-11-23,PHX,114,6,3,NJN,116,2,9,8,12
1990-11-23,IND,112,4,6,HOU,111,6,5,10,11
1990-11-23,LAC,97,5,5,CHI,105,5,6,10,11
1990-11-23,BOS,115,8,2,SAC,105,1,8,9,10
1990-11-23,PHL,111,7,4,CLE,105,7,4,14,8
1990-11-23,CHH,100,6,6,MIA,116,3,7,9,13
1990-11-23,POR,143,9,0,GOS,119,8,3,17,3
1990-11-24,WAS,107,2,8,IND,105,5,6,7,14
1990-11-24,GOS,113,8,4,NJN,117,3,9,11,13
1990-11-24,LAL,115,5,5,ORL,89,3,8,8,13
1990-11-24,NYK,97,6,4,MIL,107,8,3,14,7
1990-11-24,MIA,112,4,7,CHH,125,6,7,10,14
1990-11-24,ATL,121,4,7,PHL,124,8,4,12,11
1990-11-24,DEN,145,1,10,CHI,151,6,6,7,16
1990-11-24,CLE,102,7,5,BOS,113,9,2,16,7
1990-11-24,DAL,74,5,5,UTH,85,5,6,10,11
1990-11-25,POR,117,10,0,SAN,103,7,2,17,2
1990-11-25,MIN,91,4,7,HOU,107,6,6,10,13
1990-11-25,LAC,119,5,6,ORL,91,3,9,8,15
1990-11-25,DET,105,9,2,SAC,92,1,9,10,11
1990-11-26,BOS,118,10,2,MIA,101,4,8,14,10
1990-11-27,SEA,111,4,5,SAN,124,7,3,11,8
1990-11-27,NJN,98,4,9,PHL,92,9,4,13,13
1990-11-27,ATL,97,4,8,DET,120,10,2,14,10
1990-11-27,HOU,107,7,6,LAC,102,6,6,13,12
1990-11-27,NYK,102,6,5,CLE,107,7,6,13,11
1990-11-27,DEN,124,1,11,ORL,113,3,10,4,21
1990-11-27,MIL,112,9,3,IND,98,5,7,14,10
1990-11-27,POR,109,11,0,PHX,123,6,4,17,4
1990-11-27,WAS,115,3,8,GOS,113,8,5,11,13
1990-11-27,SAC,80,1,10,MIN,89,4,8,5,18
1990-11-28,PHL,116,9,5,IND,106,5,8,14,13
1990-11-28,DAL,107,5,6,LAC,88,6,7,11,13
1990-11-28,DET,90,11,2,NYK,83,6,6,17,8
1990-11-28,MIA,97,4,9,NJN,79,5,9,9,18
1990-11-28,CLE,108,8,6,GOS,110,8,6,16,12
1990-11-28,CHI,118,7,6,WAS,94,4,8,11,14
1990-11-28,LAL,97,6,5,SAN,80,8,3,14,8
1990-11-28,CHH,118,7,7,MIL,111,10,3,17,10
1990-11-28,UTH,103,6,6,HOU,92,8,6,14,12
1990-11-29,PHX,128,7,4,SEA,110,4,6,11,10
1990-11-29,DEN,136,2,11,SAC,128,1,11,3,22
1990-11-29,POR,107,11,1,MIN,92,5,8,16,9
1990-11-30,DET,96,12,2,PHL,94,10,5,22,7
1990-11-30,ORL,113,3,11,GOS,119,9,6,12,17
1990-11-30,ATL,93,4,10,CLE,101,8,7,12,17
1990-11-30,UTH,96,7,6,MIN,79,5,9,12,15
1990-11-30,BOS,123,12,2,WAS,95,4,9,16,11
1990-11-30,CHI,124,8,6,IND,95,5,9,13,15
1990-11-30,MIL,103,10,4,NYK,97,6,7,16,11
1990-12-01,PHX,98,8,4,LAL,108,7,5,15,9
1990-12-01,SAN,109,8,4,DAL,97,6,6,14,10
1990-12-01,PHL,116,10,6,BOS,110,13,2,23,8
1990-12-01,DEN,121,3,11,LAC,137,6,8,9,19
1990-12-01,CLE,85,9,7,CHI,120,9,6,18,13
1990-12-01,WAS,94,4,10,DET,83,13,2,17,12
1990-12-01,NJN,111,5,10,ORL,92,3,12,8,22
1990-12-01,NYK,113,6,8,CHH,96,8,7,14,15
1990-12-01,HOU,117,8,7,SAC,93,1,12,9,19
1990-12-01,SEA,124,4,7,POR,130,12,1,16,8
1990-12-01,MIA,111,5,9,GOS,137,10,6,15,15
1990-12-02,POR,101,13,1,UTH,97,8,6,21,7
1990-12-02,IND,107,5,10,MIL,103,11,4,16,14
1990-12-02,LAC,102,7,8,MIN,77,5,10,12,18
1990-12-03,UTH,135,8,7,WAS,101,5,10,13,17
1990-12-03,BOS,135,13,3,SEA,102,4,8,17,11
1990-12-04,LAL,114,8,5,DET,90,13,3,21,8
1990-12-04,PHL,109,11,6,MIL,108,11,5,22,11
1990-12-04,CLE,121,9,8,DEN,117,3,12,12,20
1990-12-04,MIN,83,5,11,IND,81,6,10,11,21
1990-12-04,NJN,106,6,10,SEA,102,4,9,10,19
1990-12-04,CHI,155,10,6,PHX,127,8,5,18,11
1990-12-04,NYK,102,7,8,ORL,113,3,13,10,21
1990-12-04,HOU,110,9,7,ATL,113,4,11,13,18
1990-12-04,MIA,95,5,10,POR,98,14,1,19,11
1990-12-04,SAC,103,1,13,DAL,83,6,7,7,20
1990-12-05,SAN,108,9,4,ATL,110,5,11,14,15
1990-12-05,MIL,113,11,6,CLE,109,10,8,21,14
1990-12-05,LAC,93,8,8,DAL,89,6,8,14,16
1990-12-05,UTH,106,9,7,DET,85,13,4,22,11
1990-12-05,IND,126,6,11,PHX,121,8,6,14,17
1990-12-05,BOS,148,14,3,DEN,140,3,13,17,16
1990-12-05,GOS,98,11,6,WAS,104,5,11,16,17
1990-12-05,ORL,110,4,13,POR,119,15,1,19,14
1990-12-06,MIN,73,6,11,LAL,83,9,5,15,16
1990-12-06,SAC,104,2,13,WAS,86,6,11,8,24
1990-12-06,MIA,103,5,11,SEA,105,4,10,9,21
1990-12-06,HOU,116,9,8,CHH,110,8,8,17,16
1990-12-07,ATL,103,6,11,MIL,104,12,6,18,17
1990-12-07,PHL,135,12,6,DEN,126,3,14,15,20
1990-12-07,GOS,113,11,7,DET,110,13,5,24,12
1990-12-07,NJN,110,7,10,PHX,129,8,7,15,17
1990-12-07,DAL,104,6,9,BOS,112,15,3,21,12
1990-12-07,CHI,108,11,6,NYK,98,7,9,18,15
1990-12-07,IND,105,7,11,POR,127,16,1,23,12
1990-12-07,ORL,106,4,14,SEA,100,5,10,9,24
1990-12-07,UTH,101,10,7,LAL,79,10,5,20,12
1990-12-08,LAC,95,9,8,UTH,105,11,7,20,15
1990-12-08,IND,114,7,12,CLE,99,10,9,17,21
1990-12-08,ATL,99,6,12,NYK,86,7,10,13,22
1990-12-08,SAN,102,9,5,BOS,96,16,3,25,8
1990-12-08,CHH,119,8,9,DEN,126,3,15,11,24
1990-12-08,DAL,107,6,10,HOU,113,10,8,16,18
1990-12-08,SAC,93,3,13,DET,104,13,6,16,19
1990-12-08,ORL,109,5,14,PHX,113,9,7,14,21
1990-12-08,CHI,101,12,6,POR,109,17,1,29,7
1990-12-09,LAL,106,10,6,WAS,99,6,12,16,18
1990-12-09,MIL,105,13,6,SEA,99,5,11,18,17
1990-12-10,HOU,95,11,8,BOS,107,16,4,27,12
1990-12-10,NJN,121,7,11,CHH,115,8,10,15,21
1990-12-11,ORL,114,5,15,PHL,119,13,6,18,21
1990-12-11,MIL,99,14,6,CHI,87,12,7,26,13
1990-12-11,DET,86,14,6,SAN,95,10,5,24,11
1990-12-11,MIN,101,6,12,LAC,95,9,9,15,21
1990-12-11,UTH,135,12,7,GOS,117,12,7,24,14
1990-12-11,PHX,113,10,7,SAC,90,3,14,13,21
1990-12-11,DEN,128,4,15,WAS,125,6,13,10,28
1990-12-11,POR,122,18,1,IND,96,8,12,26,13
1990-12-11,NYK,109,7,11,MIA,90,5,12,12,23
1990-12-12,CLE,90,10,10,LAC,100,9,10,19,20
1990-12-12,MIA,93,5,13,ATL,118,7,12,12,25
1990-12-12,CHH,81,8,11,SAN,92,11,5,19,16
1990-12-12,SEA,99,5,12,IND,90,8,13,13,25
1990-12-12,PHL,100,14,6,HOU,108,11,9,25,15
1990-12-12,LAL,97,11,6,DAL,112,6,11,17,17
1990-12-12,BOS,129,17,4,MIL,111,15,6,32,10
1990-12-13,SAC,100,3,15,POR,88,19,1,22,16
1990-12-13,GOS,129,12,8,SEA,106,6,12,18,20
1990-12-13,ATL,106,8,12,NJN,97,8,11,16,23
1990-12-13,UTH,141,13,7,DEN,126,5,15,18,22
1990-12-13,MIN,76,7,12,NYK,87,8,11,15,23
1990-12-13,PHX,125,11,7,ORL,114,5,16,16,23
1990-12-14,BOS,108,18,4,DET,100,14,7,32,11
1990-12-14,CLE,106,10,11,SAN,116,12,5,22,16
1990-12-14,WAS,106,6,14,HOU,93,12,9,18,23
1990-12-14,PHL,95,14,7,MIA,92,5,14,19,21
1990-12-14,POR,106,19,2,DAL,104,7,11,26,13
1990-12-14,CHI,128,12,8,LAC,88,10,10,22,18
1990-12-15,CHH,97,8,12,HOU,100,12,10,20,22
1990-12-15,SAC,117,4,15,ORL,108,5,17,9,32
1990-12-15,MIA,100,5,15,BOS,114,19,4,24,19
1990-12-15,NJN,104,8,12,NYK,125,9,11,17,23
1990-12-15,SEA,106,6,13,DAL,105,7,12,13,25
1990-12-15,GOS,109,13,8,LAL,111,11,7,24,15
1990-12-15,MIL,98,15,7,LAC,92,10,11,25,18
1990-12-15,ATL,125,9,12,WAS,113,7,14,16,26
1990-12-15,MIN,74,7,13,SAN,90,13,5,20,18
1990-12-15,DEN,134,5,16,PHX,142,12,7,17,23
1990-12-15,UTH,116,14,7,IND,124,8,14,22,21
1990-12-15,CHI,116,13,8,CLE,98,10,12,23,20
1990-12-16,LAL,115,12,7,IND,112,9,14,21,21
1990-12-16,POR,126,20,2,ORL,107,5,18,25,20
1990-12-17,CLE,98,10,13,ATL,109,10,12,20,25
1990-12-17,NJN,98,8,13,UTH,100,14,8,22,21
1990-12-18,SAC,108,5,15,MIN,99,7,14,12,29
1990-12-18,CHI,112,14,8,MIA,103,5,16,19,24
1990-12-18,DAL,95,7,13,PHX,114,13,7,20,20
1990-12-18,MIL,106,16,7,DET,101,14,8,30,15
1990-12-18,NYK,97,10,11,LAL,100,13,7,23,18
1990-12-18,POR,122,21,2,GOS,94,13,9,34,11
1990-12-18,SEA,122,7,13,ORL,105,5,19,12,32
1990-12-18,HOU,95,13,10,SAN,96,14,5,27,15
1990-12-18,PHL,110,15,7,LAC,99,10,12,25,19
1990-12-18,CHH,100,8,13,UTH,105,15,8,23,21
1990-12-19,SAN,144,15,5,DEN,109,5,17,20,22
1990-12-19,BOS,115,20,4,PHL,105,16,7,36,11
1990-12-19,IND,112,9,15,WAS,114,7,15,16,30
1990-12-19,CLE,84,10,14,LAL,74,14,7,24,21
1990-12-19,PHX,112,14,7,MIN,96,7,15,21,22
1990-12-19,NJN,118,8,14,LAC,105,10,13,18,27
1990-12-19,DET,105,14,9,CHI,84,15,8,29,17
1990-12-19,MIA,94,5,17,NYK,104,10,12,15,29
1990-12-20,HOU,128,13,11,ORL,126,5,20,18,31
1990-12-20,CHH,96,8,14,BOS,115,21,4,29,18
1990-12-20,ATL,105,11,12,UTH,87,16,8,27,20
1990-12-20,SAC,75,6,15,SEA,110,8,13,14,28
1990-12-20,GOS,125,13,10,POR,118,22,2,35,12
1990-12-21,DET,113,15,9,ATL,87,12,12,27,21
1990-12-21,MIA,102,5,18,PHL,126,16,8,21,26
1990-12-21,PHX,128,15,7,SAN,132,16,5,31,12
1990-12-21,IND,137,9,16,CHH,114,8,15,17,31
1990-12-21,DAL,103,7,14,MIL,89,17,7,24,21
1990-12-21,CHI,114,15,9,LAL,103,14,8,29,17
1990-12-21,WAS,87,8,15,NYK,85,11,12,19,27
1990-12-21,LAC,107,10,14,POR,117,22,3,32,17
1990-12-21,NJN,111,9,14,CLE,103,11,14,20,28
1990-12-22,GOS,115,14,10,MIN,102,7,16,21,26
1990-12-22,HOU,122,14,11,PHX,102,15,8,29,19
1990-12-22,DEN,110,5,18,DAL,119,8,14,13,32
1990-12-22,CHI,128,16,9,IND,118,10,16,26,25
1990-12-22,SEA,121,9,13,SAC,93,6,16,15,29
1990-12-22,PHL,106,17,8,DET,99,16,9,33,17
1990-12-22,NYK,106,11,13,NJN,93,10,14,21,27
1990-12-22,SAN,98,17,5,MIL,114,17,8,34,13
1990-12-22,CLE,89,11,15,WAS,109,9,15,20,30
1990-12-22,ORL,96,5,21,UTH,104,16,9,21,30
1990-12-23,BOS,132,11,2,ATL,104,4,9,15,11
1990-12-23,POR,132,23,3,DEN,101,5,19,28,22
1990-12-23,LAC,109,10,15,SAC,99,6,17,16,32
1990-12-23,LAL,118,14,9,MIN,94,7,17,21,26
1990-12-23,MIA,99,5,19,UTH,93,17,9,22,28
1990-12-25,CHI,98,17,9,DET,86,16,10,33,19
1990-12-26,BOS,152,22,4,IND,132,10,17,32,21
1990-12-26,SAC,112,6,18,DEN,128,5,20,11,38
1990-12-26,NYK,92,12,13,POR,108,24,3,36,16
1990-12-26,PHX,115,15,9,DAL,88,9,14,24,23
1990-12-26,NJN,111,10,15,ATL,113,12,13,22,28
1990-12-26,CLE,97,11,16,SEA,99,10,13,21,29
1990-12-26,LAC,99,11,15,LAL,108,15,9,26,24
1990-12-26,WAS,105,10,15,PHL,106,18,8,28,23
1990-12-26,ORL,109,5,22,HOU,103,15,11,20,33
1990-12-26,SAN,111,17,6,MIA,97,6,19,23,25
1990-12-26,MIL,126,18,8,GOS,119,15,10,33,18
1990-12-26,DET,102,16,11,CHH,94,8,16,24,27
1990-12-27,WAS,120,10,16,SEA,125,11,13,21,29
1990-12-27,CHI,128,18,9,GOS,113,15,11,33,20
1990-12-27,DEN,114,6,20,MIA,124,6,20,12,40
1990-12-27,UTH,110,17,10,DAL,102,9,15,26,25
1990-12-27,CHH,96,8,17,POR,105,25,3,33,20
1990-12-28,MIN,85,7,18,DET,97,17,11,24,29
1990-12-28,ATL,131,13,13,BOS,114,23,4,36,17
1990-12-28,PHX,115,16,9,PHL,96,19,8,35,17
1990-12-28,NJN,99,10,16,HOU,101,15,12,25,28
1990-12-28,SAN,104,18,6,SAC,88,6,19,24,25
1990-12-29,CLE,114,11,17,POR,120,26,3,37,20
1990-12-29,IND,114,10,18,NJN,105,10,17,20,35
1990-12-29,DET,99,18,11,HOU,84,16,12,34,23
1990-12-29,CHH,109,8,18,ORL,100,6,22,14,40
1990-12-29,WAS,161,10,17,DEN,133,6,21,16,38
1990-12-29,DAL,90,9,16,SAC,79,6,20,15,36
1990-12-29,UTH,131,18,10,LAC,102,11,16,29,26
1990-12-29,NYK,100,12,14,MIL,109,19,8,31,22
1990-12-29,ATL,134,14,13,GOS,130,15,12,29,25
1990-12-29,PHX,134,17,9,MIA,95,7,20,24,29
1990-12-29,CHI,116,19,9,SEA,91,12,13,31,22
1990-12-30,MIL,117,20,8,POR,112,27,3,47,11
1990-12-30,MIN,126,7,19,SEA,106,12,14,19,33
1990-12-30,ORL,155,6,23,DEN,116,6,22,12,45
1990-12-30,LAC,97,11,17,MIA,112,7,21,18,38
1990-12-30,LAL,115,16,9,PHL,107,19,9,35,18
1991-01-02,MIN,115,8,19,DAL,95,10,16,18,35
1991-01-02,IND,121,11,18,SAN,109,19,6,30,24
1991-01-02,CLE,83,11,18,PHX,105,18,9,29,27
1991-01-02,CHH,91,9,18,MIL,106,21,8,30,26
1991-01-02,DET,118,19,11,DEN,107,6,23,25,34
1991-01-02,SEA,127,12,15,PHL,99,19,10,31,25
1991-01-02,ATL,120,15,13,LAC,107,11,18,26,31
1991-01-02,UTH,112,19,10,MIA,104,8,21,27,31
1991-01-02,BOS,113,23,5,NYK,86,12,15,35,20
1991-01-03,ORL,110,7,23,LAC,108,11,19,18,42
1991-01-03,SAC,131,6,21,GOS,113,15,13,21,34
1991-01-03,MIL,97,22,8,DAL,87,10,17,32,25
1991-01-03,NYK,135,12,16,DEN,108,6,24,18,40
1991-01-03,HOU,114,16,13,CHI,92,20,9,36,22
1991-01-03,POR,104,27,4,LAL,108,17,9,44,13
1991-01-03,WAS,118,11,17,CHH,108,9,19,20,36
1991-01-04,GOS,115,15,14,LAL,99,18,9,33,23
1991-01-04,SEA,112,13,15,MIA,86,8,22,21,37
1991-01-04,BOS,132,24,5,PHX,103,19,9,43,14
1991-01-04,ATL,111,16,13,IND,96,12,18,28,31
1991-01-04,MIN,100,9,19,WAS,111,12,17,21,36
1991-01-04,CLE,94,11,19,DET,98,20,11,31,30
1991-01-04,NJN,89,10,18,SAN,93,19,7,29,25
1991-01-04,UTH,102,20,10,PHL,99,19,11,39,21
1991-01-05,ORL,90,8,23,SAN,107,20,7,28,30
1991-01-05,SAC,98,7,21,UTH,106,21,10,28,31
1991-01-05,CHH,111,9,20,LAC,103,11,20,20,40
1991-01-05,HOU,112,17,13,IND,99,12,19,29,32
1991-01-05,DEN,104,6,25,PHL,120,19,12,25,37
1991-01-05,MIL,88,23,8,PHX,86,19,10,42,18
1991-01-05,ATL,117,17,13,MIN,112,9,20,26,33
1991-01-05,POR,132,27,5,MIA,108,8,23,35,28
1991-01-05,CHI,108,20,10,CLE,92,11,20,31,30
1991-01-05,DET,99,21,11,NJN,83,10,19,31,30
1991-01-06,BOS,127,25,5,DAL,110,10,18,35,23
1991-01-06,POR,114,28,5,SEA,111,14,15,42,20
1991-01-06,LAL,135,18,10,GOS,108,16,14,34,24
1991-01-06,NYK,99,13,16,LAC,90,11,21,24,37
1991-01-07,ORL,111,8,24,SAC,83,7,22,15,46
1991-01-07,MIN,106,9,21,PHX,119,19,11,28,32
1991-01-07,PHL,102,20,12,SAN,111,21,7,41,19
1991-01-07,NJN,87,10,20,DAL,88,10,19,20,39
1991-01-08,NYK,87,14,16,BOS,101,26,5,40,21
1991-01-08,ATL,109,18,13,SAN,98,22,7,40,20
1991-01-08,MIA,95,8,24,SAC,83,7,23,15,47
1991-01-08,CHH,98,10,20,DET,101,22,11,32,31
1991-01-08,GOS,147,16,15,DEN,125,6,26,22,41
1991-01-08,MIL,99,24,8,WAS,96,13,17,37,25
1991-01-08,CHI,111,21,10,NJN,102,10,21,31,31
1991-01-08,UTH,110,22,10,CLE,88,11,21,33,31
1991-01-08,HOU,97,18,13,POR,123,29,5,47,18
1991-01-08,IND,107,12,20,LAC,122,11,22,23,42
1991-01-08,SEA,96,14,16,LAL,88,19,10,33,26
1991-01-09,DAL,109,11,19,POR,99,30,5,41,24
1991-01-09,LAL,108,19,11,UTH,85,23,10,42,21
1991-01-09,PHX,113,20,11,CLE,105,11,22,31,33
1991-01-09,ORL,103,9,24,MIN,111,9,22,18,46
1991-01-09,PHL,99,20,13,CHI,107,22,10,42,23
1991-01-09,BOS,110,27,5,MIL,102,25,8,52,13
1991-01-10,CHH,101,10,21,SAC,59,7,24,17,45
1991-01-10,DEN,133,6,27,HOU,156,18,14,24,41
1991-01-10,NYK,122,14,17,IND,129,12,21,26,38
1991-01-10,WAS,122,13,18,LAC,110,12,22,25,40
1991-01-10,SEA,103,15,16,GOS,113,17,15,32,31
1991-01-10,SAN,117,22,8,ORL,111,9,25,31,33
1991-01-11,PHX,114,21,11,HOU,110,19,14,40,25
1991-01-11,BOS,109,28,5,LAC,107,12,23,40,28
1991-01-11,MIL,105,25,9,PHL,120,20,14,45,23
1991-01-11,CHI,99,23,10,ATL,96,19,13,42,23
1991-01-11,MIA,107,9,24,MIN,108,10,22,19,46
1991-01-11,DAL,99,12,19,UTH,110,23,11,35,30
1991-01-11,LAL,105,20,11,CLE,93,11,23,31,34
1991-01-11,DET,100,23,11,POR,98,30,6,53,17
1991-01-12,GOS,118,18,15,PHX,127,22,11,40,26
1991-01-12,PHL,109,21,14,NJN,99,10,22,31,36
1991-01-12,DET,109,24,11,MIA,103,9,25,33,36
1991-01-12,SAN,112,23,8,UTH,92,24,11,47,19
1991-01-12,WAS,116,14,18,BOS,99,29,5,43,23
1991-01-12,DEN,128,6,28,CLE,120,11,24,17,52
1991-01-12,IND,118,13,21,MIL,110,25,10,38,31
1991-01-12,NYK,99,14,18,ATL,92,19,14,33,32
1991-01-12,DAL,103,12,20,ORL,127,9,26,21,46
1991-01-12,SAC,101,7,25,SEA,85,15,17,22,42
1991-01-12,CHH,95,11,21,CHI,106,24,10,35,31
1991-01-13,LAL,116,21,11,HOU,97,19,15,40,26
1991-01-13,NJN,103,10,23,POR,116,30,7,40,30
1991-01-14,DAL,81,12,21,DET,89,25,11,37,32
1991-01-14,ATL,96,19,15,NYK,82,15,18,34,33
1991-01-14,LAC,130,12,24,HOU,126,19,16,31,40
1991-01-14,CHI,110,25,10,MIL,97,25,11,50,21
1991-01-15,LAL,128,22,11,CHH,103,11,22,33,33
1991-01-15,IND,106,14,21,ATL,117,20,15,34,36
1991-01-15,NJN,111,10,24,GOS,112,18,16,28,40
1991-01-15,MIA,104,9,26,ORL,102,10,26,19,52
1991-01-15,MIN,117,11,22,POR,132,31,7,42,29
1991-01-15,SEA,146,15,18,DEN,99,7,28,22,46
1991-01-15,UTH,124,24,12,SAN,102,24,8,48,20
1991-01-15,PHX,127,23,11,WAS,97,15,18,38,29
1991-01-16,MIL,126,25,12,IND,119,14,22,39,34
1991-01-16,DEN,111,7,29,CHH,104,11,23,18,52
1991-01-16,NYK,89,15,19,MIN,93,11,23,26,42
1991-01-16,LAC,99,13,24,WAS,101,15,19,28,43
1991-01-16,CLE,108,11,25,MIA,94,10,26,21,51
1991-01-16,SAN,100,24,9,DAL,94,12,22,36,31
1991-01-16,ORL,88,10,27,CHI,99,26,10,36,37
1991-01-16,BOS,105,29,6,GOS,110,19,16,48,22
1991-01-17,HOU,91,19,17,DET,97,26,11,45,28
1991-01-17,SAC,78,8,25,LAL,93,23,11,31,36
1991-01-18,LAL,105,24,11,SEA,96,16,18,40,29
1991-01-18,PHX,103,24,11,DET,102,27,11,51,22
1991-01-18,POR,123,32,7,WAS,99,16,19,48,26
1991-01-18,DAL,112,12,23,LAC,119,13,25,25,48
1991-01-18,CLE,99,12,25,UTH,106,25,12,37,37
1991-01-18,SAN,110,25,9,CHH,117,11,24,36,33
1991-01-18,PHL,138,22,14,GOS,141,20,16,42,30
1991-01-18,MIL,125,26,12,ORL,106,10,28,36,40
1991-01-18,MIA,107,10,27,NYK,86,15,20,25,47
1991-01-18,BOS,106,29,7,NJN,111,10,25,39,32
1991-01-18,ATL,114,21,15,CHI,105,27,10,48,25
1991-01-19,PHL,97,22,15,NYK,112,15,21,37,36
1991-01-19,DEN,108,8,29,SAN,117,25,10,33,39
1991-01-19,SEA,111,16,19,WAS,89,16,20,32,39
1991-01-19,SAC,101,8,26,PHX,97,25,11,33,37
1991-01-19,ATL,114,22,15,NJN,84,11,25,33,40
1991-01-19,IND,117,14,23,UTH,104,26,12,40,35
1991-01-19,MIN,121,12,23,GOS,113,21,16,33,39
1991-01-19,HOU,107,19,18,LAC,96,14,25,33,43
1991-01-19,DAL,110,12,24,CHH,95,12,24,24,48
1991-01-20,POR,116,33,7,MIL,112,27,12,60,19
1991-01-21,MIA,106,11,27,CHI,117,27,11,38,38
1991-01-21,DEN,115,8,30,MIN,110,13,23,21,53
1991-01-21,IND,114,15,23,LAL,120,25,11,40,34
1991-01-21,DET,101,27,12,BOS,90,29,8,56,20
1991-01-21,NYK,117,16,21,PHL,116,22,16,38,37
1991-01-21,SAC,97,9,26,HOU,94,20,18,29,44
1991-01-21,WAS,121,16,21,ORL,119,10,29,26,50
1991-01-22,GOS,123,21,17,HOU,116,20,19,41,36
1991-01-22,SEA,132,17,19,MIL,101,27,13,44,32
1991-01-22,ORL,96,10,30,LAL,116,26,11,36,41
1991-01-22,POR,123,34,7,PHX,116,25,12,59,19
1991-01-22,SAN,106,26,10,LAC,100,14,26,40,36
1991-01-22,ATL,118,23,15,MIA,107,11,28,34,43
1991-01-22,CHH,90,12,25,NJN,92,11,26,23,51
1991-01-23,BOS,111,29,9,DET,94,28,12,57,21
1991-01-23,DAL,85,13,24,CLE,99,12,26,25,50
1991-01-23,NJN,99,12,26,CHI,95,28,11,40,37
1991-01-23,SAC,95,10,26,MIL,91,27,14,37,40
1991-01-23,UTH,94,26,13,NYK,109,17,21,43,34
1991-01-23,PHL,109,22,17,IND,110,15,24,37,41
1991-01-23,WAS,104,17,21,ATL,99,24,15,41,36
1991-01-24,HOU,118,20,20,MIN,94,13,24,33,44
1991-01-24,SAN,111,27,10,CLE,103,13,26,40,36
1991-01-24,DEN,120,9,30,NYK,117,18,21,27,51
1991-01-24,CHH,93,12,26,LAL,113,27,11,39,37
1991-01-25,DET,84,28,13,DAL,82,13,25,41,38
1991-01-25,NJN,103,13,26,LAL,108,28,11,41,37
1991-01-25,CHI,108,28,12,MIA,87,11,29,39,41
1991-01-25,UTH,105,26,14,SAC,93,11,26,37,40
1991-01-25,WAS,100,18,21,IND,106,16,24,34,45
1991-01-25,GOS,127,22,17,MIL,98,27,15,49,32
1991-01-25,PHX,128,25,13,SEA,113,18,19,43,32
1991-01-25,PHL,116,22,18,BOS,94,30,9,52,27
1991-01-26,SAN,112,28,10,MIN,105,13,25,41,35
1991-01-26,LAC,99,14,27,MIL,98,27,16,41,43
1991-01-26,ORL,81,10,31,DET,121,29,13,39,44
1991-01-26,CHH,79,12,27,PHL,75,23,18,35,45
1991-01-26,DEN,120,10,30,UTH,115,27,14,37,44
1991-01-26,SEA,103,18,20,ATL,102,24,16,42,36
1991-01-26,POR,121,35,7,SAC,96,11,27,46,34
1991-01-26,HOU,103,21,20,CLE,97,13,27,34,47
1991-01-26,PHX,112,26,13,NYK,94,18,22,44,35
1991-01-26,WAS,96,18,22,DAL,99,13,26,31,48
1991-01-26,MIA,105,11,30,NJN,127,13,27,24,57
1991-01-27,BOS,87,30,10,LAL,104,29,11,59,21
1991-01-28,DET,87,30,13,WAS,81,18,23,48,36
1991-01-28,POR,116,36,7,ATL,111,24,17,60,24
1991-01-28,MIN,87,13,26,BOS,108,30,11,43,37
1991-01-28,SAC,101,11,28,NJN,83,14,27,25,55
1991-01-28,GOS,115,23,17,NYK,106,18,23,41,40
1991-01-28,SAN,119,29,10,SEA,107,19,20,48,30
1991-01-29,CLE,125,13,28,CHH,106,13,27,26,55
1991-01-29,LAL,110,30,11,NJN,89,14,28,44,39
1991-01-29,UTH,116,27,15,ATL,105,24,18,51,33
1991-01-29,MIL,122,27,17,DEN,126,11,30,38,47
1991-01-29,HOU,91,22,20,SAN,89,30,10,52,30
1991-01-29,LAC,107,15,27,NYK,108,18,24,33,51
1991-01-29,WAS,105,18,24,MIA,101,11,31,29,55
1991-01-29,DAL,117,14,26,SEA,112,19,21,33,47
1991-01-29,ORL,114,10,32,PHX,112,27,13,37,45
1991-01-30,MIN,95,13,27,SAC,86,12,28,25,55
1991-01-30,IND,123,17,24,CHH,105,13,28,30,52
1991-01-30,MIA,104,11,32,PHX,115,27,14,38,46
1991-01-30,DET,93,31,13,CLE,84,14,28,45,41
1991-01-30,BOS,144,31,11,ORL,102,11,32,42,43
1991-01-31,HOU,94,23,20,SEA,97,19,22,42,42
1991-01-31,NYK,98,19,24,WAS,107,19,24,38,48
1991-01-31,UTH,105,28,15,POR,91,37,7,65,22
1991-01-31,LAL,116,31,11,ATL,103,24,19,55,30
1991-01-31,DEN,123,12,30,NJN,119,14,29,26,59
1991-01-31,GOS,135,24,17,LAC,119,15,28,39,45
1991-01-31,SAN,106,30,11,CHI,102,29,12,59,23
1991-02-01,MIA,116,11,33,IND,113,18,24,29,57
1991-02-01,MIL,117,27,18,SAC,112,12,29,39,47
1991-02-01,PHL,96,23,19,PHX,89,28,14,51,33
1991-02-01,WAS,75,20,24,DET,80,32,13,52,37
1991-02-01,LAC,92,15,29,LAL,106,32,11,47,40
1991-02-01,DAL,90,15,26,CHI,101,29,13,44,39
1991-02-01,POR,119,37,8,GOS,99,25,17,62,25
1991-02-01,CHH,92,13,29,BOS,91,32,11,45,40
1991-02-02,NYK,92,19,25,SAC,78,12,30,31,55
1991-02-02,SAN,94,31,11,HOU,100,23,21,54,32
1991-02-02,UTH,111,29,15,NJN,103,14,30,43,45
1991-02-02,CLE,113,14,29,MIN,110,14,27,28,56
1991-02-02,DEN,126,13,30,ATL,125,24,20,37,50
1991-02-02,IND,106,18,25,SEA,100,20,22,38,47
1991-02-02,ORL,108,11,33,MIA,98,12,33,23,66
1991-02-03,LAL,99,33,11,CHI,86,30,13,63,24
1991-02-03,DET,97,33,13,PHX,112,28,15,61,28
1991-02-03,HOU,143,24,21,GOS,135,25,18,49,39
1991-02-03,MIN,110,14,28,PHL,102,24,19,38,47
1991-02-03,BOS,119,32,12,WAS,101,20,25,52,37
1991-02-03,MIL,120,28,18,CHH,111,14,29,42,47
1991-02-04,CHH,93,14,30,SEA,100,20,23,34,53
1991-02-04,POR,117,38,8,NJN,102,14,31,52,39
1991-02-04,CLE,96,15,29,MIL,103,29,18,44,47
1991-02-04,SAC,97,12,31,CHI,108,30,14,42,45
1991-02-05,SAN,106,31,12,GOS,112,25,19,56,31
1991-02-05,DAL,114,15,27,IND,109,19,25,34,52
1991-02-05,ATL,118,24,21,CLE,114,15,30,39,51
1991-02-05,ORL,118,12,33,NYK,116,20,25,32,58
1991-02-05,MIN,94,15,28,UTH,93,30,15,45,43
1991-02-05,LAL,116,34,11,LAC,102,15,30,49,41
1991-02-05,DET,107,33,14,PHL,98,24,20,57,34
1991-02-05,PHX,126,29,15,DEN,103,14,30,43,45
1991-02-06,NJN,119,14,32,MIA,134,12,34,26,66
1991-02-06,PHL,108,24,21,WAS,100,20,26,44,47
1991-02-06,MIL,109,30,18,HOU,111,25,21,55,39
1991-02-06,BOS,133,33,12,CHH,117,14,31,47,43
1991-02-06,SAC,97,12,32,POR,93,39,8,51,40
1991-02-06,UTH,103,30,16,PHX,99,30,15,60,31
1991-02-06,SEA,107,21,23,LAC,104,15,31,36,54
1991-02-07,SAN,118,31,13,IND,108,19,26,50,39
1991-02-07,DAL,102,16,27,GOS,101,26,19,42,46
1991-02-07,WAS,124,20,27,NJN,117,14,33,34,60
1991-02-07,NYK,101,20,26,BOS,117,34,12,54,38
1991-02-07,CLE,92,15,31,HOU,96,26,21,41,52
1991-02-07,ORL,108,13,33,MIN,103,16,28,29,61
1991-02-07,DET,93,34,14,CHI,95,31,14,65,28
1991-02-07,ATL,127,25,21,CHH,114,14,32,39,53
1991-02-12,SAN,102,32,13,WAS,92,21,27,53,40
1991-02-12,ORL,129,14,33,DEN,122,14,31,28,64
1991-02-12,UTH,113,31,16,HOU,92,27,21,58,37
1991-02-12,POR,121,39,9,PHL,106,25,21,64,30
1991-02-12,MIA,78,13,34,CLE,94,15,32,28,66
1991-02-12,PHX,99,30,16,LAL,95,35,11,65,27
1991-02-12,SAC,103,13,32,LAC,101,15,32,28,64
1991-02-12,SEA,111,22,23,BOS,114,35,12,57,35
1991-02-12,CHI,122,32,14,ATL,113,26,21,58,35
1991-02-12,IND,110,19,27,NYK,114,20,27,39,54
1991-02-12,CHH,100,14,33,DAL,92,17,27,31,60
1991-02-12,GOS,126,26,20,MIN,105,16,29,42,49
1991-02-13,CLE,95,16,32,DAL,93,17,28,33,60
1991-02-13,LAL,120,35,12,MIN,106,16,30,51,42
1991-02-13,DET,101,34,15,IND,105,19,28,53,43
1991-02-13,NJN,140,14,34,ATL,106,26,22,40,56
1991-02-14,HOU,129,27,22,WAS,117,21,28,48,50
1991-02-14,SAN,97,33,13,PHX,106,31,16,64,29
1991-02-14,NYK,92,21,27,CHI,102,33,14,54,41
1991-02-14,MIA,141,13,35,DEN,112,14,32,27,67
1991-02-14,SAC,98,14,32,PHL,81,25,22,39,54
1991-02-14,MIL,94,30,19,DET,102,34,16,64,35
1991-02-14,GOS,112,27,20,BOS,128,36,12,63,32
1991-02-14,ORL,90,15,33,SEA,102,22,24,37,57
1991-02-15,POR,117,40,9,UTH,105,32,16,72,25
1991-02-15,CHH,103,15,33,MIL,106,30,20,45,53
1991-02-15,NJN,138,15,34,DEN,110,14,33,29,67
1991-02-15,LAL,85,36,12,BOS,98,37,12,73,24
1991-02-15,DAL,121,17,29,WAS,96,21,29,38,58
1991-02-15,CLE,90,17,32,NYK,85,21,28,38,60
1991-02-15,LAC,124,15,33,MIN,107,16,31,31,64
1991-02-16,HOU,100,28,22,PHX,91,32,16,60,38
1991-02-16,ATL,122,26,23,SEA,113,23,24,49,47
1991-02-16,DAL,96,18,29,SAN,94,33,14,51,43
1991-02-16,GOS,133,27,21,PHL,124,25,23,52,44
1991-02-16,UTH,115,32,17,MIN,107,16,32,48,49
1991-02-16,MIA,94,14,35,CHH,82,15,34,29,69
1991-02-16,CHI,99,34,14,NJN,87,16,34,50,48
1991-02-17,NYK,116,21,29,DET,88,35,16,56,45
1991-02-17,WAS,108,21,30,CLE,104,18,32,39,62
1991-02-17,IND,113,20,28,SAC,110,15,32,35,60
1991-02-17,DEN,108,14,34,BOS,126,38,12,52,46
1991-02-17,LAC,104,16,33,PHL,114,25,24,41,57
1991-02-17,ORL,103,15,34,MIL,111,31,20,46,54
1991-02-17,LAL,106,36,13,POR,96,41,9,77,22
1991-02-18,GOS,101,28,21,DAL,107,19,29,47,50
1991-02-18,DET,85,35,17,SEA,83,23,25,58,42
1991-02-18,UTH,104,33,17,SAN,81,33,15,66,32
1991-02-18,CLE,95,18,33,CHI,110,35,14,53,47
1991-02-18,MIN,128,16,33,DEN,114,14,35,30,68
1991-02-19,NYK,102,22,29,ATL,110,27,23,49,52
1991-02-19,PHL,107,26,24,SEA,104,23,26,49,50
1991-02-19,POR,107,41,10,DAL,100,20,29,61,39
1991-02-19,NJN,97,16,35,SAC,83,15,33,31,68
1991-02-19,CHH,102,15,35,IND,115,21,28,36,63
1991-02-19,HOU,103,29,22,LAL,112,37,13,66,35
1991-02-19,CHI,118,36,14,WAS,113,22,30,58,44
1991-02-19,PHX,109,32,17,BOS,105,39,12,71,29
1991-02-19,MIL,116,32,20,MIA,90,15,35,47,55
1991-02-20,DET,97,36,17,ATL,89,28,23,64,40
1991-02-20,CLE,118,18,34,SAC,104,15,34,33,68
1991-02-20,MIN,105,17,33,GOS,108,28,22,45,55
1991-02-20,IND,122,22,28,ORL,120,15,35,37,63
1991-02-20,LAC,93,16,34,PHX,113,33,17,49,51
1991-02-21,DEN,111,14,36,POR,122,42,10,56,46
1991-02-21,HOU,92,29,23,MIL,90,33,20,62,43
1991-02-21,DAL,92,20,30,LAL,106,38,13,58,43
1991-02-21,WAS,90,22,31,MIA,104,15,36,37,67
1991-02-21,NYK,101,22,30,SEA,120,23,27,45,57
1991-02-22,GOS,104,29,22,UTH,109,34,17,63,39
1991-02-22,CHH,122,15,36,DET,114,37,17,52,53
1991-02-22,CLE,98,19,34,IND,106,23,28,42,62
1991-02-22,BOS,111,39,13,NJN,99,17,35,56,48
1991-02-22,LAC,107,16,35,SAN,101,33,16,49,51
1991-02-22,POR,127,43,10,PHX,106,34,17,77,27
1991-02-22,ATL,111,28,24,LAL,102,39,13,67,37
1991-02-22,MIN,101,17,34,ORL,103,15,36,32,70
1991-02-22,MIA,96,16,36,PHL,103,27,24,43,60
1991-02-22,CHI,129,37,14,SAC,82,15,35,52,49
1991-02-23,WAS,101,22,32,NYK,104,22,31,44,63
1991-02-23,SEA,110,24,27,PHX,120,34,18,58,45
1991-02-23,DEN,150,14,37,GOS,145,29,23,43,60
1991-02-23,NJN,90,17,36,PHL,103,28,24,45,60
1991-02-23,MIL,118,33,21,CLE,103,19,35,52,56
1991-02-23,ATL,122,29,24,DAL,107,20,31,49,55
1991-02-23,CHI,129,38,14,CHH,108,16,36,54,50
1991-02-24,ORL,120,16,36,SAC,90,15,36,31,72
1991-02-24,SEA,103,24,28,UTH,91,35,17,59,45
1991-02-24,IND,115,24,28,BOS,109,40,13,64,41
1991-02-24,DET,96,37,18,LAL,102,39,14,76,32
1991-02-24,POR,88,44,10,SAN,95,33,17,77,27
1991-02-24,MIA,92,16,37,NYK,108,23,31,39,68
1991-02-24,MIN,91,17,35,HOU,100,30,23,47,58
1991-02-24,LAC,129,17,35,DEN,112,15,37,32,72
1991-02-25,PHX,128,35,18,CHH,108,16,37,51,55
1991-02-25,ATL,96,30,24,SAC,88,15,37,45,61
1991-02-25,PHL,92,29,24,LAL,90,40,14,69,38
1991-02-26,NYK,112,24,31,WAS,109,22,33,46,64
1991-02-26,SEA,93,25,28,LAC,81,18,35,43,63
1991-02-26,GOS,119,29,24,ORL,131,17,36,46,60
1991-02-26,CLE,106,19,36,DET,103,37,19,56,55
1991-02-26,MIN,100,17,36,DAL,94,20,32,37,68
1991-02-26,CHI,129,39,14,BOS,99,40,14,79,28
1991-02-26,MIA,106,16,38,MIL,119,34,21,50,59
1991-02-26,DEN,99,15,38,HOU,129,31,23,46,61
1991-02-26,SAN,102,34,17,POR,101,44,11,78,28
1991-02-26,NJN,129,17,37,IND,104,25,28,42,65
1991-02-27,UTH,118,35,18,GOS,103,29,25,64,43
1991-02-27,IND,104,25,29,DAL,108,20,33,45,62
1991-02-27,BOS,116,40,15,MIN,111,18,36,58,51
1991-02-27,PHX,116,36,18,ORL,124,18,36,54,54
1991-02-27,SAC,90,15,38,CHH,96,16,38,31,76
1991-02-27,PHL,107,30,24,ATL,103,31,24,61,48
1991-02-28,LAC,83,18,36,HOU,80,32,23,50,59
1991-02-28,NJN,98,18,37,MIL,93,35,21,53,58
1991-02-28,DEN,108,15,39,LAL,121,40,15,55,54
1991-02-28,ATL,117,31,25,POR,109,44,12,75,37
1991-02-28,NYK,100,25,31,SAN,93,35,17,60,48
1991-02-28,MIA,100,16,39,DET,98,37,20,53,59
1991-03-01,CHI,109,40,14,DAL,86,21,33,61,47
1991-03-01,PHL,121,31,24,POR,111,44,13,75,37
1991-03-01,DET,92,37,21,UTH,94,36,18,73,39
1991-03-01,SEA,122,26,28,CHH,105,17,38,43,66
1991-03-01,IND,118,25,30,CLE,115,20,36,45,66
1991-03-01,PHX,112,36,19,SAC,106,15,39,51,58
1991-03-01,BOS,108,41,15,SAN,98,35,18,76,33
1991-03-01,LAL,115,41,15,ORL,101,19,36,60,51
1991-03-01,MIL,106,35,22,WAS,105,22,34,57,56
1991-03-02,DAL,103,21,34,MIA,109,17,39,38,73
1991-03-02,MIN,102,18,37,LAC,104,19,36,37,73
1991-03-02,NJN,105,19,37,NYK,115,26,31,45,68
1991-03-02,SEA,120,27,28,SAC,106,15,40,42,68
1991-03-02,DEN,126,15,40,ORL,111,19,37,34,77
1991-03-02,GOS,121,29,26,CHH,108,17,39,46,65
1991-03-02,IND,135,26,30,CHI,114,41,14,67,44
1991-03-03,BOS,107,42,15,POR,116,44,14,86,29
1991-03-03,MIL,106,36,22,ATL,115,32,25,68,47
1991-03-03,PHL,92,32,24,UTH,95,37,18,69,42
1991-03-03,WAS,85,22,35,SAN,107,35,19,57,54
1991-03-03,DET,107,37,22,LAC,98,20,36,57,58
1991-03-03,LAL,95,42,15,HOU,104,32,24,74,39
1991-03-04,ORL,88,19,38,UTH,106,38,18,57,56
1991-03-04,GOS,99,30,26,SEA,105,28,28,58,54
1991-03-04,BOS,126,42,16,IND,101,27,30,69,46
1991-03-04,CHH,93,17,40,PHX,126,37,19,54,59
1991-03-04,DAL,102,21,35,NJN,100,19,38,40,73
1991-03-05,HOU,112,33,24,NJN,100,19,39,52,63
1991-03-05,IND,112,27,31,CHH,101,17,41,44,72
1991-03-05,CHI,104,41,15,MIL,86,36,23,77,38
1991-03-05,NYK,102,27,31,PHX,107,38,19,65,50
1991-03-05,MIA,116,18,39,LAC,113,20,37,38,76
1991-03-05,SAC,100,15,41,GOS,92,30,27,45,68
1991-03-05,ATL,139,33,25,DEN,127,16,40,49,65
1991-03-05,SEA,111,29,28,CLE,113,20,37,49,65
1991-03-05,SAN,104,36,19,PHL,99,32,25,68,44
1991-03-05,MIN,94,18,38,LAL,85,42,16,60,54
1991-03-06,ORL,89,19,39,LAC,86,20,38,39,77
1991-03-06,DAL,92,22,35,PHL,97,32,26,54,61
1991-03-06,DET,99,38,22,NYK,102,27,32,65,54
1991-03-06,BOS,126,43,16,MIA,117,19,39,62,55
1991-03-06,WAS,93,22,36,UTH,104,39,18,61,54
1991-03-07,MIN,86,19,38,SEA,91,29,29,48,67
1991-03-07,ATL,104,34,25,PHX,106,39,19,73,44
1991-03-07,MIL,99,36,24,LAL,94,42,17,78,41
1991-03-07,HOU,122,34,24,DAL,90,22,36,56,60
1991-03-07,SAN,111,37,19,NJN,99,19,40,56,59
1991-03-07,IND,145,28,31,DEN,125,16,41,44,72
1991-03-07,GOS,122,30,28,CLE,92,21,37,51,65
1991-03-08,SAC,87,16,41,CLE,79,21,38,37,79
1991-03-08,WAS,91,22,37,PHX,117,40,19,62,56
1991-03-08,ORL,129,20,39,DEN,113,16,42,36,81
1991-03-08,LAC,98,20,39,BOS,104,44,16,64,55
1991-03-08,MIA,96,19,40,ATL,102,34,26,53,66
1991-03-08,CHI,99,42,15,UTH,89,40,18,82,33
1991-03-09,WAS,72,22,38,LAL,87,42,18,64,56
1991-03-09,IND,112,29,31,DET,114,38,23,67,54
1991-03-09,MIL,98,37,24,CHH,107,17,42,54,66
1991-03-09,NYK,101,28,32,UTH,92,40,19,68,51
1991-03-09,SAN,112,38,19,SEA,99,30,29,68,48
1991-03-09,HOU,97,35,24,PHL,80,33,26,68,50
1991-03-10,MIA,101,19,41,NJN,88,19,41,38,82
1991-03-10,LAC,93,20,40,CLE,98,21,39,41,79
1991-03-10,POR,109,45,14,BOS,111,45,16,90,30
1991-03-10,ORL,101,21,39,LAL,115,43,18,64,57
1991-03-10,MIN,109,19,39,PHX,123,41,19,60,58
1991-03-10,GOS,97,31,28,SAC,87,17,41,48,69
1991-03-10,ATL,87,35,26,CHI,122,43,15,78,41
1991-03-10,DEN,124,16,43,DAL,110,22,37,38,80
1991-03-11,SAN,105,39,19,UTH,96,40,20,79,39
1991-03-11,DET,85,39,23,MIL,96,37,25,76,48
1991-03-11,POR,104,45,15,CLE,96,22,39,67,54
1991-03-11,NYK,90,29,32,NJN,85,19,42,48,74
1991-03-12,HOU,93,36,24,SEA,91,30,30,66,54
1991-03-12,MIA,95,20,41,LAL,102,44,18,64,59
1991-03-12,DEN,123,17,43,LAC,126,20,41,37,84
1991-03-12,CHH,100,18,42,WAS,103,22,39,40,81
1991-03-12,GOS,129,32,28,IND,117,29,32,61,60
1991-03-12,ATL,129,35,27,PHL,133,33,27,68,54
1991-03-12,CHI,131,44,15,MIN,99,19,40,63,55
1991-03-12,SAC,95,17,42,BOS,110,46,16,63,58
1991-03-13,LAC,97,21,41,SAN,93,40,19,61,60
1991-03-13,MIL,101,38,25,CHI,102,45,15,83,40
1991-03-13,PHL,94,34,27,NYK,102,30,32,64,59
1991-03-13,UTH,112,40,21,BOS,109,47,16,87,37
1991-03-13,DAL,98,22,38,SEA,96,30,31,52,69
1991-03-13,DET,94,39,24,CHH,83,18,43,57,67
1991-03-13,PHX,116,42,19,POR,108,46,15,88,34
1991-03-14,SAC,103,17,43,IND,107,29,33,46,76
1991-03-14,NYK,125,31,32,MIA,121,20,42,51,74
1991-03-14,HOU,119,37,24,ORL,95,21,40,58,64
1991-03-14,CLE,103,22,40,MIL,101,38,26,60,66
1991-03-14,GOS,99,33,28,SAN,101,40,20,73,48
1991-03-14,NJN,118,19,43,DET,110,40,24,59,67
1991-03-14,DEN,112,17,44,MIN,105,19,41,36,85
1991-03-15,DAL,117,23,38,ATL,127,35,28,58,66
1991-03-15,SEA,96,30,32,MIN,100,19,42,49,74
1991-03-15,CHH,92,18,44,CHI,105,46,15,64,59
1991-03-15,PHL,105,34,28,MIA,103,20,43,54,71
1991-03-15,UTH,96,41,21,POR,106,46,16,87,37
1991-03-15,LAC,109,22,41,IND,121,30,33,52,74
1991-03-15,WAS,86,23,39,BOS,94,47,17,70,56
1991-03-15,PHX,128,43,19,HOU,135,38,24,81,43
1991-03-15,LAL,127,45,18,DEN,117,18,44,63,62
1991-03-16,DAL,105,23,39,GOS,117,33,29,56,68
1991-03-16,CLE,98,23,40,CHI,102,47,15,70,55
1991-03-16,SEA,98,30,33,UTH,104,41,22,71,55
1991-03-16,DET,106,40,25,ORL,99,21,41,61,66
1991-03-16,SAC,92,17,44,SAN,85,41,20,58,64
1991-03-16,PHX,128,43,20,ATL,116,36,28,79,48
1991-03-16,NJN,110,20,43,WAS,86,23,40,43,83
1991-03-17,BOS,110,48,17,PHL,105,35,28,83,45
1991-03-17,MIN,90,20,42,MIA,87,20,44,40,86
1991-03-17,HOU,123,39,24,GOS,119,34,29,73,53
1991-03-17,NJN,108,21,43,CHH,121,18,45,39,88
1991-03-17,POR,97,47,16,LAC,107,22,42,69,58
1991-03-17,DEN,92,18,45,IND,130,31,33,49,78
1991-03-17,MIL,102,38,27,NYK,101,32,32,70,59
1991-03-17,LAL,98,46,18,SAN,91,41,21,87,39
1991-03-18,DAL,104,23,40,SAC,86,18,44,41,84
1991-03-18,CHI,121,48,15,DEN,108,18,46,66,61
1991-03-18,PHL,99,35,29,ORL,91,21,42,56,71
1991-03-18,PHX,111,44,20,IND,103,32,33,76,53
1991-03-19,MIL,101,39,27,MIA,88,20,45,59,72
1991-03-19,CHH,79,19,45,NYK,97,32,33,51,78
1991-03-19,GOS,136,34,30,POR,126,47,17,81,47
1991-03-19,ATL,104,36,29,BOS,92,49,17,85,46
1991-03-19,LAL,119,47,18,LAC,105,23,42,70,60
1991-03-19,MIN,85,21,42,HOU,98,40,24,61,66
1991-03-19,SAN,104,41,22,SAC,101,18,45,59,67
1991-03-20,DAL,96,24,40,PHX,110,45,20,69,60
1991-03-20,NYK,102,33,33,CLE,97,23,41,56,74
1991-03-20,PHL,107,36,29,DET,103,41,25,77,54
1991-03-20,SEA,114,30,34,LAL,106,48,18,78,52
1991-03-20,LAC,96,23,43,POR,100,47,18,70,61
1991-03-20,DEN,98,18,47,UTH,106,42,22,60,69
1991-03-20,NJN,118,21,44,MIN,111,21,43,42,87
1991-03-20,CHI,129,49,15,ATL,107,37,29,86,44
1991-03-20,BOS,102,49,18,WAS,81,23,41,72,59
1991-03-20,IND,117,32,34,MIA,107,20,46,52,80
1991-03-21,HOU,98,41,24,SAC,87,18,46,59,70
1991-03-21,GOS,136,35,30,DEN,116,18,48,53,78
1991-03-21,UTH,100,43,22,CHH,94,19,46,62,68
1991-03-21,ORL,105,21,43,SAN,102,42,22,63,65
1991-03-22,PHL,95,37,29,CHI,90,50,15,87,44
1991-03-22,DAL,104,24,41,NYK,102,34,33,58,74
1991-03-22,PHX,105,46,20,SEA,111,31,34,77,54
1991-03-22,DET,109,41,26,NJN,93,22,44,63,70
1991-03-22,MIA,90,20,47,SAN,97,42,23,62,70
1991-03-22,MIN,110,21,44,CLE,105,23,42,44,86
1991-03-22,LAC,106,23,44,CHH,100,19,47,42,91
1991-03-22,LAL,92,48,19,MIL,99,40,27,88,46
1991-03-22,IND,121,33,34,BOS,109,50,18,83,52
1991-03-22,WAS,121,23,42,ATL,116,37,30,60,72
1991-03-23,SAC,95,18,47,PHX,100,46,21,64,68
1991-03-23,UTH,95,44,22,MIN,89,22,44,66,66
1991-03-23,CHI,133,50,16,IND,119,34,34,84,50
1991-03-23,GOS,104,36,30,LAC,107,24,44,60,74
1991-03-23,ATL,108,37,31,MIA,93,20,48,57,79
1991-03-23,WAS,102,24,42,PHL,99,38,29,62,71
1991-03-23,DEN,136,18,49,MIL,140,41,27,59,76
1991-03-23,CLE,108,23,43,NJN,82,22,45,45,88
1991-03-23,ORL,105,22,43,DAL,93,25,41,47,84
1991-03-23,HOU,111,42,24,NYK,98,34,34,76,58
1991-03-24,POR,117,48,18,CHH,102,19,48,67,66
1991-03-24,LAL,113,48,20,SEA,96,32,34,80,54
1991-03-24,SAN,85,43,23,DET,78,42,26,85,49
1991-03-25,DEN,94,18,50,DET,118,42,27,60,77
1991-03-25,CHI,90,51,16,HOU,100,43,24,94,40
1991-03-25,SAC,89,18,48,LAL,99,49,20,67,68
1991-03-25,UTH,109,45,22,MIL,98,42,27,87,49
1991-03-25,ORL,115,23,43,GOS,106,36,31,59,74
1991-03-25,WAS,113,25,42,NJN,106,22,46,47,88
1991-03-25,LAC,106,25,44,PHX,94,47,21,72,65
1991-03-26,SAN,129,44,23,NYK,119,34,35,78,58
1991-03-26,PHX,117,47,22,MIN,95,22,45,69,67
1991-03-26,CHH,97,19,49,GOS,94,36,32,55,81
1991-03-26,NJN,98,22,47,PHL,95,38,30,60,77
1991-03-26,MIA,104,20,49,CLE,98,24,43,44,92
1991-03-26,IND,123,34,35,ATL,113,38,31,72,66
1991-03-26,POR,126,49,18,SEA,113,32,35,81,53
1991-03-27,SEA,107,32,36,POR,112,50,18,82,54
1991-03-27,DET,102,43,27,IND,93,35,35,78,62
1991-03-27,LAC,95,26,44,UTH,89,46,22,72,66
1991-03-27,DAL,85,25,42,ORL,97,24,43,49,85
1991-03-28,ATL,111,38,32,HOU,112,44,24,82,56
1991-03-28,PHX,102,48,22,MIL,88,42,28,90,50
1991-03-28,MIA,90,21,49,BOS,88,51,19,72,68
1991-03-28,NYK,104,34,36,GOS,106,36,33,70,69
1991-03-28,CLE,102,24,45,WAS,95,26,42,50,87
1991-03-28,NJN,94,23,47,CHI,128,51,17,74,64
1991-03-28,SAC,116,18,49,UTH,96,46,23,64,72
1991-03-28,CHH,94,20,49,PHL,90,38,31,58,80
1991-03-28,SAN,119,45,23,ORL,95,25,43,70,66
1991-03-29,BOS,110,50,19,CLE,108,24,44,74,63
1991-03-29,LAC,105,27,44,DAL,96,25,43,52,87
1991-03-29,DET,111,44,27,GOS,105,37,33,81,60
1991-03-29,WAS,94,26,43,CHI,112,52,17,78,60
1991-03-29,DEN,140,18,51,SAC,122,19,49,37,100
1991-03-29,SEA,117,32,37,MIN,107,22,46,54,83
1991-03-29,LAL,105,50,20,POR,109,51,18,101,38
1991-03-29,PHL,124,38,32,CHH,107,21,49,59,81
1991-03-30,NJN,117,23,48,NYK,130,34,37,57,85
1991-03-30,SEA,115,33,37,DAL,102,25,44,58,81
1991-03-30,POR,121,52,18,MIN,91,22,47,74,65
1991-03-30,MIL,104,42,29,ATL,96,38,33,80,62
1991-03-30,ORL,114,25,44,HOU,82,45,24,70,68
1991-03-30,SAN,130,46,23,DEN,116,19,51,65,74
1991-03-31,MIA,103,22,49,HOU,123,45,25,67,74
1991-03-31,LAL,115,50,21,SAC,87,19,50,69,71
1991-03-31,WAS,92,26,44,CHH,102,21,50,47,94
1991-03-31,IND,127,35,36,GOS,120,37,34,72,70
1991-03-31,PHL,110,39,32,CLE,101,25,45,64,77
1991-03-31,BOS,135,51,20,CHI,132,53,17,104,37
1991-04-02,MIN,93,22,48,POR,104,53,18,75,66
1991-04-02,CHI,106,53,18,ORL,102,26,44,79,62
1991-04-02,NJN,77,23,49,BOS,94,52,20,75,69
1991-04-02,CHH,78,22,50,DET,83,45,27,67,77
1991-04-02,PHX,131,49,22,UTH,117,46,24,95,46
1991-04-02,WAS,101,26,45,CLE,82,25,46,51,91
1991-04-02,PHL,104,40,32,MIL,121,43,29,83,61
1991-04-02,SAN,115,47,23,LAL,122,51,21,98,44
1991-04-02,SAC,96,19,51,MIA,90,22,50,41,101
1991-04-02,DAL,133,25,45,DEN,126,19,52,44,97
1991-04-03,SEA,106,34,37,SAC,91,20,51,54,88
1991-04-03,UTH,99,46,25,LAC,97,28,44,74,69
1991-04-03,GOS,127,37,35,MIA,114,22,51,59,86
1991-04-03,CLE,95,25,47,NYK,84,35,37,60,84
1991-04-03,HOU,102,46,25,DAL,86,26,45,72,70
1991-04-03,IND,104,36,36,PHL,107,40,33,76,69
1991-04-04,MIL,101,44,29,SAN,105,47,24,91,53
1991-04-04,BOS,123,53,20,NJN,104,23,50,76,70
1991-04-04,WAS,96,27,45,POR,105,54,18,81,63
1991-04-04,CHH,98,22,51,ATL,91,38,34,60,85
1991-04-04,MIN,134,22,49,DEN,122,19,53,41,102
1991-04-04,NYK,91,35,38,CHI,101,54,18,89,56
1991-04-04,PHX,98,50,22,LAL,102,52,21,102,43
1991-04-05,GOS,118,38,35,PHX,101,50,23,88,58
1991-04-05,LAL,108,53,21,MIA,87,22,52,75,73
1991-04-05,LAC,109,28,45,SEA,90,35,37,63,82
1991-04-05,IND,117,36,37,WAS,103,27,46,63,83
1991-04-05,DET,101,46,27,MIN,82,23,49,69,76
1991-04-05,CHI,107,55,18,SAN,110,48,24,103,42
1991-04-05,ORL,98,26,45,POR,115,55,18,81,63
1991-04-05,DEN,120,19,54,HOU,126,47,25,66,79
1991-04-05,DAL,87,26,46,UTH,93,47,25,73,71
1991-04-05,CLE,104,26,47,CHH,101,23,51,49,98
1991-04-06,ATL,137,38,35,IND,110,37,37,75,72
1991-04-06,SAC,119,20,52,GOS,108,39,35,59,87
1991-04-06,NYK,101,35,39,DET,88,47,27,82,66
1991-04-06,ORL,102,26,46,BOS,98,54,20,80,66
1991-04-06,MIL,133,44,30,NJN,114,23,51,67,81
1991-04-06,HOU,97,48,25,UTH,88,48,25,96,50
1991-04-07,CHI,111,55,19,PHL,114,41,33,96,52
1991-04-07,MIN,87,23,50,SAN,92,49,24,72,74
1991-04-07,LAL,93,54,21,PHX,85,50,24,104,45
1991-04-07,LAC,119,29,45,SAC,109,21,52,50,97
1991-04-07,DAL,92,26,47,POR,110,56,18,82,65
1991-04-07,DEN,117,19,55,SEA,124,35,38,54,93
1991-04-07,CHH,100,23,52,CLE,102,27,47,50,99
1991-04-08,SEA,118,36,38,DEN,112,19,56,55,94
1991-04-08,ATL,105,39,35,WAS,94,27,47,66,82
1991-04-08,SAN,115,50,24,GOS,105,39,36,89,60
1991-04-08,UTH,111,48,26,ORL,95,27,46,75,72
1991-04-09,PHX,120,50,25,GOS,106,39,37,89,62
1991-04-09,MIN,109,23,51,NJN,89,23,52,46,103
1991-04-09,LAC,100,30,45,ORL,110,27,47,57,92
1991-04-09,HOU,93,49,25,POR,103,57,18,106,43
1991-04-09,MIL,105,45,30,DET,95,47,28,92,58
1991-04-09,CLE,98,28,47,ATL,104,40,35,68,82
1991-04-09,SAC,113,21,53,DAL,104,26,48,47,101
1991-04-09,CHH,120,23,53,IND,122,37,38,60,91
1991-04-09,CHI,108,55,20,NYK,106,36,39,91,59
1991-04-10,IND,96,38,38,CHI,101,56,20,94,58
1991-04-10,SEA,140,37,38,LAC,108,30,46,67,84
1991-04-10,PHL,100,42,33,NYK,84,36,40,78,73
1991-04-10,MIA,112,22,53,WAS,106,27,48,49,101
1991-04-10,UTH,97,49,26,DAL,91,26,49,75,75
1991-04-10,DET,90,47,29,CLE,94,28,48,75,77
1991-04-10,SAN,100,51,24,POR,105,58,18,109,42
1991-04-11,GOS,111,39,38,HOU,99,49,26,88,64
1991-04-11,MIN,112,24,51,ATL,98,41,35,65,86
1991-04-11,LAL,110,55,21,UTH,95,50,26,105,47
1991-04-11,SAC,104,22,53,ORL,96,28,47,50,100
1991-04-11,MIL,111,46,30,BOS,92,54,21,100,51
1991-04-12,LAC,146,30,47,DEN,130,19,57,49,104
1991-04-12,NJN,104,23,53,CLE,103,29,48,52,101
1991-04-12,SEA,100,38,38,SAN,99,51,25,89,63
1991-04-12,NYK,112,36,41,IND,108,38,39,74,80
1991-04-12,DET,95,47,30,CHI,91,57,20,104,50
1991-04-12,BOS,119,54,22,MIA,109,23,53,77,75
1991-04-12,CHH,111,23,54,MIN,110,25,51,48,105
1991-04-12,PHL,85,43,33,WAS,95,27,49,70,82
1991-04-12,PHX,103,51,25,DAL,91,26,50,77,75
1991-04-13,SEA,105,39,38,ORL,96,28,48,67,86
1991-04-13,POR,118,59,18,LAL,113,56,21,115,39
1991-04-13,UTH,121,50,27,DEN,110,19,58,69,85
1991-04-13,SAC,94,23,53,HOU,95,49,27,72,80
1991-04-13,ATL,97,41,36,MIL,91,47,30,88,66
1991-04-13,CLE,102,29,49,NJN,98,24,53,53,102
1991-04-13,GOS,132,40,38,DAL,114,26,51,66,89
1991-04-14,PHL,88,43,34,MIN,96,25,52,68,86
1991-04-14,PHX,101,52,25,SAN,109,51,26,103,51
1991-04-14,BOS,115,55,22,NYK,102,37,41,92,63
1991-04-14,IND,125,38,40,DET,107,48,30,86,70
1991-04-14,WAS,101,28,49,MIA,96,23,54,51,103
1991-04-14,POR,139,60,18,ORL,119,28,49,88,67
1991-04-15,CHI,103,57,21,MIL,94,47,31,104,52
1991-04-15,MIN,112,26,52,SAC,94,23,54,49,106
1991-04-15,SEA,93,40,38,HOU,97,50,27,90,65
1991-04-15,LAL,112,56,22,DAL,106,26,52,82,74
1991-04-16,NYK,108,37,42,PHL,99,43,35,80,77
1991-04-16,DET,118,48,31,BOS,90,56,22,104,53
1991-04-16,CHH,92,24,54,MIA,87,23,55,47,109
1991-04-16,UTH,111,51,27,SAC,101,23,55,74,82
1991-04-16,NJN,126,24,54,IND,132,39,40,63,94
1991-04-16,DEN,118,19,59,PHX,153,52,26,71,85
1991-04-16,SAN,128,52,26,LAC,98,31,47,83,73
1991-04-16,WAS,112,29,49,MIL,106,47,32,76,81
1991-04-16,POR,115,61,18,HOU,96,51,27,112,45
1991-04-16,ORL,113,28,50,ATL,106,42,36,70,86
1991-04-17,DAL,102,26,53,MIN,100,27,52,53,105
1991-04-17,PHX,105,53,26,LAC,100,31,48,84,74
1991-04-17,MIA,101,23,56,CHI,111,58,21,81,77
1991-04-17,ATL,111,42,37,CHH,123,25,54,67,91
1991-04-17,CLE,112,30,49,ORL,102,29,50,59,99
1991-04-17,GOS,118,41,38,LAL,111,57,22,98,60
1991-04-18,PHL,122,43,36,BOS,97,56,23,99,59
1991-04-18,UTH,130,52,27,SEA,103,40,39,92,66
1991-04-18,WAS,103,30,49,NJN,108,24,55,54,104
1991-04-18,HOU,95,51,28,SAN,102,53,26,104,54
1991-04-18,SAC,123,23,56,DEN,104,19,60,42,116
1991-04-19,SEA,104,40,40,PHX,93,54,26,94,66
1991-04-19,CLE,124,31,49,BOS,117,56,24,87,73
1991-04-19,ORL,112,29,51,WAS,107,30,50,59,101
1991-04-19,MIA,114,23,57,PHL,100,44,36,67,93
1991-04-19,IND,130,40,40,NYK,118,38,42,78,82
1991-04-19,DEN,125,19,61,SAN,122,54,26,73,87
1991-04-19,CHH,99,26,54,CHI,115,59,21,85,75
1991-04-19,DAL,113,27,53,HOU,107,51,29,78,82
1991-04-19,LAC,113,31,49,GOS,114,42,38,73,87
1991-04-19,MIN,109,27,53,MIL,91,47,33,74,86
1991-04-19,POR,127,62,18,SAC,105,24,56,86,74
1991-04-19,ATL,120,42,38,DET,126,49,31,91,69
1991-04-20,NYK,108,38,43,CHH,102,26,55,64,98
1991-04-20,UTH,107,53,27,LAL,93,57,23,110,50
1991-04-20,MIL,133,47,34,IND,100,41,40,88,74
1991-04-20,NJN,118,25,55,MIA,103,24,57,49,112
1991-04-21,CLE,123,32,49,PHL,110,44,37,76,86
1991-04-21,ORL,120,30,51,NJN,110,26,55,56,106
1991-04-21,PHX,135,54,27,POR,118,63,18,117,45
1991-04-21,WAS,87,30,51,MIN,89,28,53,58,104
1991-04-21,LAL,103,57,24,SEA,100,41,40,98,64
1991-04-21,GOS,125,43,38,UTH,106,54,27,97,65
1991-04-21,CHI,108,60,21,DET,100,50,31,110,52
1991-04-21,SAN,135,54,27,DAL,101,28,53,82,80
1991-04-21,BOS,105,56,25,ATL,117,42,39,98,64
1991-04-21,SAC,105,24,57,LAC,101,31,50,55,107
1991-04-21,HOU,131,51,30,DEN,125,20,61,71,91
1991-11-01,SAC,94,0,0,LAC,90,0,0,0,0
1991-11-01,SAN,140,0,0,DAL,99,0,0,0,0
1991-11-01,ORL,106,0,0,NYK,96,0,0,0,0
1991-11-01,CHI,110,0,0,PHL,90,0,0,0,0
1991-11-01,BOS,111,0,0,CHH,108,0,0,0,0
1991-11-01,MIN,97,0,0,UTH,112,0,0,0,0
1991-11-01,POR,117,0,0,CLE,106,0,0,0,0
1991-11-01,SEA,95,0,0,PHX,99,0,0,0,0
1991-11-01,IND,103,0,0,WAS,109,0,0,0,0
1991-11-01,DET,99,0,0,MIL,109,0,0,0,0
1991-11-01,DEN,105,0,0,GOS,108,0,0,0,0
1991-11-01,HOU,126,0,0,LAL,121,0,0,0,0
1991-11-02,DEN,109,0,1,HOU,101,1,0,1,1
1991-11-02,MIL,109,1,0,CHI,107,1,0,2,0
1991-11-02,CHH,108,0,1,NJN,116,0,0,0,1
1991-11-02,PHL,115,0,1,ORL,122,1,0,1,1
1991-11-02,LAC,106,0,1,CLE,105,0,1,0,2
1991-11-02,MIA,107,0,0,NYK,93,0,1,0,1
1991-11-02,POR,76,1,0,PHX,100,1,0,2,0
1991-11-02,ATL,87,0,0,DET,89,0,1,0,1
1991-11-02,GOS,153,1,0,SAC,91,1,0,2,0
1991-11-02,WAS,126,1,0,BOS,118,1,0,2,0
1991-11-02,IND,127,0,1,UTH,112,1,0,1,1
1991-11-02,DAL,113,0,1,LAL,114,0,1,0,2
1991-11-03,SEA,98,0,1,SAN,106,1,0,1,1
1991-11-05,PHX,105,2,0,IND,111,1,1,3,1
1991-11-05,CHI,110,1,1,GOS,118,2,0,3,1
1991-11-05,LAL,109,1,1,LAC,114,1,1,2,2
1991-11-05,HOU,106,1,1,POR,99,1,1,2,2
1991-11-05,DAL,101,0,2,CLE,112,0,2,0,4
1991-11-05,WAS,106,2,0,PHL,107,0,2,2,2
1991-11-05,MIA,89,1,0,BOS,93,1,1,2,1
1991-11-05,DET,117,1,1,CHH,93,0,2,1,3
1991-11-05,NYK,113,0,2,MIL,85,2,0,2,2
1991-11-05,ATL,98,0,1,UTH,94,1,1,1,2
1991-11-05,DEN,97,1,1,SAN,96,2,0,3,1
1991-11-05,SEA,98,0,2,SAC,87,1,1,1,3
1991-11-06,CHH,114,0,3,ATL,104,1,1,1,4
1991-11-06,SAC,112,1,2,IND,102,2,1,3,3
1991-11-06,MIL,114,2,1,GOS,120,3,0,5,1
1991-11-06,PHL,107,1,2,NJN,105,1,0,2,2
1991-11-06,MIN,94,0,1,DAL,97,0,3,0,4
1991-11-06,LAC,111,2,1,PHX,87,2,1,4,2
1991-11-06,BOS,113,2,1,CHI,132,1,2,3,3
1991-11-06,SAN,119,2,1,POR,93,1,2,3,3
1991-11-06,ORL,105,2,0,WAS,88,2,1,4,1
1991-11-07,HOU,105,2,1,CLE,86,1,2,3,3
1991-11-07,NJN,89,1,1,MIA,111,1,1,2,2
1991-11-07,DEN,88,2,1,MIN,77,0,2,2,3
1991-11-07,NYK,128,1,2,ORL,100,3,0,4,2
1991-11-07,UTH,95,1,2,SEA,103,1,2,2,4
1991-11-08,POR,121,1,3,IND,96,2,2,3,5
1991-11-08,PHL,126,2,2,GOS,116,4,0,6,2
1991-11-08,LAC,106,3,1,DEN,82,3,1,6,2
1991-11-08,PHX,113,2,2,LAL,85,1,2,3,4
1991-11-08,CHI,108,2,2,DAL,92,1,3,3,5
1991-11-08,SAN,107,3,1,CLE,101,1,3,4,4
1991-11-08,BOS,95,2,2,ATL,100,1,2,3,4
1991-11-08,CHH,122,1,3,MIL,125,2,2,3,5
1991-11-09,UTH,101,1,3,LAC,84,4,1,5,4
1991-11-09,NJN,100,1,2,DET,110,2,1,3,3
1991-11-09,WAS,119,2,2,GOS,127,4,1,6,3
1991-11-09,ATL,97,2,2,MIA,93,2,1,4,3
1991-11-09,SAC,80,2,2,MIN,84,0,3,2,5
1991-11-09,SEA,118,2,2,IND,111,2,3,4,5
1991-11-09,NYK,118,2,2,CHH,113,1,4,3,6
1991-11-09,HOU,96,3,1,PHX,95,3,2,6,3
1991-11-09,CHI,107,3,2,ORL,76,3,1,6,3
1991-11-09,MIL,111,3,2,DAL,95,1,4,4,6
1991-11-10,LAL,96,1,3,MIN,86,1,3,2,6
1991-11-10,POR,116,2,3,BOS,90,2,3,4,6
1991-11-10,DET,85,3,1,WAS,79,2,3,5,4
1991-11-11,PHL,102,3,2,MIL,99,4,2,7,4
1991-11-11,LAC,106,4,2,IND,97,2,4,6,6
1991-11-11,UTH,106,2,3,SAC,90,2,3,4,6
1991-11-12,SAC,103,2,4,BOS,126,2,4,4,8
1991-11-12,WAS,82,2,4,ORL,95,3,2,5,6
1991-11-12,DAL,92,1,5,HOU,98,4,1,5,6
1991-11-12,POR,120,3,3,DEN,82,3,2,6,5
1991-11-12,NYK,98,3,2,NJN,96,1,3,4,5
1991-11-12,ATL,118,3,2,CHH,100,1,5,4,7
1991-11-12,CHI,110,4,2,DET,93,4,1,8,3
1991-11-12,CLE,119,1,4,MIL,113,4,3,5,7
1991-11-12,GOS,119,5,1,PHX,116,3,3,8,4
1991-11-13,MIA,107,2,2,DET,102,4,2,6,4
1991-11-13,NJN,92,1,4,UTH,98,3,3,4,7
1991-11-13,SAN,107,4,1,LAC,93,5,2,9,3
1991-11-13,PHX,111,3,4,BOS,117,3,4,6,8
1991-11-13,CHH,95,1,6,CHI,117,5,2,6,8
1991-11-13,MIN,114,1,4,WAS,119,2,5,3,9
1991-11-13,IND,110,2,5,NYK,107,4,2,6,7
1991-11-13,ORL,100,4,2,PHL,121,4,2,8,4
1991-11-14,CLE,115,2,4,SEA,109,3,2,5,6
1991-11-14,SAC,98,2,5,ATL,96,4,2,6,7
1991-11-14,DAL,95,1,6,LAC,88,5,3,6,9
1991-11-14,GOS,112,6,1,LAL,115,2,3,8,4
1991-11-15,DET,123,4,3,UTH,115,4,3,8,6
1991-11-15,PHX,115,3,5,ATL,119,4,3,7,8
1991-11-15,MIA,120,3,2,CHH,105,1,7,4,9
1991-11-15,LAL,86,3,3,HOU,74,5,1,8,4
1991-11-15,BOS,122,4,4,PHL,97,5,2,9,6
1991-11-15,MIN,102,1,5,POR,107,4,3,5,8
1991-11-15,CHI,114,6,2,MIL,101,4,4,10,6
1991-11-15,IND,108,3,5,SEA,124,3,3,6,8
1991-11-15,NJN,111,1,5,WAS,116,3,5,4,10
1991-11-16,SAC,93,3,5,HOU,102,5,2,8,7
1991-11-16,MIL,116,4,5,MIA,120,4,2,8,7
1991-11-16,SAN,106,5,1,NYK,89,4,3,9,4
1991-11-16,CLE,127,3,4,IND,117,3,6,6,10
1991-11-16,WAS,98,4,5,UTH,107,4,4,8,9
1991-11-16,DEN,122,3,3,POR,111,5,3,8,6
1991-11-16,LAC,105,5,4,GOS,123,6,2,11,6
1991-11-16,DET,86,5,3,PHL,89,5,3,10,6
1991-11-16,ORL,102,4,3,NJN,100,1,6,5,9
1991-11-16,CHH,118,1,8,BOS,109,5,4,6,12
1991-11-16,DAL,91,2,6,PHX,88,3,6,5,12
1991-11-17,MIN,91,1,6,SEA,101,4,3,5,9
1991-11-17,LAL,111,4,3,ATL,89,5,3,9,6
1991-11-18,IND,118,3,7,DET,101,5,4,8,11
1991-11-19,WAS,106,4,6,SEA,113,5,3,9,9
1991-11-19,MIA,111,5,2,UTH,91,5,4,10,6
1991-11-19,HOU,90,6,2,NYK,79,4,4,10,6
1991-11-19,DEN,93,4,3,DAL,96,3,6,7,9
1991-11-19,NJN,122,1,7,SAC,118,3,6,4,13
1991-11-19,POR,132,5,4,LAC,112,5,5,10,9
1991-11-19,MIL,127,4,6,CHH,104,2,8,6,14
1991-11-19,LAL,103,5,3,PHX,95,3,7,8,10
1991-11-20,CHH,109,2,9,CLE,108,4,4,6,13
1991-11-20,ATL,116,5,4,SAC,104,3,7,8,11
1991-11-20,DAL,89,4,6,NYK,92,4,5,8,11
1991-11-20,PHX,113,3,8,DEN,97,4,4,7,12
1991-11-20,GOS,108,7,2,CHI,112,7,2,14,4
1991-11-20,PHL,114,6,3,MIA,107,6,2,12,5
1991-11-20,SAN,113,6,1,MIN,106,1,7,7,8
1991-11-20,ORL,102,5,3,UTH,107,5,5,10,8
1991-11-20,BOS,116,5,5,IND,101,4,7,9,12
1991-11-20,DET,86,5,5,SEA,91,6,3,11,8
1991-11-21,LAC,91,5,6,POR,106,6,4,11,10
1991-11-21,HOU,106,7,2,MIN,102,1,8,8,10
1991-11-21,MIL,112,5,6,WAS,87,4,7,9,13
1991-11-21,CLE,116,4,5,NJN,112,2,7,6,12
1991-11-22,MIA,118,6,3,SAC,112,3,8,9,11
1991-11-22,SEA,109,7,3,CHI,112,8,2,15,5
1991-11-22,UTH,121,6,5,DEN,96,4,5,10,10
1991-11-22,POR,112,7,4,GOS,116,7,3,14,7
1991-11-22,PHX,105,4,8,LAC,97,5,7,9,15
1991-11-22,LAL,98,6,3,SAN,96,7,1,13,4
1991-11-22,PHL,92,7,3,ATL,99,6,4,13,7
1991-11-22,CHH,112,3,9,IND,110,4,8,7,17
1991-11-22,DET,90,5,6,NYK,99,5,5,10,11
1991-11-23,NYK,100,6,5,PHL,92,7,4,13,9
1991-11-23,MIN,102,1,9,HOU,89,8,2,9,11
1991-11-23,IND,119,4,9,MIA,83,7,3,11,12
1991-11-23,NJN,107,2,8,BOS,125,6,5,8,13
1991-11-23,WAS,126,4,8,ATL,115,7,4,11,12
1991-11-23,DAL,121,4,7,UTH,109,7,5,11,12
1991-11-23,ORL,93,5,4,SAC,95,3,9,8,13
1991-11-23,CLE,96,5,5,DET,89,5,7,10,12
1991-11-23,DEN,100,4,6,CHI,107,9,2,13,8
1991-11-23,GOS,120,8,3,MIL,115,6,6,14,9
1991-11-24,LAL,102,7,3,MIL,97,6,7,13,10
1991-11-24,POR,116,7,5,SAN,111,7,2,14,7
1991-11-24,LAC,89,5,8,SEA,86,7,4,12,12
1991-11-25,BOS,121,7,5,WAS,108,5,8,12,13
1991-11-26,PHL,91,7,5,CLE,95,6,5,13,10
1991-11-26,NYK,98,7,5,MIA,81,7,4,14,9
1991-11-26,ATL,93,7,5,DET,103,5,8,12,13
1991-11-26,SEA,136,7,5,GOS,130,9,3,16,8
1991-11-26,SAC,104,4,9,PHX,89,5,8,9,17
1991-11-26,DEN,103,4,7,CHH,97,4,9,8,16
1991-11-26,HOU,118,8,3,NJN,109,2,9,10,12
1991-11-26,POR,107,8,5,MIL,98,6,8,14,13
1991-11-26,LAC,79,6,8,CHI,116,10,2,16,10
1991-11-26,ORL,87,5,5,LAL,98,8,3,13,8
1991-11-27,DET,100,6,8,ATL,91,7,6,13,14
1991-11-27,UTH,113,7,6,CHH,107,4,10,11,16
1991-11-27,PHX,141,5,9,SAC,100,5,9,10,18
1991-11-27,SAN,106,7,3,NJN,100,2,10,9,13
1991-11-27,BOS,101,8,5,ORL,92,5,6,13,11
1991-11-27,MIA,87,7,5,LAL,89,9,3,16,8
1991-11-27,DAL,113,5,7,IND,106,5,9,10,16
1991-11-27,MIN,101,2,9,DEN,92,5,7,7,16
1991-11-27,CLE,107,7,5,PHL,97,7,6,14,11
1991-11-29,LAC,94,6,9,WAS,101,5,9,11,18
1991-11-29,POR,114,9,5,CHI,116,11,2,20,7
1991-11-29,CLE,115,8,5,ORL,104,5,7,13,12
1991-11-29,IND,141,5,10,HOU,121,9,3,14,13
1991-11-29,UTH,135,8,6,GOS,108,9,4,17,10
1991-11-29,BOS,114,9,5,LAL,91,10,3,19,8
1991-11-29,PHX,131,6,9,CHH,111,4,11,10,20
1991-11-29,DEN,101,5,8,SEA,90,8,5,13,13
1991-11-29,DAL,91,6,7,NJN,97,2,11,8,18
1991-11-29,ATL,85,7,7,SAN,88,8,3,15,10
1991-11-29,MIA,95,7,6,PHL,92,7,7,14,13
1991-11-30,ORL,105,5,8,MIA,99,8,6,13,14
1991-11-30,NYK,103,8,5,DET,96,7,8,15,13
1991-11-30,DAL,79,6,8,MIN,78,3,9,9,17
1991-11-30,PHX,134,7,9,UTH,125,9,6,16,15
1991-11-30,SAN,119,9,3,SEA,101,8,6,17,9
1991-11-30,SAC,102,5,10,CHI,118,12,2,17,12
1991-11-30,LAC,130,6,10,CHH,112,4,12,10,22
1991-11-30,DEN,107,6,8,NJN,97,3,11,9,19
1991-11-30,MIL,137,6,9,IND,119,6,10,12,19
1991-11-30,PHL,91,7,8,LAL,93,10,4,17,12
1991-11-30,ATL,129,7,8,BOS,102,10,5,17,13
1991-12-01,DET,94,7,9,HOU,87,9,4,16,13
1991-12-01,POR,91,9,6,WAS,87,6,9,15,15
1991-12-02,CHH,97,4,13,NYK,99,9,5,13,18
1991-12-03,DET,99,8,9,IND,108,6,11,14,20
1991-12-03,MIN,95,3,10,PHX,101,8,9,11,19
1991-12-03,SEA,91,8,7,WAS,90,6,10,14,17
1991-12-03,HOU,100,9,5,DEN,110,7,8,16,13
1991-12-03,SAC,99,5,11,SAN,94,10,3,15,14
1991-12-03,NJN,88,3,12,PHL,86,7,9,10,21
1991-12-03,MIL,126,7,9,LAL,94,11,4,18,13
1991-12-03,DAL,99,7,8,ATL,103,8,8,15,16
1991-12-03,MIA,94,8,7,POR,124,10,6,18,13
1991-12-03,GOS,108,9,5,UTH,103,9,7,18,12
1991-12-04,IND,108,7,11,PHX,114,9,9,16,20
1991-12-04,CHH,124,4,14,LAL,106,11,5,15,19
1991-12-04,UTH,101,9,8,WAS,74,6,11,15,19
1991-12-04,LAC,92,7,10,SAN,81,10,4,17,14
1991-12-04,CHI,108,13,2,CLE,102,9,5,22,7
1991-12-04,ORL,115,6,8,POR,124,11,6,17,14
1991-12-04,BOS,124,10,6,MIA,97,8,8,18,14
1991-12-05,DET,101,8,10,CLE,110,9,6,17,16
1991-12-05,MIL,101,8,9,NJN,109,4,12,12,21
1991-12-05,HOU,97,9,6,ATL,109,9,8,18,14
1991-12-05,GOS,117,10,5,DAL,107,7,9,17,14
1991-12-06,SEA,96,9,7,MIN,94,3,11,12,18
1991-12-06,SAN,92,10,5,UTH,93,10,8,20,13
1991-12-06,IND,126,7,12,MIL,106,8,10,15,22
1991-12-06,PHL,105,7,10,POR,102,12,6,19,16
1991-12-06,WAS,94,6,12,DET,105,8,11,14,23
1991-12-06,NJN,89,5,12,LAL,98,11,6,16,18
1991-12-06,CHI,114,14,2,CHH,96,5,14,19,16
1991-12-06,ORL,105,6,9,PHX,122,10,9,16,18
1991-12-06,DEN,100,8,8,LAC,102,8,10,16,18
1991-12-06,BOS,103,11,6,NYK,92,10,5,21,11
1991-12-07,IND,112,8,12,POR,115,12,7,20,19
1991-12-07,CLE,99,10,6,WAS,97,6,13,16,19
1991-12-07,ATL,128,10,8,NYK,137,10,6,20,14
1991-12-07,ORL,95,6,10,CHH,109,5,15,11,25
1991-12-07,GOS,124,11,5,SAC,120,6,11,17,16
1991-12-07,SEA,104,10,7,DAL,101,7,10,17,17
1991-12-07,PHL,103,8,10,CHI,100,15,2,23,12
1991-12-07,HOU,91,9,7,UTH,96,11,8,20,15
1991-12-07,LAC,101,9,10,MIN,87,3,12,12,22
1991-12-07,MIA,108,8,9,PHX,109,11,9,19,18
1991-12-08,MIL,102,8,11,SAN,83,10,6,18,17
1991-12-08,LAL,103,12,6,DAL,88,7,11,19,17
1991-12-09,BOS,132,12,6,DEN,94,8,9,20,15
1991-12-10,CHI,108,15,3,SEA,103,11,7,26,10
1991-12-10,PHX,102,12,9,DET,93,9,11,21,20
1991-12-10,IND,109,8,13,SAN,102,10,7,18,20
1991-12-10,NJN,88,5,13,NYK,114,11,6,16,19
1991-12-10,UTH,122,12,8,ORL,103,6,11,18,19
1991-12-10,POR,106,13,7,HOU,108,9,8,22,15
1991-12-10,ATL,118,10,9,MIL,104,9,11,19,20
1991-12-10,GOS,117,12,5,LAC,127,10,10,22,15
1991-12-10,DAL,114,7,12,MIA,110,8,10,15,22
1991-12-10,SAC,90,6,12,LAL,92,13,6,19,18
1991-12-11,LAL,95,14,6,UTH,101,13,8,27,14
1991-12-11,MIN,85,3,13,SAN,98,10,8,13,21
1991-12-11,CHH,103,6,15,DAL,106,8,12,14,27
1991-12-11,NYK,96,12,6,SEA,87,11,8,23,14
1991-12-11,MIA,105,8,11,CLE,103,11,6,19,17
1991-12-11,LAC,101,11,10,DET,96,9,12,20,22
1991-12-11,PHL,88,9,10,DEN,98,8,10,17,20
1991-12-12,GOS,96,12,6,HOU,99,10,8,22,14
1991-12-12,NJN,121,5,14,DEN,81,9,10,14,24
1991-12-12,SAC,106,6,13,ORL,100,6,12,12,25
1991-12-12,CLE,134,11,7,ATL,107,11,9,22,16
1991-12-12,WAS,97,6,14,MIL,109,9,12,15,26
1991-12-13,BOS,117,13,6,SEA,97,11,9,24,15
1991-12-13,SAN,107,11,8,PHX,112,13,9,24,17
1991-12-13,CHI,99,16,3,NYK,89,13,6,29,9
1991-12-13,IND,124,9,13,DAL,108,9,12,18,25
1991-12-13,POR,103,13,8,DET,113,9,13,22,21
1991-12-13,MIN,95,3,14,PHL,104,9,11,12,25
1991-12-13,LAC,102,12,10,UTH,101,14,8,26,18
1991-12-13,CHH,108,6,16,MIA,112,9,11,15,27
1991-12-14,POR,115,13,9,SAC,110,7,13,20,22
1991-12-14,UTH,102,14,9,DET,100,10,13,24,22
1991-12-14,HOU,100,11,8,SAN,107,11,9,22,17
1991-12-14,NJN,102,6,14,CHH,109,6,17,12,31
1991-12-14,WAS,100,6,15,CHI,113,17,3,23,18
1991-12-14,CLE,97,12,7,DAL,99,9,13,21,20
1991-12-14,PHL,104,10,11,SEA,95,11,10,21,21
1991-12-14,NYK,111,13,7,BOS,101,14,6,27,13
1991-12-14,MIL,103,10,12,MIN,92,3,15,13,27
1991-12-14,MIA,121,10,11,ATL,101,11,10,21,21
1991-12-14,IND,129,10,13,DEN,108,9,11,19,24
1991-12-14,GOS,128,12,7,ORL,107,6,13,18,20
1991-12-15,LAC,119,13,10,ORL,104,6,14,19,24
1991-12-15,LAL,110,14,7,SAC,94,7,14,21,21
1991-12-16,POR,119,14,9,MIN,104,3,16,17,25
1991-12-16,DET,103,10,14,DEN,89,9,12,19,26
1991-12-17,CHH,102,7,17,UTH,122,15,9,22,26
1991-12-17,CLE,148,12,8,MIA,80,11,11,23,19
1991-12-17,SEA,116,11,11,LAC,99,14,10,25,21
1991-12-17,CHI,89,18,3,LAL,102,15,7,33,10
1991-12-17,GOS,119,13,7,MIN,105,3,17,16,24
1991-12-17,HOU,100,11,9,WAS,97,6,16,17,25
1991-12-17,ORL,98,6,15,BOS,105,14,7,20,22
1991-12-17,DAL,87,10,13,SAN,98,12,9,22,22
1991-12-17,ATL,117,11,11,IND,113,11,13,22,24
1991-12-17,NYK,102,14,7,NJN,94,6,15,20,22
1991-12-18,LAC,100,14,11,GOS,104,14,7,28,18
1991-12-18,SAN,93,13,9,WAS,96,6,17,19,26
1991-12-18,PHL,105,11,11,UTH,107,16,9,27,20
1991-12-18,MIA,118,11,12,IND,112,11,14,22,26
1991-12-18,DET,117,11,14,CHH,97,7,18,18,32
1991-12-18,DEN,123,9,13,PHX,109,14,9,23,22
1991-12-18,BOS,131,15,7,MIL,117,11,12,26,19
1991-12-18,NJN,102,6,16,CLE,93,13,8,19,24
1991-12-19,ORL,87,6,16,MIL,95,11,13,17,29
1991-12-19,SEA,119,12,11,DEN,106,10,13,22,24
1991-12-19,HOU,109,12,9,SAC,102,7,15,19,24
1991-12-19,MIN,93,3,18,LAL,85,16,7,19,25
1991-12-20,PHX,116,14,10,SAN,91,13,10,27,20
1991-12-20,DAL,99,10,14,WAS,107,7,17,17,31
1991-12-20,CHH,95,7,19,HOU,99,13,9,20,28
1991-12-20,PHL,127,11,12,MIA,99,12,12,23,24
1991-12-20,GOS,123,15,7,POR,118,15,9,30,16
1991-12-20,ATL,99,12,11,CLE,122,13,9,25,20
1991-12-20,DET,112,12,14,LAL,93,16,8,28,22
1991-12-20,NJN,98,7,16,CHI,115,18,4,25,20
1991-12-20,BOS,112,16,7,UTH,101,17,9,33,16
1991-12-21,MIL,110,12,13,PHL,97,12,12,24,25
1991-12-21,DEN,102,10,14,WAS,117,8,17,18,31
1991-12-21,MIA,112,12,13,BOS,101,17,7,29,20
1991-12-21,DAL,109,10,15,SAC,85,7,16,17,31
1991-12-21,SEA,120,13,11,GOS,112,16,7,29,18
1991-12-21,CHI,117,19,4,ATL,103,12,12,31,16
1991-12-21,MIN,87,4,18,LAC,100,14,12,18,30
1991-12-21,NYK,106,15,7,UTH,97,17,10,32,17
1991-12-21,IND,118,11,15,NJN,109,7,17,18,32
1991-12-21,CLE,120,14,9,CHH,111,7,20,21,29
1991-12-22,POR,96,15,10,SEA,87,14,11,29,21
1991-12-22,LAL,88,16,9,PHX,100,15,10,31,19
1991-12-22,ORL,94,6,17,HOU,99,14,9,20,26
1991-12-23,NJN,105,7,18,ATL,93,12,13,19,31
1991-12-23,MIA,113,13,13,ORL,102,6,18,19,31
1991-12-23,MIN,91,4,19,NYK,97,16,7,20,26
1991-12-23,PHL,106,12,13,CHH,114,7,21,19,34
1991-12-23,SAN,101,13,11,SAC,90,7,17,20,28
1991-12-23,CLE,113,15,9,UTH,112,17,11,32,20
1991-12-23,HOU,85,15,9,DAL,105,11,15,26,24
1991-12-25,LAC,75,15,12,LAL,85,16,10,31,22
1991-12-25,CHI,121,20,4,BOS,99,17,8,37,12
1991-12-26,PHX,132,16,10,MIA,104,14,13,30,23
1991-12-26,ATL,111,12,14,CHI,122,21,4,33,18
1991-12-26,IND,110,12,15,PHL,113,12,14,24,29
1991-12-26,SAC,106,7,18,SEA,115,14,12,21,30
1991-12-26,NJN,99,8,18,HOU,93,15,10,23,28
1991-12-26,UTH,123,17,12,LAC,115,15,13,32,25
1991-12-26,NYK,89,17,7,SAN,118,14,11,31,18
1991-12-26,POR,113,16,10,DAL,88,12,15,28,25
1991-12-26,ORL,100,6,19,DET,112,13,14,19,33
1991-12-26,DEN,100,10,15,GOS,110,16,8,26,23
1991-12-26,MIL,94,13,13,CLE,111,16,9,29,22
1991-12-27,DET,106,14,14,ORL,94,6,20,20,34
1991-12-27,CLE,103,17,9,SAN,97,15,11,32,20
1991-12-27,CHH,120,8,21,NJN,136,9,18,17,39
1991-12-27,MIN,102,4,20,GOS,106,17,8,21,28
1991-12-27,WAS,100,9,17,HOU,107,15,11,24,28
1991-12-27,SEA,87,15,12,BOS,110,17,9,32,21
1991-12-28,PHX,121,17,10,DAL,103,12,16,29,26
1991-12-28,LAC,102,15,14,PHL,95,13,14,28,28
1991-12-28,DEN,97,10,16,BOS,90,18,9,28,25
1991-12-28,UTH,128,18,12,MIA,103,14,14,32,26
1991-12-28,LAL,88,17,10,POR,98,17,10,34,20
1991-12-28,NYK,115,17,8,IND,106,12,16,29,24
1991-12-28,WAS,129,9,18,CHH,124,8,22,17,40
1991-12-28,ATL,125,12,15,MIN,122,4,21,16,36
1991-12-28,CHI,127,22,4,SAC,118,7,19,29,23
1991-12-29,ORL,87,6,21,SAN,96,15,12,21,33
1991-12-29,POR,129,18,10,MIA,96,14,15,32,25
1991-12-29,MIL,110,13,14,HOU,100,16,11,29,25
1991-12-30,IND,104,12,17,CHI,109,23,4,35,21
1991-12-30,DEN,109,11,16,PHL,93,13,15,24,31
1991-12-30,MIN,109,4,22,SAC,117,7,20,11,42
1991-12-30,LAL,99,17,11,GOS,114,18,8,35,19
1991-12-30,DET,103,15,14,PHX,110,18,10,33,24
1991-12-30,WAS,94,10,18,SAN,84,16,12,26,30
1991-12-30,NJN,122,10,18,ORL,112,6,22,16,40
1991-12-30,CLE,121,18,9,HOU,89,16,12,34,21
1991-12-30,LAC,86,16,14,BOS,97,18,10,34,24
1992-01-02,NYK,103,18,8,CLE,110,19,9,37,17
1992-01-02,ATL,123,13,15,PHX,105,19,10,32,25
1992-01-02,GOS,125,19,8,DEN,111,12,16,31,24
1992-01-02,SAC,114,8,20,PHL,110,13,16,21,36
1992-01-02,UTH,107,19,12,POR,103,19,10,38,22
1992-01-02,SEA,113,15,13,MIA,109,14,16,29,29
1992-01-02,HOU,83,16,13,DET,106,15,15,31,28
1992-01-02,CHH,102,8,23,LAC,109,16,15,24,38
1992-01-02,MIN,91,4,23,MIL,92,14,14,18,37
1992-01-03,MIL,113,15,14,CHI,108,24,4,39,18
1992-01-03,DAL,96,12,17,DET,106,16,15,28,32
1992-01-03,LAL,87,17,12,IND,114,12,18,29,30
1992-01-03,BOS,100,19,10,CLE,111,20,9,39,19
1992-01-03,NJN,108,11,18,WAS,112,11,18,22,36
1992-01-04,WAS,99,12,18,NYK,113,18,9,30,27
1992-01-04,SAC,97,9,20,MIA,110,14,17,23,37
1992-01-04,UTH,113,20,12,DAL,78,12,18,32,30
1992-01-04,GOS,140,20,8,IND,121,13,18,33,26
1992-01-04,MIN,100,4,24,BOS,96,19,11,23,35
1992-01-04,CHI,140,24,5,NJN,96,11,19,35,24
1992-01-04,SEA,93,16,13,PHL,112,13,17,29,30
1992-01-04,CHH,113,8,24,PHX,108,19,11,27,35
1992-01-04,ATL,97,14,15,LAC,95,17,15,31,30
1992-01-04,SAN,110,16,13,HOU,112,16,14,32,27
1992-01-04,DEN,93,12,17,ORL,91,6,23,18,40
1992-01-05,NYK,108,19,9,PHX,104,19,12,38,21
1992-01-05,LAL,123,17,13,MIA,111,15,17,32,30
1992-01-05,POR,115,19,11,PHL,102,14,17,33,28
1992-01-06,UTH,124,21,12,IND,108,13,19,34,31
1992-01-06,NJN,105,11,20,LAC,90,17,16,28,36
1992-01-06,SAN,100,16,14,DET,90,17,15,33,29
1992-01-06,BOS,110,19,12,SAC,108,9,21,28,33
1992-01-06,ATL,109,15,15,HOU,97,17,14,32,29
1992-01-07,NYK,94,20,9,ATL,109,16,15,36,24
1992-01-07,MIN,98,5,24,CLE,113,21,9,26,33
1992-01-07,DEN,99,13,17,SEA,106,16,14,29,31
1992-01-07,DAL,80,12,19,LAL,104,18,13,30,32
1992-01-07,POR,104,20,11,ORL,89,6,24,26,35
1992-01-07,CHI,102,25,5,WAS,89,12,19,37,24
1992-01-08,PHX,135,19,13,DEN,114,13,18,32,31
1992-01-08,MIA,106,15,18,CHI,108,26,5,41,23
1992-01-08,DET,114,17,16,SAC,95,9,22,26,38
1992-01-08,PHL,114,14,18,HOU,104,17,15,31,33
1992-01-08,NJN,103,12,20,MIN,97,5,25,17,45
1992-01-08,SEA,103,17,14,ORL,104,6,25,23,39
1992-01-08,SAN,103,17,14,LAL,87,19,13,36,27
1992-01-08,MIL,99,16,14,UTH,98,22,12,38,26
1992-01-08,BOS,99,20,12,NYK,95,20,10,40,22
1992-01-08,IND,102,13,20,LAC,104,17,17,30,37
1992-01-09,ATL,124,17,15,DAL,108,12,20,29,35
1992-01-09,CHH,109,9,24,SAC,96,9,23,18,47
1992-01-09,WAS,92,12,20,CLE,99,22,9,34,29
1992-01-10,NJN,104,13,20,MIL,97,17,14,30,34
1992-01-10,LAL,102,19,14,DEN,88,13,19,32,33
1992-01-10,GOS,120,21,8,SAN,128,18,14,39,22
1992-01-10,DET,86,18,16,POR,81,21,11,39,27
1992-01-10,DAL,82,12,21,SEA,94,17,15,29,36
1992-01-10,CHI,105,27,5,UTH,90,22,13,49,18
1992-01-10,PHL,102,15,18,LAC,90,18,17,33,35
1992-01-10,BOS,94,21,12,MIN,104,5,26,26,38
1992-01-10,PHX,118,20,13,ORL,107,7,25,27,38
1992-01-10,MIA,107,15,19,HOU,111,17,16,32,35
1992-01-11,CLE,108,23,9,PHL,102,16,18,39,27
1992-01-11,DEN,85,13,20,SAN,96,19,14,32,34
1992-01-11,CHH,93,10,24,POR,115,21,12,31,36
1992-01-11,DET,90,19,16,NJN,88,14,20,33,36
1992-01-11,HOU,119,18,16,SEA,115,18,15,36,31
1992-01-11,WAS,107,12,21,LAC,96,18,18,30,39
1992-01-11,IND,138,13,21,ATL,115,18,15,31,36
1992-01-11,CHI,108,28,5,MIA,99,15,20,43,25
1992-01-11,MIN,101,6,26,UTH,96,22,14,28,40
1992-01-11,MIL,105,17,15,SAC,106,9,24,26,39
1992-01-11,NYK,100,20,11,BOS,96,21,13,41,24
1992-01-11,PHX,130,21,13,GOS,118,21,9,42,22
1992-01-12,LAL,112,20,14,ORL,99,7,26,27,40
1992-01-13,LAC,98,18,19,SEA,94,18,16,36,35
1992-01-13,DET,84,20,16,DAL,81,12,22,32,38
1992-01-13,PHX,131,22,13,MIN,111,7,26,29,39
1992-01-13,DEN,111,13,21,SAC,109,10,24,23,45
1992-01-14,CHI,103,29,5,PHL,80,16,19,45,24
1992-01-14,WAS,127,13,21,IND,118,14,21,27,42
1992-01-14,UTH,116,22,15,MIN,110,7,27,29,42
1992-01-14,ORL,111,7,27,NYK,115,21,11,28,38
1992-01-14,SAN,123,20,14,GOS,124,21,10,41,24
1992-01-14,ATL,93,18,16,MIL,88,17,16,35,32
1992-01-14,CLE,114,24,9,POR,121,22,12,46,21
1992-01-14,HOU,111,19,16,DEN,94,14,21,33,37
1992-01-14,SEA,116,18,17,CHH,117,10,25,28,42
1992-01-14,NJN,97,14,21,DAL,88,12,23,26,44
1992-01-15,BOS,120,21,14,NJN,130,15,21,36,35
1992-01-15,LAL,95,21,14,CHH,93,11,25,32,39
1992-01-15,SAC,111,10,25,PHX,128,23,13,33,38
1992-01-15,IND,104,14,22,DET,118,21,16,35,38
1992-01-15,MIA,134,15,21,MIL,115,17,17,32,38
1992-01-15,NYK,91,22,11,POR,96,23,12,45,23
1992-01-16,WAS,94,14,21,MIA,102,16,21,30,42
1992-01-16,HOU,91,20,16,GOS,98,22,10,42,26
1992-01-16,MIN,111,7,28,SAN,125,20,15,27,43
1992-01-16,CLE,85,24,10,CHI,100,30,5,54,15
1992-01-16,UTH,116,23,15,ATL,111,19,16,42,31
1992-01-16,DAL,90,12,24,DEN,101,14,22,26,46
1992-01-16,SEA,101,18,18,LAC,98,19,19,37,37
1992-01-17,CHI,102,31,5,SAN,96,21,15,52,20
1992-01-17,LAC,111,19,20,ATL,107,19,17,38,37
1992-01-17,MIL,90,17,18,NYK,85,22,12,39,30
1992-01-17,PHX,134,24,13,SAC,94,10,26,34,39
1992-01-17,IND,120,14,23,ORL,127,7,28,21,51
1992-01-17,POR,120,24,12,CHH,104,11,26,35,38
1992-01-17,BOS,98,21,15,PHL,95,16,20,37,35
1992-01-18,WAS,101,14,22,PHL,105,16,21,30,43
1992-01-18,CLE,108,24,11,NYK,106,22,13,46,24
1992-01-18,DAL,141,12,25,GOS,143,23,10,35,35
1992-01-18,MIN,100,7,29,NJN,112,16,21,23,50
1992-01-18,IND,127,14,24,MIA,103,17,21,31,45
1992-01-18,UTH,108,24,15,HOU,80,20,17,44,32
1992-01-18,SAC,119,10,27,CHH,113,11,27,21,54
1992-01-18,SEA,112,19,18,LAL,108,22,14,41,32
1992-01-19,BOS,98,22,15,SAN,89,21,16,43,31
1992-01-19,DEN,93,15,22,ATL,119,19,18,34,40
1992-01-19,PHX,132,25,13,POR,128,25,12,50,25
1992-01-19,MIL,108,18,18,ORL,98,8,28,26,46
1992-01-19,DET,85,22,16,CHI,87,32,5,54,21
1992-01-20,PHL,99,17,21,WAS,91,14,23,31,44
1992-01-20,CLE,102,25,11,BOS,107,23,15,48,26
1992-01-20,LAL,116,22,15,SEA,110,20,18,42,33
1992-01-20,GOS,135,24,10,CHH,119,11,28,35,38
1992-01-20,NYK,105,22,14,IND,97,15,24,37,38
1992-01-20,MIA,121,17,22,MIN,106,7,30,24,52
1992-01-21,SEA,119,20,19,ATL,128,20,18,40,37
1992-01-21,SAN,114,21,17,LAC,100,20,20,41,37
1992-01-21,POR,131,25,13,LAL,92,23,15,48,28
1992-01-21,SAC,94,11,27,DEN,85,15,23,26,50
1992-01-21,HOU,117,20,18,MIL,107,19,18,39,36
1992-01-21,ORL,105,8,29,MIN,92,7,31,15,60
1992-01-21,CHI,108,33,5,PHX,102,26,13,59,18
1992-01-22,CHH,112,11,29,CHI,115,34,5,45,34
1992-01-22,GOS,136,25,10,ATL,124,21,18,46,28
1992-01-22,DAL,118,12,26,MIL,116,19,19,31,45
1992-01-22,NJN,106,17,21,PHX,104,26,14,43,35
1992-01-22,CLE,119,25,12,IND,115,15,25,40,37
1992-01-22,BOS,107,24,15,ORL,95,9,29,33,44
1992-01-22,MIA,125,18,22,WAS,112,14,24,32,46
1992-01-22,UTH,100,25,15,SAN,98,22,17,47,32
1992-01-22,PHL,119,18,21,NYK,109,23,14,41,35
1992-01-23,DEN,115,15,24,UTH,111,26,15,41,39
1992-01-23,SAC,105,12,27,LAL,108,23,16,35,43
1992-01-23,MIN,100,7,32,DET,111,22,17,29,49
1992-01-23,SEA,109,20,20,POR,113,26,13,46,33
1992-01-23,HOU,109,21,18,LAC,96,20,21,41,39
1992-01-24,PHL,119,19,21,MIN,86,7,33,26,54
1992-01-24,NJN,123,18,21,MIA,117,19,22,37,43
1992-01-24,SAN,115,22,18,MIL,86,19,20,41,38
1992-01-24,BOS,93,25,15,PHX,100,26,15,51,30
1992-01-24,IND,102,15,26,CLE,104,26,12,41,38
1992-01-24,POR,125,27,13,ATL,117,21,19,48,32
1992-01-24,CHI,117,35,5,DET,93,23,17,58,22
1992-01-24,ORL,121,9,30,DAL,103,13,26,22,56
1992-01-24,GOS,109,26,10,NYK,114,23,15,49,25
1992-01-24,LAL,95,24,16,SAC,92,12,28,36,44
1992-01-25,CHI,114,36,5,HOU,100,22,18,58,23
1992-01-25,CHH,107,11,30,IND,105,15,27,26,57
1992-01-25,DEN,107,16,24,MIL,100,19,21,35,45
1992-01-25,SEA,103,20,21,UTH,104,26,16,46,37
1992-01-25,PHL,115,20,21,NJN,94,19,21,39,42
1992-01-25,LAC,93,20,22,NYK,100,24,15,44,37
1992-01-25,ORL,99,10,30,CLE,96,27,12,37,42
1992-01-25,MIA,103,19,23,DAL,101,13,27,32,50
1992-01-25,WAS,115,14,25,PHX,121,27,15,41,40
1992-01-26,BOS,106,25,16,DET,91,23,18,48,34
1992-01-27,UTH,80,27,16,NYK,97,25,15,52,31
1992-01-28,SAN,109,23,18,CHI,104,37,5,60,23
1992-01-28,HOU,111,22,19,MIN,102,7,34,29,53
1992-01-28,WAS,87,14,26,BOS,98,26,16,40,42
1992-01-28,ORL,97,11,30,SEA,102,20,22,31,52
1992-01-28,SAC,124,12,29,NJN,118,19,22,31,51
1992-01-28,GOS,116,26,11,POR,124,28,13,54,24
1992-01-28,ATL,110,21,20,PHL,109,21,21,42,41
1992-01-28,CHH,95,12,30,DET,100,23,19,35,49
1992-01-29,DET,90,24,19,CLE,95,27,13,51,32
1992-01-29,UTH,124,27,17,SAC,105,13,29,40,46
1992-01-29,PHX,128,28,15,NJN,95,19,23,47,38
1992-01-29,MIL,100,19,22,ATL,110,22,20,41,42
1992-01-29,NYK,101,26,15,WAS,89,14,27,40,42
1992-01-29,LAL,112,25,16,GOS,99,26,12,51,28
1992-01-29,PHL,90,21,22,IND,115,15,28,36,50
1992-01-29,DAL,93,13,28,SAN,108,24,18,37,46
1992-01-29,MIA,119,20,23,SEA,114,21,22,41,45
1992-01-30,CLE,115,28,13,ORL,98,11,31,39,44
1992-01-30,DEN,96,17,24,LAL,106,26,16,43,40
1992-01-30,HOU,105,23,19,CHI,102,37,6,60,25
1992-01-31,CHH,105,12,31,SEA,122,21,23,33,54
1992-01-31,SAN,103,25,18,MIN,101,7,35,32,53
1992-01-31,POR,113,29,13,NJN,108,19,24,48,37
1992-01-31,MIL,102,19,23,BOS,100,27,16,46,39
1992-01-31,WAS,114,14,28,NYK,125,27,15,41,43
1992-01-31,DET,109,24,20,MIA,98,21,23,45,43
1992-01-31,SAC,112,13,30,LAC,109,20,23,33,53
1992-01-31,DAL,92,13,29,CHI,107,37,7,50,36
1992-01-31,UTH,117,28,17,PHX,116,29,15,57,32
1992-01-31,GOS,124,26,13,DEN,103,17,25,43,38
1992-01-31,IND,115,16,28,ATL,106,23,20,39,48
1992-01-31,PHL,112,21,23,ORL,88,11,32,32,55
1992-02-01,LAC,99,20,24,NJN,88,19,25,39,49
1992-02-01,DAL,90,13,30,UTH,104,29,17,42,47
1992-02-01,ATL,80,23,21,DET,89,25,20,48,41
1992-02-01,PHX,106,29,16,HOU,92,24,19,53,35
1992-02-01,PHL,126,22,23,BOS,110,27,17,49,40
1992-02-02,LAL,97,27,16,CHI,103,38,7,65,23
1992-02-02,NYK,113,28,15,GOS,120,27,13,55,28
1992-02-02,WAS,114,14,29,ORL,104,11,33,25,62
1992-02-02,MIA,118,21,24,CHH,100,12,32,33,56
1992-02-02,DEN,122,17,26,IND,128,17,28,34,54
1992-02-02,CLE,106,29,13,MIN,95,7,36,36,49
1992-02-02,POR,147,30,13,SAC,107,14,30,44,43
1992-02-02,MIL,122,20,23,SEA,106,22,23,42,46
1992-02-03,ATL,110,23,22,SEA,112,22,24,45,46
1992-02-03,ORL,114,11,34,GOS,122,28,13,39,47
1992-02-03,SAC,99,14,31,DAL,95,13,31,27,62
1992-02-03,UTH,126,30,17,CHI,123,39,7,69,24
1992-02-03,PHX,113,30,16,LAL,104,27,17,57,33
1992-02-03,HOU,122,24,20,IND,111,18,28,42,48
1992-02-03,MIN,114,7,37,DEN,99,17,27,24,64
1992-02-04,LAC,97,21,24,DAL,80,13,32,34,56
1992-02-04,CHH,115,12,33,WAS,99,15,29,27,62
1992-02-04,NYK,122,28,16,MIA,91,22,24,50,40
1992-02-04,SAN,95,26,18,POR,88,31,13,57,31
1992-02-05,NJN,85,19,26,SEA,95,23,24,42,50
1992-02-05,SAC,100,15,31,UTH,98,31,17,46,48
1992-02-05,PHX,126,31,16,CHI,114,39,8,70,24
1992-02-05,PHL,108,23,23,CLE,110,30,13,53,36
1992-02-05,MIA,126,22,25,GOS,124,29,13,51,38
1992-02-05,MIN,102,8,37,ORL,109,11,35,19,72
1992-02-05,DET,102,26,20,MIL,94,21,23,47,43
1992-02-05,BOS,98,27,18,HOU,85,25,20,52,38
1992-02-05,LAL,100,27,18,LAC,95,22,24,49,42
1992-02-06,ATL,123,23,23,ORL,112,12,35,35,58
1992-02-06,NYK,102,29,16,HOU,85,25,21,54,37
1992-02-06,CLE,95,31,13,DET,112,27,20,58,33
1992-02-06,DAL,98,13,33,POR,103,31,14,44,47
1992-02-06,CHH,132,13,33,GOS,113,29,14,42,47
1992-02-06,MIL,106,21,24,DEN,97,17,28,38,52
1992-02-06,WAS,124,15,30,NJN,108,19,27,34,57
1992-02-06,SAN,106,27,18,IND,117,18,29,45,47
1992-02-11,SEA,105,24,24,HOU,99,25,22,49,46
1992-02-11,SAN,100,27,19,BOS,84,28,18,55,37
1992-02-11,ATL,108,24,23,CHH,113,14,33,38,56
1992-02-11,ORL,98,12,36,IND,100,19,29,31,65
1992-02-11,CHI,133,39,9,NJN,113,19,28,58,37
1992-02-11,MIN,108,8,38,LAL,116,28,18,36,56
1992-02-11,GOS,139,29,15,WAS,127,16,30,45,45
1992-02-11,MIA,102,23,25,PHL,114,23,24,46,49
1992-02-11,UTH,111,31,18,CLE,109,31,14,62,32
1992-02-11,MIL,104,22,24,DET,87,28,20,50,44
1992-02-11,POR,121,32,14,DEN,112,17,29,49,43
1992-02-12,SAC,98,16,31,WAS,97,16,31,32,62
1992-02-12,DAL,108,13,34,BOS,100,28,19,41,53
1992-02-12,LAC,97,22,25,HOU,95,25,23,47,48
1992-02-12,IND,104,20,29,NYK,111,30,16,50,45
1992-02-12,DEN,108,17,30,CLE,102,31,15,48,45
1992-02-12,PHX,97,32,16,POR,107,33,14,65,30
1992-02-12,PHL,87,24,24,NJN,102,19,29,43,53
1992-02-13,UTH,97,32,18,LAL,91,29,18,61,36
1992-02-13,NYK,85,31,16,CHI,106,40,9,71,25
1992-02-13,MIA,121,23,26,ATL,119,24,24,47,50
1992-02-13,MIL,127,23,24,CHH,118,15,33,38,57
1992-02-13,GOS,109,30,15,SAN,94,28,19,58,34
1992-02-13,DET,93,28,21,MIN,96,8,39,36,60
1992-02-14,IND,107,20,30,MIL,100,24,24,44,54
1992-02-14,SAC,106,17,31,POR,107,34,14,51,45
1992-02-14,NJN,107,20,29,PHL,99,24,25,44,54
1992-02-14,LAL,92,29,19,WAS,108,16,32,45,51
1992-02-14,DEN,105,18,30,DAL,85,14,34,32,64
1992-02-14,SEA,108,25,24,SAN,91,28,20,53,44
1992-02-14,ORL,107,12,37,ATL,112,24,25,36,62
1992-02-14,HOU,105,25,24,BOS,99,28,20,53,44
1992-02-14,LAC,104,23,25,PHX,97,32,17,55,42
1992-02-15,GOS,140,31,15,SEA,122,26,24,57,39
1992-02-15,DAL,103,14,35,HOU,99,26,24,40,59
1992-02-15,PHX,124,32,18,WAS,98,17,32,49,50
1992-02-15,CHI,99,41,9,NYK,98,31,17,72,26
1992-02-15,MIN,101,9,39,IND,117,21,30,30,69
1992-02-15,UTH,106,33,18,DEN,93,19,30,52,48
1992-02-15,CLE,128,31,16,NJN,92,21,29,52,45
1992-02-16,PHL,83,24,26,DET,90,28,22,52,48
1992-02-16,ORL,118,12,38,MIL,104,24,25,36,63
1992-02-16,CHH,126,15,34,MIA,109,24,26,39,60
1992-02-16,POR,106,35,14,LAC,107,24,25,59,39
1992-02-16,LAL,107,29,20,BOS,114,28,21,57,41
1992-02-16,SAC,106,17,32,SAN,112,28,21,45,53
1992-02-17,GOS,116,32,15,LAL,100,29,21,61,36
1992-02-17,CHI,112,42,9,CLE,113,32,16,74,25
1992-02-17,MIA,102,24,27,NYK,104,31,18,55,45
1992-02-17,WAS,110,17,33,ATL,117,25,25,42,58
1992-02-17,HOU,122,26,25,MIN,124,9,40,35,65
1992-02-17,IND,128,22,30,CHH,117,16,34,38,64
1992-02-17,LAC,124,25,25,SAN,110,29,21,54,46
1992-02-17,SEA,98,26,25,PHX,96,33,18,59,43
1992-02-17,UTH,88,34,18,BOS,83,29,21,63,39
1992-02-18,POR,129,35,15,PHX,116,33,19,68,34
1992-02-18,MIL,128,24,26,CLE,116,33,16,57,42
1992-02-18,DAL,90,15,35,PHL,94,24,27,39,62
1992-02-18,NYK,110,32,18,SAC,97,17,33,49,51
1992-02-18,DET,117,29,22,ORL,95,13,38,42,60
1992-02-19,ORL,99,13,39,CHI,112,42,10,55,49
1992-02-19,UTH,118,35,18,DAL,96,15,36,50,54
1992-02-19,ATL,102,26,25,WAS,103,17,34,43,59
1992-02-19,IND,129,23,30,SAC,115,17,34,40,64
1992-02-19,GOS,117,33,15,BOS,112,29,22,62,37
1992-02-19,NJN,106,21,30,DET,102,30,22,51,52
1992-02-19,SAN,113,29,22,MIN,103,10,40,39,62
1992-02-19,LAC,125,26,25,LAL,94,29,22,55,47
1992-02-19,CHH,106,16,35,DEN,104,19,31,35,66
1992-02-20,NYK,89,33,18,CLE,92,33,17,66,35
1992-02-20,HOU,110,26,26,PHL,101,25,27,51,53
1992-02-20,SEA,105,27,25,LAL,103,29,23,56,48
1992-02-20,MIL,109,25,26,MIA,111,24,28,49,54
1992-02-21,WAS,99,18,34,DEN,106,19,32,37,66
1992-02-21,GOS,123,34,15,PHX,115,33,20,67,35
1992-02-21,UTH,124,36,18,HOU,97,27,26,63,44
1992-02-21,BOS,113,29,23,CHH,110,17,35,46,58
1992-02-21,CLE,119,34,17,SAC,102,17,35,51,52
1992-02-21,SAN,100,30,22,PHL,90,25,28,55,50
1992-02-21,LAC,116,27,25,POR,123,36,15,63,40
1992-02-21,NJN,105,22,30,IND,101,24,30,46,60
1992-02-21,DAL,109,15,37,MIN,94,10,41,25,78
1992-02-21,ATL,88,26,26,CHI,103,43,10,69,36
1992-02-21,ORL,100,13,40,DET,114,30,23,43,63
1992-02-22,LAL,124,29,24,GOS,126,35,15,64,39
1992-02-22,CHI,105,44,10,MIN,90,10,42,54,52
1992-02-22,PHX,130,33,21,LAC,112,27,26,60,47
1992-02-22,SEA,113,28,25,POR,104,37,15,65,40
1992-02-22,CHH,130,17,36,ORL,110,13,41,30,77
1992-02-22,NYK,98,33,19,DEN,87,20,32,53,51
1992-02-22,ATL,119,26,27,NJN,107,23,30,49,57
1992-02-22,MIA,107,25,28,DET,98,31,23,56,51
1992-02-23,CLE,103,35,17,MIL,89,25,27,60,44
1992-02-23,HOU,90,27,27,SAN,83,31,22,58,49
1992-02-23,WAS,117,18,35,SAC,124,17,36,35,71
1992-02-23,IND,102,24,31,BOS,95,30,23,54,54
1992-02-24,DAL,131,16,37,GOS,138,36,15,52,52
1992-02-24,POR,110,37,16,UTH,107,37,18,74,34
1992-02-24,PHL,108,25,29,SAC,96,18,36,43,65
1992-02-24,ATL,117,27,27,DEN,95,20,33,47,60
1992-02-24,MIN,91,10,43,SEA,106,29,25,39,68
1992-02-24,PHX,104,34,21,NYK,95,34,19,68,40
1992-02-25,SAN,123,31,23,MIA,101,26,28,57,51
1992-02-25,LAC,101,27,27,UTH,106,37,19,64,46
1992-02-25,CHH,94,18,36,MIL,82,25,28,43,64
1992-02-25,NJN,109,23,31,BOS,95,30,24,53,55
1992-02-25,DET,108,31,24,CHI,106,45,10,76,34
1992-02-26,LAL,81,29,25,NYK,68,34,20,63,45
1992-02-26,HOU,118,28,27,GOS,116,37,15,65,42
1992-02-26,ORL,95,13,42,PHL,89,26,29,39,71
1992-02-26,BOS,130,30,25,IND,109,25,31,55,56
1992-02-26,PHX,103,35,21,CLE,100,36,17,71,38
1992-02-26,MIN,106,10,44,DAL,105,16,38,26,82
1992-02-26,DEN,98,20,34,MIA,105,26,29,46,63
1992-02-26,CHI,122,45,11,WAS,103,18,36,63,47
1992-02-27,DET,104,32,24,MIL,97,25,29,57,53
1992-02-27,CHH,136,19,36,PHL,84,26,30,45,66
1992-02-27,SAN,124,32,23,GOS,103,37,16,69,39
1992-02-27,UTH,124,38,19,SEA,130,30,25,68,44
1992-02-27,NJN,98,24,31,POR,96,38,16,62,47
1992-02-27,SAC,110,18,37,NYK,109,34,21,52,58
1992-02-28,ATL,102,28,27,BOS,90,31,25,59,52
1992-02-28,MIL,105,25,30,CHI,109,46,11,71,41
1992-02-28,WAS,96,18,37,POR,117,38,17,56,54
1992-02-28,DEN,81,20,35,HOU,84,29,27,49,62
1992-02-28,IND,114,25,32,ORL,109,14,42,39,74
1992-02-28,LAC,108,27,28,MIA,92,27,29,54,57
1992-02-28,DAL,115,16,39,PHX,107,36,21,52,60
1992-02-28,LAL,90,30,25,CLE,101,36,18,66,43
1992-02-29,NYK,103,34,22,MIN,87,11,44,45,66
1992-02-29,WAS,92,18,38,PHL,101,26,31,44,69
1992-02-29,SAC,115,19,37,SEA,110,31,25,50,62
1992-02-29,DET,90,33,24,NJN,99,25,31,58,55
1992-02-29,SAN,115,33,23,DEN,112,20,36,53,59
1992-02-29,CHH,121,20,36,IND,119,26,32,46,68
1992-02-29,GOS,136,37,17,MIA,110,27,30,64,47
1992-03-01,SEA,113,31,26,CLE,107,37,18,68,44
1992-03-01,BOS,101,31,26,DAL,91,17,39,48,65
1992-03-01,PHX,114,36,22,UTH,109,38,20,74,42
1992-03-01,MIL,109,25,31,ATL,106,29,27,54,58
1992-03-01,NJN,90,26,31,NYK,75,35,22,61,53
1992-03-01,LAL,97,30,26,HOU,105,30,27,60,53
1992-03-01,ORL,96,14,43,LAC,101,28,28,42,71
1992-03-01,CHI,111,47,11,POR,91,39,17,86,28
1992-03-02,DET,99,33,25,WAS,89,18,39,51,64
1992-03-02,SAC,98,20,37,GOS,118,38,17,58,54
1992-03-03,MIN,102,11,45,SAN,103,34,23,45,68
1992-03-03,SEA,111,32,26,DEN,92,20,37,52,63
1992-03-03,NYK,102,35,23,DAL,83,17,40,52,63
1992-03-03,ORL,93,14,44,WAS,106,18,40,32,84
1992-03-03,POR,105,39,18,LAL,101,30,27,69,45
1992-03-03,PHX,112,37,22,HOU,107,31,27,68,49
1992-03-03,CHI,101,48,11,IND,103,26,33,74,44
1992-03-03,MIA,116,27,31,LAC,117,29,28,56,59
1992-03-03,GOS,101,39,17,UTH,123,38,21,77,38
1992-03-04,BOS,125,32,26,ORL,100,14,45,46,71
1992-03-04,DET,110,34,25,IND,107,27,33,61,58
1992-03-04,PHL,107,27,31,ATL,102,29,28,56,59
1992-03-04,DEN,100,20,38,POR,129,40,18,60,56
1992-03-04,SAC,108,20,38,CLE,109,37,19,57,57
1992-03-04,UTH,102,39,21,SAN,93,35,23,74,44
1992-03-04,MIL,110,26,31,CHH,119,21,36,47,67
1992-03-04,LAL,101,30,28,NJN,92,27,31,57,59
1992-03-05,NYK,101,36,23,LAC,91,30,28,66,51
1992-03-05,PHX,118,38,22,SEA,105,33,26,71,48
1992-03-05,GOS,116,39,18,CLE,108,38,19,77,37
1992-03-05,MIN,100,11,46,CHI,113,48,12,59,58
1992-03-05,HOU,114,31,28,MIA,93,27,32,58,60
1992-03-05,WAS,119,19,40,DAL,109,17,41,36,81
1992-03-06,DEN,91,20,39,DET,106,35,25,55,64
1992-03-06,ATL,113,29,29,IND,115,27,34,56,63
1992-03-06,POR,114,41,18,SAC,106,20,39,61,57
1992-03-06,CHI,123,49,12,MIA,81,27,33,76,45
1992-03-06,MIL,124,26,32,ORL,102,14,46,40,78
1992-03-06,UTH,117,40,21,NJN,96,27,32,67,53
1992-03-06,PHL,88,28,31,DAL,86,17,42,45,73
1992-03-06,BOS,117,33,26,LAC,100,30,29,63,55
1992-03-07,ATL,94,29,30,CLE,110,38,20,67,50
1992-03-07,WAS,94,20,40,MIL,90,27,32,47,72
1992-03-07,SAN,122,35,24,PHX,109,39,22,74,46
1992-03-07,SEA,109,33,27,NJN,98,27,33,60,60
1992-03-07,IND,108,28,34,MIN,97,11,47,39,81
1992-03-07,NYK,107,37,23,CHH,78,22,36,59,59
1992-03-07,GOS,110,40,18,HOU,100,32,28,72,46
1992-03-08,ORL,93,14,47,BOS,111,34,26,48,73
1992-03-08,DEN,88,20,40,UTH,112,41,21,61,61
1992-03-08,MIA,112,27,34,WAS,98,21,40,48,74
1992-03-08,PHL,99,29,31,CHI,103,50,12,79,43
1992-03-08,LAC,97,30,30,GOS,96,41,18,71,48
1992-03-08,LAL,93,31,28,DET,98,36,25,67,53
1992-03-08,POR,109,42,18,SEA,97,34,27,76,45
1992-03-08,DAL,81,17,43,SAN,93,36,24,53,67
1992-03-08,SAC,108,20,40,HOU,109,32,29,52,69
1992-03-09,PHL,99,29,32,NYK,111,38,23,67,55
1992-03-10,SAN,103,37,24,ATL,92,29,31,66,55
1992-03-10,NYK,104,39,23,LAL,106,31,29,70,52
1992-03-10,MIL,112,27,33,POR,126,43,18,70,51
1992-03-10,CLE,102,39,20,PHX,100,39,23,78,43
1992-03-10,HOU,116,33,29,DAL,93,17,44,50,73
1992-03-10,IND,101,29,34,WAS,91,21,41,50,75
1992-03-10,SEA,92,34,28,DET,98,37,25,71,53
1992-03-10,ORL,82,14,48,DEN,89,20,41,34,89
1992-03-10,MIA,108,28,34,BOS,101,35,26,63,60
1992-03-10,SAC,109,20,41,LAC,120,31,30,51,71
1992-03-10,CHH,105,22,37,MIN,96,11,48,33,85
1992-03-10,GOS,129,41,19,NJN,122,27,34,68,53
1992-03-11,PHL,111,29,33,IND,93,30,34,59,67
1992-03-11,CHI,119,51,12,BOS,85,35,27,86,39
1992-03-11,ATL,98,29,32,LAL,109,32,29,61,61
1992-03-11,MIN,113,11,49,POR,124,44,18,55,67
1992-03-11,DAL,105,17,45,CHH,120,23,37,40,82
1992-03-11,LAC,96,32,30,SEA,104,34,29,66,59
1992-03-12,SAN,104,38,24,HOU,98,34,29,72,53
1992-03-12,MIL,100,27,34,PHX,106,39,24,66,58
1992-03-12,GOS,112,42,19,DET,119,38,25,80,44
1992-03-12,SAC,103,20,42,UTH,114,42,21,62,63
1992-03-13,MIA,113,29,34,DEN,109,21,41,50,75
1992-03-13,HOU,118,34,30,CHH,100,24,37,58,67
1992-03-13,ATL,95,29,33,POR,106,45,18,74,51
1992-03-13,WAS,118,21,42,MIN,115,11,50,32,92
1992-03-13,CLE,109,40,20,LAL,107,33,29,73,49
1992-03-13,LAC,105,32,31,DAL,97,17,46,49,77
1992-03-13,PHL,104,30,33,PHX,108,40,24,70,57
1992-03-13,ORL,98,14,49,IND,97,30,35,44,84
1992-03-13,BOS,108,35,28,NJN,110,27,35,62,63
1992-03-14,SAC,83,20,43,DET,89,39,25,59,68
1992-03-14,ATL,115,29,34,MIA,102,30,34,59,68
1992-03-14,SAN,113,39,24,UTH,106,43,21,82,45
1992-03-14,MIL,110,27,35,PHL,105,30,34,57,69
1992-03-14,ORL,96,15,49,CHI,112,52,12,67,61
1992-03-14,WAS,89,22,42,LAL,92,33,30,55,72
1992-03-14,NYK,94,39,24,NJN,96,28,35,67,59
1992-03-15,LAC,131,33,31,SAC,105,20,44,53,75
1992-03-15,CLE,100,41,20,DEN,91,21,42,62,62
1992-03-15,BOS,152,35,29,POR,148,46,18,81,47
1992-03-15,HOU,106,35,30,UTH,97,43,22,78,52
1992-03-15,MIN,113,11,51,PHX,118,41,24,52,75
1992-03-15,SEA,109,35,29,DAL,100,17,47,52,76
1992-03-16,IND,98,30,36,LAL,85,34,30,64,66
1992-03-16,MIA,100,30,35,CHI,116,53,12,83,47
1992-03-16,DET,77,40,25,ATL,89,30,34,70,59
1992-03-16,SAN,112,40,24,CHH,117,24,38,64,62
1992-03-16,WAS,102,22,43,CLE,111,42,20,64,63
1992-03-17,SEA,107,36,29,GOS,119,42,20,78,49
1992-03-17,PHX,92,42,24,DAL,81,17,48,59,72
1992-03-17,HOU,100,36,30,LAC,92,34,31,70,61
1992-03-17,ORL,86,15,50,NYK,99,39,25,54,75
1992-03-17,POR,111,46,19,MIN,91,11,52,57,71
1992-03-17,MIL,127,28,35,BOS,106,36,29,64,64
1992-03-17,DEN,118,21,43,SAC,100,20,45,41,88
1992-03-17,NJN,79,29,35,CHI,90,54,12,83,47
1992-03-18,DET,91,40,26,PHL,85,30,35,70,61
1992-03-18,SAN,118,40,25,SAC,89,20,46,60,71
1992-03-18,BOS,96,36,30,CLE,94,43,20,79,50
1992-03-18,GOS,123,43,20,MIN,120,11,53,54,73
1992-03-18,DAL,86,17,49,LAC,117,34,32,51,81
1992-03-18,ATL,96,31,34,ORL,99,15,51,46,85
1992-03-18,MIA,111,30,36,IND,116,31,36,61,72
1992-03-18,LAL,93,34,31,POR,98,47,19,81,50
1992-03-19,HOU,91,37,30,SEA,112,36,30,73,60
1992-03-19,PHL,116,30,36,CHH,123,25,38,55,74
1992-03-19,NYK,96,40,25,MIL,92,29,35,69,60
1992-03-19,WAS,100,22,44,CHI,106,55,12,77,56
1992-03-19,UTH,115,43,23,DEN,100,22,43,65,66
1992-03-20,NJN,99,29,36,WAS,96,22,45,51,81
1992-03-20,DAL,96,17,50,SAC,125,20,47,37,97
1992-03-20,DET,99,41,26,BOS,104,37,30,78,56
1992-03-20,IND,102,32,36,MIL,97,29,36,61,72
1992-03-20,LAL,131,34,32,MIN,121,11,54,45,86
1992-03-20,CHH,110,26,38,ATL,112,31,35,57,73
1992-03-20,CLE,122,43,21,GOS,107,44,20,87,41
1992-03-20,PHX,101,43,24,LAC,114,35,32,78,56
1992-03-21,DEN,87,22,44,LAC,114,36,32,58,76
1992-03-21,SAN,101,41,25,SEA,96,37,30,78,55
1992-03-21,NYK,105,41,25,MIA,88,30,37,71,62
1992-03-21,UTH,95,44,23,POR,77,48,19,92,42
1992-03-21,CHI,108,56,12,ORL,111,16,51,72,63
1992-03-21,PHX,121,43,25,MIN,105,11,55,54,80
1992-03-21,HOU,97,37,31,SAC,100,21,47,58,78
1992-03-22,IND,108,33,36,PHL,100,30,37,63,73
1992-03-22,DAL,105,17,51,SEA,113,37,31,54,82
1992-03-22,BOS,114,38,30,GOS,97,44,21,82,51
1992-03-22,CHH,113,26,39,DET,101,41,27,67,66
1992-03-22,MIA,107,30,38,NJN,100,30,36,60,74
1992-03-22,MIL,109,29,37,WAS,88,22,46,51,83
1992-03-22,CLE,123,44,21,ATL,80,32,35,76,56
1992-03-23,PHL,105,30,38,SAN,92,42,25,72,63
1992-03-23,NJN,123,30,37,CHH,120,27,39,57,76
1992-03-23,ATL,126,32,36,GOS,125,44,22,76,58
1992-03-23,MIN,95,11,56,DEN,100,22,45,33,101
1992-03-24,SAC,113,22,47,MIL,102,30,37,52,84
1992-03-24,CHI,116,56,13,DEN,103,23,45,79,58
1992-03-24,POR,109,48,20,DAL,83,17,52,65,72
1992-03-24,NYK,126,42,25,ORL,117,17,51,59,76
1992-03-24,CLE,128,45,21,IND,113,34,36,79,57
1992-03-24,SEA,128,38,31,HOU,106,37,32,75,63
1992-03-25,NJN,110,31,37,BOS,118,39,30,70,67
1992-03-25,PHX,132,44,25,MIL,104,30,38,74,63
1992-03-25,DET,99,41,28,GOS,103,44,23,85,51
1992-03-25,WAS,109,22,47,IND,131,34,37,56,84
1992-03-25,MIN,97,11,57,MIA,105,31,38,42,95
1992-03-25,ORL,96,17,52,CLE,106,46,21,63,73
1992-03-25,UTH,100,45,23,PHL,94,31,38,76,61
1992-03-25,CHH,113,27,40,SAN,108,42,26,69,66
1992-03-26,LAL,115,35,32,DAL,92,17,53,52,85
1992-03-26,ATL,107,33,36,WAS,95,22,48,55,84
1992-03-26,DEN,104,23,46,NYK,106,43,25,66,71
1992-03-26,SAC,106,23,47,POR,128,49,20,72,67
1992-03-26,LAC,109,37,32,HOU,95,37,33,74,65
1992-03-27,SEA,96,39,31,MIL,95,30,39,69,70
1992-03-27,PHX,117,45,25,PHL,113,31,39,76,64
1992-03-27,IND,117,35,37,GOS,125,45,23,80,60
1992-03-27,CHH,115,28,40,CLE,121,47,21,75,61
1992-03-27,BOS,106,40,30,DET,87,41,29,81,59
1992-03-27,MIA,118,32,38,SAN,101,42,27,74,65
1992-03-27,UTH,92,46,23,LAL,103,36,32,82,55
1992-03-27,MIN,103,11,58,ATL,105,34,36,45,94
1992-03-28,CHI,126,57,13,CLE,102,48,21,105,34
1992-03-28,SEA,87,40,31,NYK,92,44,25,84,56
1992-03-28,ORL,100,17,53,MIA,109,33,38,50,91
1992-03-28,LAC,103,38,32,MIL,95,30,40,68,72
1992-03-28,DEN,101,23,47,PHX,121,46,25,69,72
1992-03-28,NJN,148,31,38,GOS,153,46,23,77,61
1992-03-28,POR,115,50,20,HOU,95,37,34,87,54
1992-03-28,WAS,113,22,49,CHH,97,28,41,50,90
1992-03-29,BOS,117,41,30,ATL,93,35,36,76,66
1992-03-29,DAL,105,17,54,DEN,98,23,48,40,102
1992-03-29,POR,96,51,20,NYK,107,45,25,96,45
1992-03-29,DET,107,41,30,SAN,103,42,28,83,58
1992-03-29,LAL,117,37,32,PHL,88,31,40,68,72
1992-03-29,MIN,86,11,59,SAC,112,23,48,34,107
1992-03-30,GOS,124,47,23,PHL,106,31,41,78,64
1992-03-30,UTH,120,46,24,MIL,100,30,41,76,65
1992-03-30,NJN,117,31,39,SAN,109,42,29,73,68
1992-03-30,CHH,123,28,42,ORL,112,17,54,45,96
1992-03-31,PHX,128,47,25,POR,111,51,21,98,46
1992-03-31,NYK,90,46,25,CHI,96,58,13,104,38
1992-03-31,DET,81,42,30,LAC,97,39,32,81,62
1992-03-31,HOU,101,37,35,LAL,107,38,32,75,67
1992-03-31,SEA,122,40,32,UTH,103,47,24,87,56
1992-03-31,SAC,136,24,48,GOS,148,48,23,72,71
1992-03-31,DEN,114,23,49,MIN,121,11,60,34,109
1992-03-31,CLE,123,48,22,MIA,114,34,38,82,60
1992-04-01,DAL,102,18,54,ORL,89,17,55,35,109
1992-04-01,SAN,104,42,30,LAL,86,39,32,81,62
1992-04-01,BOS,120,42,30,WAS,106,23,49,65,79
1992-04-01,IND,137,35,38,ATL,117,35,37,70,75
1992-04-01,CHI,100,59,13,CHH,94,29,42,88,55
1992-04-01,MIL,117,30,42,NJN,121,32,39,62,81
1992-04-01,PHL,108,31,42,MIA,91,34,39,65,81
1992-04-02,POR,118,51,22,UTH,86,47,25,98,47
1992-04-02,PHX,109,48,25,GOS,105,49,23,97,48
1992-04-02,SAC,103,24,49,SEA,111,41,32,65,81
1992-04-02,CHH,96,29,43,NYK,117,46,26,75,69
1992-04-02,CLE,115,49,22,LAC,98,40,32,89,54
1992-04-02,HOU,137,37,36,DEN,114,23,50,60,86
1992-04-03,CHI,114,60,13,LAC,103,40,33,100,46
1992-04-03,IND,101,36,38,BOS,97,43,30,79,68
1992-04-03,NYK,115,47,26,ATL,94,35,38,82,64
1992-04-03,UTH,113,47,26,PHX,94,49,25,96,51
1992-04-03,DAL,95,19,54,MIN,104,12,60,31,114
1992-04-03,WAS,119,23,50,DET,85,42,31,65,81
1992-04-03,SAN,106,43,30,ORL,113,17,56,60,86
1992-04-03,GOS,124,49,24,SAC,116,24,50,73,74
1992-04-03,NJN,122,33,39,MIL,103,30,43,63,82
1992-04-03,MIA,100,34,40,CLE,103,50,22,84,62
1992-04-03,LAL,91,39,33,SEA,96,42,32,81,65
1992-04-04,CHH,118,29,44,WAS,109,24,50,53,94
1992-04-04,HOU,110,38,36,ORL,101,18,56,56,92
1992-04-04,ATL,121,35,39,PHL,126,32,42,67,81
1992-04-05,MIN,93,13,60,UTH,91,48,26,61,86
1992-04-05,CLE,97,51,22,NYK,93,48,26,99,48
1992-04-05,IND,120,37,38,NJN,128,34,39,71,77
1992-04-05,BOS,97,43,31,CHI,86,61,13,104,44
1992-04-05,DEN,87,23,51,SAN,90,43,31,66,82
1992-04-05,SAC,103,24,51,DAL,89,19,55,43,106
1992-04-05,MIL,96,30,44,LAC,97,40,34,70,78
1992-04-05,GOS,122,50,24,POR,130,52,22,102,46
1992-04-05,DET,104,42,32,MIA,80,34,41,76,73
1992-04-05,LAL,109,39,34,PHX,104,49,26,88,60
1992-04-07,NYK,94,48,27,DET,103,43,32,91,59
1992-04-07,PHX,103,49,27,SAC,101,25,51,74,78
1992-04-07,CHI,116,61,14,MIL,101,30,45,91,59
1992-04-07,SAN,92,44,31,HOU,95,39,36,83,67
1992-04-07,POR,110,53,22,GOS,101,50,25,103,47
1992-04-07,DEN,101,23,52,UTH,124,48,27,71,79
1992-04-07,MIA,100,34,42,WAS,89,24,51,58,93
1992-04-07,ORL,135,18,57,CHH,110,30,44,48,101
1992-04-07,MIN,108,14,60,LAC,115,41,34,55,94
1992-04-07,CLE,97,52,22,BOS,100,44,31,96,53
1992-04-07,SEA,117,43,32,LAL,88,40,34,83,66
1992-04-07,NJN,97,35,39,ATL,104,35,40,70,79
1992-04-08,GOS,110,50,26,DAL,91,19,56,69,82
1992-04-08,PHL,71,33,42,DET,89,44,32,77,74
1992-04-08,WAS,103,24,52,NJN,109,35,40,59,92
1992-04-08,MIL,107,30,46,IND,122,37,39,67,85
1992-04-08,BOS,93,45,31,NYK,89,48,28,93,59
1992-04-09,LAC,106,42,34,POR,100,54,22,96,56
1992-04-09,SEA,119,44,32,PHX,104,50,27,94,59
1992-04-09,ORL,96,19,57,ATL,94,36,40,55,97
1992-04-09,UTH,113,49,27,DAL,90,19,57,68,84
1992-04-09,SAC,124,25,52,DEN,107,23,53,48,105
1992-04-09,CLE,141,52,23,CHH,134,30,45,82,68
1992-04-09,MIN,102,14,61,HOU,117,40,36,54,97
1992-04-09,LAL,94,40,35,SAN,102,44,32,84,67
1992-04-10,IND,96,38,39,CHI,108,62,14,100,53
1992-04-10,NJN,110,36,40,CLE,86,53,23,89,63
1992-04-10,NYK,115,48,29,PHL,99,33,43,81,72
1992-04-10,DET,125,45,32,CHH,106,30,46,75,78
1992-04-10,WAS,93,24,53,MIA,108,35,42,59,95
1992-04-10,POR,113,54,23,SEA,106,45,32,99,55
1992-04-10,BOS,109,46,31,MIL,100,30,47,76,78
1992-04-11,SAC,114,26,52,MIN,94,14,62,40,114
1992-04-11,ATL,118,36,41,NJN,98,37,40,73,81
1992-04-11,CHI,108,63,14,IND,106,38,40,101,54
1992-04-11,MIA,105,36,42,ORL,101,20,57,56,99
1992-04-11,LAL,90,40,36,UTH,93,50,27,90,63
1992-04-11,HOU,92,41,36,DAL,99,19,58,60,94
1992-04-11,LAC,122,43,34,DEN,88,23,54,66,88
1992-04-11,GOS,134,51,26,PHX,125,50,28,101,54
1992-04-12,CHH,102,30,47,BOS,128,47,31,77,78
1992-04-12,CLE,114,53,24,WAS,91,24,54,77,78
1992-04-12,SEA,126,45,33,MIN,116,14,63,59,96
1992-04-12,PHL,90,33,44,MIL,94,30,48,63,92
1992-04-12,DET,72,46,32,NYK,61,49,29,95,61
1992-04-12,POR,123,55,23,SAN,97,45,32,100,55
1992-04-13,UTH,138,51,27,GOS,99,52,26,103,53
1992-04-13,ORL,104,20,58,NJN,110,37,41,57,99
1992-04-13,LAL,100,40,37,DEN,93,23,55,63,92
1992-04-13,CHI,100,64,14,ATL,93,37,41,101,55
1992-04-14,CLE,115,54,24,CHI,100,65,14,119,38
1992-04-14,SAN,120,45,33,DAL,108,20,58,65,91
1992-04-14,MIL,94,31,48,DET,98,47,32,78,80
1992-04-14,NYK,93,49,30,WAS,90,24,55,73,85
1992-04-14,LAC,97,44,34,SAC,103,27,52,71,86
1992-04-14,IND,123,38,41,CHH,96,30,48,68,89
1992-04-14,MIA,100,37,42,NJN,105,38,41,75,83
1992-04-14,PHX,122,50,29,SEA,100,46,33,96,62
1992-04-14,HOU,108,41,37,POR,96,56,23,97,60
1992-04-14,MIN,100,14,64,GOS,122,52,27,66,91
1992-04-14,PHL,94,33,45,BOS,99,48,31,81,76
1992-04-15,DET,89,48,32,BOS,92,49,31,97,63
1992-04-15,DAL,94,20,59,POR,100,56,24,76,83
1992-04-15,DEN,110,23,56,LAL,107,41,37,64,93
1992-04-15,ORL,102,20,59,PHL,99,33,46,53,105
1992-04-15,CHH,115,30,49,CLE,107,55,24,85,73
1992-04-15,ATL,95,37,42,NYK,94,50,30,87,72
1992-04-15,UTH,130,52,27,HOU,98,42,37,94,64
1992-04-16,WAS,119,24,56,ORL,106,21,59,45,115
1992-04-16,MIA,95,37,43,MIL,87,31,49,68,92
1992-04-16,SAC,102,28,52,LAL,94,41,38,69,90
1992-04-16,LAC,96,44,35,MIN,93,14,65,58,100
1992-04-16,PHX,121,51,29,SAN,101,46,33,97,62
1992-04-16,NJN,113,39,41,IND,119,39,41,78,82
1992-04-17,SEA,130,46,34,SAC,106,29,52,75,86
1992-04-17,SAN,108,46,34,DEN,94,24,56,70,90
1992-04-17,IND,102,40,41,CLE,107,55,25,95,66
1992-04-17,ATL,95,38,42,CHI,121,65,15,103,57
1992-04-17,GOS,116,53,27,LAC,104,45,35,98,62
1992-04-17,UTH,120,53,27,MIN,106,14,66,67,93
1992-04-17,DAL,109,20,60,HOU,106,42,38,62,98
1992-04-17,CHH,112,31,49,PHL,122,33,47,64,96
1992-04-18,MIL,103,31,50,NYK,114,50,31,81,81
1992-04-18,POR,101,57,24,LAL,109,41,39,98,63
1992-04-18,NJN,127,39,42,ORL,111,21,60,60,102
1992-04-18,PHL,111,34,47,WAS,104,25,56,59,103
1992-04-19,DEN,92,24,57,DAL,104,21,60,45,117
1992-04-19,CLE,112,56,25,ATL,108,38,43,94,68
1992-04-19,CHI,103,66,15,DET,85,48,33,114,48
1992-04-19,BOS,109,50,31,MIA,93,38,43,88,74
1992-04-19,GOS,108,54,27,SEA,106,47,34,101,61
1992-04-19,SAN,90,47,34,UTH,101,54,27,101,61
1992-04-19,MIN,130,14,67,CHH,107,31,50,45,117
1992-04-19,LAL,109,42,39,LAC,108,45,36,87,75
1992-04-19,HOU,97,42,39,PHX,100,52,29,94,68
1992-11-06,LAC,112,0,0,LAL,114,0,0,0,0
1992-11-06,CLE,96,0,0,CHI,101,0,0,0,0
1992-11-06,SAC,114,0,0,SAN,106,0,0,0,0
1992-11-06,PHL,111,0,0,NJN,114,0,0,0,0
1992-11-06,ATL,94,0,0,NYK,106,0,0,0,0
1992-11-06,BOS,113,0,0,MIN,92,0,0,0,0
1992-11-06,DET,81,0,0,MIL,86,0,0,0,0
1992-11-06,UTH,114,0,0,GOS,129,0,0,0,0
1992-11-06,CHH,126,0,0,WAS,119,0,0,0,0
1992-11-06,HOU,94,0,0,SEA,111,0,0,0,0
1992-11-06,ORL,110,0,0,MIA,100,0,0,0,0
1992-11-07,MIN,119,0,1,GOS,121,1,0,1,1
1992-11-07,CHI,99,1,0,ATL,100,0,1,1,1
1992-11-07,SEA,89,1,0,HOU,85,0,1,1,1
1992-11-07,WAS,98,0,1,ORL,103,1,0,1,1
1992-11-07,NYK,89,1,0,PHL,85,0,1,1,1
1992-11-07,MIL,124,1,0,BOS,88,1,0,2,0
1992-11-07,DEN,125,0,0,SAN,121,0,1,0,1
1992-11-07,DAL,106,0,0,UTH,122,0,1,0,1
1992-11-07,PHX,111,0,0,LAC,105,0,1,0,1
1992-11-07,MIA,106,0,1,NJN,94,1,0,1,1
1992-11-07,IND,87,0,0,DET,89,0,1,0,1
1992-11-08,POR,123,0,0,DEN,104,1,0,1,0
1992-11-08,CLE,127,0,1,CHH,107,1,0,1,1
1992-11-08,LAL,114,1,0,SAC,124,1,0,2,0
1992-11-09,CHI,102,1,1,IND,97,0,1,1,2
1992-11-10,SAN,104,0,2,MIL,98,2,0,2,2
1992-11-10,ORL,108,2,0,CHH,112,1,1,3,1
1992-11-10,POR,100,1,0,PHX,89,1,0,2,0
1992-11-10,SAC,99,2,0,LAC,97,0,2,2,2
1992-11-10,CLE,131,1,1,WAS,92,0,2,1,3
1992-11-10,MIA,110,1,1,BOS,106,1,1,2,2
1992-11-10,MIN,118,0,2,DAL,104,0,1,0,3
1992-11-10,GOS,106,2,0,LAL,107,1,1,3,1
1992-11-10,DEN,109,1,1,UTH,118,1,1,2,2
1992-11-10,NYK,99,2,0,NJN,96,1,1,3,1
1992-11-11,DAL,116,0,2,MIL,124,2,1,2,3
1992-11-11,IND,120,0,2,PHL,114,0,2,0,4
1992-11-11,HOU,101,0,2,ATL,82,1,1,1,3
1992-11-11,CHI,98,2,1,DET,96,1,1,3,2
1992-11-11,CHH,99,2,1,BOS,109,1,2,3,3
1992-11-11,LAC,109,0,3,SAC,101,3,0,3,3
1992-11-12,DET,95,1,2,MIA,88,2,1,3,3
1992-11-12,UTH,91,2,1,PHX,102,1,1,3,2
1992-11-12,NJN,84,1,2,MIN,88,1,2,2,4
1992-11-12,GOS,122,2,1,CLE,126,2,1,4,2
1992-11-12,SEA,114,2,0,LAL,102,2,1,4,1
1992-11-12,SAN,97,1,2,ATL,104,1,2,2,4
1992-11-12,ORL,127,2,1,WAS,100,0,3,2,4
1992-11-13,WAS,106,0,4,NYK,104,3,0,3,4
1992-11-13,LAL,98,2,2,LAC,124,1,3,3,5
1992-11-13,POR,115,2,0,CLE,109,3,1,5,1
1992-11-13,IND,110,1,2,CHH,109,2,2,3,4
1992-11-13,MIL,96,3,1,CHI,101,3,1,6,2
1992-11-13,BOS,115,2,2,PHL,126,0,3,2,5
1992-11-14,UTH,124,2,2,LAC,104,2,3,4,5
1992-11-14,MIN,101,2,2,PHX,108,2,1,4,3
1992-11-14,SAN,87,1,3,HOU,93,1,2,2,5
1992-11-14,NYK,85,3,1,BOS,80,2,3,5,4
1992-11-14,SEA,133,3,0,SAC,117,3,1,6,1
1992-11-14,DAL,113,0,3,ATL,105,2,2,2,5
1992-11-14,GOS,116,2,2,POR,130,3,0,5,2
1992-11-14,CHH,95,2,3,MIA,104,2,2,4,5
1992-11-14,NJN,124,1,3,ORL,113,3,1,4,4
1992-11-14,DET,100,2,2,IND,104,2,2,4,4
1992-11-14,CHI,117,4,1,DEN,84,1,2,5,3
1992-11-15,SAC,109,3,2,CLE,107,3,2,6,4
1992-11-15,NJN,111,2,3,WAS,104,1,4,3,7
1992-11-15,LAL,105,2,3,GOS,102,2,3,4,6
1992-11-15,MIL,115,3,2,DEN,98,1,3,4,5
1992-11-16,POR,109,4,0,NYK,94,4,1,8,1
1992-11-16,PHX,117,3,1,SEA,108,4,0,7,1
1992-11-17,MIA,119,3,2,GOS,125,2,4,5,6
1992-11-17,WAS,101,1,5,BOS,97,2,4,3,9
1992-11-17,SEA,100,4,1,NYK,90,4,2,8,3
1992-11-17,LAC,115,2,4,DET,106,2,3,4,7
1992-11-17,MIN,103,2,3,CHI,124,5,1,7,4
1992-11-17,ATL,106,2,3,MIL,114,4,2,6,5
1992-11-17,CHH,134,2,4,DAL,111,1,3,3,7
1992-11-17,HOU,116,2,2,SAC,109,4,2,6,4
1992-11-17,NJN,97,3,3,UTH,108,3,2,6,5
1992-11-17,IND,128,3,2,DEN,98,1,4,4,6
1992-11-17,SAN,106,1,4,CLE,95,3,3,4,7
1992-11-18,BOS,91,2,5,UTH,92,4,2,6,7
1992-11-18,PHL,110,1,3,ORL,120,3,2,4,5
1992-11-18,PHX,127,4,1,SAC,111,4,3,8,4
1992-11-19,SAN,123,2,4,DAL,95,1,4,3,8
1992-11-19,ORL,126,4,2,GOS,102,3,4,7,6
1992-11-19,HOU,99,3,2,CLE,92,3,4,6,6
1992-11-19,LAC,101,3,4,NYK,91,4,3,7,7
1992-11-19,SEA,99,5,1,CHI,108,6,1,11,2
1992-11-19,ATL,101,2,4,NJN,108,3,4,5,8
1992-11-19,DEN,99,1,5,DET,87,2,4,3,9
1992-11-20,MIN,100,2,4,WAS,108,2,5,4,9
1992-11-20,IND,95,4,2,UTH,97,5,2,9,4
1992-11-20,PHL,129,1,4,MIA,128,3,3,4,7
1992-11-20,LAL,120,3,3,CHI,118,7,1,10,4
1992-11-20,SAC,99,4,4,POR,104,5,0,9,4
1992-11-20,CHH,117,3,4,GOS,110,3,5,6,9
1992-11-21,MIA,111,3,4,CHH,123,4,4,7,8
1992-11-21,SEA,138,5,2,DET,101,2,5,7,7
1992-11-21,HOU,103,4,2,SAN,100,3,4,7,6
1992-11-21,DAL,108,1,5,CLE,119,3,5,4,10
1992-11-21,LAC,111,4,4,PHX,107,5,1,9,5
1992-11-21,NJN,95,4,4,PHL,104,2,4,6,8
1992-11-21,DEN,131,2,5,MIN,118,2,5,4,10
1992-11-21,WAS,126,3,5,UTH,109,6,2,9,7
1992-11-21,MIL,105,5,2,IND,95,4,3,9,5
1992-11-21,ATL,116,2,5,BOS,107,2,6,4,11
1992-11-21,NYK,92,4,4,ORL,77,5,2,9,6
1992-11-22,PHX,111,5,2,CHI,128,7,2,12,4
1992-11-22,NJN,101,4,5,GOS,114,3,6,7,11
1992-11-22,LAL,119,4,3,DEN,107,3,5,7,8
1992-11-22,POR,115,6,0,DET,90,2,6,8,6
1992-11-23,BOS,97,2,7,ATL,101,3,5,5,12
1992-11-23,SAC,103,4,5,SEA,99,6,2,10,7
1992-11-24,SEA,103,6,3,NJN,97,4,6,10,9
1992-11-24,HOU,88,5,2,LAC,83,5,4,10,6
1992-11-24,GOS,92,4,6,CHI,101,8,2,12,8
1992-11-24,IND,114,4,4,MIA,82,3,5,7,9
1992-11-24,CHH,127,5,4,PHL,119,3,4,8,8
1992-11-24,NYK,98,5,4,WAS,88,4,5,9,9
1992-11-24,POR,95,7,0,SAN,91,3,5,10,5
1992-11-24,CLE,109,4,5,MIL,105,6,2,10,7
1992-11-25,ORL,107,5,3,HOU,94,6,2,11,5
1992-11-25,MIN,78,2,6,NYK,99,6,4,8,10
1992-11-25,PHX,121,5,3,POR,117,8,0,13,3
1992-11-25,BOS,150,2,8,WAS,112,4,6,6,14
1992-11-25,PHL,105,3,5,ATL,111,4,5,7,10
1992-11-25,DAL,112,1,6,LAC,130,5,5,6,11
1992-11-25,UTH,102,6,3,SAN,128,3,6,9,9
1992-11-25,MIL,94,6,3,CLE,85,5,5,11,8
1992-11-25,DET,97,2,7,CHH,101,6,4,8,11
1992-11-25,DEN,114,3,6,SAC,99,5,5,8,11
1992-11-25,LAL,98,5,3,NJN,100,4,7,9,10
1992-11-25,MIA,110,3,6,IND,93,5,4,8,10
1992-11-27,MIA,93,4,6,HOU,101,6,3,10,9
1992-11-27,POR,90,8,1,LAL,98,5,4,13,5
1992-11-27,CLE,122,5,6,ATL,101,5,5,10,11
1992-11-27,BOS,111,3,8,CHH,102,7,4,10,12
1992-11-27,DAL,104,1,7,SEA,127,7,3,8,10
1992-11-27,LAC,106,6,5,DEN,109,4,6,10,11
1992-11-27,WAS,83,4,7,MIN,102,2,7,6,14
1992-11-27,PHX,121,6,3,GOS,107,4,7,10,10
1992-11-27,IND,116,5,5,ORL,130,6,3,11,8
1992-11-27,PHL,111,3,6,MIL,115,7,3,10,9
1992-11-27,UTH,110,6,4,NJN,112,5,7,11,11
1992-11-28,MIN,82,3,7,DET,80,2,8,5,15
1992-11-28,MIL,97,8,3,WAS,95,4,8,12,11
1992-11-28,HOU,99,7,3,UTH,108,6,5,13,8
1992-11-28,ORL,95,7,3,CLE,93,6,6,13,9
1992-11-28,DEN,119,5,6,LAC,121,6,6,11,12
1992-11-28,ATL,112,5,6,MIA,100,4,7,9,13
1992-11-28,GOS,134,4,8,PHX,131,7,3,11,11
1992-11-28,SAN,104,4,6,SEA,97,8,3,12,9
1992-11-28,CHH,122,7,5,IND,134,5,6,12,11
1992-11-28,SAC,89,5,6,NJN,94,6,7,11,13
1992-11-28,NYK,112,7,4,CHI,75,9,2,16,6
1992-11-28,PHL,109,3,7,BOS,117,4,8,7,15
1992-11-29,POR,107,8,2,SAC,99,5,7,13,9
1992-11-29,LAL,114,6,4,DAL,85,1,8,7,12
1992-11-29,DET,92,2,9,NYK,76,8,4,10,13
1992-12-01,SAC,117,5,8,LAL,110,7,4,12,12
1992-12-01,SEA,116,8,4,ORL,102,8,3,16,7
1992-12-01,NYK,101,8,5,POR,85,9,2,17,7
1992-12-01,WAS,119,4,9,SAN,106,5,6,9,15
1992-12-01,UTH,116,7,5,DAL,101,1,9,8,14
1992-12-01,CLE,111,6,7,BOS,101,5,8,11,15
1992-12-01,PHX,109,7,4,CHH,90,7,6,14,10
1992-12-01,DEN,112,5,7,HOU,105,7,4,12,11
1992-12-01,ATL,119,6,6,IND,107,6,6,12,12
1992-12-02,NJN,122,7,7,ATL,115,7,6,14,13
1992-12-02,GOS,110,5,8,CHH,111,7,7,12,15
1992-12-02,IND,103,6,7,POR,112,9,3,15,10
1992-12-02,MIL,100,9,3,MIA,97,4,8,13,11
1992-12-02,BOS,101,5,9,CHI,96,9,3,14,12
1992-12-02,PHL,82,3,8,SAN,98,5,7,8,15
1992-12-03,CLE,100,7,7,NYK,90,9,5,16,12
1992-12-03,HOU,89,7,5,LAL,95,7,5,14,10
1992-12-03,LAC,122,7,6,ORL,104,8,4,15,10
1992-12-03,WAS,113,5,9,MIL,95,10,3,15,12
1992-12-03,UTH,110,8,5,MIN,91,4,7,12,12
1992-12-03,SEA,125,9,4,DAL,108,1,10,10,14
1992-12-04,DEN,116,6,7,GOS,113,5,9,11,16
1992-12-04,IND,122,6,8,ATL,106,7,7,13,15
1992-12-04,SAC,111,6,8,CHH,112,8,7,14,15
1992-12-04,PHX,103,8,4,LAL,93,8,5,16,9
1992-12-04,CHI,111,9,4,POR,99,10,3,19,7
1992-12-04,PHL,99,3,9,DET,101,3,9,6,18
1992-12-04,NJN,108,8,7,SAN,103,6,7,14,14
1992-12-04,BOS,114,6,9,MIA,104,4,9,10,18
1992-12-05,WAS,109,6,9,IND,111,7,8,13,17
1992-12-05,GOS,119,5,10,ORL,104,8,5,13,15
1992-12-05,DET,112,4,9,PHL,88,3,10,7,19
1992-12-05,LAC,119,8,6,CHH,109,9,7,17,13
1992-12-05,MIA,104,4,10,NJN,111,9,7,13,17
1992-12-05,CLE,94,8,7,POR,96,10,4,18,11
1992-12-05,DAL,96,1,11,HOU,117,7,6,8,17
1992-12-05,CHI,96,10,4,BOS,89,7,9,17,13
1992-12-05,ATL,113,7,8,SAN,105,6,8,13,16
1992-12-05,UTH,119,9,5,DEN,89,7,7,16,12
1992-12-05,NYK,111,9,6,MIL,98,10,4,19,10
1992-12-05,SEA,124,10,4,MIN,87,4,8,14,12
1992-12-06,LAL,107,8,6,MIN,85,4,9,12,15
1992-12-06,MIL,112,10,5,PHX,122,9,4,19,9
1992-12-08,HOU,102,8,6,MIN,94,4,10,12,16
1992-12-08,GOS,115,6,10,IND,125,8,8,14,18
1992-12-08,POR,126,11,4,MIL,97,10,6,21,10
1992-12-08,SAC,106,6,9,WAS,114,6,10,12,19
1992-12-08,ATL,123,8,8,CHI,114,11,4,19,12
1992-12-08,CLE,106,8,8,LAC,115,9,6,17,14
1992-12-08,SAN,121,6,9,UTH,103,10,5,16,14
1992-12-08,DAL,112,1,12,MIA,126,4,11,5,23
1992-12-08,NYK,100,10,6,SEA,88,11,4,21,10
1992-12-08,ORL,102,8,6,BOS,117,7,10,15,16
1992-12-08,NJN,100,10,7,PHX,105,10,4,20,11
1992-12-09,CHH,101,9,8,PHX,110,11,4,20,12
1992-12-09,CHI,108,11,5,CLE,91,8,9,19,14
1992-12-09,LAL,124,9,6,POR,111,12,4,21,10
1992-12-09,PHL,115,3,11,SEA,104,11,5,14,16
1992-12-09,DET,108,5,9,ORL,103,8,7,13,16
1992-12-09,BOS,129,8,10,DEN,119,7,8,15,18
1992-12-10,UTH,112,10,6,WAS,96,7,10,17,16
1992-12-10,NJN,111,10,8,LAC,105,10,6,20,14
1992-12-10,SAC,99,6,10,IND,106,9,8,15,18
1992-12-10,GOS,114,6,11,MIL,102,10,7,16,18
1992-12-10,NYK,103,11,6,CHH,110,9,9,20,15
1992-12-10,SAN,101,7,9,MIA,91,5,11,12,20
1992-12-10,DAL,88,1,13,MIN,111,4,11,5,24
1992-12-11,POR,124,12,5,IND,134,10,8,22,13
1992-12-11,ATL,112,9,8,DEN,107,7,9,16,17
1992-12-11,DET,107,6,9,CLE,103,8,10,14,19
1992-12-11,ORL,107,8,8,PHX,108,12,4,20,12
1992-12-11,BOS,90,9,10,SEA,100,11,6,20,16
1992-12-11,PHL,110,4,11,LAC,125,10,7,14,18
1992-12-11,LAL,118,10,6,WAS,93,7,11,17,17
1992-12-11,CHI,96,12,5,HOU,110,9,6,21,11
1992-12-12,CHH,109,10,9,DEN,100,7,10,17,19
1992-12-12,CLE,97,8,11,SEA,93,12,6,20,17
1992-12-12,ATL,96,10,8,PHL,103,4,12,14,20
1992-12-12,DAL,91,1,14,SAN,113,8,9,9,23
1992-12-12,CHI,95,12,6,NJN,89,11,8,23,14
1992-12-12,UTH,108,11,6,MIL,82,10,8,21,14
1992-12-12,MIA,118,5,12,PHX,122,13,4,18,16
1992-12-12,MIN,87,5,11,HOU,104,10,6,15,17
1992-12-12,NYK,95,11,7,DET,88,7,9,18,16
1992-12-12,SAC,120,6,11,GOS,124,7,11,13,22
1992-12-13,POR,117,12,6,WAS,98,7,12,19,18
1992-12-13,LAC,112,11,7,IND,101,11,8,22,15
1992-12-13,LAL,114,11,6,MIL,96,10,9,21,15
1992-12-14,NYK,106,12,7,DEN,89,7,11,19,18
1992-12-15,MIA,106,5,13,SAC,98,6,12,11,25
1992-12-15,SEA,108,12,7,MIL,100,10,10,22,17
1992-12-15,SAN,101,9,9,LAL,107,12,6,21,15
1992-12-15,ORL,119,8,9,PHL,107,5,12,13,21
1992-12-15,ATL,94,10,9,DET,107,7,10,17,19
1992-12-15,MIN,119,5,12,BOS,124,9,11,14,23
1992-12-15,NJN,94,11,9,NYK,108,13,7,24,16
1992-12-15,CLE,124,9,11,HOU,97,11,6,20,17
1992-12-15,CHI,125,13,6,CHH,110,11,9,24,15
1992-12-15,PHX,125,14,4,WAS,110,7,13,21,17
1992-12-15,GOS,109,8,11,LAC,90,12,7,20,18
1992-12-16,PHL,97,5,13,CLE,115,10,11,15,24
1992-12-16,CHH,91,11,10,UTH,93,12,6,23,16
1992-12-16,IND,114,11,9,BOS,91,10,11,21,20
1992-12-16,DEN,99,7,12,POR,100,13,6,20,18
1992-12-16,DET,89,8,10,ATL,88,10,10,18,20
1992-12-16,LAC,114,12,8,GOS,116,9,11,21,19
1992-12-16,DAL,102,1,15,LAL,95,13,6,14,21
1992-12-17,WAS,99,7,14,CHI,107,14,6,21,20
1992-12-17,ORL,112,9,9,SAC,91,6,13,15,22
1992-12-17,MIL,101,10,11,NJN,102,11,10,21,21
1992-12-17,HOU,121,11,7,SAN,109,9,10,20,17
1992-12-18,SAN,122,9,11,DAL,101,2,15,11,26
1992-12-18,SEA,126,13,7,POR,109,14,6,27,13
1992-12-18,DET,122,9,10,IND,106,12,9,21,19
1992-12-18,LAL,100,13,7,PHX,116,15,4,28,11
1992-12-18,BOS,87,10,12,NYK,113,14,7,24,19
1992-12-18,CLE,119,11,11,SAC,108,6,14,17,25
1992-12-18,LAC,103,12,9,MIN,95,5,13,17,22
1992-12-18,PHL,98,5,14,UTH,112,13,6,18,20
1992-12-18,MIA,100,6,13,ATL,108,10,11,16,24
1992-12-19,IND,124,12,10,NJN,110,12,10,24,20
1992-12-19,HOU,112,12,7,DAL,93,2,16,14,23
1992-12-19,MIL,90,10,12,DET,103,10,10,20,22
1992-12-19,DEN,86,7,13,LAL,92,13,8,20,21
1992-12-19,ATL,84,11,11,ORL,125,10,9,21,20
1992-12-19,SEA,121,14,7,LAC,101,13,9,27,16
1992-12-19,NYK,91,15,7,MIA,87,6,14,21,21
1992-12-19,CLE,121,12,11,UTH,104,14,6,26,17
1992-12-19,CHI,96,15,6,PHL,98,5,15,20,21
1992-12-19,GOS,122,10,11,MIN,116,5,14,15,25
1992-12-19,WAS,117,7,15,CHH,126,11,11,18,26
1992-12-20,NJN,104,12,11,SAC,98,6,15,18,26
1992-12-20,POR,130,14,7,GOS,114,11,11,25,18
1992-12-21,PHL,113,6,15,IND,101,13,10,19,25
1992-12-21,CHI,86,15,7,MIA,82,6,15,21,22
1992-12-21,WAS,107,7,16,CLE,111,13,11,20,27
1992-12-22,LAC,108,13,10,DAL,94,2,17,15,27
1992-12-22,MIL,99,10,13,SAC,102,6,16,16,29
1992-12-22,NJN,104,13,11,BOS,106,10,13,23,24
1992-12-22,PHX,106,16,4,GOS,104,11,12,27,16
1992-12-22,POR,96,15,7,SEA,107,15,7,30,14
1992-12-22,ORL,101,11,9,UTH,98,14,7,25,16
1992-12-22,ATL,114,11,12,CHH,130,12,11,23,23
1992-12-22,SAN,113,10,11,DEN,108,7,14,17,25
1992-12-22,DET,98,11,10,HOU,84,13,7,24,17
1992-12-23,CHI,107,16,7,WAS,98,7,17,23,24
1992-12-23,MIA,86,6,16,UTH,92,14,8,20,24
1992-12-23,MIN,96,5,15,SAC,102,7,16,12,31
1992-12-23,BOS,98,11,13,HOU,94,13,8,24,21
1992-12-23,CLE,118,14,11,IND,104,13,11,27,22
1992-12-23,DEN,96,7,15,PHX,111,17,4,24,19
1992-12-23,CHH,107,13,11,DET,95,12,10,25,21
1992-12-23,GOS,111,11,13,DAL,97,2,18,13,31
1992-12-23,LAL,79,14,8,SEA,80,16,7,30,15
1992-12-25,LAC,94,14,10,SAN,103,11,11,25,21
1992-12-25,CHI,89,17,7,NYK,77,16,7,33,14
1992-12-26,LAL,92,14,9,SAN,104,12,11,26,20
1992-12-26,WAS,97,7,18,DET,99,12,11,19,29
1992-12-26,UTH,108,15,8,BOS,92,12,13,27,21
1992-12-26,MIA,106,6,17,ORL,100,12,9,18,26
1992-12-26,IND,84,13,12,CHI,95,18,7,31,19
1992-12-26,CLE,114,15,11,NJN,119,13,12,28,23
1992-12-26,DAL,96,2,19,GOS,110,12,13,14,32
1992-12-26,MIL,102,10,14,NYK,100,16,8,26,22
1992-12-26,PHX,113,18,4,SEA,110,17,7,35,11
1992-12-26,HOU,90,13,9,DEN,82,7,16,20,25
1992-12-26,POR,121,15,8,PHL,115,7,15,22,23
1992-12-26,MIN,105,5,16,ATL,113,11,13,16,29
1992-12-27,SAC,118,8,16,BOS,102,12,14,20,30
1992-12-27,PHX,129,19,4,DEN,88,7,17,26,21
1992-12-27,LAC,106,14,11,PHL,110,7,16,21,27
1992-12-28,ORL,110,12,10,MIL,94,11,14,23,24
1992-12-28,UTH,114,16,8,MIN,95,5,17,21,25
1992-12-28,SAN,105,13,11,GOS,106,13,13,26,24
1992-12-28,MIA,107,7,17,LAL,96,14,10,21,27
1992-12-28,WAS,97,7,19,ATL,96,12,13,19,32
1992-12-28,NJN,104,14,12,CHH,103,14,11,28,23
1992-12-28,CLE,98,15,12,DET,89,13,11,28,23
1992-12-29,SEA,111,17,8,BOS,87,12,15,29,23
1992-12-29,ATL,96,12,14,CLE,114,16,12,28,26
1992-12-29,NYK,97,16,9,IND,91,13,13,29,22
1992-12-29,SAC,139,9,16,DAL,81,2,20,11,36
1992-12-29,CHH,103,14,12,CHI,114,19,7,33,19
1992-12-29,HOU,112,14,9,GOS,132,14,13,28,22
1992-12-30,DEN,94,7,18,SAN,114,13,12,20,30
1992-12-30,MIN,92,5,18,NJN,118,15,12,20,30
1992-12-30,IND,90,13,14,NYK,94,17,9,30,23
1992-12-30,UTH,119,17,8,PHL,110,8,16,25,24
1992-12-30,ORL,93,13,10,LAL,96,14,11,27,21
1992-12-30,PHX,133,20,4,HOU,110,14,10,34,14
1992-12-30,MIA,100,8,17,CHI,105,20,7,28,24
1992-12-30,LAC,105,14,12,BOS,99,12,16,26,28
1992-12-30,POR,111,16,8,DAL,92,2,21,18,29
1992-12-30,DET,118,13,12,WAS,110,8,19,21,31
1993-01-02,POR,102,17,8,UTH,110,18,8,35,16
1993-01-02,NYK,97,18,9,LAC,98,15,12,33,21
1993-01-02,SAC,154,10,16,PHL,98,8,17,18,33
1993-01-02,ORL,97,13,11,DET,98,14,12,27,23
1993-01-02,CHI,109,21,7,IND,100,13,15,34,22
1993-01-02,CLE,106,17,12,LAL,91,15,11,32,23
1993-01-02,CHH,118,14,13,NJN,117,16,12,30,25
1993-01-02,GOS,113,15,13,HOU,107,14,11,29,24
1993-01-02,ATL,93,12,15,MIL,106,11,15,23,30
1993-01-02,SEA,108,18,8,DEN,104,7,19,25,27
1993-01-02,MIN,103,5,19,DAL,71,2,22,7,41
1993-01-02,WAS,100,8,20,MIA,93,8,18,16,38
1993-01-03,POR,103,17,9,HOU,101,14,12,31,21
1993-01-03,SAN,114,14,12,PHX,113,21,4,35,16
1993-01-03,MIL,109,12,15,LAL,101,15,12,27,27
1993-01-03,BOS,120,12,17,LAC,112,16,12,28,29
1993-01-05,HOU,104,14,13,PHX,106,21,5,35,18
1993-01-05,ORL,99,13,12,NJN,102,16,13,29,25
1993-01-05,SEA,116,19,8,GOS,106,16,13,35,21
1993-01-05,IND,114,13,16,LAC,106,16,13,29,29
1993-01-05,UTH,113,19,8,SAN,87,15,12,34,20
1993-01-05,ATL,100,12,16,WAS,107,9,20,21,36
1993-01-05,NYK,95,18,10,CLE,91,18,12,36,22
1993-01-05,CHH,103,15,13,BOS,107,13,17,28,30
1993-01-05,CHI,88,22,7,LAL,91,15,13,37,20
1993-01-05,SAC,126,11,16,DEN,106,7,20,18,36
1993-01-05,MIA,89,8,19,DET,83,15,12,23,31
1993-01-05,DAL,95,2,23,POR,109,18,9,20,32
1993-01-05,MIL,114,13,15,MIN,100,6,20,19,35
1993-01-06,DET,110,15,13,LAC,103,16,14,31,27
1993-01-06,PHL,132,8,18,NJN,106,17,13,25,31
1993-01-06,MIN,78,6,19,LAL,98,16,13,22,32
1993-01-06,CLE,117,18,13,CHI,95,22,8,40,21
1993-01-06,BOS,103,14,17,IND,94,14,16,28,33
1993-01-07,HOU,91,14,14,POR,113,19,9,33,23
1993-01-07,DAL,107,2,24,PHX,111,22,5,24,29
1993-01-07,GOS,119,16,14,MIA,105,9,19,25,33
1993-01-07,SAN,109,15,13,UTH,99,20,8,35,21
1993-01-07,MIL,94,14,15,ATL,100,12,17,26,32
1993-01-08,CHI,120,22,9,MIL,95,14,16,36,25
1993-01-08,MIN,93,6,21,SEA,98,20,8,26,29
1993-01-08,DET,92,16,13,ATL,101,13,17,29,30
1993-01-08,ORL,95,13,13,NYK,94,19,10,32,23
1993-01-08,CHH,115,15,14,LAC,101,16,15,31,29
1993-01-08,LAL,93,17,13,SAC,90,12,16,29,29
1993-01-08,DEN,115,7,21,HOU,90,14,15,21,36
1993-01-08,BOS,102,15,17,NJN,88,17,14,32,31
1993-01-08,WAS,117,10,20,PHL,119,9,18,19,38
1993-01-09,DAL,102,2,25,UTH,126,20,9,22,34
1993-01-09,DEN,95,8,21,SEA,107,21,8,29,29
1993-01-09,NJN,124,17,15,WAS,79,10,21,27,36
1993-01-09,PHL,104,10,18,CHI,91,23,9,33,27
1993-01-09,ORL,88,14,13,IND,104,14,17,28,30
1993-01-09,DET,104,16,14,GOS,108,17,14,33,28
1993-01-09,SAC,108,12,17,MIA,94,9,20,21,37
1993-01-09,CLE,116,19,13,MIN,93,6,22,25,35
1993-01-09,SAN,109,16,13,POR,93,20,9,36,22
1993-01-10,LAL,89,18,13,MIA,101,9,21,27,34
1993-01-10,MIL,99,14,17,LAC,104,16,16,30,33
1993-01-10,HOU,97,14,16,UTH,90,21,9,35,25
1993-01-10,NYK,97,19,11,BOS,100,16,17,35,28
1993-01-11,DAL,113,2,26,CHH,132,16,14,18,40
1993-01-11,DET,91,16,15,SAN,109,17,13,33,28
1993-01-12,CLE,115,20,13,BOS,121,17,17,37,30
1993-01-12,WAS,121,10,22,MIL,98,14,18,24,40
1993-01-12,SEA,122,22,8,PHX,113,23,5,45,13
1993-01-12,IND,112,15,17,PHL,93,11,18,26,35
1993-01-12,SAC,93,13,17,NYK,104,19,12,32,29
1993-01-12,ORL,106,14,14,CHI,122,23,10,37,24
1993-01-12,UTH,125,21,10,MIA,122,10,21,31,31
1993-01-12,POR,109,20,10,DEN,100,8,22,28,32
1993-01-12,LAC,103,17,16,HOU,113,15,16,32,32
1993-01-12,ATL,126,14,17,GOS,118,18,14,32,31
1993-01-13,DET,112,16,16,DAL,96,2,27,18,43
1993-01-13,NJN,104,18,15,CLE,98,20,14,38,29
1993-01-13,BOS,98,18,17,WAS,93,11,22,29,39
1993-01-13,PHL,129,11,19,GOS,122,18,15,29,34
1993-01-13,DEN,108,8,23,NYK,92,20,12,28,35
1993-01-13,MIN,81,6,23,SAN,89,18,13,24,36
1993-01-14,SAC,104,13,18,PHX,114,23,6,36,24
1993-01-14,MIL,93,14,19,SAN,108,19,13,33,32
1993-01-14,POR,104,21,10,MIA,93,10,22,31,32
1993-01-14,UTH,96,22,10,SEA,89,23,8,45,18
1993-01-14,HOU,114,16,16,CHH,102,17,14,33,30
1993-01-14,LAC,105,17,17,LAL,102,18,14,35,31
1993-01-14,ATL,108,15,17,DET,91,17,16,32,33
1993-01-15,PHX,107,24,6,MIA,99,10,23,34,29
1993-01-15,IND,120,16,17,CLE,132,20,15,36,32
1993-01-15,LAL,99,18,15,POR,96,22,10,40,25
1993-01-15,CHI,122,24,10,GOS,101,18,16,42,26
1993-01-15,SEA,123,23,9,LAC,104,18,17,41,26
1993-01-15,NJN,110,19,15,PHL,105,12,19,31,34
1993-01-15,BOS,94,19,17,ORL,113,14,15,33,32
1993-01-15,MIN,99,6,24,DEN,89,9,23,15,47
1993-01-15,DAL,93,2,28,NYK,107,20,13,22,41
1993-01-16,PHL,123,12,20,DET,108,17,17,29,37
1993-01-16,CHI,124,25,10,ORL,128,15,15,40,25
1993-01-16,IND,117,16,18,GOS,116,18,17,34,35
1993-01-16,CLE,127,21,15,ATL,99,16,17,37,32
1993-01-16,UTH,108,23,10,SAC,107,13,19,36,29
1993-01-16,HOU,104,17,16,NYK,102,21,13,38,29
1993-01-16,WAS,101,11,23,NJN,109,20,15,31,38
1993-01-16,MIL,99,14,20,BOS,110,19,18,33,38
1993-01-16,DEN,106,9,24,DAL,91,2,29,11,53
1993-01-16,SAN,124,20,13,CHH,111,17,15,37,28
1993-01-17,POR,109,22,11,SEA,97,24,9,46,20
1993-01-18,NYK,106,21,14,PHX,103,25,6,46,20
1993-01-18,PHL,124,13,20,ORL,118,16,15,29,35
1993-01-18,SEA,106,24,10,UTH,96,24,10,48,20
1993-01-18,GOS,107,18,18,SAC,111,13,20,31,38
1993-01-18,CHI,103,25,11,BOS,93,20,18,45,29
1993-01-18,MIN,93,7,24,LAC,94,18,18,25,42
1993-01-18,NJN,100,21,15,IND,97,17,18,38,33
1993-01-18,LAL,90,19,15,HOU,110,18,16,37,31
1993-01-19,SAN,121,21,13,DEN,110,10,24,31,37
1993-01-19,SAC,96,14,20,HOU,102,19,16,33,36
1993-01-19,CHH,100,17,16,ATL,102,16,18,33,34
1993-01-19,IND,116,17,19,WAS,96,11,24,28,43
1993-01-19,MIL,92,14,21,POR,119,23,11,37,32
1993-01-19,DAL,113,2,30,DET,103,17,18,19,48
1993-01-20,BOS,121,20,19,ATL,106,17,18,37,37
1993-01-20,GOS,120,18,19,UTH,113,24,11,42,30
1993-01-20,CLE,123,22,15,PHX,119,25,7,47,22
1993-01-20,MIA,112,10,24,PHL,115,14,20,24,44
1993-01-20,LAL,101,19,16,SEA,111,25,10,44,26
1993-01-20,MIN,94,7,25,POR,110,24,11,31,36
1993-01-20,NYK,114,22,14,CHH,91,17,17,39,31
1993-01-21,IND,108,18,19,MIL,110,14,22,32,41
1993-01-21,NJN,94,22,15,CHI,107,26,11,48,26
1993-01-21,DAL,94,3,30,DEN,110,10,25,13,55
1993-01-21,HOU,126,20,16,DET,120,17,19,37,35
1993-01-22,CHI,97,27,11,CHH,105,17,18,44,29
1993-01-22,SAN,123,22,13,DET,109,17,20,39,33
1993-01-22,ATL,102,17,19,NJN,91,22,16,39,35
1993-01-22,ORL,104,16,16,MIA,110,10,25,26,41
1993-01-22,WAS,115,11,25,PHX,122,25,8,36,33
1993-01-22,LAC,92,19,18,CLE,100,23,15,42,33
1993-01-22,POR,135,25,11,SAC,127,14,21,39,32
1993-01-22,UTH,98,24,12,LAL,94,19,17,43,29
1993-01-22,GOS,114,19,19,SEA,118,26,10,45,29
1993-01-22,PHL,91,15,20,NYK,109,23,14,38,34
1993-01-23,ATL,91,18,19,PHX,110,26,8,44,27
1993-01-23,DEN,97,11,25,CLE,95,24,15,35,40
1993-01-23,SAC,113,14,22,MIN,108,7,26,21,48
1993-01-23,IND,100,18,20,HOU,113,21,16,39,36
1993-01-23,MIL,104,15,22,PHL,113,15,21,30,43
1993-01-23,ORL,127,16,17,DAL,106,3,31,19,48
1993-01-24,NJN,100,22,17,HOU,83,22,16,44,33
1993-01-24,LAC,116,19,19,SEA,95,27,10,46,29
1993-01-24,WAS,110,11,26,LAL,112,19,18,30,44
1993-01-24,CHH,105,18,18,IND,112,18,21,36,39
1993-01-24,UTH,113,25,12,POR,124,26,11,51,23
1993-01-24,SAN,103,23,13,CHI,99,27,12,50,25
1993-01-24,MIA,122,11,25,DAL,106,3,32,14,57
1993-01-25,DEN,102,12,25,MIN,97,7,27,19,52
1993-01-25,ATL,117,18,20,SAC,106,15,22,33,42
1993-01-25,DET,119,17,21,PHX,121,27,8,44,29
1993-01-26,UTH,113,25,13,CLE,96,24,16,49,29
1993-01-26,WAS,104,11,27,MIA,102,12,25,23,52
1993-01-26,NJN,106,23,17,LAL,91,20,18,43,35
1993-01-26,MIL,100,15,23,HOU,86,22,17,37,40
1993-01-26,ORL,120,17,17,ATL,106,19,20,36,37
1993-01-26,NYK,98,24,14,PHL,90,16,21,40,35
1993-01-26,DAL,88,3,33,CHI,123,27,13,30,46
1993-01-26,POR,143,27,11,GOS,133,19,20,46,31
1993-01-27,GOS,123,19,21,DEN,95,13,25,32,46
1993-01-27,DET,103,17,22,BOS,94,21,19,38,41
1993-01-27,PHL,125,16,22,IND,127,19,21,35,43
1993-01-27,MIN,116,7,28,PHX,117,28,8,35,36
1993-01-27,LAC,107,20,19,UTH,97,26,13,46,32
1993-01-27,SEA,99,27,11,SAN,119,24,13,51,24
1993-01-27,CHH,117,18,19,SAC,107,15,23,33,42
1993-01-28,MIA,87,12,26,MIL,109,16,23,28,49
1993-01-28,NYK,105,25,14,ATL,110,19,21,44,35
1993-01-28,HOU,94,22,18,CHI,83,28,13,50,31
1993-01-28,IND,127,20,21,LAL,110,20,19,40,40
1993-01-28,DEN,110,13,26,NJN,100,24,17,37,43
1993-01-28,CLE,127,24,17,ORL,113,18,17,42,34
1993-01-29,DET,112,18,22,MIN,103,7,29,25,51
1993-01-29,PHX,125,29,8,SAN,110,25,13,54,21
1993-01-29,DAL,120,3,34,SAC,130,15,24,18,58
1993-01-29,GOS,105,20,21,LAC,106,21,19,41,40
1993-01-29,ORL,105,18,18,BOS,116,21,20,39,38
1993-01-29,CHH,108,19,19,LAL,123,20,20,39,39
1993-01-29,PHL,92,16,23,WAS,86,12,27,28,50
1993-01-30,MIA,98,12,27,CLE,95,25,17,37,44
1993-01-30,ATL,149,20,21,PHL,123,17,23,37,44
1993-01-30,SAN,129,25,14,SAC,124,16,24,41,38
1993-01-30,DEN,109,14,26,CHI,102,28,14,42,40
1993-01-30,UTH,113,26,14,LAC,105,22,19,48,33
1993-01-30,HOU,108,23,18,NJN,105,24,18,47,36
1993-01-30,MIN,91,7,30,MIL,82,17,23,24,53
1993-01-30,PHX,126,30,8,DAL,105,3,35,33,43
1993-01-30,IND,110,21,21,DET,106,19,22,40,43
1993-01-30,SEA,108,27,12,POR,86,28,11,55,23
1993-01-30,WAS,121,12,28,CHH,127,19,20,31,48
1993-01-31,BOS,87,22,20,LAL,96,21,20,43,40
1993-02-01,DAL,96,3,36,NJN,115,24,19,27,55
1993-02-01,CHH,112,20,20,SEA,100,28,12,48,32
1993-02-01,SAC,115,16,25,ORL,119,18,19,34,44
1993-02-01,MIL,116,17,24,GOS,102,20,22,37,46
1993-02-01,UTH,92,27,14,CHI,96,28,15,55,29
1993-02-02,HOU,115,24,18,IND,104,22,21,46,39
1993-02-02,LAL,97,22,20,ORL,110,19,19,41,39
1993-02-02,LAC,112,22,20,PHX,108,31,8,53,28
1993-02-02,POR,91,28,12,MIN,104,8,30,36,42
1993-02-02,NYK,105,25,15,WAS,100,12,29,37,44
1993-02-02,CLE,100,25,18,GOS,90,20,23,45,41
1993-02-02,SAN,111,26,14,NJN,93,25,19,51,33
1993-02-02,ATL,118,21,21,SEA,109,28,13,49,34
1993-02-03,PHX,122,31,9,MIN,102,9,30,40,39
1993-02-03,MIL,100,18,24,CLE,108,26,18,44,42
1993-02-03,DAL,102,3,37,HOU,119,25,18,28,55
1993-02-03,UTH,100,27,15,DEN,96,15,26,42,41
1993-02-03,MIA,116,13,27,ATL,96,22,21,35,48
1993-02-03,PHL,118,17,24,CHH,129,21,20,38,44
1993-02-03,SAC,88,16,26,CHI,107,29,15,45,41
1993-02-04,LAL,114,22,21,UTH,110,28,15,50,36
1993-02-04,NJN,113,25,20,SEA,103,28,14,53,34
1993-02-04,SAN,133,27,14,IND,115,22,22,49,36
1993-02-04,LAC,105,23,20,CHI,107,30,15,53,35
1993-02-04,NYK,105,26,15,GOS,101,20,24,46,39
1993-02-05,POR,106,28,13,ORL,114,20,19,48,32
1993-02-05,WAS,138,12,30,GOS,111,20,25,32,55
1993-02-05,HOU,105,26,18,MIN,112,9,31,35,49
1993-02-05,MIA,105,14,27,NYK,108,27,15,41,42
1993-02-05,BOS,105,22,21,PHL,93,17,25,39,46
1993-02-05,CLE,109,27,18,DET,89,19,23,46,41
1993-02-05,CHH,118,22,20,MIL,111,18,25,40,45
1993-02-05,PHX,132,32,9,LAL,104,23,21,55,30
1993-02-05,DAL,105,3,38,IND,104,22,23,25,61
1993-02-05,DEN,116,15,27,SAC,103,16,27,31,54
1993-02-06,ATL,109,22,22,CLE,120,28,18,50,40
1993-02-06,WAS,92,13,30,SEA,120,28,15,41,45
1993-02-06,SAN,104,28,14,MIN,95,10,31,38,45
1993-02-06,DEN,111,16,27,DAL,93,4,38,20,65
1993-02-06,LAC,119,23,21,SAC,110,16,28,39,49
1993-02-07,NYK,104,28,15,MIA,82,14,28,42,43
1993-02-07,BOS,87,23,21,GOS,82,20,26,43,47
1993-02-07,DET,101,19,24,SEA,103,29,15,48,39
1993-02-07,MIL,102,18,26,NJN,105,26,20,44,46
1993-02-07,PHX,121,33,9,ORL,105,21,19,54,28
1993-02-07,POR,91,28,14,CHI,101,31,15,59,29
1993-02-08,PHL,115,17,26,NYK,120,29,15,46,41
1993-02-08,HOU,100,26,19,WAS,106,13,31,39,50
1993-02-08,LAL,108,23,22,DAL,100,4,39,27,61
1993-02-08,UTH,108,28,16,ORL,96,21,20,49,36
1993-02-09,CHH,103,23,20,CLE,107,29,18,52,38
1993-02-09,GOS,114,20,27,ATL,125,22,23,42,50
1993-02-09,SAN,112,29,14,LAC,97,24,21,53,35
1993-02-09,BOS,104,24,21,MIL,92,18,27,42,48
1993-02-09,SAC,114,16,29,UTH,119,29,16,45,45
1993-02-09,SEA,92,30,15,DEN,96,17,27,47,42
1993-02-09,DET,105,19,25,MIA,106,14,29,33,54
1993-02-10,MIN,90,10,32,MIA,101,15,29,25,61
1993-02-10,IND,104,22,24,CHI,115,32,15,54,39
1993-02-10,LAL,111,24,22,DEN,102,18,27,42,49
1993-02-10,ORL,96,21,21,CLE,87,30,18,51,39
1993-02-10,PHL,90,17,27,HOU,98,26,20,43,47
1993-02-10,DAL,102,4,40,WAS,110,14,31,18,71
1993-02-10,NJN,109,27,20,DET,86,19,26,46,46
1993-02-10,PHX,122,34,9,LAC,100,24,22,58,31
1993-02-11,NYK,125,30,15,HOU,95,27,20,57,35
1993-02-11,GOS,100,20,28,PHX,122,35,9,55,37
1993-02-11,CHH,116,23,21,ORL,107,22,21,45,42
1993-02-11,SAC,116,16,30,ATL,105,23,23,39,53
1993-02-11,SEA,96,30,16,UTH,101,30,16,60,32
1993-02-11,SAN,105,30,14,WAS,95,15,31,45,45
1993-02-12,DAL,100,4,41,BOS,109,25,21,29,62
1993-02-12,LAC,104,24,23,POR,111,28,15,52,38
1993-02-12,IND,100,22,25,MIN,102,10,33,32,58
1993-02-12,CHI,98,33,15,NYK,104,31,15,64,30
1993-02-12,DEN,126,18,28,PHL,122,17,28,35,56
1993-02-12,DET,106,19,27,NJN,97,28,20,47,47
1993-02-12,CLE,120,30,19,MIL,98,18,28,48,47
1993-02-12,MIA,107,16,29,CHH,116,24,21,40,50
1993-02-13,SEA,95,30,17,PHX,94,36,9,66,26
1993-02-13,DEN,123,19,28,WAS,104,15,32,34,60
1993-02-13,DAL,96,4,42,PHL,119,17,29,21,71
1993-02-13,SAC,110,17,30,GOS,111,20,29,37,59
1993-02-13,MIN,88,11,33,HOU,97,27,21,38,54
1993-02-13,CHI,111,33,16,CLE,116,31,19,64,35
1993-02-13,UTH,112,31,16,ATL,121,23,24,54,40
1993-02-13,SAN,90,31,14,BOS,85,26,21,57,35
1993-02-13,MIL,117,18,29,IND,115,22,26,40,55
1993-02-14,GOS,114,21,29,WAS,94,15,33,36,62
1993-02-14,CHH,117,25,21,DET,107,20,27,45,48
1993-02-14,ORL,102,22,22,NYK,100,32,15,54,37
1993-02-14,POR,86,29,15,LAC,96,24,24,53,39
1993-02-14,NJN,117,28,21,MIA,111,16,30,44,51
1993-02-14,LAL,135,25,22,ATL,96,24,24,49,46
1993-02-15,MIA,130,16,31,DEN,129,20,28,36,59
1993-02-15,CHI,119,33,17,SAC,101,17,31,50,48
1993-02-15,LAC,99,25,24,SAN,102,32,14,57,38
1993-02-15,MIL,128,19,29,CHH,122,26,21,45,50
1993-02-15,MIN,91,11,34,UTH,112,31,17,42,51
1993-02-15,CLE,110,32,19,IND,105,22,27,54,46
1993-02-16,GOS,133,22,29,SAN,112,33,14,55,43
1993-02-16,NYK,117,32,16,DAL,87,4,43,36,59
1993-02-16,SEA,112,31,17,WAS,102,15,34,46,51
1993-02-16,PHX,110,36,10,BOS,97,26,22,62,32
1993-02-16,HOU,149,28,21,PHL,111,18,29,46,50
1993-02-16,POR,105,29,16,ATL,90,24,25,53,41
1993-02-16,DET,124,20,28,ORL,120,23,22,43,50
1993-02-16,NJN,100,29,21,MIL,88,20,29,49,50
1993-02-17,CHI,114,34,17,UTH,96,32,17,66,34
1993-02-17,CLE,124,33,19,DAL,97,4,44,37,63
1993-02-17,IND,125,22,28,SAC,99,17,32,39,60
1993-02-17,ORL,111,23,23,DEN,99,20,29,43,52
1993-02-17,MIA,111,17,31,DET,107,21,28,38,59
1993-02-17,CHH,116,26,22,NYK,124,33,16,59,38
1993-02-18,SAN,103,33,15,PHL,98,18,30,51,45
1993-02-18,MIN,121,11,35,SAC,114,17,33,28,68
1993-02-18,MIL,94,20,30,UTH,105,32,18,52,48
1993-02-18,GOS,116,23,29,SEA,131,32,17,55,46
1993-02-18,LAC,108,25,25,WAS,95,15,35,40,60
1993-02-18,POR,105,30,16,LAL,103,26,22,56,38
1993-02-18,PHX,131,37,10,ATL,119,24,26,61,36
1993-02-18,HOU,119,29,21,BOS,84,26,23,55,44
1993-02-23,CLE,102,34,19,MIA,100,18,31,52,50
1993-02-23,UTH,78,33,18,HOU,105,30,21,63,39
1993-02-23,SAN,103,34,15,PHX,105,38,10,72,25
1993-02-23,DET,101,21,29,PHL,89,18,31,39,60
1993-02-23,CHH,104,26,23,NJN,95,30,21,56,44
1993-02-23,LAC,123,26,25,SAC,116,17,34,43,59
1993-02-23,IND,113,23,28,BOS,86,26,24,49,52
1993-02-23,CHI,99,35,17,MIL,95,20,31,55,48
1993-02-23,DEN,99,20,30,SEA,103,33,17,53,47
1993-02-23,NYK,95,34,16,MIN,91,12,35,46,51
1993-02-23,ORL,125,24,23,POR,107,31,16,55,39
1993-02-23,ATL,109,24,27,WAS,94,15,36,39,63
1993-02-24,MIA,102,18,32,POR,91,31,17,49,49
1993-02-24,SAC,99,17,35,LAL,104,26,23,43,58
1993-02-24,MIL,90,20,32,NYK,91,35,16,55,48
1993-02-24,DAL,92,4,45,DEN,113,20,31,24,76
1993-02-24,BOS,103,26,25,NJN,88,30,22,56,47
1993-02-24,MIN,77,12,36,SEA,89,34,17,46,53
1993-02-24,GOS,120,23,30,UTH,108,33,19,56,49
1993-02-24,WAS,105,15,37,IND,101,24,28,39,65
1993-02-24,PHL,107,18,32,ATL,132,25,27,43,59
1993-02-25,ORL,106,25,23,CHI,108,36,17,61,40
1993-02-25,CHH,111,27,23,SAN,104,34,16,61,39
1993-02-25,HOU,131,31,21,PHX,104,39,10,70,31
1993-02-26,NJN,91,30,23,POR,102,31,18,61,41
1993-02-26,PHX,113,39,11,UTH,106,33,20,72,31
1993-02-26,GOS,98,24,30,LAC,106,27,25,51,55
1993-02-26,MIN,99,12,37,DAL,89,4,46,16,83
1993-02-26,IND,137,24,29,CHH,105,28,23,52,52
1993-02-26,ATL,99,26,27,BOS,110,27,25,53,52
1993-02-26,LAL,102,27,23,CLE,114,35,19,62,42
1993-02-26,MIA,93,19,32,SAN,86,34,17,53,49
1993-02-26,SAC,120,17,36,SEA,141,35,17,52,53
1993-02-26,DET,108,22,29,NYK,80,36,16,58,45
1993-02-26,PHL,114,18,33,MIL,111,20,33,38,66
1993-02-26,WAS,91,16,37,ORL,92,25,24,41,61
1993-02-27,CHI,112,37,17,ATL,92,26,28,63,45
1993-02-27,HOU,107,32,21,DEN,102,21,31,53,52
1993-02-27,DET,93,23,29,MIL,95,20,34,43,63
1993-02-27,SEA,109,36,17,GOS,92,24,31,60,48
1993-02-27,UTH,117,33,21,SAC,121,17,37,50,58
1993-02-28,IND,110,25,29,DAL,96,4,47,29,76
1993-02-28,PHX,94,40,11,CLE,101,36,19,76,30
1993-02-28,NJN,102,30,24,NYK,76,36,17,66,41
1993-02-28,ORL,90,26,24,SAN,94,34,18,60,42
1993-02-28,LAL,124,27,24,LAC,112,28,25,55,49
1993-02-28,MIA,105,20,32,MIN,93,13,37,33,69
1993-02-28,BOS,122,28,25,POR,110,32,18,60,43
1993-02-28,DEN,110,21,32,CHH,103,28,24,49,56
1993-03-01,UTH,107,33,22,CHH,110,28,25,61,47
1993-03-01,GOS,131,24,32,PHL,118,19,33,43,65
1993-03-01,DET,99,23,30,BOS,95,29,25,52,55
1993-03-02,ORL,108,26,25,MIN,89,13,38,39,63
1993-03-02,DEN,127,22,32,LAL,115,28,24,50,56
1993-03-02,MIL,120,21,34,DAL,86,4,48,25,82
1993-03-02,NYK,107,36,18,ATL,98,26,29,62,47
1993-03-02,NJN,80,31,24,CHI,87,38,17,69,41
1993-03-02,SEA,108,37,17,CLE,105,37,19,74,36
1993-03-02,LAC,83,28,26,HOU,99,33,21,61,47
1993-03-02,IND,109,26,29,SAN,95,35,18,61,47
1993-03-02,POR,102,32,19,PHX,97,40,12,72,31
1993-03-03,GOS,111,25,32,LAL,117,28,25,53,57
1993-03-03,CHI,125,39,17,DAL,97,4,49,43,66
1993-03-03,BOS,132,29,26,SAN,91,35,19,64,45
1993-03-03,DET,98,24,30,UTH,106,33,23,57,53
1993-03-03,PHX,125,40,13,PHL,115,19,34,59,47
1993-03-03,MIA,125,21,32,WAS,106,16,38,37,70
1993-03-03,SAC,86,18,37,HOU,89,34,21,52,58
1993-03-04,DEN,103,23,32,POR,88,33,19,56,51
1993-03-04,WAS,98,16,39,LAC,117,28,27,44,66
1993-03-04,NJN,116,31,25,ORL,97,27,25,58,50
1993-03-04,SEA,138,38,17,CHH,112,29,25,67,42
1993-03-04,NYK,125,37,18,UTH,111,34,23,71,41
1993-03-04,MIN,95,13,39,CLE,103,37,20,50,59
1993-03-04,IND,136,27,29,ATL,111,26,30,53,59
1993-03-05,MIL,109,22,34,ORL,91,27,26,49,60
1993-03-05,MIA,109,22,32,LAC,105,29,27,51,59
1993-03-05,POR,92,33,20,CHH,94,29,26,62,46
1993-03-05,PHX,130,41,13,SAC,122,18,38,59,51
1993-03-05,CHI,102,40,17,SAN,107,35,20,75,37
1993-03-05,DAL,86,4,50,HOU,105,35,21,39,71
1993-03-05,LAL,101,29,25,PHL,97,19,35,48,60
1993-03-05,BOS,105,30,26,DET,101,24,31,54,57
1993-03-06,ATL,139,26,31,UTH,118,34,24,60,55
1993-03-06,SEA,149,39,17,PHL,93,19,36,58,53
1993-03-06,HOU,119,36,21,SAC,102,18,39,54,60
1993-03-06,MIN,106,13,40,SAN,105,36,20,49,60
1993-03-06,NJN,117,32,25,DEN,90,24,32,56,57
1993-03-06,DAL,102,4,51,PHX,109,42,13,46,64
1993-03-07,MIA,114,23,32,IND,99,28,29,51,61
1993-03-07,ORL,112,27,27,LAC,95,29,28,56,55
1993-03-07,LAL,101,30,25,CHH,105,30,26,60,51
1993-03-07,MIL,91,23,34,DET,98,24,32,47,66
1993-03-07,BOS,96,31,26,CLE,88,38,20,69,46
1993-03-07,GOS,96,25,33,POR,113,33,21,58,54
1993-03-08,CLE,122,38,21,DEN,107,24,33,62,54
1993-03-08,ATL,121,27,31,LAC,113,29,29,56,60
1993-03-08,MIN,83,14,40,PHL,92,19,37,33,77
1993-03-08,NYK,109,38,18,ORL,107,28,27,66,45
1993-03-08,IND,105,28,30,SEA,99,40,17,68,47
1993-03-09,CHH,124,31,26,WAS,104,16,40,47,66
1993-03-09,SAC,108,18,40,PHX,128,43,13,61,53
1993-03-09,CHI,86,40,18,SEA,83,40,18,80,36
1993-03-09,DET,121,25,32,LAL,123,30,26,55,58
1993-03-09,MIL,103,23,35,ATL,117,28,31,51,66
1993-03-09,HOU,104,37,21,MIA,94,24,32,61,53
1993-03-09,UTH,116,34,25,MIN,107,14,41,48,66
1993-03-09,SAN,119,36,21,DAL,84,4,52,40,73
1993-03-10,PHL,100,20,37,BOS,104,32,26,52,63
1993-03-10,DAL,96,4,53,POR,124,34,21,38,74
1993-03-10,WAS,112,16,41,DEN,126,24,34,40,75
1993-03-10,ORL,119,28,28,IND,106,29,30,57,58
1993-03-10,PHX,111,44,13,GOS,100,25,34,69,47
1993-03-10,LAC,98,29,30,NJN,109,33,25,62,55
1993-03-10,NYK,110,39,18,LAL,104,31,26,70,44
1993-03-11,MIL,105,23,36,SEA,116,40,19,63,55
1993-03-11,DET,112,25,33,DEN,104,25,34,50,67
1993-03-11,SAC,109,18,41,MIN,95,14,42,32,83
1993-03-11,HOU,104,38,21,POR,91,35,21,73,42
1993-03-11,CLE,118,39,21,CHH,99,32,26,71,47
1993-03-11,GOS,91,25,35,NJN,103,34,25,59,60
1993-03-11,MIA,97,24,33,CHI,95,41,18,65,51
1993-03-12,LAC,117,29,31,MIN,93,14,43,43,74
1993-03-12,PHX,116,45,13,DAL,98,4,54,49,67
1993-03-12,ATL,110,29,31,ORL,92,29,28,58,59
1993-03-12,PHL,95,20,38,LAL,101,31,27,51,65
1993-03-12,CHI,123,41,19,CHH,108,32,27,73,46
1993-03-12,BOS,109,33,26,MIL,115,23,37,56,63
1993-03-12,WAS,98,16,42,NYK,109,40,18,56,60
1993-03-13,HOU,104,39,21,UTH,95,35,25,74,46
1993-03-13,MIA,106,25,33,SEA,102,41,19,66,52
1993-03-13,PHX,93,46,13,NJN,124,35,25,81,38
1993-03-13,SAC,122,19,41,DAL,94,4,55,23,96
1993-03-13,SAN,108,37,21,POR,99,35,22,72,43
1993-03-14,NYK,121,41,18,IND,90,29,31,70,49
1993-03-14,DET,101,26,33,CHI,99,42,19,68,52
1993-03-14,ORL,97,29,29,SEA,105,41,20,70,49
1993-03-14,BOS,93,33,27,CHH,96,32,28,65,55
1993-03-14,ATL,117,30,31,LAL,107,32,27,62,58
1993-03-14,MIN,107,14,44,LAC,124,30,31,44,75
1993-03-15,WAS,105,16,43,CLE,101,40,21,56,64
1993-03-15,SAN,87,38,21,LAL,92,32,28,70,49
1993-03-15,DAL,96,4,56,UTH,109,35,26,39,82
1993-03-15,DEN,100,25,35,MIA,103,26,33,51,68
1993-03-15,CHI,101,42,20,LAC,94,31,31,73,51
1993-03-15,POR,110,35,23,NJN,94,36,25,71,48
1993-03-16,NYK,102,42,18,MIL,99,24,37,66,55
1993-03-16,CLE,110,40,22,PHL,98,20,39,60,61
1993-03-16,GOS,88,25,36,BOS,114,33,28,58,64
1993-03-16,SAC,110,20,41,DET,113,27,33,47,74
1993-03-16,HOU,94,40,21,ORL,93,29,30,69,51
1993-03-16,MIN,100,14,45,DEN,97,25,36,39,81
1993-03-16,CHH,107,33,28,ATL,122,31,31,64,59
1993-03-16,SEA,98,42,20,MIA,85,27,33,69,53
1993-03-17,UTH,104,36,26,DET,80,28,33,64,59
1993-03-17,PHX,129,46,14,POR,111,36,23,82,37
1993-03-17,LAL,100,33,28,SAN,101,38,22,71,50
1993-03-17,NJN,114,36,26,ATL,93,32,31,68,57
1993-03-17,DAL,102,4,57,ORL,96,29,31,33,88
1993-03-17,PHL,89,20,40,WAS,94,17,43,37,83
1993-03-17,IND,114,29,32,MIL,91,24,38,53,70
1993-03-18,CLE,95,41,22,NYK,115,43,18,84,40
1993-03-18,LAC,117,31,32,MIA,133,27,34,58,66
1993-03-18,CHH,113,33,29,MIN,85,15,45,48,74
1993-03-18,SEA,131,43,20,SAC,111,20,42,63,62
1993-03-18,GOS,85,25,37,HOU,98,41,21,66,58
1993-03-18,DEN,101,25,37,BOS,105,34,28,59,65
1993-03-19,SAN,96,39,22,ORL,93,29,32,68,54
1993-03-19,LAL,119,33,29,BOS,129,35,28,68,57
1993-03-19,PHL,87,20,41,DAL,89,5,57,25,98
1993-03-19,UTH,97,37,26,SEA,108,44,20,81,46
1993-03-19,CHI,104,43,20,WAS,99,18,43,61,63
1993-03-19,ATL,121,32,32,MIN,103,15,46,47,78
1993-03-19,SAC,101,20,43,GOS,113,25,38,45,81
1993-03-19,PHX,127,47,14,DET,97,28,34,75,48
1993-03-19,IND,112,30,32,CHH,108,34,29,64,61
1993-03-19,NJN,99,37,26,MIL,85,24,39,61,65
1993-03-19,POR,106,36,24,HOU,98,42,21,78,45
1993-03-20,MIL,112,24,40,PHL,86,20,42,44,82
1993-03-20,DEN,108,25,38,ORL,114,29,33,54,71
1993-03-20,MIA,96,28,34,CLE,91,41,23,69,57
1993-03-20,WAS,101,18,44,CHI,126,44,20,62,64
1993-03-20,LAC,107,31,33,UTH,100,37,27,68,60
1993-03-21,MIN,95,15,47,CHH,99,34,30,49,77
1993-03-21,LAL,101,33,30,DET,106,28,35,61,65
1993-03-21,POR,104,37,24,BOS,106,36,28,73,52
1993-03-21,HOU,89,42,22,SEA,100,45,20,87,42
1993-03-21,NJN,106,38,26,DAL,84,6,57,44,83
1993-03-21,NYK,115,44,18,SAN,96,40,22,84,40
1993-03-21,PHX,108,48,14,IND,109,31,32,79,46
1993-03-22,GOS,96,26,38,DET,91,29,35,55,73
1993-03-22,DEN,107,25,39,UTH,93,37,28,62,67
1993-03-22,WAS,97,18,45,NJN,92,39,26,57,71
1993-03-23,ORL,103,30,33,MIA,89,29,34,59,67
1993-03-23,SAC,121,20,44,LAC,104,32,33,52,77
1993-03-23,CHH,103,35,30,HOU,111,42,23,77,53
1993-03-23,PHX,121,48,15,NYK,92,45,18,93,33
1993-03-23,CLE,127,41,24,SAN,90,40,23,81,47
1993-03-23,ATL,125,33,32,DAL,107,6,58,39,90
1993-03-23,PHL,88,20,43,DEN,80,26,39,46,82
1993-03-23,CHI,107,45,20,MIN,100,15,48,60,68
1993-03-23,SEA,99,46,20,POR,108,37,25,83,45
1993-03-23,UTH,119,37,29,IND,101,32,32,69,61
1993-03-24,PHL,100,21,43,CHI,113,46,20,67,63
1993-03-24,WAS,98,19,45,DAL,101,6,59,25,104
1993-03-24,NJN,118,39,27,CHH,116,35,31,74,58
1993-03-24,LAC,116,32,34,MIL,105,25,40,57,74
1993-03-24,BOS,115,37,28,MIA,109,29,35,66,63
1993-03-24,LAL,105,33,31,PHX,120,49,15,82,46
1993-03-24,MIN,92,15,49,SAN,105,40,24,55,73
1993-03-25,ATL,106,34,32,HOU,96,43,23,77,55
1993-03-25,DEN,99,26,40,GOS,88,27,38,53,78
1993-03-25,SEA,117,46,21,IND,120,32,33,78,54
1993-03-25,SAC,111,21,44,POR,113,38,25,59,69
1993-03-25,UTH,104,38,29,NYK,87,45,19,83,48
1993-03-26,LAL,95,33,32,NYK,105,45,20,78,52
1993-03-26,POR,122,39,25,LAC,110,33,34,72,59
1993-03-26,WAS,69,19,46,HOU,90,43,24,62,70
1993-03-26,PHL,84,21,44,CLE,103,42,24,63,68
1993-03-26,MIA,110,29,36,NJN,100,40,27,69,63
1993-03-26,CHI,107,47,20,ORL,86,31,33,78,53
1993-03-26,SAN,98,41,24,UTH,104,39,29,80,53
1993-03-26,PHX,109,50,15,MIL,103,25,41,75,56
1993-03-26,DET,115,29,36,CHH,107,35,32,64,68
1993-03-26,MIN,91,15,50,GOS,94,27,39,42,89
1993-03-26,BOS,106,38,28,DAL,97,7,59,45,87
1993-03-27,SEA,112,46,22,LAC,108,33,35,79,57
1993-03-27,ORL,98,31,34,NJN,84,40,28,71,62
1993-03-27,ATL,118,35,32,MIA,106,30,36,65,68
1993-03-27,DEN,123,27,40,IND,106,33,33,60,73
1993-03-27,SAC,105,21,45,MIL,125,25,42,46,87
1993-03-28,DET,91,30,36,CLE,78,43,24,73,60
1993-03-28,BOS,114,39,28,WAS,113,19,47,58,75
1993-03-28,MIN,101,15,51,HOU,100,44,24,59,75
1993-03-28,GOS,84,28,39,NYK,94,46,20,74,59
1993-03-28,DAL,107,7,60,SAN,114,41,25,48,85
1993-03-28,CHH,114,35,33,POR,121,40,25,75,58
1993-03-28,PHL,100,21,45,PHX,110,51,15,72,60
1993-03-28,LAL,92,33,33,IND,90,33,34,66,67
1993-03-29,MIL,107,26,42,WAS,114,19,48,45,90
1993-03-29,UTH,101,40,29,DEN,114,28,40,68,69
1993-03-29,ATL,127,36,32,POR,118,41,25,77,57
1993-03-29,BOS,110,40,28,SAC,89,21,46,61,74
1993-03-30,SAN,99,42,25,SEA,97,47,22,89,47
1993-03-30,CHH,89,35,34,MIA,116,30,37,65,71
1993-03-30,CHI,109,48,20,PHX,113,52,15,100,35
1993-03-30,LAC,101,33,36,LAL,93,34,33,67,69
1993-03-30,GOS,100,28,40,MIN,103,16,51,44,91
1993-03-30,NYK,109,47,20,SAC,87,21,47,68,67
1993-03-30,NJN,91,40,29,PHL,77,21,46,61,75
1993-03-30,ORL,105,32,34,DET,91,31,36,63,70
1993-03-31,DEN,94,29,40,ATL,103,37,32,66,72
1993-03-31,LAL,113,34,34,MIN,126,17,51,51,85
1993-03-31,BOS,109,41,28,PHL,103,21,47,62,75
1993-03-31,DET,120,31,37,POR,111,41,26,72,63
1993-03-31,UTH,93,40,30,SAN,85,43,25,83,55
1993-03-31,DAL,96,7,61,SEA,103,47,23,54,84
1993-03-31,IND,114,33,35,WAS,95,20,48,53,83
1993-04-01,HOU,121,44,25,MIL,115,26,43,70,68
1993-04-01,ORL,93,33,34,CHH,102,35,35,68,69
1993-04-01,NJN,95,41,29,MIA,82,31,37,72,66
1993-04-01,WAS,97,20,49,SAC,117,21,48,41,97
1993-04-01,NYK,91,48,20,CLE,83,43,25,91,45
1993-04-02,SAN,108,43,26,MIN,101,18,51,61,77
1993-04-02,PHL,91,21,48,POR,96,41,27,62,75
1993-04-02,DAL,93,7,62,GOS,134,28,41,35,103
1993-04-02,LAC,111,34,36,ATL,99,38,32,72,68
1993-04-02,MIA,107,31,38,NYK,123,49,20,80,58
1993-04-02,CHI,118,48,21,NJN,105,42,29,90,50
1993-04-02,BOS,114,42,28,PHX,118,53,15,95,43
1993-04-02,CHH,114,36,35,CLE,113,43,26,79,61
1993-04-02,DET,109,32,37,SAC,100,22,48,54,85
1993-04-02,DEN,116,29,41,MIL,107,26,44,55,85
1993-04-02,IND,118,34,35,ORL,102,33,35,67,70
1993-04-03,SEA,129,48,23,ATL,105,38,33,86,56
1993-04-03,WAS,114,20,50,POR,102,42,27,62,77
1993-04-03,HOU,118,45,25,GOS,111,29,41,74,66
1993-04-04,LAC,119,35,36,DAL,115,7,63,42,99
1993-04-04,IND,100,35,35,PHX,110,54,15,89,50
1993-04-04,CLE,105,43,27,NJN,99,42,30,85,57
1993-04-04,DEN,120,30,41,MIN,94,18,52,48,93
1993-04-04,PHL,112,21,49,SAC,102,22,49,43,98
1993-04-04,MIA,124,31,39,ORL,106,33,36,64,75
1993-04-04,SAN,103,44,26,NYK,108,50,20,94,46
1993-04-04,LAL,99,34,35,UTH,111,41,30,75,65
1993-04-04,BOS,89,42,29,CHI,101,49,21,91,50
1993-04-06,NJN,85,42,31,IND,98,35,36,77,67
1993-04-06,DET,91,33,37,WAS,79,21,50,54,87
1993-04-06,SAN,111,44,27,GOS,125,29,42,73,69
1993-04-06,MIL,113,26,45,CHI,109,50,21,76,66
1993-04-06,SEA,107,49,23,DAL,109,7,64,56,87
1993-04-06,PHX,115,55,15,LAL,114,34,36,89,51
1993-04-06,SAC,100,22,50,DEN,101,31,41,53,91
1993-04-06,HOU,114,46,25,LAC,101,36,36,82,61
1993-04-06,CLE,115,44,27,MIA,100,32,39,76,66
1993-04-06,ORL,116,33,37,PHL,90,22,49,55,86
1993-04-06,POR,110,42,28,UTH,95,42,30,84,58
1993-04-06,ATL,109,38,34,NYK,104,51,20,89,54
1993-04-07,CHH,96,37,35,ORL,109,34,37,71,72
1993-04-07,WAS,90,21,51,PHL,98,22,50,43,101
1993-04-07,MIN,105,18,53,IND,113,36,36,54,89
1993-04-08,UTH,90,42,31,HOU,95,47,25,89,56
1993-04-08,SAC,114,22,51,PHX,123,56,15,78,66
1993-04-08,GOS,122,30,42,LAL,116,34,37,64,79
1993-04-08,NYK,110,51,21,BOS,88,42,30,93,51
1993-04-08,POR,126,43,28,DAL,107,8,64,51,92
1993-04-08,MIL,92,27,45,MIA,117,32,40,59,85
1993-04-08,NJN,98,42,32,DET,100,34,37,76,69
1993-04-08,SAN,112,44,28,LAC,108,36,37,80,65
1993-04-09,LAL,105,34,38,POR,109,44,28,78,66
1993-04-09,PHL,113,23,50,CHH,122,37,36,60,86
1993-04-09,PHX,98,57,15,DEN,97,32,41,89,56
1993-04-09,ATL,87,39,34,CHI,88,50,22,89,56
1993-04-09,SEA,111,49,24,SAC,97,22,52,71,76
1993-04-09,MIN,92,18,54,ORL,95,35,37,53,91
1993-04-09,BOS,90,42,31,DET,105,35,37,77,68
1993-04-09,CLE,114,45,27,WAS,95,21,52,66,79
1993-04-10,CHH,105,38,36,ATL,118,39,35,77,71
1993-04-10,GOS,100,31,42,DAL,94,8,65,39,107
1993-04-10,HOU,98,48,25,SAN,88,45,28,93,53
1993-04-10,LAC,118,36,38,DEN,101,32,42,68,80
1993-04-10,NJN,99,42,33,CLE,100,46,27,88,60
1993-04-10,MIA,119,33,40,PHL,114,23,51,56,91
1993-04-10,MIL,108,27,46,ORL,97,36,37,63,83
1993-04-10,IND,87,37,36,CHI,92,51,22,88,58
1993-04-11,LAL,98,34,39,SEA,96,50,24,84,63
1993-04-11,POR,127,45,28,MIN,110,18,55,63,83
1993-04-11,WAS,94,21,53,DET,106,36,37,57,90
1993-04-11,BOS,90,42,32,NYK,102,52,21,94,53
1993-04-11,PHX,112,58,15,UTH,99,42,32,100,47
1993-04-12,GOS,96,32,42,DEN,107,32,43,64,85
1993-04-12,CHH,120,38,37,PHL,101,23,52,61,89
1993-04-12,UTH,107,42,33,DAL,94,8,66,50,99
1993-04-12,DET,95,37,37,CHI,98,52,22,89,59
1993-04-12,LAC,111,37,38,PHX,104,59,15,96,53
1993-04-12,MIA,106,34,40,MIL,95,28,46,62,86
1993-04-13,HOU,126,49,25,LAL,107,35,39,84,64
1993-04-13,BOS,96,42,33,IND,90,37,37,79,70
1993-04-13,NYK,93,53,21,WAS,85,21,54,74,75
1993-04-13,ATL,109,40,35,CLE,112,47,27,87,62
1993-04-13,POR,101,46,28,LAC,99,38,38,84,66
1993-04-13,ORL,110,36,38,MIL,91,28,47,64,85
1993-04-13,SAC,100,22,53,SAN,110,45,29,67,82
1993-04-13,SEA,129,50,25,MIN,95,18,56,68,81
1993-04-14,PHX,98,59,16,MIN,84,18,57,77,73
1993-04-14,CHI,119,53,22,MIA,92,35,40,88,62
1993-04-14,DEN,96,33,43,HOU,107,50,25,83,68
1993-04-14,DET,87,37,38,ATL,84,40,36,77,74
1993-04-14,GOS,93,32,43,SAN,96,46,29,78,72
1993-04-14,IND,109,37,38,NJN,90,42,34,79,72
1993-04-14,CHH,107,39,37,NYK,111,54,21,93,58
1993-04-14,DAL,99,8,67,LAL,112,35,40,43,107
1993-04-15,WAS,110,21,55,MIA,92,35,41,56,96
1993-04-15,MIL,93,28,48,CLE,108,48,27,76,75
1993-04-15,UTH,122,43,33,POR,117,47,28,90,61
1993-04-15,NJN,105,42,35,BOS,106,43,33,85,68
1993-04-15,PHL,101,23,53,ORL,85,37,38,60,91
1993-04-16,DAL,99,8,68,DEN,86,33,44,41,112
1993-04-16,MIN,109,18,58,POR,117,47,29,65,87
1993-04-16,LAC,122,38,39,GOS,115,32,44,70,83
1993-04-16,CLE,113,49,27,ORL,110,37,39,86,66
1993-04-16,CHH,127,39,38,DET,93,38,38,77,76
1993-04-16,IND,100,38,38,NYK,94,55,21,93,59
1993-04-16,SAN,93,47,29,SAC,100,22,54,69,83
1993-04-16,CHI,119,54,22,MIL,105,28,49,82,71
1993-04-16,PHX,102,60,16,SEA,108,51,25,111,41
1993-04-16,LAL,84,36,40,HOU,100,51,25,87,65
1993-04-17,WAS,103,22,55,NJN,104,42,36,64,91
1993-04-17,DAL,107,9,68,SAC,108,23,54,32,122
1993-04-17,NYK,95,55,22,DET,85,38,39,93,61
1993-04-17,UTH,110,44,33,PHX,101,60,17,104,50
1993-04-17,ATL,107,40,37,CHH,110,40,38,80,75
1993-04-17,MIA,100,35,42,BOS,103,44,33,79,75
1993-04-17,SEA,81,52,25,HOU,86,52,25,104,50
1993-04-18,CLE,103,50,27,CHI,94,55,22,105,49
1993-04-18,LAL,115,36,41,GOS,112,32,45,68,86
1993-04-18,DEN,94,33,45,LAC,83,39,39,72,84
1993-04-18,POR,105,48,29,SAN,101,47,30,95,59
1993-04-18,MIL,98,28,50,IND,108,39,38,67,88
1993-04-18,ORL,88,37,40,BOS,79,45,33,82,73
1993-04-18,PHL,106,24,53,MIN,79,18,59,42,112
1993-04-19,SEA,96,52,26,SAN,89,47,31,99,57
1993-04-19,PHX,97,60,18,HOU,111,53,25,113,43
1993-04-20,ATL,111,40,38,IND,102,40,38,80,76
1993-04-20,MIN,95,18,60,LAL,107,37,41,55,101
1993-04-20,POR,115,49,29,GOS,99,32,46,81,75
1993-04-20,CLE,105,51,27,DET,81,38,40,89,67
1993-04-20,CHI,123,55,23,PHL,94,25,53,80,76
1993-04-20,SAC,101,24,54,UTH,92,45,33,69,87
1993-04-20,ORL,105,38,40,WAS,86,22,56,60,96
1993-04-20,DAL,98,9,69,LAC,107,39,40,48,109
1993-04-20,MIA,97,35,43,NYK,109,56,22,91,65
1993-04-21,NYK,105,57,22,NJN,74,43,36,100,58
1993-04-21,PHL,107,25,54,MIA,97,35,44,60,98
1993-04-21,CHH,119,41,38,MIL,111,28,51,69,89
1993-04-21,DEN,137,34,45,DAL,112,9,70,43,115
1993-04-21,UTH,113,45,34,LAL,102,38,41,83,75
1993-04-21,WAS,98,22,57,ATL,119,41,38,63,95
1993-04-21,BOS,126,45,34,ORL,98,39,40,84,74
1993-04-21,GOS,132,32,47,SAC,105,25,54,57,101
1993-04-21,IND,95,40,39,CLE,111,52,27,92,66
1993-04-22,LAC,98,40,40,SEA,100,53,26,93,66
1993-04-22,HOU,112,54,25,MIN,110,18,61,72,86
1993-04-22,SAN,131,47,32,DEN,111,35,45,82,77
1993-04-22,CHI,109,56,23,DET,103,38,41,94,64
1993-04-22,POR,114,50,29,PHX,115,60,19,110,48
1993-04-23,NJN,116,43,37,ORL,119,39,41,82,78
1993-04-23,UTH,105,46,34,GOS,91,33,47,79,81
1993-04-23,SAC,108,25,55,POR,112,50,30,75,85
1993-04-23,MIA,121,35,45,WAS,120,22,58,57,103
1993-04-23,DET,109,38,42,IND,104,40,40,78,82
1993-04-23,DAL,103,9,71,MIN,100,18,62,27,133
1993-04-23,BOS,107,46,34,CLE,99,53,27,99,61
1993-04-23,ATL,122,42,38,MIL,106,28,52,70,90
1993-04-23,PHL,84,26,54,NYK,99,58,22,84,76
1993-04-23,CHH,104,42,38,CHI,103,57,23,99,61
1993-04-23,SEA,122,54,26,LAL,93,38,42,92,68
1993-04-24,PHX,99,61,19,SAN,97,48,32,109,51
1993-04-24,LAL,125,38,43,SAC,107,25,56,63,99
1993-04-24,IND,94,40,41,MIA,88,36,45,76,86
1993-04-24,MIL,106,28,53,CHH,108,43,38,71,91
1993-04-24,HOU,123,55,25,DAL,128,10,71,65,96
1993-04-24,ORL,104,40,41,ATL,85,43,38,83,79
1993-04-25,MIN,113,18,63,UTH,111,47,34,65,97
1993-04-25,DEN,120,35,46,PHX,118,62,19,97,65
1993-04-25,DET,116,39,42,NJN,110,43,38,82,80
1993-04-25,WAS,94,22,59,BOS,106,47,34,69,93
1993-04-25,CLE,107,53,28,PHL,103,26,55,79,83
1993-04-25,LAC,123,40,41,POR,112,51,30,91,71
1993-04-25,NYK,89,59,22,CHI,84,57,24,116,46
1993-04-25,SAN,119,48,33,HOU,117,55,26,103,59
1993-04-25,GOS,119,33,48,SEA,109,55,26,88,74
1993-11-05,CHH,123,0,0,CHI,124,0,0,0,0
1993-11-05,HOU,110,0,0,NJN,88,0,0,0,0
1993-11-05,ATL,116,0,0,IND,110,0,0,0,0
1993-11-05,UTH,102,0,0,DAL,86,0,0,0,0
1993-11-05,BOS,108,0,0,NYK,111,0,0,0,0
1993-11-05,CLE,91,0,0,MIL,94,0,0,0,0
1993-11-05,MIA,96,0,0,ORL,116,0,0,0,0
1993-11-05,LAC,97,0,0,POR,95,0,0,0,0
1993-11-05,PHL,94,0,0,WAS,82,0,0,0,0
1993-11-05,SAC,109,0,0,DEN,100,0,0,0,0
1993-11-05,DET,104,0,0,MIN,99,0,0,0,0
1993-11-05,SAN,91,0,0,GOS,85,0,0,0,0
1993-11-05,LAL,116,0,0,PHX,108,0,0,0,0
1993-11-06,MIN,95,0,1,UTH,105,1,0,1,1
1993-11-06,CHI,71,1,0,MIA,95,0,1,1,1
1993-11-06,SEA,129,0,0,LAL,101,1,0,1,0
1993-11-06,DAL,89,0,1,GOS,93,0,1,0,2
1993-11-06,MIL,103,1,0,CHH,120,0,1,1,1
1993-11-06,ORL,114,1,0,PHL,89,1,0,2,0
1993-11-06,WAS,88,0,1,BOS,100,0,1,0,2
1993-11-06,IND,107,0,1,DET,113,1,0,1,1
1993-11-07,POR,92,0,1,HOU,106,1,0,1,1
1993-11-07,PHX,132,0,1,SAC,110,1,0,1,1
1993-11-07,SAN,73,1,0,NJN,99,0,1,1,1
1993-11-07,CLE,107,0,1,NYK,115,1,0,1,1
1993-11-07,DEN,99,0,1,LAC,97,1,0,1,1
1993-11-08,BOS,108,1,1,MIL,100,1,1,2,2
1993-11-08,CHI,106,1,1,ATL,80,1,0,2,1
1993-11-08,UTH,100,2,0,SEA,101,1,0,3,0
1993-11-09,SAN,110,1,1,MIN,95,0,2,1,3
1993-11-09,DET,112,2,0,WAS,118,0,2,2,2
1993-11-09,NYK,95,2,0,PHL,86,1,1,3,1
1993-11-09,CLE,113,0,2,CHH,108,1,1,1,3
1993-11-09,LAC,99,1,1,PHX,114,1,1,2,2
1993-11-09,LAL,102,1,1,POR,109,0,2,1,3
1993-11-09,ORL,104,2,0,IND,98,0,2,2,2
1993-11-09,SEA,118,2,0,DEN,86,1,1,3,1
1993-11-09,GOS,93,1,1,HOU,102,2,0,3,1
1993-11-09,DAL,80,0,2,NJN,86,1,1,1,3
1993-11-10,UTH,91,2,1,ATL,88,1,1,3,2
1993-11-10,SAC,112,1,1,LAL,101,1,2,2,3
1993-11-10,PHX,101,2,1,SAN,93,2,1,4,2
1993-11-10,MIL,90,1,2,CHI,91,2,1,3,3
1993-11-10,PHL,89,1,2,BOS,91,2,1,3,3
1993-11-10,WAS,84,1,2,NYK,92,3,0,4,2
1993-11-11,NJN,105,2,1,IND,108,0,3,2,4
1993-11-11,CHH,120,1,2,ORL,87,3,0,4,2
1993-11-11,LAC,111,1,2,DET,99,2,1,3,3
1993-11-11,MIA,116,1,1,MIL,103,1,3,2,4
1993-11-11,SEA,115,3,0,CLE,102,1,2,4,2
1993-11-11,HOU,107,3,0,MIN,99,0,3,3,3
1993-11-12,MIN,99,0,4,DAL,115,0,3,0,7
1993-11-12,SAC,93,2,1,SAN,91,2,2,4,3
1993-11-12,IND,84,1,3,NYK,103,4,0,5,3
1993-11-12,LAL,84,1,3,DEN,113,1,2,2,5
1993-11-12,WAS,105,1,3,PHL,93,1,3,2,6
1993-11-12,GOS,93,1,2,CLE,102,1,3,2,5
1993-11-12,UTH,109,3,1,DET,89,2,2,5,3
1993-11-12,BOS,107,3,1,CHH,110,2,2,5,3
1993-11-12,ORL,100,3,1,MIA,115,2,1,5,2
1993-11-12,POR,94,1,2,ATL,84,1,2,2,4
1993-11-13,DEN,98,2,2,GOS,106,1,3,3,5
1993-11-13,SEA,97,4,0,ATL,89,1,3,5,3
1993-11-13,CHI,97,3,1,BOS,98,3,2,6,3
1993-11-13,HOU,99,4,0,PHX,95,3,1,7,1
1993-11-13,NYK,99,5,0,MIL,86,1,4,6,4
1993-11-13,DAL,100,1,3,UTH,101,4,1,5,4
1993-11-13,LAC,92,2,2,SAN,90,2,3,4,5
1993-11-13,NJN,97,2,2,PHL,98,1,4,3,6
1993-11-14,LAL,107,1,4,CLE,100,2,3,3,7
1993-11-14,NJN,132,2,3,SAC,102,3,1,5,4
1993-11-14,POR,114,2,2,DET,111,2,3,4,5
1993-11-15,PHL,84,2,4,HOU,88,5,0,7,4
1993-11-16,GOS,104,2,3,PHX,116,3,2,5,5
1993-11-16,NJN,84,3,3,HOU,90,6,0,9,3
1993-11-16,DEN,74,2,3,SAN,86,2,4,4,7
1993-11-16,ORL,114,3,2,UTH,96,5,1,8,3
1993-11-16,ATL,118,1,4,SAC,95,3,2,4,6
1993-11-16,MIL,98,1,5,MIN,102,0,5,1,10
1993-11-16,LAL,116,2,4,LAC,114,3,2,5,6
1993-11-16,IND,93,1,4,CHH,102,3,2,4,6
1993-11-16,POR,96,3,2,CLE,101,2,4,5,6
1993-11-16,SEA,95,5,0,CHI,94,3,2,8,2
1993-11-16,DAL,90,1,4,NYK,103,6,0,7,4
1993-11-17,MIA,111,3,1,UTH,115,5,2,8,3
1993-11-17,BOS,105,4,2,NJN,100,3,4,7,6
1993-11-17,CHH,130,4,2,SAC,113,3,3,7,5
1993-11-17,PHL,90,2,5,ATL,92,2,4,4,9
1993-11-17,WAS,117,2,3,MIL,104,1,6,3,9
1993-11-17,SAN,95,3,4,NYK,90,7,0,10,4
1993-11-17,DET,98,2,4,ORL,92,4,2,6,6
1993-11-18,POR,120,3,3,CHI,98,3,3,6,6
1993-11-18,IND,83,1,5,HOU,99,7,0,8,5
1993-11-18,LAC,88,3,3,DAL,84,1,5,4,8
1993-11-18,DEN,100,2,4,CLE,93,3,4,5,8
1993-11-18,GOS,103,2,4,LAL,76,3,4,5,8
1993-11-19,LAL,86,3,5,CHI,88,3,4,6,9
1993-11-19,MIA,92,3,2,ATL,95,3,4,6,6
1993-11-19,PHL,124,2,6,UTH,115,6,2,8,8
1993-11-19,MIN,113,1,5,SAC,108,3,4,4,9
1993-11-19,BOS,115,5,2,ORL,106,4,3,9,5
1993-11-19,PHX,118,4,2,POR,109,4,3,8,5
1993-11-19,CHH,127,5,2,WAS,111,3,3,8,5
1993-11-19,DET,95,3,4,SAN,86,4,4,7,8
1993-11-19,SEA,116,6,0,DAL,87,1,6,7,6
1993-11-20,ATL,96,4,4,CHH,91,6,2,10,6
1993-11-20,IND,100,1,6,BOS,94,6,2,7,8
1993-11-20,HOU,108,8,0,LAC,86,4,3,12,3
1993-11-20,PHX,112,5,2,CLE,96,3,5,8,7
1993-11-20,WAS,104,3,4,MIA,102,3,3,6,7
1993-11-20,NJN,85,3,5,ORL,87,4,4,7,9
1993-11-20,MIL,97,1,7,SAN,101,4,5,5,12
1993-11-20,NYK,72,7,1,UTH,86,6,3,13,4
1993-11-20,GOS,97,3,4,SEA,112,7,0,10,4
1993-11-20,MIN,89,2,5,DEN,90,3,4,5,9
1993-11-21,POR,103,4,4,DAL,90,1,7,5,11
1993-11-21,DET,103,4,4,PHL,89,3,6,7,10
1993-11-21,SAC,103,3,5,CHI,101,4,4,7,9
1993-11-21,NJN,105,3,6,LAL,102,3,6,6,12
1993-11-22,BOS,71,6,3,IND,102,2,6,8,9
1993-11-22,SAN,110,5,5,LAC,98,4,4,9,9
1993-11-22,NYK,119,7,2,MIA,87,3,4,10,6
1993-11-23,POR,109,5,4,DEN,94,4,4,9,8
1993-11-23,WAS,118,4,4,CHH,98,6,3,10,7
1993-11-23,ATL,103,5,4,LAL,94,3,7,8,11
1993-11-23,DAL,98,1,8,LAC,105,4,5,5,13
1993-11-23,ORL,120,5,4,GOS,107,3,5,8,9
1993-11-23,HOU,100,9,0,CHI,93,4,5,13,5
1993-11-24,UTH,93,7,3,HOU,95,10,0,17,3
1993-11-24,CHH,141,6,4,LAL,124,3,8,9,12
1993-11-24,DET,103,5,4,BOS,118,6,4,11,8
1993-11-24,SAN,109,6,5,CHI,84,4,6,10,11
1993-11-24,PHX,130,6,2,DEN,97,4,5,10,7
1993-11-24,MIA,102,3,5,GOS,108,3,6,6,11
1993-11-24,MIL,85,1,8,ATL,89,6,4,7,12
1993-11-24,CLE,113,3,6,WAS,107,5,4,8,10
1993-11-24,IND,97,3,6,PHL,108,3,7,6,13
1993-11-24,MIN,107,2,6,NJN,106,4,6,6,12
1993-11-24,SAC,93,4,5,SEA,120,8,0,12,5
1993-11-26,UTH,100,7,4,NJN,97,4,7,11,11
1993-11-26,CHH,110,7,4,MIL,99,1,9,8,13
1993-11-26,SAC,89,4,6,HOU,92,11,0,15,6
1993-11-26,PHL,88,4,7,GOS,100,4,6,8,13
1993-11-26,ATL,124,7,4,WAS,108,5,5,12,9
1993-11-26,MIN,92,3,6,SEA,110,9,0,12,6
1993-11-26,DEN,112,4,6,POR,101,6,4,10,10
1993-11-26,BOS,93,7,4,MIA,101,3,6,10,10
1993-11-26,DAL,85,1,9,CHI,108,4,7,5,16
1993-11-26,IND,100,3,7,LAL,102,3,9,6,16
1993-11-27,WAS,112,5,6,ORL,110,6,4,11,10
1993-11-27,MIA,114,4,6,CHH,100,8,4,12,10
1993-11-27,MIL,89,1,10,BOS,85,7,5,8,15
1993-11-27,MIN,92,3,7,LAL,96,4,9,7,16
1993-11-27,DEN,111,5,6,NJN,89,4,8,9,14
1993-11-27,ATL,111,8,4,PHL,79,4,8,12,12
1993-11-27,SAN,104,7,5,DAL,80,1,10,8,15
1993-11-27,NYK,112,8,2,DET,85,5,5,13,7
1993-11-27,PHX,120,7,2,UTH,98,8,4,15,6
1993-11-27,LAC,80,5,5,HOU,82,12,0,17,5
1993-11-27,CLE,101,4,6,SEA,90,10,0,14,6
1993-11-28,POR,120,6,5,SAC,109,4,7,10,12
1993-11-28,DET,88,5,6,GOS,91,5,6,10,12
1993-11-29,SAC,103,4,8,IND,105,3,8,7,16
1993-11-29,SAN,102,8,5,MIL,95,2,10,10,15
1993-11-29,LAC,118,5,6,NJN,94,4,9,9,15
1993-11-30,HOU,102,13,0,MIL,91,2,11,15,11
1993-11-30,CLE,92,5,6,DET,74,5,7,10,13
1993-11-30,UTH,103,8,5,DEN,92,6,6,14,11
1993-11-30,GOS,103,6,6,DAL,91,1,11,7,17
1993-11-30,MIA,109,5,6,POR,123,7,5,12,11
1993-11-30,PHL,80,4,9,SEA,92,10,1,14,10
1993-11-30,CHI,132,5,7,PHX,113,8,2,13,9
1993-11-30,ATL,122,9,4,BOS,114,7,6,16,10
1993-12-01,LAL,124,5,9,DAL,91,1,12,6,21
1993-12-01,NJN,97,4,10,CLE,82,6,6,10,16
1993-12-01,BOS,120,7,7,WAS,113,6,6,13,13
1993-12-01,LAC,100,6,6,IND,120,4,8,10,14
1993-12-01,SAC,101,4,9,MIN,111,3,8,7,17
1993-12-01,CHH,88,8,5,SAN,92,9,5,17,10
1993-12-01,ORL,114,6,5,POR,106,8,5,14,10
1993-12-02,WAS,95,6,7,SEA,105,11,1,17,8
1993-12-02,UTH,103,9,5,IND,87,5,8,14,13
1993-12-02,DET,101,5,8,PHX,102,8,3,13,11
1993-12-02,GOS,91,7,6,MIN,103,4,8,11,14
1993-12-02,NYK,85,9,2,HOU,94,14,0,23,2
1993-12-03,DAL,106,1,13,MIL,107,2,12,3,25
1993-12-03,NJN,103,5,10,PHX,104,9,3,14,13
1993-12-03,ORL,84,7,5,SAN,94,10,5,17,10
1993-12-03,MIA,99,5,7,CHI,104,6,7,11,14
1993-12-03,ATL,133,10,4,HOU,111,15,0,25,4
1993-12-03,BOS,114,8,7,POR,108,8,6,16,13
1993-12-03,DEN,102,6,7,CHH,94,8,6,14,13
1993-12-04,NYK,123,9,3,SAC,101,4,10,13,13
1993-12-04,UTH,122,10,5,CHH,108,8,7,18,12
1993-12-04,CLE,83,6,7,ORL,87,7,6,13,13
1993-12-04,PHL,82,4,10,SAN,90,11,5,15,15
1993-12-04,SEA,99,12,1,MIN,82,5,8,17,9
1993-12-04,LAC,102,6,7,LAL,109,6,9,12,16
1993-12-04,GOS,99,7,7,IND,92,5,9,12,16
1993-12-04,WAS,105,6,8,POR,118,8,7,14,15
1993-12-05,MIL,98,3,12,PHX,117,10,3,13,15
1993-12-05,LAL,99,7,9,MIN,101,5,9,12,18
1993-12-05,DEN,115,7,7,DAL,110,1,14,8,21
1993-12-05,CLE,98,6,8,HOU,99,15,1,21,9
1993-12-06,SEA,103,13,1,WAS,96,6,9,19,10
1993-12-06,UTH,103,11,5,NYK,96,10,3,21,8
1993-12-07,ORL,91,8,6,DET,89,5,9,13,15
1993-12-07,IND,105,5,10,SAC,87,4,11,9,21
1993-12-07,LAL,78,7,10,NYK,92,10,4,17,14
1993-12-07,GOS,95,8,7,DEN,90,8,7,16,14
1993-12-07,CLE,109,6,9,POR,100,9,7,15,16
1993-12-07,NJN,117,5,11,BOS,90,9,7,14,18
1993-12-07,CHI,115,7,7,LAC,111,6,8,13,15
1993-12-07,DAL,101,1,15,MIA,106,5,8,6,23
1993-12-07,HOU,121,16,1,CHH,102,8,8,24,9
1993-12-08,UTH,113,12,5,WAS,91,6,10,18,15
1993-12-08,DET,97,5,10,ATL,105,11,4,16,14
1993-12-08,BOS,129,9,8,SAC,115,4,12,13,20
1993-12-08,MIL,97,3,13,LAC,100,6,9,9,22
1993-12-08,SAN,107,12,5,SEA,109,14,1,26,6
1993-12-08,MIN,111,6,9,POR,114,9,8,15,17
1993-12-08,PHL,95,4,11,CHI,88,8,7,12,18
1993-12-09,GOS,81,9,7,NYK,94,11,4,20,11
1993-12-09,CHH,95,8,9,CLE,93,7,9,15,18
1993-12-09,IND,111,6,10,ORL,105,9,6,15,16
1993-12-09,HOU,115,17,1,MIA,109,6,8,23,9
1993-12-09,ATL,105,12,4,SAN,95,12,6,24,10
1993-12-09,DAL,93,1,16,SEA,125,15,1,16,17
1993-12-09,PHX,114,11,3,WAS,95,6,11,17,14
1993-12-10,MIN,109,6,10,LAC,108,7,9,13,19
1993-12-10,POR,117,10,8,LAL,99,7,11,17,19
1993-12-10,DEN,107,8,8,UTH,98,13,5,21,13
1993-12-10,PHL,103,5,11,SAC,109,4,13,9,24
1993-12-10,ORL,117,9,7,BOS,102,10,8,19,15
1993-12-10,NJN,105,6,11,CHI,109,8,8,14,19
1993-12-10,DET,88,5,11,MIL,90,3,14,8,25
1993-12-11,WAS,108,6,12,ATL,116,13,4,19,16
1993-12-11,CHI,93,9,8,CLE,84,7,10,16,18
1993-12-11,MIA,111,6,9,BOS,80,10,9,16,18
1993-12-11,GOS,115,9,8,UTH,112,13,6,22,14
1993-12-11,HOU,82,18,1,SEA,75,16,1,34,2
1993-12-11,SAN,105,12,7,DEN,100,9,8,21,15
1993-12-11,DAL,103,1,17,PHX,114,12,3,13,20
1993-12-11,MIN,80,7,10,DET,92,5,12,12,22
1993-12-11,CHH,105,9,9,NJN,99,6,12,15,21
1993-12-11,MIL,86,4,14,PHL,99,5,12,9,26
1993-12-11,NYK,98,12,4,IND,91,7,10,19,14
1993-12-12,POR,88,11,8,ORL,103,10,7,21,15
1993-12-12,LAL,97,7,12,GOS,100,10,8,17,20
1993-12-12,SAC,102,5,13,LAC,112,7,10,12,23
1993-12-13,BOS,112,10,10,PHL,107,6,12,16,22
1993-12-13,NJN,110,6,13,MIA,105,7,9,13,22
1993-12-13,UTH,102,13,7,SAN,87,13,7,26,14
1993-12-13,PHX,112,13,3,MIL,104,4,15,17,18
1993-12-14,IND,106,7,11,WAS,87,6,13,13,24
1993-12-14,CHH,101,10,9,MIN,85,7,11,17,20
1993-12-14,SEA,124,16,2,ORL,100,11,7,27,9
1993-12-14,NYK,93,13,4,DEN,84,9,9,22,13
1993-12-14,CLE,92,7,11,ATL,103,14,4,21,15
1993-12-14,DAL,93,1,18,POR,100,11,9,12,27
1993-12-14,DET,93,6,12,LAL,99,7,13,13,25
1993-12-14,MIA,88,7,10,HOU,97,19,1,26,11
1993-12-15,PHX,110,14,3,GOS,104,11,8,25,11
1993-12-15,LAC,110,8,10,ORL,109,11,8,19,18
1993-12-15,MIN,95,7,12,UTH,97,14,7,21,19
1993-12-15,SAC,95,5,14,MIL,96,4,16,9,30
1993-12-15,BOS,98,11,10,CHI,108,10,8,21,18
1993-12-15,SAN,111,13,8,POR,91,12,9,25,17
1993-12-15,PHL,101,6,13,DEN,93,9,10,15,23
1993-12-16,NYK,108,14,4,LAL,85,8,13,22,17
1993-12-16,NJN,111,7,13,CHH,95,11,9,18,22
1993-12-16,MIA,90,7,11,CLE,89,7,12,14,23
1993-12-16,DAL,89,1,19,SAN,103,14,8,15,27
1993-12-16,ATL,81,15,4,IND,99,8,11,23,15
1993-12-16,WAS,95,6,14,DET,97,6,13,12,27
1993-12-17,PHL,105,7,13,LAL,94,8,14,15,27
1993-12-17,LAC,90,9,10,MIN,105,7,13,16,23
1993-12-17,CHH,99,11,10,DEN,96,9,11,20,21
1993-12-17,CHI,98,11,8,NYK,86,15,4,26,12
1993-12-17,PHX,101,15,3,ORL,104,11,9,26,12
1993-12-17,BOS,96,11,11,UTH,97,15,7,26,18
1993-12-17,SEA,127,17,2,MIL,97,5,16,22,18
1993-12-17,SAC,94,5,15,GOS,109,11,9,16,24
1993-12-18,DET,98,7,13,CLE,92,7,13,14,26
1993-12-18,IND,108,9,11,NJN,98,8,13,17,24
1993-12-18,HOU,104,20,1,DAL,93,1,20,21,21
1993-12-18,POR,105,12,10,MIN,95,8,13,20,23
1993-12-18,CHI,102,12,8,SAN,90,15,8,27,16
1993-12-18,WAS,96,6,15,UTH,102,16,7,22,22
1993-12-18,ATL,102,15,5,DEN,96,9,12,24,17
1993-12-18,PHX,116,15,4,LAC,109,9,11,24,15
1993-12-18,SEA,126,18,2,GOS,111,12,9,30,11
1993-12-18,MIA,113,8,11,PHL,90,8,13,16,24
1993-12-19,CLE,122,7,14,LAL,92,8,15,15,29
1993-12-19,POR,93,13,10,MIL,81,5,17,18,27
1993-12-19,SAC,91,5,16,ORL,97,12,9,17,25
1993-12-20,LAC,92,9,12,MIL,105,5,18,14,30
1993-12-20,NYK,101,15,5,DAL,92,1,21,16,26
1993-12-20,PHL,121,8,14,DET,92,8,13,16,27
1993-12-20,CHI,109,13,8,CHH,97,12,10,25,18
1993-12-20,MIN,84,8,14,WAS,99,6,16,14,30
1993-12-20,PHX,102,16,4,IND,94,10,11,26,15
1993-12-21,DET,97,8,14,CHH,108,12,11,20,25
1993-12-21,CLE,112,8,14,UTH,97,17,7,25,21
1993-12-21,SEA,91,19,2,IND,88,10,12,29,14
1993-12-21,DEN,121,9,13,PHX,95,17,4,26,17
1993-12-21,ORL,102,13,9,LAL,109,8,16,21,25
1993-12-21,GOS,98,12,10,POR,100,14,10,26,20
1993-12-21,SAN,88,15,9,HOU,90,21,1,36,10
1993-12-21,NJN,85,8,14,NYK,81,16,5,24,19
1993-12-22,LAC,109,9,13,WAS,92,7,16,16,29
1993-12-22,PHL,90,9,14,MIA,98,9,11,18,25
1993-12-22,MIL,96,6,18,DAL,86,1,22,7,40
1993-12-22,BOS,103,11,12,ATL,108,16,5,27,17
1993-12-22,CHI,106,14,8,MIN,98,8,15,22,23
1993-12-23,MIN,89,8,16,DAL,93,1,23,9,39
1993-12-23,POR,108,15,10,IND,96,10,13,25,23
1993-12-23,SAN,88,15,10,UTH,96,17,8,32,18
1993-12-23,ORL,122,13,10,NJN,112,9,14,22,24
1993-12-23,NYK,84,16,6,ATL,75,17,5,33,11
1993-12-23,SAC,114,5,17,WAS,88,7,17,12,34
1993-12-23,SEA,86,20,2,PHX,87,17,5,37,7
1993-12-23,CHH,118,13,11,BOS,100,11,13,24,24
1993-12-23,GOS,141,12,11,LAC,95,10,13,22,24
1993-12-23,CLE,107,9,14,MIL,88,7,18,16,32
1993-12-23,HOU,93,22,1,DEN,106,10,13,32,14
1993-12-23,DET,72,8,15,CHI,81,15,8,23,23
1993-12-23,MIA,109,10,11,LAL,92,9,16,19,27
1993-12-25,PHX,111,18,5,HOU,91,22,2,40,7
1993-12-25,CHI,95,16,8,ORL,93,14,10,30,18
1993-12-26,MIA,109,11,11,SAC,95,6,17,17,28
1993-12-26,LAL,93,9,17,HOU,118,22,3,31,20
1993-12-26,DEN,100,11,13,MIN,97,8,17,19,30
1993-12-26,NJN,91,9,15,ATL,87,17,6,26,21
1993-12-26,SAN,99,15,11,BOS,85,11,14,26,25
1993-12-26,POR,106,16,10,GOS,108,13,11,29,21
1993-12-26,CLE,107,10,14,IND,103,10,14,20,28
1993-12-27,LAC,96,10,14,PHL,86,9,15,19,29
1993-12-27,MIL,87,7,19,WAS,96,7,18,14,37
1993-12-27,UTH,97,18,8,MIN,93,8,18,26,26
1993-12-27,PHX,118,19,5,BOS,102,11,15,30,20
1993-12-27,ORL,122,14,11,SAC,110,6,18,20,29
1993-12-27,CHH,109,14,11,DET,94,8,16,22,27
1993-12-28,NYK,95,17,6,NJN,97,10,15,27,21
1993-12-28,CLE,127,11,14,CHH,115,15,11,26,25
1993-12-28,GOS,90,14,11,PHL,107,9,16,23,27
1993-12-28,SEA,112,20,3,HOU,97,23,3,43,6
1993-12-28,ATL,119,17,7,DET,101,8,17,25,24
1993-12-28,MIA,76,12,11,SAN,84,16,11,28,22
1993-12-28,DAL,85,2,23,DEN,97,12,13,14,36
1993-12-29,WAS,97,8,18,SAC,103,6,19,14,37
1993-12-29,LAL,92,9,18,SEA,99,21,3,30,21
1993-12-29,UTH,110,19,8,BOS,107,11,16,30,24
1993-12-29,ORL,90,15,11,ATL,92,18,7,33,18
1993-12-29,POR,114,16,11,LAC,98,11,14,27,25
1993-12-29,CHI,94,17,8,NJN,86,11,15,28,23
1993-12-30,NYK,102,17,7,WAS,84,8,19,25,26
1993-12-30,MIA,100,12,12,ORL,108,15,12,27,24
1993-12-30,DET,91,8,18,SAC,97,7,19,15,37
1993-12-30,LAC,111,11,15,BOS,119,11,17,22,32
1993-12-30,IND,82,10,15,SAN,107,17,11,27,26
1993-12-30,PHX,119,20,5,PHL,107,10,16,30,21
1993-12-30,MIL,105,7,20,CLE,103,12,14,19,34
1993-12-30,CHH,115,15,12,CHI,95,18,8,33,20
1993-12-30,DEN,101,13,13,GOS,96,14,12,27,25
1993-12-30,MIN,104,8,19,HOU,110,23,4,31,23
1994-01-02,BOS,97,12,17,NJN,101,11,16,23,33
1994-01-02,SAN,94,18,11,LAL,92,9,19,27,30
1994-01-02,DEN,80,14,13,PHL,96,10,17,24,30
1994-01-02,SAC,119,8,19,DAL,116,2,24,10,43
1994-01-02,NYK,123,18,7,CHH,124,16,12,34,19
1994-01-02,DET,85,8,19,MIA,93,12,13,20,32
1994-01-02,POR,90,17,11,UTH,92,20,8,37,19
1994-01-03,UTH,115,21,8,DAL,85,2,25,23,33
1994-01-04,HOU,106,24,4,POR,95,17,12,41,16
1994-01-04,CHI,97,18,9,DET,91,8,20,26,29
1994-01-04,GOS,115,14,13,SAC,112,9,19,23,32
1994-01-04,PHX,106,21,5,SEA,112,22,3,43,8
1994-01-04,DEN,118,14,14,LAL,119,9,20,23,34
1994-01-04,IND,104,10,16,CLE,99,12,15,22,31
1994-01-04,MIA,100,13,13,NJN,83,12,16,25,29
1994-01-04,ATL,133,19,7,CHH,94,17,12,36,19
1994-01-04,NYK,100,18,8,ORL,95,16,12,34,20
1994-01-04,SAN,107,19,11,PHL,84,11,17,30,28
1994-01-05,ORL,105,16,13,CHI,90,19,9,35,22
1994-01-05,NJN,91,12,17,MIL,100,8,20,20,37
1994-01-05,UTH,91,22,8,PHX,107,21,6,43,14
1994-01-05,WAS,97,8,20,IND,95,11,16,19,36
1994-01-05,CLE,96,12,16,BOS,101,12,18,24,34
1994-01-05,MIN,109,8,20,DEN,95,14,15,22,35
1994-01-05,LAC,98,11,16,SEA,106,23,3,34,19
1994-01-05,SAC,106,9,20,LAL,98,10,20,19,40
1994-01-05,DAL,102,2,26,HOU,114,25,4,27,30
1994-01-06,GOS,102,15,13,SAN,98,20,11,35,24
1994-01-06,CHH,110,17,13,POR,116,17,13,34,26
1994-01-06,MIL,86,9,20,NYK,92,19,8,28,28
1994-01-07,BOS,85,13,18,CLE,99,12,17,25,35
1994-01-07,ATL,100,20,7,POR,85,18,13,38,20
1994-01-07,UTH,104,22,9,MIA,110,14,13,36,22
1994-01-07,LAL,111,10,21,LAC,108,11,17,21,38
1994-01-07,DAL,93,2,27,PHL,103,11,18,13,45
1994-01-07,DEN,76,14,16,SAN,84,20,12,34,28
1994-01-07,MIN,103,9,20,PHX,110,22,6,31,26
1994-01-07,SEA,102,24,3,SAC,93,10,20,34,23
1994-01-07,WAS,92,9,20,CHI,99,19,10,28,30
1994-01-08,HOU,100,26,4,PHL,93,12,18,38,22
1994-01-08,DET,92,8,21,IND,101,11,17,19,38
1994-01-08,ORL,112,17,13,WAS,101,9,21,26,34
1994-01-08,DEN,104,14,17,SAC,98,10,21,24,38
1994-01-08,MIL,87,9,21,NJN,90,12,18,21,39
1994-01-08,SEA,108,25,3,UTH,87,22,10,47,13
1994-01-08,ATL,102,21,7,CLE,89,13,17,34,24
1994-01-08,LAC,90,11,18,MIA,109,15,13,26,31
1994-01-08,MIN,108,9,21,BOS,90,13,19,22,40
1994-01-08,CHI,100,20,10,DAL,81,2,28,22,38
1994-01-08,CHH,102,17,14,NYK,99,20,8,37,22
1994-01-09,LAL,89,11,21,SAN,95,21,12,32,33
1994-01-09,PHX,122,23,6,GOS,107,16,13,39,19
1994-01-09,NYK,99,20,9,POR,85,18,14,38,23
1994-01-10,PHL,99,12,19,BOS,94,13,20,25,39
1994-01-10,ORL,115,18,13,HOU,100,27,4,45,17
1994-01-11,PHX,93,24,6,CHH,95,18,14,42,20
1994-01-11,SAN,108,22,12,MIN,98,10,21,32,33
1994-01-11,DET,86,8,22,DEN,94,15,17,23,39
1994-01-11,NYK,98,21,9,LAC,77,11,19,32,28
1994-01-11,LAL,117,11,22,GOS,122,16,14,27,36
1994-01-11,NJN,100,13,18,WAS,115,9,22,22,40
1994-01-11,POR,108,18,15,SEA,99,26,3,44,18
1994-01-11,SAC,103,10,22,MIA,95,16,13,26,35
1994-01-11,MIL,76,9,22,IND,82,12,17,21,39
1994-01-12,GOS,100,17,14,MIA,92,16,14,33,28
1994-01-12,ORL,109,19,13,CLE,118,13,18,32,31
1994-01-12,IND,107,13,17,DEN,96,16,17,29,34
1994-01-12,ATL,92,22,7,CHI,81,21,10,43,17
1994-01-12,DAL,85,2,29,MIN,103,10,22,12,51
1994-01-12,PHL,117,13,19,LAC,98,11,20,24,39
1994-01-12,BOS,84,13,21,HOU,94,27,5,40,26
1994-01-13,SAN,107,23,12,PHX,88,24,7,47,19
1994-01-13,WAS,120,10,22,HOU,102,28,5,38,27
1994-01-13,CLE,104,14,18,NJN,93,13,19,27,37
1994-01-13,DET,80,8,23,NYK,94,22,9,30,32
1994-01-13,MIL,83,9,23,UTH,101,22,11,31,34
1994-01-13,SAC,115,11,22,CHH,104,19,14,30,36
1994-01-14,LAL,122,11,23,CHH,130,19,15,30,38
1994-01-14,CHI,107,21,11,UTH,91,23,11,44,22
1994-01-14,BOS,95,13,22,LAC,102,11,21,24,43
1994-01-14,GOS,121,18,14,SEA,100,26,4,44,18
1994-01-14,NJN,103,13,20,DEN,96,16,18,29,38
1994-01-14,PHL,104,14,19,IND,102,14,17,28,36
1994-01-14,MIN,96,11,22,ORL,92,19,14,30,36
1994-01-14,ATL,113,23,7,DAL,96,2,30,25,37
1994-01-14,POR,115,19,15,MIA,110,16,15,35,30
1994-01-15,CLE,110,15,18,PHL,67,15,19,30,37
1994-01-15,SEA,97,26,5,MIA,78,16,16,42,21
1994-01-15,SAC,103,12,22,PHX,119,24,8,36,30
1994-01-15,DAL,87,2,31,SAN,104,24,12,26,43
1994-01-15,NYK,97,23,9,DET,88,8,24,31,33
1994-01-15,CHI,82,22,11,HOU,76,28,6,50,17
1994-01-15,MIL,105,9,24,ORL,113,19,15,28,39
1994-01-15,IND,94,14,18,ATL,91,24,7,38,25
1994-01-15,WAS,118,11,22,LAC,109,12,21,23,43
1994-01-16,POR,106,20,15,CHH,101,20,15,40,30
1994-01-16,BOS,105,13,23,DEN,100,16,19,29,42
1994-01-16,NJN,99,14,20,UTH,94,23,12,37,32
1994-01-17,NYK,106,24,9,MIN,94,12,22,36,31
1994-01-17,WAS,87,12,22,SAN,100,25,12,37,34
1994-01-17,ATL,102,24,8,MIL,98,9,25,33,33
1994-01-17,GOS,104,19,14,PHX,99,25,8,44,22
1994-01-17,CLE,114,16,18,ORL,107,20,15,36,33
1994-01-17,DET,94,8,25,UTH,109,23,13,31,38
1994-01-17,CHI,121,23,11,PHL,91,15,20,38,31
1994-01-18,MIL,123,9,26,DET,91,8,26,17,52
1994-01-18,DEN,103,16,20,POR,104,21,15,37,35
1994-01-18,SEA,103,27,5,LAL,88,11,24,38,29
1994-01-18,HOU,83,28,7,BOS,95,14,23,42,30
1994-01-18,PHX,113,25,9,DAL,103,2,32,27,41
1994-01-18,MIA,124,16,17,LAC,126,12,22,28,39
1994-01-19,DAL,84,2,33,BOS,89,15,23,17,56
1994-01-19,UTH,104,24,13,CLE,92,17,18,41,31
1994-01-19,CHH,115,20,16,PHL,103,15,21,35,37
1994-01-19,CHI,84,24,11,WAS,83,12,23,36,34
1994-01-19,ORL,108,20,16,LAC,96,13,22,33,38
1994-01-19,IND,109,15,18,MIA,92,16,18,31,36
1994-01-19,NJN,112,15,20,MIN,91,12,23,27,43
1994-01-19,NYK,120,25,9,SAN,108,26,12,51,21
1994-01-19,ATL,119,25,8,GOS,120,20,14,45,22
1994-01-19,SAC,95,12,23,SEA,114,28,5,40,28
1994-01-20,MIN,93,12,24,SAN,83,26,13,38,37
1994-01-20,DEN,111,16,21,HOU,106,28,8,44,29
1994-01-20,LAL,107,11,25,PHX,102,26,9,37,34
1994-01-21,LAC,90,13,23,CLE,106,17,19,30,42
1994-01-21,MIA,98,16,19,DET,118,8,27,24,46
1994-01-21,CHI,96,25,11,IND,95,16,18,41,29
1994-01-21,ORL,106,21,16,NYK,103,26,9,47,25
1994-01-21,POR,111,22,15,LAL,93,12,25,34,40
1994-01-21,MIL,113,10,26,CHH,110,21,16,31,42
1994-01-21,DAL,87,2,34,SEA,91,29,5,31,39
1994-01-21,BOS,124,16,23,GOS,116,21,14,37,37
1994-01-21,ATL,111,25,9,NJN,113,16,20,41,29
1994-01-21,UTH,112,25,13,SAC,83,12,24,37,37
1994-01-22,HOU,106,28,9,UTH,101,26,13,54,22
1994-01-22,DEN,98,17,21,SEA,91,30,5,47,26
1994-01-22,IND,81,16,19,CHI,90,26,11,42,30
1994-01-22,SAC,109,12,25,CLE,119,18,19,30,44
1994-01-22,NJN,124,17,20,GOS,98,21,15,38,35
1994-01-22,CHH,91,21,17,MIL,80,11,26,32,43
1994-01-22,WAS,98,12,24,DET,93,9,27,21,51
1994-01-22,PHX,118,26,10,POR,117,23,15,49,25
1994-01-22,MIN,81,13,24,ATL,98,25,10,38,34
1994-01-22,PHL,112,15,22,ORL,121,22,16,37,38
1994-01-22,SAN,103,26,14,DAL,83,2,35,28,49
1994-01-23,NYK,92,26,10,PHL,99,15,23,41,33
1994-01-23,MIA,113,16,20,WAS,80,13,24,29,44
1994-01-24,DET,86,9,28,CHI,92,27,11,36,39
1994-01-24,BOS,110,17,23,DAL,102,2,36,19,59
1994-01-24,UTH,95,26,14,SEA,90,30,6,56,20
1994-01-24,IND,88,16,20,MIL,96,11,27,27,47
1994-01-25,MIA,119,17,20,CHH,98,22,17,39,37
1994-01-25,POR,122,23,16,NJN,117,18,20,41,36
1994-01-25,SAN,107,27,14,SAC,91,12,26,39,40
1994-01-25,MIL,90,12,27,ATL,95,26,10,38,37
1994-01-25,SEA,103,30,7,LAC,111,13,24,43,31
1994-01-25,NYK,98,26,11,PHX,96,27,10,53,21
1994-01-25,ORL,112,23,16,WAS,89,13,25,36,41
1994-01-25,HOU,96,29,9,CLE,93,19,19,48,28
1994-01-26,MIN,100,13,25,UTH,98,27,14,40,39
1994-01-26,BOS,103,18,23,MIA,98,18,20,36,43
1994-01-26,GOS,108,21,16,DET,92,9,29,30,45
1994-01-26,CHH,120,22,18,ORL,145,24,16,46,34
1994-01-26,ATL,116,27,10,PHX,107,27,11,54,21
1994-01-26,LAL,103,12,26,IND,99,16,21,28,47
1994-01-26,PHL,104,16,23,DAL,90,2,37,18,60
1994-01-27,HOU,113,30,9,SAC,97,12,27,42,36
1994-01-27,DEN,113,18,21,IND,106,16,22,34,43
1994-01-27,WAS,98,13,26,DAL,95,2,38,15,64
1994-01-27,LAC,101,14,24,NYK,103,27,11,41,35
1994-01-27,SEA,102,30,8,NJN,92,18,21,48,29
1994-01-27,CLE,100,19,20,CHI,84,28,11,47,31
1994-01-28,UTH,119,27,15,GOS,91,22,16,49,31
1994-01-28,CHI,113,28,12,MIL,96,12,28,40,40
1994-01-28,LAL,105,13,26,DET,97,9,30,22,56
1994-01-28,POR,109,24,16,MIN,98,14,25,38,41
1994-01-28,ORL,97,25,16,MIA,106,18,21,43,37
1994-01-28,CHH,105,22,19,ATL,117,28,10,50,29
1994-01-28,PHL,103,17,23,PHX,108,27,12,44,35
1994-01-29,SEA,92,31,8,NYK,106,28,11,59,19
1994-01-29,DEN,128,19,21,DET,110,9,31,28,52
1994-01-29,LAC,103,14,25,MIN,93,14,26,28,51
1994-01-29,WAS,99,14,26,ORL,103,25,17,39,43
1994-01-29,GOS,106,22,17,NJN,120,18,22,40,39
1994-01-29,DAL,108,2,39,SAC,101,12,28,14,67
1994-01-29,SAN,100,28,14,ATL,87,29,10,57,24
1994-01-29,PHL,94,17,24,MIL,89,12,29,29,53
1994-01-29,HOU,108,31,9,IND,119,16,23,47,32
1994-01-29,CLE,98,20,20,MIA,113,19,21,39,41
1994-01-30,POR,93,25,16,NYK,103,29,11,54,27
1994-01-30,BOS,106,19,23,PHX,94,28,12,47,35
1994-01-31,DET,103,9,32,CLE,107,20,21,29,53
1994-01-31,LAC,96,15,25,GOS,110,22,18,37,43
1994-01-31,DAL,85,3,39,ATL,90,29,11,32,50
1994-02-01,NYK,114,30,11,BOS,79,20,23,50,34
1994-02-01,MIL,82,12,30,MIA,88,20,21,32,51
1994-02-01,NJN,104,19,22,SEA,103,31,9,50,31
1994-02-01,IND,116,17,23,WAS,96,14,27,31,50
1994-02-01,SAC,102,12,29,POR,97,25,17,37,46
1994-02-01,DEN,98,20,21,CHI,118,29,12,49,33
1994-02-01,SAN,112,29,14,LAL,97,14,26,43,40
1994-02-01,PHX,108,28,13,LAC,106,15,26,43,39
1994-02-01,UTH,104,28,15,HOU,88,31,10,59,25
1994-02-02,GOS,97,23,18,DEN,84,20,22,43,40
1994-02-02,CHH,112,22,20,IND,124,18,23,40,43
1994-02-02,MIN,88,14,27,DAL,92,3,40,17,67
1994-02-02,DET,104,9,33,MIL,90,12,31,21,64
1994-02-02,ATL,118,30,11,ORL,99,26,17,56,28
1994-02-02,PHL,97,18,24,CLE,105,21,21,39,45
1994-02-02,WAS,80,14,28,NYK,85,31,11,45,39
1994-02-02,BOS,84,20,24,SEA,97,31,10,51,34
1994-02-03,POR,126,25,18,PHX,105,29,13,54,31
1994-02-03,HOU,99,31,11,LAL,88,14,27,45,38
1994-02-03,UTH,85,29,15,CHI,94,30,12,59,27
1994-02-03,CLE,97,22,21,SAN,98,30,14,52,35
1994-02-04,ATL,114,31,11,NYK,102,32,11,63,22
1994-02-04,SAC,83,13,29,DEN,108,20,23,33,52
1994-02-04,DAL,87,4,40,LAL,95,14,28,18,68
1994-02-04,CHH,118,22,21,MIA,124,21,21,43,42
1994-02-04,DET,84,10,33,SEA,108,32,10,42,43
1994-02-04,PHL,95,18,25,WAS,102,14,29,32,54
1994-02-04,IND,114,19,23,MIN,93,14,28,33,51
1994-02-04,GOS,99,24,18,CHI,101,31,12,55,30
1994-02-04,ORL,92,26,18,MIL,98,12,32,38,50
1994-02-04,BOS,91,20,25,SAN,100,31,14,51,39
1994-02-05,MIA,94,22,21,PHL,96,18,26,40,47
1994-02-05,UTH,128,29,16,POR,114,26,18,55,34
1994-02-05,IND,111,20,23,CHH,102,22,22,42,45
1994-02-05,MIL,94,13,32,SEA,115,33,10,46,42
1994-02-05,LAC,122,15,27,SAC,110,13,30,28,57
1994-02-05,CLE,109,22,22,ATL,93,32,11,54,33
1994-02-05,DET,100,10,34,NJN,107,20,22,30,56
1994-02-06,LAL,107,15,28,UTH,90,30,16,45,44
1994-02-06,PHX,89,29,14,CHI,88,32,12,61,26
1994-02-06,NYK,95,32,12,ORL,77,26,19,58,31
1994-02-06,DEN,99,21,23,DAL,89,4,41,25,64
1994-02-06,NJN,102,21,22,SAN,104,32,14,53,36
1994-02-06,HOU,101,32,11,MIN,90,14,29,46,40
1994-02-06,WAS,84,15,29,GOS,106,24,19,39,48
1994-02-07,MIA,96,22,22,NYK,85,33,12,55,34
1994-02-07,ATL,141,32,12,DET,97,10,35,42,47
1994-02-07,PHL,125,19,26,CHH,117,22,23,41,49
1994-02-07,IND,104,21,23,GOS,99,25,19,46,42
1994-02-08,MIL,106,13,33,HOU,98,33,11,46,44
1994-02-08,CLE,112,23,22,NJN,104,21,23,44,45
1994-02-08,LAL,107,16,28,PHX,104,30,14,46,42
1994-02-08,DAL,108,4,42,MIN,105,14,30,18,72
1994-02-08,SAN,110,33,14,WAS,90,15,30,48,44
1994-02-08,LAC,89,16,27,CHI,118,32,13,48,40
1994-02-08,POR,124,26,19,SAC,100,13,31,39,50
1994-02-08,DEN,95,22,23,UTH,96,30,17,52,40
1994-02-09,PHL,79,20,26,NYK,114,33,13,53,39
1994-02-09,ORL,104,26,20,ATL,87,33,12,59,32
1994-02-09,MIA,98,23,22,IND,102,22,23,45,45
1994-02-09,SAC,105,13,32,LAC,95,16,28,29,60
1994-02-09,PHX,111,30,15,MIN,106,14,31,44,46
1994-02-09,BOS,95,20,26,DET,102,10,36,30,62
1994-02-09,UTH,96,31,17,LAL,103,17,28,48,45
1994-02-09,SEA,115,34,10,POR,94,27,19,61,29
1994-02-09,NJN,106,21,24,CLE,95,24,22,45,46
1994-02-09,CHH,116,22,24,GOS,126,25,20,47,44
1994-02-10,SAN,94,34,14,DEN,87,22,24,56,38
1994-02-10,NYK,105,34,13,GOS,113,26,20,60,33
1994-02-10,DET,81,11,36,HOU,104,33,12,44,48
1994-02-10,MIL,80,14,33,CHI,97,33,13,47,46
1994-02-10,LAL,84,18,28,SAC,103,14,32,32,60
1994-02-10,DAL,87,5,42,WAS,77,15,31,20,73
1994-02-10,ATL,114,33,13,MIA,98,23,23,56,36
1994-02-15,SEA,133,35,10,PHL,105,20,27,55,37
1994-02-15,NJN,103,22,24,NYK,83,34,14,56,38
1994-02-15,HOU,103,34,12,ATL,99,34,13,68,25
1994-02-15,DET,100,11,37,WAS,93,15,32,26,69
1994-02-15,DAL,103,6,42,POR,106,27,20,33,62
1994-02-15,GOS,123,27,20,SAC,113,15,32,42,52
1994-02-15,ORL,102,27,20,BOS,92,20,27,47,47
1994-02-15,SAN,109,35,14,IND,100,23,23,58,37
1994-02-15,CLE,111,24,23,DEN,99,22,25,46,48
1994-02-15,LAL,89,18,29,LAC,100,16,29,34,58
1994-02-15,MIN,97,14,32,MIL,90,14,34,28,66
1994-02-16,CHI,101,34,13,MIA,109,23,24,57,37
1994-02-16,MIL,95,14,35,DEN,107,22,26,36,61
1994-02-16,SAC,94,15,33,PHL,92,20,28,35,61
1994-02-16,CHH,102,22,25,HOU,97,35,12,57,37
1994-02-16,PHX,126,31,15,POR,100,28,20,59,35
1994-02-16,LAC,99,17,29,UTH,103,31,18,48,47
1994-02-17,CLE,95,25,23,NYK,102,34,15,59,38
1994-02-17,WAS,109,15,33,MIN,105,15,32,30,65
1994-02-17,DAL,73,6,43,IND,84,23,24,29,67
1994-02-17,SAN,115,36,14,DET,96,12,37,48,51
1994-02-17,GOS,119,28,20,ATL,115,34,14,62,34
1994-02-17,BOS,98,20,28,NJN,117,23,24,43,52
1994-02-17,MIA,115,24,24,SEA,112,36,10,60,34
1994-02-18,ORL,124,28,20,SEA,93,36,11,64,31
1994-02-18,WAS,110,16,33,NJN,113,24,24,40,57
1994-02-18,SAC,90,16,33,UTH,81,32,18,48,51
1994-02-18,MIN,78,15,33,CLE,85,25,24,40,57
1994-02-18,CHI,84,34,14,DEN,109,23,26,57,40
1994-02-18,CHH,99,23,25,MIL,106,14,36,37,61
1994-02-18,PHX,113,32,15,LAL,96,18,30,50,45
1994-02-18,POR,109,28,21,PHL,93,20,29,48,50
1994-02-18,LAC,91,17,30,ATL,97,34,15,51,45
1994-02-19,DAL,96,6,44,DET,105,12,38,18,82
1994-02-19,SAN,100,37,14,MIA,96,25,24,62,38
1994-02-19,HOU,106,35,13,PHX,88,33,15,68,28
1994-02-19,UTH,100,32,19,LAC,93,17,31,49,50
1994-02-19,GOS,101,29,20,BOS,90,20,29,49,49
1994-02-20,POR,102,29,21,BOS,93,20,30,49,51
1994-02-20,DEN,97,24,26,ATL,92,35,15,59,41
1994-02-20,LAL,107,18,31,PHL,95,20,30,38,61
1994-02-20,NYK,86,35,15,CHI,68,34,15,69,30
1994-02-20,MIL,104,15,36,ORL,109,29,20,44,56
1994-02-20,CHH,101,23,26,CLE,105,26,24,49,50
1994-02-20,NJN,122,25,24,WAS,101,16,34,41,58
1994-02-20,IND,101,24,24,SEA,95,36,12,60,36
1994-02-21,CHI,118,34,16,CHH,93,23,27,57,43
1994-02-21,PHX,112,33,16,SAC,86,17,33,50,49
1994-02-21,DET,88,13,38,DAL,98,6,45,19,83
1994-02-21,UTH,119,33,19,PHL,92,20,31,53,50
1994-02-21,MIN,89,15,34,SAN,114,38,14,53,48
1994-02-21,MIA,128,25,25,WAS,98,16,35,41,60
1994-02-22,SAC,95,17,34,BOS,93,20,31,37,65
1994-02-22,NYK,82,36,15,SEA,93,36,13,72,28
1994-02-22,NJN,97,26,24,MIA,123,26,25,52,49
1994-02-22,CLE,114,27,24,MIN,81,15,35,42,59
1994-02-22,IND,107,25,24,DAL,101,7,45,32,69
1994-02-22,HOU,98,36,13,DEN,97,25,26,61,39
1994-02-22,MIL,113,15,37,GOS,117,30,20,45,57
1994-02-22,POR,120,30,21,LAC,117,17,32,47,53
1994-02-23,CHI,123,35,16,GOS,100,31,20,66,36
1994-02-23,DEN,102,25,27,BOS,94,20,32,45,59
1994-02-23,LAC,112,17,33,POR,121,31,21,48,54
1994-02-23,ATL,99,35,16,SEA,92,37,13,72,29
1994-02-23,WAS,96,16,36,CLE,106,28,24,44,60
1994-02-23,UTH,106,34,19,SAN,102,39,14,73,33
1994-02-23,PHL,102,20,32,NJN,106,26,25,46,57
1994-02-23,ORL,103,30,20,IND,99,26,24,56,44
1994-02-24,CHH,110,23,28,DAL,115,7,46,30,74
1994-02-24,SAC,102,18,34,LAL,90,19,31,37,65
1994-02-24,HOU,93,37,13,NYK,73,36,16,73,29
1994-02-24,MIN,101,15,36,PHX,120,34,16,49,52
1994-02-25,UTH,107,35,19,PHX,87,35,16,70,35
1994-02-25,SEA,115,37,14,BOS,102,20,33,57,47
1994-02-25,WAS,94,16,37,CHI,116,36,16,52,53
1994-02-25,LAC,121,17,34,SAC,111,19,34,36,68
1994-02-25,PHL,84,20,33,MIA,115,27,25,47,58
1994-02-25,ATL,111,36,16,MIL,100,15,38,51,54
1994-02-25,IND,110,26,25,DET,90,13,39,39,64
1994-02-25,CLE,107,29,24,GOS,97,31,21,60,45
1994-02-25,DEN,102,26,27,NYK,94,36,17,62,44
1994-02-25,LAL,110,19,32,SAN,126,39,15,58,47
1994-02-25,ORL,114,31,20,NJN,102,27,25,58,45
1994-02-26,POR,104,32,21,SAN,96,40,15,72,36
1994-02-26,CLE,110,30,24,DAL,99,8,46,38,70
1994-02-26,CHI,86,37,16,IND,96,27,25,64,41
1994-02-26,MIL,115,15,39,WAS,100,16,38,31,77
1994-02-26,HOU,85,38,13,UTH,95,36,19,74,32
1994-02-26,PHL,102,20,34,ATL,118,37,16,57,50
1994-02-26,DET,100,13,40,MIA,105,28,25,41,65
1994-02-27,NJN,117,27,26,DAL,90,8,47,35,73
1994-02-27,MIN,107,15,37,GOS,100,31,22,46,59
1994-02-27,LAL,100,19,33,BOS,97,20,34,39,67
1994-02-27,ORL,114,32,20,CHH,103,23,29,55,49
1994-02-27,PHX,92,35,17,NYK,78,36,18,71,35
1994-02-27,POR,104,33,21,DEN,97,27,27,60,48
1994-02-27,LAC,118,18,34,SEA,122,38,14,56,48
1994-02-28,CHI,81,37,17,CLE,89,31,24,68,41
1994-02-28,UTH,89,37,19,HOU,85,38,14,75,33
1994-03-01,PHL,103,20,35,WAS,109,16,39,36,74
1994-03-01,SEA,112,39,14,CHH,96,23,30,62,44
1994-03-01,HOU,97,38,15,ORL,85,33,20,71,35
1994-03-01,NJN,108,28,26,DET,98,13,41,41,67
1994-03-01,SAC,88,19,35,NYK,100,36,19,55,54
1994-03-01,GOS,114,31,23,LAC,109,18,35,49,58
1994-03-01,MIL,102,16,39,MIA,110,29,25,45,64
1994-03-01,IND,106,28,25,POR,94,34,21,62,46
1994-03-01,ATL,102,38,16,MIN,99,16,37,54,53
1994-03-02,DET,107,13,42,POR,131,34,22,47,64
1994-03-02,MIN,100,16,38,MIA,108,30,25,46,63
1994-03-02,BOS,96,20,35,CLE,110,32,24,52,59
1994-03-02,CHI,89,37,18,LAL,97,20,33,57,51
1994-03-02,LAC,118,18,36,CHH,109,23,31,41,67
1994-03-02,SAN,96,40,16,UTH,106,38,19,78,35
1994-03-03,WAS,98,17,39,ATL,109,39,16,56,55
1994-03-03,NYK,97,37,19,NJN,86,29,26,66,45
1994-03-03,GOS,120,32,23,PHX,107,36,17,68,40
1994-03-03,DAL,94,8,48,ORL,107,33,21,41,69
1994-03-03,CLE,95,33,24,PHL,87,20,36,53,60
1994-03-04,PHX,106,36,18,MIN,101,16,39,52,57
1994-03-04,SAN,121,40,17,LAC,113,19,36,59,53
1994-03-04,IND,126,29,25,NJN,110,29,27,58,52
1994-03-04,CHI,96,37,19,POR,115,35,22,72,41
1994-03-04,DEN,98,27,28,ORL,89,34,21,61,49
1994-03-04,BOS,109,20,36,LAL,99,21,33,41,69
1994-03-05,SEA,114,40,14,SAC,98,19,36,59,50
1994-03-05,GOS,129,33,23,CHH,112,23,32,56,55
1994-03-05,MIA,120,31,25,PHL,83,20,37,51,62
1994-03-05,HOU,124,39,15,LAC,107,19,37,58,52
1994-03-05,MIL,117,16,40,DET,108,13,43,29,83
1994-03-05,WAS,124,17,40,LAL,118,21,34,38,74
1994-03-05,ATL,90,40,16,IND,88,30,25,70,41
1994-03-05,DAL,90,8,49,UTH,103,39,19,47,68
1994-03-06,DEN,117,28,28,MIN,97,16,40,44,68
1994-03-06,CLE,99,34,24,CHI,95,37,20,71,44
1994-03-06,PHX,92,37,18,UTH,103,40,19,77,37
1994-03-06,NJN,126,29,28,PHL,99,20,38,49,66
1994-03-06,SAC,85,19,37,SEA,102,41,14,60,51
1994-03-06,SAN,111,41,17,ORL,103,34,22,75,39
1994-03-07,MIL,84,17,40,LAL,106,21,35,38,75
1994-03-07,MIA,104,32,25,BOS,112,21,36,53,61
1994-03-07,DET,85,13,44,NYK,99,38,19,51,63
1994-03-07,POR,137,36,22,GOS,108,34,23,70,45
1994-03-08,CLE,103,35,24,SAC,82,19,38,54,62
1994-03-08,CHI,116,37,21,ATL,95,41,16,78,37
1994-03-08,SEA,113,42,14,GOS,98,34,24,76,38
1994-03-08,CHH,97,23,33,PHX,89,37,19,60,52
1994-03-08,UTH,100,41,19,MIN,86,16,41,57,60
1994-03-08,DAL,110,8,50,LAC,116,19,38,27,88
1994-03-08,ORL,95,34,23,DEN,88,29,28,63,51
1994-03-08,SAN,115,42,17,HOU,99,40,15,82,32
1994-03-09,DET,114,13,45,NJN,97,30,28,43,73
1994-03-09,MIL,94,17,41,IND,105,30,26,47,67
1994-03-09,PHL,101,20,39,ORL,117,35,23,55,62
1994-03-09,POR,122,37,22,UTH,99,42,19,79,41
1994-03-09,WAS,106,18,40,PHX,142,37,20,55,60
1994-03-09,MIN,96,16,42,SAC,104,19,39,35,81
1994-03-09,MIA,102,32,26,DEN,80,29,29,61,55
1994-03-09,ATL,83,41,17,NYK,90,39,19,80,36
1994-03-10,GOS,100,34,25,POR,97,38,22,72,47
1994-03-10,LAL,106,22,35,DAL,101,8,51,30,86
1994-03-10,HOU,87,40,16,SEA,82,43,14,83,30
1994-03-11,NJN,87,30,29,IND,73,31,26,61,55
1994-03-11,ATL,108,41,18,CHI,77,38,21,79,39
1994-03-11,DET,98,14,45,CLE,96,36,24,50,69
1994-03-11,MIN,91,16,43,CHH,97,24,33,40,76
1994-03-11,ORL,112,36,23,PHL,105,20,40,56,63
1994-03-11,SAN,99,43,17,SEA,100,43,15,86,32
1994-03-11,MIL,100,17,42,SAC,108,20,39,37,81
1994-03-11,MIA,107,33,26,PHX,122,38,20,71,46
1994-03-11,LAC,106,20,38,DAL,96,8,52,28,90
1994-03-11,WAS,100,18,41,DEN,93,29,30,47,71
1994-03-11,BOS,83,22,36,NYK,90,40,19,62,55
1994-03-12,HOU,98,41,16,SAN,109,43,18,84,34
1994-03-12,NYK,96,41,19,CLE,86,36,25,77,44
1994-03-12,IND,104,31,27,MIL,97,17,43,48,70
1994-03-12,DET,92,15,45,ATL,104,42,18,57,63
1994-03-12,NJN,117,31,29,CHH,92,25,33,56,62
1994-03-12,CHI,111,38,22,SAC,94,21,39,59,61
1994-03-13,BOS,87,22,37,MIA,106,33,27,55,64
1994-03-13,ORL,93,37,23,PHX,100,39,20,76,43
1994-03-13,WAS,97,19,41,PHL,114,20,41,39,82
1994-03-13,MIN,88,16,44,LAL,90,23,35,39,79
1994-03-13,DAL,93,8,53,HOU,100,41,17,49,70
1994-03-13,SEA,114,44,15,POR,102,38,23,82,38
1994-03-13,LAC,120,21,38,GOS,117,35,25,56,63
1994-03-14,DEN,116,29,31,SAN,88,44,18,73,49
1994-03-14,SAC,102,21,40,DET,108,15,46,36,86
1994-03-14,CHH,107,25,34,BOS,101,22,38,47,72
1994-03-14,UTH,102,42,20,LAL,101,24,35,66,55
1994-03-15,LAC,108,22,38,UTH,105,43,20,65,58
1994-03-15,GOS,123,35,26,WAS,93,19,42,54,68
1994-03-15,MIA,101,34,27,MIL,94,17,44,51,71
1994-03-15,HOU,105,42,17,POR,99,38,24,80,41
1994-03-15,MIN,96,16,45,PHL,87,21,41,37,86
1994-03-15,SEA,87,45,15,DET,89,16,46,61,61
1994-03-15,CHI,108,39,22,ORL,98,37,24,76,46
1994-03-15,NYK,88,42,19,IND,82,32,27,74,46
1994-03-15,CLE,106,36,26,PHX,119,40,20,76,46
1994-03-16,BOS,100,22,39,CHI,101,40,22,62,61
1994-03-16,SAC,132,21,41,NJN,111,32,29,53,70
1994-03-16,IND,109,32,28,PHX,98,41,20,73,48
1994-03-16,CHH,92,26,34,ATL,79,43,18,69,52
1994-03-16,LAL,129,24,36,WAS,94,19,43,43,79
1994-03-16,ORL,100,37,25,DAL,98,8,54,45,79
1994-03-16,SAN,110,44,19,POR,102,38,25,82,44
1994-03-17,MIA,115,35,27,DAL,98,8,55,43,82
1994-03-17,MIN,92,17,45,SEA,107,45,16,62,61
1994-03-17,NYK,105,43,19,MIL,83,17,45,60,64
1994-03-17,HOU,112,43,17,GOS,99,36,26,79,43
1994-03-17,LAC,99,23,38,DEN,102,30,31,53,69
1994-03-18,LAL,90,25,36,NJN,102,32,30,57,66
1994-03-18,ORL,113,38,25,CLE,96,36,27,74,52
1994-03-18,CHI,87,41,22,SEA,84,46,16,87,38
1994-03-18,IND,78,33,28,ATL,81,43,19,76,47
1994-03-18,PHL,98,21,42,MIN,100,17,46,38,88
1994-03-18,POR,122,38,26,WAS,104,19,44,57,70
1994-03-18,PHX,113,41,21,DET,114,17,46,58,67
1994-03-18,DEN,103,31,31,SAC,115,22,41,53,72
1994-03-18,CHH,82,27,34,UTH,78,43,21,70,55
1994-03-19,HOU,106,44,17,DET,88,18,46,62,63
1994-03-19,DAL,107,8,56,GOS,116,36,27,44,83
1994-03-19,NYK,105,44,19,BOS,91,22,40,66,59
1994-03-19,PHX,105,41,22,NJN,93,33,30,74,52
1994-03-19,SAN,107,45,19,SAC,100,23,41,68,60
1994-03-19,MIA,106,36,27,CLE,95,36,28,72,55
1994-03-19,IND,107,33,29,UTH,103,43,22,76,51
1994-03-20,LAL,97,25,37,ORL,91,39,25,64,62
1994-03-20,CHH,115,28,34,SEA,124,46,17,74,51
1994-03-20,LAC,114,23,39,POR,110,39,26,62,65
1994-03-20,DEN,132,31,32,WAS,99,19,45,50,77
1994-03-20,BOS,80,22,41,ATL,101,44,19,66,60
1994-03-20,MIL,103,17,46,PHL,101,21,43,38,89
1994-03-20,MIN,80,18,46,CHI,90,42,22,60,68
1994-03-21,LAL,84,26,37,MIA,81,37,27,63,64
1994-03-21,HOU,128,45,17,WAS,112,19,46,64,63
1994-03-21,ATL,100,45,19,UTH,96,43,23,88,42
1994-03-22,GOS,117,37,27,ORL,116,39,26,76,53
1994-03-22,CHH,125,28,35,PHL,91,21,44,49,79
1994-03-22,NYK,87,45,19,CHI,78,43,22,88,41
1994-03-22,NJN,105,33,31,LAC,102,24,39,57,70
1994-03-22,SEA,105,47,17,SAN,89,46,19,93,36
1994-03-22,CLE,93,36,29,IND,61,34,29,70,58
1994-03-22,SAC,94,23,42,POR,96,39,27,62,69
1994-03-22,MIN,83,18,47,HOU,81,46,17,64,64
1994-03-22,DEN,108,32,32,MIL,94,18,46,50,78
1994-03-22,PHX,124,42,22,MIA,118,37,28,79,50
1994-03-23,UTH,93,43,24,ORL,98,39,27,82,51
1994-03-23,ATL,100,46,19,CHH,92,29,35,75,54
1994-03-23,PHL,87,21,45,CHI,99,43,23,64,68
1994-03-23,IND,78,34,30,CLE,77,37,29,71,59
1994-03-23,DET,111,18,47,LAC,107,24,40,42,87
1994-03-23,DAL,109,8,57,LAL,112,27,37,35,94
1994-03-24,SAC,91,23,43,SAN,107,46,20,69,63
1994-03-24,WAS,117,19,47,BOS,123,22,42,41,89
1994-03-24,MIN,106,19,47,NYK,123,46,19,65,66
1994-03-24,HOU,113,46,18,LAL,107,28,37,74,55
1994-03-24,DEN,113,33,32,MIA,101,37,29,70,61
1994-03-24,SEA,116,48,17,PHX,106,43,22,91,39
1994-03-24,GOS,114,38,27,MIL,112,18,47,56,74
1994-03-25,DET,92,19,47,CHH,106,29,36,48,83
1994-03-25,NJN,110,34,31,CHI,87,44,23,78,54
1994-03-25,ATL,94,47,19,LAC,97,24,41,71,60
1994-03-25,IND,82,35,30,NYK,85,47,19,82,49
1994-03-25,UTH,103,43,25,MIL,96,18,48,61,73
1994-03-25,POR,100,40,27,SAC,91,23,44,63,71
1994-03-25,PHX,99,43,23,DAL,94,8,58,51,81
1994-03-25,PHL,88,21,46,CLE,105,37,30,58,76
1994-03-26,WAS,100,19,48,NJN,103,35,31,54,79
1994-03-26,HOU,98,47,18,UTH,83,44,25,91,43
1994-03-26,DEN,112,34,32,DAL,101,8,59,42,91
1994-03-26,ATL,100,47,20,MIA,90,37,30,84,50
1994-03-26,GOS,101,39,27,SAN,112,47,20,86,47
1994-03-26,CHH,121,30,36,LAC,109,25,41,55,77
1994-03-26,SEA,113,49,17,MIN,93,19,48,68,65
1994-03-26,CHI,90,44,24,IND,88,35,31,79,55
1994-03-27,ORL,90,40,27,NYK,111,48,19,88,46
1994-03-27,LAL,110,28,38,MIL,101,18,49,46,87
1994-03-27,PHX,113,44,23,HOU,98,48,18,92,41
1994-03-27,CLE,111,38,30,DET,99,19,48,57,78
1994-03-27,BOS,124,23,42,PHL,122,21,47,44,89
1994-03-27,POR,95,41,27,SAN,107,48,20,89,47
1994-03-28,IND,126,35,32,LAC,93,25,42,60,74
1994-03-28,SEA,111,50,17,DEN,97,35,32,85,49
1994-03-29,CHI,106,45,24,PHL,103,21,48,66,72
1994-03-29,POR,100,41,28,SEA,114,51,17,92,45
1994-03-29,LAL,91,29,38,MIN,89,19,49,48,87
1994-03-29,NYK,106,49,19,CHH,95,31,36,80,55
1994-03-29,UTH,113,44,26,GOS,116,39,28,83,54
1994-03-29,MIA,115,37,31,DET,123,19,49,56,80
1994-03-29,MIL,107,18,50,BOS,119,24,42,42,92
1994-03-29,ORL,120,40,28,WAS,101,19,49,59,77
1994-03-29,SAC,101,23,45,HOU,122,48,19,71,64
1994-03-29,ATL,101,48,20,NJN,98,36,31,84,51
1994-03-29,DAL,92,8,60,SAN,117,49,20,57,80
1994-03-29,CLE,106,39,30,LAC,96,25,43,64,73
1994-03-30,BOS,99,25,42,IND,103,36,32,61,74
1994-03-30,GOS,104,40,28,HOU,114,49,19,89,47
1994-03-30,NJN,111,36,32,MIA,101,37,32,73,64
1994-03-31,LAC,102,25,44,PHX,117,45,23,70,67
1994-03-31,SAC,102,23,46,ATL,106,49,20,72,66
1994-03-31,MIL,111,18,51,POR,109,41,29,59,80
1994-03-31,SAN,101,50,20,CLE,85,40,30,90,50
1994-03-31,SEA,95,52,17,LAL,92,30,38,82,55
1994-04-01,PHL,100,21,49,POR,111,41,30,62,79
1994-04-01,CHI,102,46,24,DET,95,20,49,66,73
1994-04-01,NJN,96,37,32,ORL,98,41,28,78,60
1994-04-01,GOS,146,40,29,MIN,109,19,50,59,79
1994-04-01,PHX,93,46,23,ATL,87,50,20,96,43
1994-04-01,MIA,101,37,33,IND,91,37,32,74,65
1994-04-01,LAL,101,30,39,HOU,88,50,19,80,58
1994-04-01,BOS,95,25,43,WAS,99,19,50,44,93
1994-04-01,DAL,104,8,61,CHH,106,31,37,39,98
1994-04-02,DAL,88,8,62,CLE,95,40,31,48,93
1994-04-02,SAN,117,51,20,CHH,111,32,37,83,57
1994-04-02,UTH,101,44,27,DEN,91,35,33,79,60
1994-04-02,NYK,110,50,19,MIA,87,38,33,88,52
1994-04-02,SAC,102,23,47,MIN,87,19,51,42,98
1994-04-02,SEA,119,53,17,GOS,109,41,29,94,46
1994-04-02,IND,128,37,33,ORL,113,42,28,79,61
1994-04-02,WAS,104,20,50,MIL,96,19,51,39,101
1994-04-03,DET,93,20,50,CHI,96,47,24,67,74
1994-04-03,LAC,98,25,45,HOU,106,50,20,75,65
1994-04-03,LAL,102,31,39,ATL,89,50,21,81,60
1994-04-03,PHX,108,47,23,DEN,98,35,34,82,57
1994-04-03,NJN,105,37,33,POR,109,42,30,79,63
1994-04-03,PHL,112,21,50,BOS,135,25,44,46,94
1994-04-05,POR,135,43,30,PHX,113,48,23,91,53
1994-04-05,CHI,114,48,24,WAS,88,21,50,69,74
1994-04-05,SAC,80,24,47,DAL,88,8,63,32,110
1994-04-05,SAN,101,52,20,GOS,106,41,30,93,50
1994-04-05,SEA,86,54,17,UTH,79,45,27,99,44
1994-04-05,NJN,120,37,34,BOS,94,26,44,63,78
1994-04-05,DEN,91,35,35,LAC,92,25,46,60,81
1994-04-05,MIA,100,38,34,NYK,86,51,19,89,53
1994-04-05,ORL,104,42,29,MIL,97,19,52,61,81
1994-04-05,IND,105,38,33,DET,89,20,51,58,84
1994-04-05,CLE,105,41,31,CHH,99,32,38,73,69
1994-04-06,LAL,128,32,39,SAC,123,24,48,56,87
1994-04-06,PHX,107,48,24,SAN,95,52,21,100,45
1994-04-06,PHL,115,21,51,MIL,114,19,53,40,104
1994-04-06,CHH,129,32,39,IND,90,39,33,71,72
1994-04-06,MIN,110,19,52,LAC,100,26,46,45,98
1994-04-06,WAS,103,21,51,MIA,114,39,34,60,85
1994-04-06,ATL,111,50,22,BOS,107,26,45,76,67
1994-04-07,HOU,134,51,20,GOS,102,42,30,93,50
1994-04-07,NYK,97,51,20,CLE,94,42,31,93,51
1994-04-07,NJN,93,38,34,ATL,87,51,22,89,56
1994-04-07,UTH,99,45,28,DAL,82,9,63,54,91
1994-04-07,DEN,104,35,36,SEA,90,55,17,90,53
1994-04-08,ORL,117,43,29,DET,103,20,52,63,81
1994-04-08,BOS,112,26,46,MIN,108,20,52,46,98
1994-04-08,LAL,99,33,39,DEN,112,36,36,69,75
1994-04-08,WAS,108,21,52,CLE,98,42,32,63,84
1994-04-08,SEA,111,55,18,DAL,93,9,64,64,82
1994-04-08,SAC,104,24,49,PHX,101,49,24,73,73
1994-04-08,CHH,99,33,39,NJN,78,39,34,72,73
1994-04-08,PHL,100,22,51,NYK,97,52,20,74,71
1994-04-08,IND,94,39,34,CHI,100,49,24,88,58
1994-04-09,POR,112,44,30,LAL,104,33,40,77,70
1994-04-09,MIN,105,20,53,GOS,117,42,31,62,84
1994-04-09,PHL,122,23,51,CHH,127,34,39,57,90
1994-04-09,MIA,105,40,34,ORL,125,44,29,84,63
1994-04-09,ATL,117,51,23,WAS,103,22,52,73,75
1994-04-09,HOU,100,52,20,SAN,89,52,22,104,42
1994-04-09,UTH,128,46,28,LAC,104,26,47,72,75
1994-04-09,CHI,125,50,24,MIL,99,19,54,69,78
1994-04-10,DEN,92,37,36,HOU,93,53,20,90,56
1994-04-10,DET,111,20,53,BOS,116,27,46,47,99
1994-04-10,SEA,111,56,18,PHX,108,49,25,105,43
1994-04-10,NJN,107,39,35,NYK,88,52,21,91,56
1994-04-11,GOS,122,43,31,DAL,108,9,65,52,96
1994-04-11,SAN,101,52,23,MIN,89,20,54,72,77
1994-04-11,SAC,118,25,49,LAC,97,26,48,51,97
1994-04-11,IND,121,39,35,BOS,108,28,46,67,81
1994-04-11,CHH,99,35,39,MIA,97,40,35,75,74
1994-04-11,NYK,100,52,22,ORL,108,45,29,97,51
1994-04-12,DET,107,20,54,PHL,134,23,52,43,106
1994-04-12,LAC,101,26,49,SEA,116,57,18,83,67
1994-04-12,UTH,126,47,28,SAC,91,26,49,73,77
1994-04-12,CHI,111,51,24,NJN,105,40,35,91,59
1994-04-12,LAL,117,33,41,GOS,128,44,31,77,72
1994-04-12,HOU,98,54,20,MIN,89,20,55,74,75
1994-04-12,DEN,102,37,37,PHX,107,49,26,86,63
1994-04-12,POR,107,45,30,DAL,108,9,66,54,96
1994-04-12,CLE,119,42,33,MIL,91,19,55,61,88
1994-04-13,PHL,87,24,52,IND,115,40,35,64,87
1994-04-13,SAN,78,53,23,DEN,83,37,38,90,61
1994-04-13,MIL,105,19,56,NJN,107,40,36,59,92
1994-04-13,BOS,109,28,47,DET,96,20,55,48,102
1994-04-13,ATL,110,52,23,CLE,95,43,33,95,56
1994-04-13,MIA,90,40,36,CHI,96,52,24,92,60
1994-04-13,PHX,117,50,26,LAL,88,33,42,83,68
1994-04-14,HOU,104,55,20,SAC,99,26,50,81,70
1994-04-14,SEA,150,58,18,LAC,101,26,50,84,68
1994-04-14,WAS,106,22,53,NYK,111,52,23,74,76
1994-04-14,ORL,108,46,29,CHH,112,36,39,82,68
1994-04-14,GOS,113,45,31,POR,108,45,31,90,62
1994-04-14,UTH,101,48,28,SAN,90,53,24,101,52
1994-04-15,MIL,96,19,57,ATL,105,53,23,72,80
1994-04-15,CHH,85,37,39,CHI,88,53,24,90,63
1994-04-15,NYK,103,53,23,WAS,90,22,54,75,77
1994-04-15,CLE,109,43,34,MIA,100,40,37,83,71
1994-04-15,MIN,112,20,56,IND,130,41,35,61,91
1994-04-15,LAL,100,33,43,POR,105,45,32,78,75
1994-04-15,BOS,113,29,47,ORL,110,46,30,75,77
1994-04-15,DAL,99,10,66,DEN,97,38,38,48,104
1994-04-15,NJN,119,41,36,DET,114,20,56,61,92
1994-04-16,SEA,100,59,18,HOU,97,56,20,115,38
1994-04-16,LAC,108,26,51,LAL,103,33,44,59,95
1994-04-16,ATL,123,54,23,PHL,94,24,53,78,76
1994-04-16,GOS,109,46,31,UTH,105,49,28,95,59
1994-04-16,SAN,94,53,25,PHX,96,51,26,104,51
1994-04-16,MIL,90,19,58,CLE,91,44,34,63,92
1994-04-16,DAL,98,11,66,SAC,106,26,51,37,117
1994-04-17,POR,110,46,32,HOU,119,56,21,102,53
1994-04-17,WAS,142,22,55,BOS,100,30,47,52,102
1994-04-17,DET,99,20,57,IND,104,42,35,62,92
1994-04-17,ORL,118,46,31,CHI,101,54,24,100,55
1994-04-17,MIN,88,20,57,DEN,99,38,39,58,96
1994-04-17,CHH,107,37,40,NYK,91,54,23,91,63
1994-04-17,MIA,103,40,38,NJN,110,42,36,82,74
1994-04-18,LAC,131,27,51,GOS,134,47,31,74,82
1994-04-18,DAL,97,11,67,PHX,106,52,26,63,93
1994-04-18,CHI,87,54,25,ATL,70,55,23,109,48
1994-04-19,DEN,105,39,39,LAL,98,33,45,72,84
1994-04-19,BOS,120,30,48,MIL,112,19,59,49,107
1994-04-19,PHX,122,53,26,SEA,116,60,18,113,44
1994-04-19,NYK,84,54,24,ATL,87,55,24,109,48
1994-04-19,SAC,108,27,51,UTH,115,49,29,76,80
1994-04-19,PHL,110,24,54,NJN,115,43,36,67,90
1994-04-19,SAN,90,53,26,HOU,80,57,21,110,47
1994-04-19,MIA,126,40,39,MIN,99,20,58,60,97
1994-04-19,DET,104,20,58,ORL,132,47,31,67,89
1994-04-19,WAS,110,23,55,IND,111,43,35,66,90
1994-04-20,LAL,90,33,46,SEA,112,60,19,93,65
1994-04-20,LAC,85,27,52,DEN,100,40,39,67,91
1994-04-20,MIL,103,19,60,DET,78,20,59,39,119
1994-04-20,IND,109,44,35,CLE,98,45,34,89,69
1994-04-20,CHH,117,38,40,WAS,111,23,56,61,96
1994-04-20,ORL,121,48,31,MIN,101,20,59,68,90
1994-04-21,MIA,94,41,39,ATL,89,56,24,97,63
1994-04-21,UTH,122,50,29,POR,111,46,33,96,62
1994-04-21,BOS,89,31,48,CHH,95,39,40,70,88
1994-04-21,NYK,130,54,25,PHL,82,24,55,78,80
1994-04-21,GOS,121,48,31,SAC,96,27,52,75,83
1994-04-21,HOU,126,57,22,DAL,100,11,68,68,90
1994-04-22,IND,133,45,35,PHL,88,24,56,69,91
1994-04-22,PHX,127,54,26,LAC,121,27,53,81,79
1994-04-22,DEN,106,41,39,UTH,113,51,29,92,68
1994-04-22,SEA,94,61,19,SAN,87,54,26,115,45
1994-04-22,MIN,103,20,60,POR,118,46,34,66,94
1994-04-22,MIL,85,20,60,NYK,125,55,25,75,85
1994-04-22,DAL,107,11,69,HOU,95,58,22,69,91
1994-04-22,CLE,117,45,35,WAS,96,23,57,68,92
1994-04-22,CHI,94,55,25,BOS,104,31,49,86,74
1994-04-23,ATL,93,56,25,ORL,89,49,31,105,56
1994-04-23,GOS,126,49,31,LAL,91,33,47,82,78
1994-04-23,PHX,101,55,26,SAC,100,27,53,82,79
1994-04-23,CHH,108,40,40,DET,103,20,60,60,100
1994-04-23,IND,114,46,35,MIA,81,42,39,88,74
1994-04-23,NJN,135,44,36,MIL,100,20,61,64,97
1994-04-24,LAC,97,27,54,SAN,112,54,27,81,81
1994-04-24,HOU,107,58,23,DEN,115,41,40,99,63
1994-04-24,ORL,120,49,32,NJN,91,45,36,94,68
1994-04-24,CHI,76,55,26,NYK,92,56,25,111,51
1994-04-24,DAL,116,12,69,MIN,102,20,61,32,130
1994-04-24,CLE,117,46,35,BOS,91,32,49,78,84
1994-04-24,WAS,117,23,58,CHH,99,41,40,64,98
1994-04-24,POR,108,47,34,SEA,110,62,19,109,53
1994-04-24,LAL,97,33,48,UTH,103,52,29,85,77
1994-04-24,SAC,105,27,54,GOS,97,50,31,77,85
1994-04-24,PHL,110,24,57,DET,102,20,61,44,118
1994-11-04,LAC,100,0,0,POR,121,0,0,0,0
1994-11-04,UTH,119,0,0,MIA,108,0,0,0,0
1994-11-04,HOU,90,0,0,NJN,86,0,0,0,0
1994-11-04,SAN,118,0,0,GOS,123,0,0,0,0
1994-11-04,DEN,130,0,0,MIN,108,0,0,0,0
1994-11-04,WAS,110,0,0,ORL,108,0,0,0,0
1994-11-04,SAC,107,0,0,PHX,89,0,0,0,0
1994-11-04,DET,98,0,0,LAL,115,0,0,0,0
1994-11-04,CHI,89,0,0,CHH,83,0,0,0,0
1994-11-04,PHL,86,0,0,MIL,91,0,0,0,0
1994-11-04,BOS,107,0,0,NYK,120,0,0,0,0
1994-11-04,ATL,92,0,0,IND,94,0,0,0,0
1994-11-05,SEA,110,0,0,UTH,103,1,0,1,0
1994-11-05,DAL,112,0,0,NJN,103,0,1,0,1
1994-11-05,ORL,122,0,1,PHL,107,0,1,0,2
1994-11-05,CHH,107,0,1,CLE,115,0,0,0,1
1994-11-05,DEN,104,1,0,GOS,108,1,0,2,0
1994-11-05,POR,112,1,0,LAC,95,0,1,1,1
1994-11-05,CHI,99,1,0,WAS,100,1,0,2,0
1994-11-05,MIL,97,1,0,LAL,96,1,0,2,0
1994-11-05,MIN,85,0,1,HOU,115,1,0,1,1
1994-11-05,ATL,109,0,1,DET,114,0,1,0,2
1994-11-05,IND,112,1,0,BOS,103,0,1,1,1
1994-11-06,PHX,119,0,1,MIA,107,0,1,0,2
1994-11-07,UTH,104,1,1,ATL,86,0,2,1,3
1994-11-07,SAN,105,0,1,NJN,96,0,2,0,3
1994-11-07,CHI,98,1,1,PHL,83,0,2,1,3
1994-11-08,CLE,98,1,0,HOU,100,2,0,3,0
1994-11-08,DAL,107,1,0,DEN,115,1,1,2,1
1994-11-08,DET,126,1,1,MIN,112,0,2,1,3
1994-11-08,GOS,121,2,0,MIA,114,0,2,2,2
1994-11-08,NYK,117,1,0,LAL,113,1,1,2,1
1994-11-09,CHH,128,0,2,ORL,130,1,1,1,3
1994-11-09,SAN,109,1,1,UTH,101,2,1,3,2
1994-11-09,IND,104,2,0,HOU,109,3,0,5,0
1994-11-09,PHX,106,1,1,ATL,102,0,3,1,4
1994-11-09,PHL,98,0,3,WAS,97,2,0,2,3
1994-11-09,MIN,99,0,3,LAL,122,1,2,1,5
1994-11-09,NJN,110,0,3,CHI,109,2,1,2,4
1994-11-09,SEA,100,1,0,SAC,108,1,0,2,0
1994-11-10,SAC,84,2,0,POR,104,2,0,4,0
1994-11-10,LAC,91,0,2,ATL,108,0,4,0,6
1994-11-10,DET,112,2,1,IND,110,2,1,4,2
1994-11-10,CLE,108,1,1,MIL,88,2,0,3,1
1994-11-10,NYK,101,2,0,ORL,99,2,1,4,1
1994-11-11,LAL,117,2,2,DEN,124,2,1,4,3
1994-11-11,SEA,129,1,1,PHX,123,2,1,3,2
1994-11-11,MIN,100,0,4,CHI,112,2,2,2,6
1994-11-11,PHL,100,1,3,DAL,107,1,1,2,4
1994-11-11,MIL,115,2,1,CHH,123,0,3,2,4
1994-11-11,WAS,104,2,1,NJN,91,1,3,3,4
1994-11-11,BOS,82,0,2,HOU,102,4,0,4,2
1994-11-11,UTH,104,2,2,GOS,112,3,0,5,2
1994-11-12,MIN,101,0,5,BOS,114,0,3,0,8
1994-11-12,CHH,113,1,3,DET,100,3,1,4,4
1994-11-12,CHI,120,3,2,DAL,124,2,1,5,3
1994-11-12,NJN,84,1,4,HOU,100,5,0,6,4
1994-11-12,SAC,105,2,1,ATL,97,1,4,3,5
1994-11-12,GOS,121,4,0,LAL,99,2,3,6,3
1994-11-12,PHL,103,1,4,ORL,116,2,2,3,6
1994-11-12,LAC,101,0,3,PHX,108,2,2,2,5
1994-11-12,DEN,119,3,1,UTH,110,2,3,5,4
1994-11-12,SAN,101,2,1,NYK,82,3,0,5,1
1994-11-12,MIA,99,0,3,WAS,109,3,1,3,4
1994-11-12,CLE,86,2,1,IND,93,2,2,4,3
1994-11-13,SEA,115,2,1,LAC,90,0,4,2,5
1994-11-14,UTH,110,2,4,NYK,97,3,1,5,5
1994-11-15,HOU,105,6,0,SAC,99,3,1,9,1
1994-11-15,DEN,112,4,1,SAN,99,3,1,7,2
1994-11-15,POR,93,3,0,PHX,96,3,2,6,2
1994-11-15,ATL,110,1,5,BOS,94,1,3,2,8
1994-11-15,LAC,92,0,5,LAL,102,2,4,2,9
1994-11-15,NJN,112,1,5,SEA,106,3,1,4,6
1994-11-15,CLE,89,2,2,CHH,86,2,3,4,5
1994-11-15,GOS,112,5,0,MIN,114,0,6,5,6
1994-11-15,MIA,115,0,4,DAL,102,3,1,3,5
1994-11-15,DET,99,3,2,PHL,98,1,5,4,7
1994-11-15,MIL,82,2,2,IND,81,3,2,5,4
1994-11-15,ORL,122,3,2,WAS,102,4,1,7,3
1994-11-16,SAN,92,3,2,CHI,94,3,3,6,5
1994-11-16,BOS,120,1,4,SEA,93,3,2,4,6
1994-11-16,PHL,109,1,6,MIA,96,1,4,2,10
1994-11-16,PHX,105,4,2,MIN,90,1,6,5,8
1994-11-16,LAL,89,3,4,NYK,110,3,2,6,6
1994-11-17,DEN,92,5,1,DET,94,4,2,9,3
1994-11-17,DAL,96,3,2,SAC,94,3,2,6,4
1994-11-17,POR,80,3,1,CLE,81,3,2,6,3
1994-11-17,HOU,106,7,0,CHI,83,4,3,11,3
1994-11-17,NJN,111,2,5,WAS,103,4,2,6,7
1994-11-17,CHH,99,2,4,LAC,83,0,6,2,10
1994-11-17,GOS,109,5,1,NYK,100,4,2,9,3
1994-11-18,ORL,113,4,2,NJN,103,3,5,7,7
1994-11-18,PHX,124,5,2,POR,111,3,2,8,4
1994-11-18,UTH,121,3,4,DET,96,5,2,8,6
1994-11-18,PHL,97,2,6,LAC,83,0,7,2,13
1994-11-18,ATL,93,2,5,MIL,97,3,2,5,7
1994-11-18,MIA,111,1,5,BOS,115,2,4,3,9
1994-11-18,IND,94,3,3,SEA,87,3,3,6,6
1994-11-18,LAL,82,3,5,CLE,80,4,2,7,7
1994-11-19,NYK,92,4,3,ATL,79,2,6,6,9
1994-11-19,CHH,89,3,4,IND,102,4,3,7,7
1994-11-19,GOS,119,6,1,UTH,115,4,4,10,5
1994-11-19,DEN,101,5,2,HOU,109,8,0,13,2
1994-11-19,MIL,96,4,2,SEA,120,3,4,7,6
1994-11-19,DAL,85,4,2,CHI,111,4,4,8,6
1994-11-19,WAS,102,4,3,BOS,103,3,4,7,7
1994-11-19,MIN,101,1,7,SAN,109,3,3,4,10
1994-11-20,POR,98,3,3,DET,96,5,3,8,6
1994-11-20,NJN,98,3,6,LAC,97,0,8,3,14
1994-11-20,SAC,96,3,3,CLE,88,4,3,7,6
1994-11-21,UTH,106,4,5,PHX,91,6,2,10,7
1994-11-21,NYK,92,5,3,SAN,88,4,3,9,6
1994-11-21,ORL,124,5,2,MIA,89,1,6,6,8
1994-11-22,HOU,94,9,0,POR,102,4,3,13,3
1994-11-22,LAC,93,0,9,CHI,105,5,4,5,13
1994-11-22,BOS,94,4,4,MIL,116,4,3,8,7
1994-11-22,SEA,104,4,4,NJN,97,4,6,8,10
1994-11-22,CLE,112,4,4,MIN,79,1,8,5,12
1994-11-22,CHH,102,3,5,GOS,98,7,1,10,6
1994-11-22,ATL,102,2,7,PHL,99,3,6,5,13
1994-11-23,UTH,113,5,5,SEA,103,5,4,10,9
1994-11-23,BOS,98,4,5,CHH,91,4,5,8,10
1994-11-23,DEN,113,5,3,CHI,111,6,4,11,7
1994-11-23,SAC,98,4,3,NJN,103,4,7,8,10
1994-11-23,MIA,100,1,7,CLE,87,5,4,6,11
1994-11-23,MIN,77,1,9,ATL,89,3,7,4,16
1994-11-23,SAN,110,4,4,POR,105,5,3,9,7
1994-11-23,PHX,140,6,3,LAC,109,0,10,6,13
1994-11-23,LAL,118,4,5,DAL,106,4,3,8,8
1994-11-23,ORL,117,6,2,HOU,94,9,1,15,3
1994-11-23,DET,113,5,4,MIL,108,5,3,10,7
1994-11-24,IND,123,5,3,GOS,96,7,2,12,5
1994-11-25,MIN,71,1,10,PHL,109,3,7,4,17
1994-11-25,UTH,124,6,5,CHI,94,6,5,12,10
1994-11-25,WAS,94,4,4,CLE,96,5,5,9,9
1994-11-25,ATL,87,4,7,LAL,92,5,5,9,12
1994-11-25,SAN,94,5,4,SEA,114,5,5,10,9
1994-11-25,DET,97,6,4,MIA,111,2,7,8,11
1994-11-25,IND,111,6,3,MIL,106,5,4,11,7
1994-11-25,SAC,108,4,4,DEN,105,6,3,10,7
1994-11-25,BOS,118,5,5,ORL,124,7,2,12,7
1994-11-25,DAL,101,4,4,POR,91,5,4,9,8
1994-11-25,LAC,102,0,11,NJN,107,5,7,5,18
1994-11-26,MIL,105,5,5,ORL,113,8,2,13,7
1994-11-26,WAS,96,4,5,LAL,112,6,5,10,10
1994-11-26,HOU,94,9,2,SEA,98,6,5,15,7
1994-11-26,CLE,101,6,5,GOS,87,7,3,13,8
1994-11-26,PHL,99,4,7,BOS,108,5,6,9,13
1994-11-26,DEN,123,6,4,DAL,124,5,4,11,8
1994-11-26,NYK,95,6,3,CHH,105,4,6,10,9
1994-11-26,PHX,111,7,3,SAN,108,5,5,12,8
1994-11-27,POR,99,5,5,IND,89,7,3,12,8
1994-11-27,SAC,89,5,4,UTH,94,7,5,12,9
1994-11-27,DET,106,6,5,GOS,91,7,4,13,9
1994-11-27,PHX,115,8,3,NJN,110,6,7,14,10
1994-11-28,SEA,118,7,5,IND,99,7,4,14,9
1994-11-28,SAN,92,5,6,MIN,88,1,11,6,17
1994-11-29,POR,94,6,5,UTH,105,8,5,14,10
1994-11-29,ATL,85,4,8,CHH,90,5,6,9,14
1994-11-29,WAS,91,4,6,NYK,99,6,4,10,10
1994-11-29,NJN,120,6,8,LAL,129,7,5,13,13
1994-11-29,MIA,89,3,7,SAC,94,5,5,8,12
1994-11-29,HOU,96,9,3,DEN,81,6,5,15,8
1994-11-29,DAL,84,6,4,MIN,83,1,12,7,16
1994-11-29,MIL,106,5,6,PHX,123,9,3,14,9
1994-11-29,GOS,127,7,5,LAC,124,0,12,7,17
1994-11-30,CHH,105,6,6,MIA,87,3,8,9,14
1994-11-30,CLE,117,7,5,LAL,79,8,5,15,10
1994-11-30,ORL,114,9,2,SAC,107,6,5,15,7
1994-11-30,CHI,118,6,6,PHX,105,10,3,16,9
1994-11-30,SEA,109,8,5,SAN,100,6,6,14,11
1994-11-30,BOS,118,6,6,DET,115,7,5,13,11
1994-12-01,UTH,94,9,5,MIN,96,1,13,10,18
1994-12-01,GOS,109,8,5,HOU,113,10,3,18,8
1994-12-01,LAC,84,0,13,IND,93,7,5,7,18
1994-12-01,DAL,80,7,4,DEN,89,6,6,13,10
1994-12-01,MIL,87,5,7,CLE,93,8,5,13,12
1994-12-02,CHI,81,7,6,ATL,92,4,9,11,15
1994-12-02,ORL,125,10,2,NYK,100,7,4,17,6
1994-12-02,POR,91,6,6,SAN,95,6,7,12,13
1994-12-02,LAL,107,8,6,HOU,89,11,3,19,9
1994-12-02,PHL,99,4,8,SAC,96,6,6,10,14
1994-12-02,WAS,115,4,7,DET,104,7,6,11,13
1994-12-02,MIA,115,3,9,NJN,97,6,9,9,18
1994-12-02,BOS,102,7,6,PHX,107,10,4,17,10
1994-12-03,CLE,78,9,5,PHL,83,5,8,14,13
1994-12-03,DEN,99,7,6,CHH,88,7,6,14,12
1994-12-03,GOS,107,8,6,IND,118,8,5,16,11
1994-12-03,SEA,111,9,5,MIL,108,5,8,14,13
1994-12-03,ATL,107,5,9,ORL,105,11,2,16,11
1994-12-03,NJN,89,6,10,SAC,94,6,7,12,17
1994-12-03,LAC,95,0,14,MIN,103,2,13,2,27
1994-12-03,NYK,111,7,5,WAS,95,5,7,12,12
1994-12-03,DAL,87,7,5,UTH,112,9,6,16,11
1994-12-03,DET,107,7,7,PHX,97,11,4,18,11
1994-12-03,CHI,125,7,7,BOS,109,7,7,14,14
1994-12-04,POR,106,6,7,MIL,103,5,9,11,16
1994-12-05,LAC,83,0,15,CHH,115,7,7,7,22
1994-12-05,CHI,94,8,7,NJN,99,6,11,14,18
1994-12-05,PHL,96,6,8,NYK,101,8,5,14,13
1994-12-06,MIN,95,3,13,DEN,102,8,6,11,19
1994-12-06,SEA,103,10,5,HOU,90,11,4,21,9
1994-12-06,LAL,113,9,6,GOS,101,8,7,17,13
1994-12-06,SAC,108,7,7,MIL,95,5,10,12,17
1994-12-06,IND,90,9,5,DET,83,8,7,17,12
1994-12-06,SAN,121,7,7,DAL,124,7,6,14,13
1994-12-06,CLE,97,9,6,ORL,114,11,3,20,9
1994-12-06,NJN,91,7,11,ATL,94,6,9,13,20
1994-12-06,UTH,97,10,6,CHH,106,8,7,18,13
1994-12-06,NYK,104,9,5,BOS,90,7,8,16,13
1994-12-07,BOS,93,7,9,ATL,80,7,9,14,18
1994-12-07,MIA,102,4,9,PHL,111,6,9,10,18
1994-12-07,LAC,96,0,16,MIL,94,5,11,5,27
1994-12-07,ORL,90,12,3,CLE,75,9,7,21,10
1994-12-08,SAC,103,8,7,SEA,91,11,5,19,12
1994-12-08,SAN,114,7,8,UTH,117,10,7,17,15
1994-12-08,DAL,121,8,6,WAS,124,5,8,13,14
1994-12-08,HOU,101,11,5,CHH,95,9,7,20,12
1994-12-08,NJN,106,7,12,PHX,133,11,5,18,17
1994-12-09,BOS,89,8,9,CLE,96,9,8,17,17
1994-12-09,POR,116,7,7,GOS,107,8,8,15,15
1994-12-09,ATL,89,7,10,NYK,85,10,5,17,15
1994-12-09,PHL,88,7,9,IND,94,10,5,17,14
1994-12-09,DET,96,8,8,CHI,117,8,8,16,16
1994-12-09,LAL,84,10,6,LAC,109,1,16,11,22
1994-12-09,MIA,96,4,10,ORL,110,13,3,17,13
1994-12-10,LAC,127,2,16,SEA,132,11,6,13,22
1994-12-10,CLE,87,10,8,DET,79,8,9,18,17
1994-12-10,ORL,109,14,3,ATL,98,8,10,22,13
1994-12-10,NJN,108,7,13,BOS,96,8,10,15,23
1994-12-10,IND,117,11,5,MIA,103,4,11,15,16
1994-12-10,DEN,111,9,6,WAS,89,6,8,15,14
1994-12-10,HOU,96,12,5,SAN,108,7,9,19,14
1994-12-10,UTH,113,11,7,LAL,120,10,7,21,14
1994-12-10,DAL,99,8,7,CHH,86,9,8,17,15
1994-12-10,SAC,106,9,7,GOS,94,8,9,17,16
1994-12-10,MIL,106,5,12,CHI,103,9,8,14,20
1994-12-10,NYK,107,10,6,PHL,103,7,10,17,16
1994-12-10,MIN,89,3,14,PHX,103,12,5,15,19
1994-12-11,POR,93,8,7,SAC,88,10,7,18,14
1994-12-12,PHX,90,13,5,GOS,84,8,10,21,15
1994-12-12,NYK,111,11,6,MIA,122,4,12,15,18
1994-12-12,NJN,128,8,13,ORL,101,15,3,23,16
1994-12-12,UTH,101,11,8,POR,89,9,7,20,15
1994-12-12,SAN,122,8,9,WAS,101,6,9,14,18
1994-12-12,BOS,113,8,11,DEN,103,10,6,18,17
1994-12-13,PHL,105,7,11,MIA,90,5,12,12,23
1994-12-13,HOU,93,12,6,WAS,85,6,10,18,16
1994-12-13,GOS,107,8,11,SAC,112,10,8,18,19
1994-12-13,DAL,108,9,7,LAL,115,11,7,20,14
1994-12-13,ATL,85,8,11,MIN,83,3,15,11,26
1994-12-13,CLE,90,11,8,IND,83,12,5,23,13
1994-12-13,CHH,107,9,9,MIL,101,6,12,15,21
1994-12-13,CHI,98,9,9,DET,78,8,10,17,19
1994-12-14,IND,81,12,6,ATL,79,9,11,21,17
1994-12-14,POR,121,9,8,LAC,73,2,17,11,25
1994-12-14,SAN,122,9,9,BOS,110,9,11,18,20
1994-12-14,DET,93,8,11,CHH,106,10,9,18,20
1994-12-14,NJN,88,9,13,CLE,95,12,8,21,21
1994-12-14,MIN,95,3,16,UTH,103,12,8,15,24
1994-12-14,PHX,111,14,5,SEA,93,12,6,26,11
1994-12-14,ORL,120,15,4,DEN,96,10,7,25,11
1994-12-14,MIL,99,6,13,PHL,96,8,11,14,24
1994-12-15,HOU,94,13,6,LAL,97,12,7,25,13
1994-12-15,WAS,85,6,11,UTH,95,13,8,19,19
1994-12-15,SEA,114,12,7,POR,103,10,8,22,15
1994-12-15,SAC,84,11,8,NYK,94,11,7,22,15
1994-12-15,MIA,99,5,13,DEN,101,10,8,15,21
1994-12-15,DAL,122,9,8,BOS,113,9,12,18,20
1994-12-15,LAC,89,2,18,GOS,82,8,12,10,30
1994-12-16,PHL,80,8,12,CLE,84,13,8,21,20
1994-12-16,GOS,128,8,13,ORL,131,16,4,24,17
1994-12-16,PHX,106,15,5,NYK,85,12,7,27,12
1994-12-16,MIN,94,3,17,NJN,93,9,14,12,31
1994-12-16,ATL,80,9,12,CHI,85,10,9,19,21
1994-12-16,IND,93,13,6,CHH,91,11,9,24,15
1994-12-17,WAS,87,6,12,MIN,96,4,17,10,29
1994-12-17,PHX,109,16,5,SAC,98,11,9,27,14
1994-12-17,LAC,87,3,18,DAL,106,10,8,13,26
1994-12-17,HOU,109,13,7,BOS,112,9,13,22,20
1994-12-17,SEA,124,13,7,ORL,84,17,4,30,11
1994-12-17,CHI,89,11,9,UTH,97,14,8,25,17
1994-12-17,CHH,111,11,10,DEN,92,11,8,22,18
1994-12-17,PHL,92,8,13,DET,97,8,12,16,25
1994-12-17,SAN,116,10,9,LAL,102,13,7,23,16
1994-12-17,MIA,96,5,14,ATL,85,9,13,14,27
1994-12-18,POR,111,10,9,NYK,87,12,8,22,17
1994-12-18,MIL,98,7,13,UTH,101,15,8,22,21
1994-12-18,NJN,103,9,15,MIA,102,6,14,15,29
1994-12-19,DEN,104,11,9,BOS,85,10,13,21,22
1994-12-19,PHX,113,17,5,WAS,102,6,13,23,18
1994-12-19,CHI,63,11,10,CLE,77,14,8,25,18
1994-12-20,NYK,83,12,9,NJN,85,10,15,22,24
1994-12-20,CHH,99,12,10,IND,95,14,6,26,16
1994-12-20,SEA,110,14,7,LAC,79,3,19,17,26
1994-12-20,PHL,88,8,14,UTH,91,16,8,24,22
1994-12-20,GOS,107,8,14,DAL,110,11,8,19,22
1994-12-20,POR,104,11,9,ORL,108,17,5,28,14
1994-12-20,LAL,108,13,8,MIN,95,5,17,18,25
1994-12-20,ATL,115,9,14,MIL,97,7,14,16,28
1994-12-20,SAC,105,11,10,WAS,102,6,14,17,24
1994-12-21,LAC,91,3,20,ORL,102,18,5,21,25
1994-12-21,DEN,97,12,9,SAN,111,11,9,23,18
1994-12-21,NJN,117,11,15,DET,99,9,12,20,27
1994-12-21,IND,107,14,7,CHI,99,11,11,25,18
1994-12-21,MIA,122,6,15,MIL,112,7,15,13,30
1994-12-22,GOS,107,8,15,WAS,87,6,15,14,30
1994-12-22,CHH,103,13,10,PHL,91,8,15,21,25
1994-12-22,ATL,94,10,14,UTH,103,17,8,27,22
1994-12-22,SAC,109,12,10,MIN,89,5,18,17,28
1994-12-22,SEA,103,15,7,DAL,101,12,8,27,15
1994-12-22,HOU,114,13,8,PHX,106,18,5,31,13
1994-12-22,NYK,90,12,10,CLE,93,15,8,27,18
1994-12-23,CLE,80,16,8,NJN,75,12,15,28,23
1994-12-23,LAL,100,14,8,SAC,89,13,10,27,18
1994-12-23,MIA,116,7,15,CHH,93,14,10,21,25
1994-12-23,CHI,116,11,12,IND,92,15,7,26,19
1994-12-23,ORL,123,19,5,MIL,91,7,16,26,21
1994-12-23,SAN,98,12,9,HOU,96,14,8,26,17
1994-12-23,BOS,77,10,14,PHL,85,8,16,18,30
1994-12-23,DET,77,9,13,ATL,97,10,15,19,28
1994-12-23,PHX,126,18,6,DEN,110,12,10,30,16
1994-12-23,LAC,102,3,21,WAS,105,6,16,9,37
1994-12-23,POR,118,11,10,DAL,92,12,9,23,19
1994-12-25,CHI,107,12,12,NYK,104,12,11,24,23
1994-12-25,DEN,105,12,11,SEA,96,16,7,28,18
1994-12-26,MIN,82,5,19,LAC,81,3,22,8,41
1994-12-26,PHX,139,19,6,DAL,113,12,10,31,16
1994-12-26,MIA,88,8,15,HOU,101,14,9,22,24
1994-12-26,CLE,123,17,8,BOS,102,10,15,27,23
1994-12-26,WAS,121,7,16,ORL,128,20,5,27,21
1994-12-26,SEA,123,16,8,SAC,103,13,11,29,19
1994-12-26,MIL,101,7,17,NJN,97,12,16,19,33
1994-12-26,POR,94,12,10,PHL,101,9,16,21,26
1994-12-27,SAN,119,13,9,CHH,108,14,11,27,20
1994-12-27,CHI,92,13,12,LAC,95,3,23,16,35
1994-12-27,GOS,129,9,15,LAL,105,15,8,24,23
1994-12-27,SAC,102,13,12,POR,101,12,11,25,23
1994-12-27,HOU,105,15,9,ATL,93,11,15,26,24
1994-12-27,DAL,118,12,11,PHX,119,20,6,32,17
1994-12-27,NJN,91,12,17,NYK,99,12,12,24,29
1994-12-27,DEN,91,13,11,IND,95,15,8,28,19
1994-12-27,DET,88,9,14,MIL,98,8,17,17,31
1994-12-27,ORL,103,21,5,MIA,83,8,16,29,21
1994-12-28,NYK,101,13,12,DET,93,9,15,22,27
1994-12-28,BOS,97,10,16,CHI,105,13,13,23,29
1994-12-28,SEA,121,17,8,PHL,102,10,16,27,24
1994-12-28,UTH,117,18,8,IND,95,16,8,34,16
1994-12-28,CLE,91,18,8,WAS,75,7,17,25,25
1994-12-29,MIA,126,8,17,LAC,83,4,23,12,40
1994-12-29,CHH,125,14,12,ORL,123,22,5,36,17
1994-12-29,LAL,96,15,9,SEA,95,18,8,33,17
1994-12-29,ATL,127,11,16,SAN,121,14,9,25,25
1994-12-29,HOU,126,16,9,GOS,124,10,15,26,24
1994-12-29,POR,104,12,12,DEN,93,13,12,25,24
1994-12-30,DEN,118,13,13,POR,114,13,12,26,25
1994-12-30,UTH,103,19,8,HOU,111,17,9,36,17
1994-12-30,IND,96,16,9,NJN,79,12,18,28,27
1994-12-30,PHX,112,21,6,LAL,127,16,9,37,15
1994-12-30,DAL,110,12,12,GOS,94,10,16,22,28
1994-12-30,DET,107,9,16,BOS,124,10,17,19,33
1994-12-30,MIN,81,6,19,NYK,90,14,12,20,31
1994-12-30,SAC,85,14,12,PHL,82,10,17,24,29
1994-12-30,WAS,101,7,18,SAN,115,14,10,21,28
1994-12-30,CHI,133,14,13,MIA,88,9,17,23,30
1994-12-30,ORL,116,22,6,LAC,105,4,24,26,30
1994-12-30,CLE,87,19,8,ATL,85,12,16,31,24
1994-12-30,MIL,94,9,17,CHH,101,15,12,24,29
1995-01-03,UTH,123,19,9,MIL,91,9,18,28,27
1995-01-03,MIN,99,6,20,DEN,108,14,13,20,33
1995-01-03,DAL,98,13,12,HOU,110,18,9,31,21
1995-01-03,SAC,100,15,12,PHX,108,21,7,36,19
1995-01-03,NJN,114,12,19,IND,103,17,9,29,28
1995-01-03,LAL,105,17,9,DET,96,9,17,26,26
1995-01-03,ATL,98,12,17,POR,103,13,13,25,30
1995-01-03,GOS,86,10,17,SAN,91,15,10,25,27
1995-01-03,WAS,107,7,19,SEA,121,18,9,25,28
1995-01-04,PHX,127,22,7,PHL,122,10,18,32,25
1995-01-04,IND,94,17,10,WAS,90,7,20,24,30
1995-01-04,CHH,118,16,12,POR,106,14,13,30,25
1995-01-04,NYK,89,15,12,ATL,80,12,18,27,30
1995-01-04,CLE,85,20,8,SEA,116,19,9,39,17
1995-01-04,CHI,86,15,13,DEN,80,15,13,30,26
1995-01-04,BOS,117,11,17,MIA,113,9,18,20,35
1995-01-04,ORL,113,23,6,NJN,110,13,19,36,25
1995-01-05,HOU,108,19,9,DAL,99,13,13,32,22
1995-01-05,LAC,95,4,25,PHL,93,10,19,14,44
1995-01-05,UTH,103,20,9,SAN,104,16,10,36,19
1995-01-05,GOS,103,10,18,MIL,111,9,19,19,37
1995-01-05,MIA,114,9,19,MIN,91,6,21,15,40
1995-01-05,SAC,94,15,13,DET,88,9,18,24,31
1995-01-06,CLE,93,20,9,NYK,103,16,12,36,21
1995-01-06,ATL,112,12,19,WAS,90,7,21,19,40
1995-01-06,BOS,92,12,17,POR,95,14,14,26,31
1995-01-06,LAL,106,18,9,MIL,98,10,19,28,28
1995-01-06,DAL,103,13,14,IND,92,18,10,31,24
1995-01-06,ORL,121,24,6,MIN,99,6,22,30,28
1995-01-06,CHI,101,16,13,SEA,108,20,9,36,22
1995-01-06,NJN,88,13,20,CHH,89,17,12,30,32
1995-01-07,WAS,105,7,22,POR,114,15,14,22,36
1995-01-07,UTH,111,20,10,PHL,90,10,20,30,30
1995-01-07,DEN,100,15,14,PHX,109,23,7,38,21
1995-01-07,CHH,106,18,12,BOS,98,12,18,30,30
1995-01-07,SAC,96,16,13,MIA,95,10,19,26,32
1995-01-07,CLE,92,20,10,CHI,78,16,14,36,24
1995-01-07,LAC,88,5,25,SAN,103,17,10,22,35
1995-01-07,ATL,102,13,19,NJN,85,13,21,26,40
1995-01-07,HOU,83,20,9,IND,88,18,11,38,20
1995-01-08,NYK,102,17,12,MIN,87,6,23,23,35
1995-01-08,LAL,122,19,9,MIA,105,10,20,29,29
1995-01-08,DET,88,9,19,ORL,108,25,6,34,25
1995-01-08,DEN,102,15,15,MIL,96,10,20,25,35
1995-01-09,POR,129,16,14,LAL,83,20,9,36,23
1995-01-09,UTH,106,21,10,DAL,90,14,14,35,24
1995-01-09,PHX,119,24,7,MIL,102,10,21,34,28
1995-01-09,BOS,114,12,19,WAS,101,7,23,19,42
1995-01-10,CLE,108,21,10,CHH,116,19,12,40,22
1995-01-10,CHI,109,16,15,ORL,77,26,6,42,21
1995-01-10,MIN,85,6,24,SAC,98,17,13,23,37
1995-01-10,GOS,118,10,19,SEA,128,21,9,31,28
1995-01-10,DET,98,9,20,NJN,84,13,22,22,42
1995-01-10,WAS,96,7,24,ATL,99,14,19,21,43
1995-01-10,NYK,117,18,12,IND,105,19,11,37,23
1995-01-10,SAN,108,18,10,LAC,97,5,26,23,36
1995-01-11,ORL,124,26,7,DET,107,10,20,36,27
1995-01-11,MIL,97,10,22,SAC,88,18,13,28,35
1995-01-11,HOU,108,20,10,MIA,97,10,21,30,31
1995-01-11,UTH,114,22,10,DEN,88,16,15,38,25
1995-01-11,POR,104,17,14,GOS,92,10,20,27,34
1995-01-11,CHH,100,20,12,MIN,91,6,25,26,37
1995-01-11,BOS,100,13,19,IND,97,19,12,32,31
1995-01-11,PHL,77,10,21,CHI,115,17,15,27,36
1995-01-11,DAL,98,14,15,LAC,93,5,27,19,42
1995-01-11,LAL,108,20,10,PHX,118,25,7,45,17
1995-01-12,DEN,94,16,16,DAL,78,15,15,31,31
1995-01-12,PHX,96,26,7,CLE,107,21,11,47,18
1995-01-12,SAN,113,19,10,MIA,108,10,22,29,32
1995-01-13,ATL,96,15,19,ORL,101,27,7,42,26
1995-01-13,SEA,108,22,9,LAC,101,5,28,27,37
1995-01-13,HOU,103,21,10,SAN,100,20,10,41,20
1995-01-13,CHI,79,18,15,SAC,89,18,14,36,29
1995-01-13,MIL,88,11,22,NYK,91,19,12,30,34
1995-01-13,BOS,93,14,19,UTH,95,23,10,37,29
1995-01-13,WAS,99,7,25,IND,113,19,13,26,38
1995-01-13,PHL,101,10,22,NJN,110,13,23,23,45
1995-01-13,MIN,104,6,26,DET,92,10,21,16,47
1995-01-13,LAL,115,20,11,GOS,104,10,21,30,32
1995-01-14,ORL,91,28,7,PHL,70,10,23,38,30
1995-01-14,IND,95,20,13,MIL,97,11,23,31,36
1995-01-14,NJN,93,14,23,MIN,84,7,26,21,49
1995-01-14,NYK,81,20,12,UTH,86,24,10,44,22
1995-01-14,GOS,97,10,22,CLE,103,22,11,32,33
1995-01-14,CHH,96,21,12,CHI,85,18,16,39,28
1995-01-14,DAL,77,15,16,MIA,84,10,23,25,39
1995-01-14,DEN,118,17,16,HOU,104,22,10,39,26
1995-01-14,LAC,108,5,29,PHX,134,26,8,31,37
1995-01-15,SEA,131,23,9,POR,124,18,14,41,23
1995-01-15,SAN,103,20,11,DAL,108,15,17,35,28
1995-01-15,BOS,98,14,20,SAC,97,19,14,33,34
1995-01-16,MIN,94,7,27,HOU,75,22,11,29,38
1995-01-16,ATL,99,15,20,MIA,95,11,23,26,43
1995-01-16,LAL,96,21,11,LAC,88,5,30,26,41
1995-01-16,GOS,77,10,23,DEN,73,18,16,28,39
1995-01-16,IND,98,20,14,UTH,99,25,10,45,24
1995-01-16,NYK,107,20,13,NJN,90,15,23,35,36
1995-01-16,PHL,110,10,24,DET,116,10,22,20,46
1995-01-16,WAS,109,7,26,CHI,101,18,17,25,43
1995-01-17,SEA,115,24,9,CLE,91,23,11,47,20
1995-01-17,PHX,129,27,8,DEN,113,18,17,45,25
1995-01-17,ORL,109,29,7,CHH,98,22,12,51,19
1995-01-17,BOS,92,15,20,SAN,101,20,12,35,32
1995-01-17,SAC,95,19,15,POR,88,18,15,37,30
1995-01-18,CHI,93,18,18,MIL,97,12,23,30,41
1995-01-18,LAC,92,5,31,CLE,83,23,12,28,43
1995-01-18,IND,106,20,15,LAL,105,22,11,42,26
1995-01-18,DET,86,11,22,UTH,99,26,10,37,32
1995-01-18,CHH,111,22,13,SAN,110,21,12,43,25
1995-01-18,ATL,80,16,20,PHL,92,10,25,26,45
1995-01-18,DAL,97,16,17,ORL,108,30,7,46,24
1995-01-18,MIA,121,11,24,BOS,93,15,21,26,45
1995-01-19,HOU,77,22,12,NYK,93,21,13,43,25
1995-01-19,POR,115,18,16,PHX,122,28,8,46,24
1995-01-19,MIN,87,8,27,SEA,102,25,9,33,36
1995-01-19,SAC,112,20,15,GOS,103,11,23,31,38
1995-01-19,MIL,120,13,23,WAS,115,8,26,21,49
1995-01-20,CHI,93,18,19,MIN,86,8,28,26,47
1995-01-20,WAS,102,8,27,PHL,98,11,25,19,52
1995-01-20,UTH,94,27,10,CLE,84,23,13,50,23
1995-01-20,IND,99,21,15,ATL,89,16,21,37,36
1995-01-20,CHH,99,23,13,NJN,97,15,24,38,37
1995-01-20,BOS,118,15,22,LAL,120,22,12,37,34
1995-01-20,DEN,108,18,18,ORL,112,31,7,49,25
1995-01-20,DAL,93,16,18,NYK,106,22,13,38,31
1995-01-20,DET,96,11,23,HOU,106,22,13,33,36
1995-01-20,MIA,114,12,24,SAN,115,21,13,33,37
1995-01-20,LAC,97,6,31,POR,108,18,17,24,48
1995-01-21,ATL,89,16,22,BOS,84,15,23,31,45
1995-01-21,LAC,86,6,32,SAC,92,21,15,27,47
1995-01-21,MIL,120,14,23,DET,100,11,24,25,47
1995-01-21,DAL,91,16,19,SEA,117,26,9,42,28
1995-01-21,DEN,100,18,19,CLE,101,23,14,41,33
1995-01-21,PHL,117,11,26,LAL,113,23,12,34,38
1995-01-22,PHX,111,29,8,ORL,110,32,7,61,15
1995-01-22,POR,103,19,17,SAC,87,22,15,41,32
1995-01-22,IND,98,22,15,SAN,93,22,13,44,28
1995-01-22,NJN,103,15,25,WAS,109,9,27,24,52
1995-01-22,CHI,100,19,19,HOU,81,23,13,42,32
1995-01-22,MIN,100,8,29,CHH,83,24,13,32,42
1995-01-22,MIA,95,12,25,NYK,104,23,13,35,38
1995-01-23,UTH,116,28,10,DAL,111,16,20,44,30
1995-01-23,CHH,102,24,14,LAL,108,23,13,47,27
1995-01-23,CLE,90,24,14,LAC,68,6,33,30,47
1995-01-24,CHI,102,20,19,SAN,104,22,14,42,33
1995-01-24,GOS,93,11,24,NJN,106,15,26,26,50
1995-01-24,MIA,107,12,26,IND,96,23,15,35,41
1995-01-24,MIL,99,15,23,HOU,115,23,14,38,37
1995-01-24,ORL,110,32,8,BOS,97,15,24,47,32
1995-01-24,SEA,111,27,9,DEN,89,18,20,45,29
1995-01-24,DET,116,11,25,PHL,105,12,26,23,51
1995-01-24,SAC,110,22,16,DAL,109,16,21,38,37
1995-01-24,MIN,85,9,29,PHX,100,30,8,39,37
1995-01-24,NYK,105,24,13,POR,99,20,17,44,30
1995-01-25,BOS,98,15,25,LAC,107,6,34,21,59
1995-01-25,CHH,96,24,15,ATL,103,17,22,41,37
1995-01-25,LAL,120,24,13,NJN,116,16,26,40,39
1995-01-25,UTH,130,29,10,SAC,88,23,16,52,26
1995-01-25,PHL,97,12,27,MIL,98,15,24,27,51
1995-01-26,ATL,68,18,22,CLE,77,25,14,43,36
1995-01-26,DET,89,12,25,POR,106,20,18,32,43
1995-01-26,ORL,102,33,8,CHI,99,20,20,53,28
1995-01-26,NYK,87,25,13,LAC,74,7,34,32,47
1995-01-26,SEA,108,28,9,UTH,120,30,10,58,19
1995-01-26,WAS,118,10,27,GOS,121,11,25,21,52
1995-01-26,SAN,103,23,14,HOU,100,24,14,47,28
1995-01-26,IND,86,23,16,PHX,92,31,8,54,24
1995-01-27,CLE,77,26,14,POR,87,21,18,47,32
1995-01-27,DEN,96,18,21,NJN,90,16,27,34,48
1995-01-27,MIL,87,16,24,MIA,96,13,26,29,50
1995-01-27,CHH,105,24,16,NYK,90,26,13,50,29
1995-01-27,BOS,117,15,26,GOS,91,12,25,27,51
1995-01-27,DAL,94,16,22,MIN,102,9,30,25,52
1995-01-27,PHL,107,12,28,PHX,108,32,8,44,36
1995-01-28,ORL,107,34,8,MIL,103,16,25,50,33
1995-01-28,ATL,93,18,23,CHH,102,25,16,43,39
1995-01-28,WAS,93,10,28,LAC,87,7,35,17,63
1995-01-28,DAL,84,16,23,SAC,87,23,17,39,40
1995-01-28,SEA,121,28,10,LAL,128,25,13,53,23
1995-01-28,DET,89,12,26,MIA,85,14,26,26,52
1995-01-28,SAN,103,24,14,DEN,77,19,21,43,35
1995-01-28,HOU,114,24,15,MIN,93,10,30,34,45
1995-01-28,IND,106,23,17,PHL,103,12,29,35,46
1995-01-28,UTH,111,31,10,NJN,94,16,28,47,38
1995-01-29,CHI,116,20,21,GOS,94,12,26,32,47
1995-01-29,NYK,107,26,14,PHX,88,33,8,59,22
1995-01-30,PHL,104,12,30,SEA,109,28,11,40,41
1995-01-30,MIA,92,14,27,ATL,95,18,24,32,51
1995-01-30,CLE,82,26,15,PHX,89,33,9,59,24
1995-01-30,DET,102,13,26,LAC,95,7,36,20,62
1995-01-30,UTH,115,32,10,MIN,80,10,31,42,41
1995-01-30,POR,98,22,18,NJN,99,16,29,38,47
1995-01-31,NYK,90,27,14,GOS,87,12,27,39,41
1995-01-31,LAL,115,26,13,CHI,119,21,21,47,34
1995-01-31,SAC,96,24,17,SAN,97,25,14,49,31
1995-01-31,MIL,107,16,26,DAL,105,16,24,32,50
1995-01-31,HOU,86,25,15,DEN,74,19,22,44,37
1995-01-31,WAS,88,11,28,CHH,97,26,16,37,44
1995-02-01,IND,101,24,17,CLE,82,26,16,50,33
1995-02-01,BOS,93,16,26,CHH,100,27,16,43,42
1995-02-01,ATL,111,19,24,GOS,99,12,28,31,52
1995-02-01,PHL,98,12,31,WAS,89,11,29,23,60
1995-02-01,POR,107,22,19,SAN,111,26,14,48,33
1995-02-01,PHX,118,34,9,LAL,109,26,14,60,23
1995-02-01,UTH,129,33,10,DEN,88,19,23,52,33
1995-02-01,NJN,95,17,29,MIL,77,17,26,34,55
1995-02-01,MIN,83,10,32,DAL,104,16,25,26,57
1995-02-01,MIA,98,14,28,DET,75,14,26,28,54
1995-02-02,DET,85,14,27,CLE,83,26,17,40,44
1995-02-02,ORL,103,35,8,SEA,106,29,11,64,19
1995-02-02,SAC,88,24,18,CHI,68,22,21,46,39
1995-02-02,HOU,121,26,15,UTH,101,34,10,60,25
1995-02-03,PHX,110,35,9,CHI,100,22,22,57,31
1995-02-03,GOS,106,12,29,LAC,89,7,37,19,66
1995-02-03,PHL,86,13,31,NYK,106,28,14,41,45
1995-02-03,ATL,98,20,24,SEA,121,30,11,50,35
1995-02-03,IND,118,25,17,ORL,106,35,9,60,26
1995-02-03,MIN,97,10,33,POR,112,22,20,32,53
1995-02-03,DAL,103,17,25,SAN,114,27,14,44,39
1995-02-03,WAS,95,11,30,MIA,105,15,28,26,58
1995-02-03,CHH,117,28,16,MIL,98,17,27,45,43
1995-02-03,LAL,74,26,15,DEN,88,19,24,45,39
1995-02-04,SAN,97,28,14,SAC,96,25,18,53,32
1995-02-04,LAC,118,7,38,LAL,121,26,16,33,54
1995-02-04,NJN,78,18,29,BOS,92,16,27,34,56
1995-02-04,DAL,119,17,26,UTH,98,34,11,51,37
1995-02-04,CLE,82,26,18,IND,73,26,17,52,35
1995-02-04,DET,84,15,27,ATL,78,20,25,35,52
1995-02-04,MIL,96,17,28,PHL,102,13,32,30,60
1995-02-05,GOS,93,13,29,CHI,97,22,23,35,52
1995-02-05,ORL,103,35,10,NYK,100,29,14,64,24
1995-02-05,MIA,109,16,28,SEA,136,31,11,47,39
1995-02-05,BOS,115,17,27,MIN,82,10,34,27,61
1995-02-05,CHH,111,29,16,WAS,105,11,31,40,47
1995-02-05,PHX,100,36,9,HOU,124,27,15,63,24
1995-02-06,POR,120,23,20,HOU,82,28,15,51,35
1995-02-06,PHL,92,14,32,ATL,107,20,26,34,58
1995-02-06,NJN,101,18,30,DET,97,16,27,34,57
1995-02-07,DAL,113,18,26,PHX,114,36,10,54,36
1995-02-07,SEA,103,32,11,SAN,106,29,14,61,25
1995-02-07,NYK,87,29,15,MIL,95,17,29,46,44
1995-02-07,LAC,88,7,39,UTH,101,34,12,41,51
1995-02-07,CLE,90,27,18,PHL,84,14,33,41,51
1995-02-07,MIN,109,10,35,GOS,100,13,30,23,65
1995-02-07,DET,119,16,28,WAS,115,11,32,27,60
1995-02-07,DEN,83,20,24,LAL,85,27,16,47,40
1995-02-07,CHH,92,30,16,IND,95,26,18,56,34
1995-02-08,DET,78,17,28,CHH,106,30,17,47,45
1995-02-08,MIL,100,18,29,MIN,93,11,35,29,64
1995-02-08,ATL,111,21,26,NJN,88,19,30,40,56
1995-02-08,IND,77,27,18,NYK,96,29,16,56,34
1995-02-08,MIA,111,16,29,WAS,107,11,33,27,62
1995-02-08,BOS,75,18,27,CLE,67,28,18,46,45
1995-02-08,UTH,104,35,12,PHX,108,37,10,72,22
1995-02-08,LAL,115,28,16,SAN,99,30,14,58,30
1995-02-08,POR,116,24,20,CHI,103,23,23,47,43
1995-02-08,SAC,86,25,19,HOU,97,28,16,53,35
1995-02-08,ORL,110,36,10,DAL,92,18,27,54,37
1995-02-09,DEN,101,20,25,GOS,109,13,31,33,56
1995-02-09,SEA,126,32,12,CHI,118,23,24,55,36
1995-02-09,LAC,122,7,40,HOU,107,29,16,36,56
1995-02-14,MIN,96,11,36,WAS,99,11,34,22,70
1995-02-14,MIA,112,17,29,MIL,99,19,29,36,58
1995-02-14,DAL,95,18,28,POR,90,25,20,43,48
1995-02-14,DEN,88,20,26,ATL,99,22,26,42,52
1995-02-14,DET,106,17,29,NYK,94,30,16,47,45
1995-02-14,SAC,108,25,20,BOS,101,19,27,44,47
1995-02-14,ORL,111,37,10,IND,92,27,19,64,29
1995-02-14,SEA,118,33,12,GOS,108,14,31,47,43
1995-02-14,NJN,109,19,31,CHH,98,31,17,50,48
1995-02-14,HOU,124,29,17,LAC,104,8,40,37,57
1995-02-14,SAN,112,30,15,UTH,96,35,13,65,28
1995-02-15,LAL,102,29,16,SEA,96,34,12,63,28
1995-02-15,PHL,97,14,34,MIN,101,11,37,25,71
1995-02-15,GOS,115,14,32,BOS,116,19,28,33,60
1995-02-15,CHI,107,23,25,WAS,92,12,34,35,59
1995-02-15,IND,114,27,20,DET,88,18,29,45,49
1995-02-15,PHX,120,38,10,POR,113,25,21,63,31
1995-02-15,CLE,100,28,19,ORL,99,38,10,66,29
1995-02-16,SAC,98,26,20,LAL,82,30,16,56,36
1995-02-16,MIL,85,19,30,CLE,106,29,19,48,49
1995-02-16,MIA,87,18,29,NYK,96,30,17,48,46
1995-02-16,NJN,100,20,31,DEN,94,20,27,40,58
1995-02-16,CHH,89,31,18,HOU,105,30,17,61,35
1995-02-16,UTH,120,35,14,SAN,113,31,15,66,29
1995-02-17,POR,114,25,22,SEA,109,34,13,59,35
1995-02-17,LAC,127,8,41,BOS,121,20,28,28,69
1995-02-17,CHI,117,24,25,DET,102,18,30,42,55
1995-02-17,MIN,78,12,37,IND,110,28,20,40,57
1995-02-17,PHX,128,39,10,GOS,139,14,33,53,43
1995-02-17,ORL,129,38,11,PHL,83,14,35,52,46
1995-02-17,NYK,100,31,17,MIA,91,18,30,49,47
1995-02-17,WAS,92,12,35,HOU,109,31,17,43,52
1995-02-17,DAL,90,19,28,ATL,110,23,26,42,54
1995-02-18,UTH,108,36,14,BOS,98,20,29,56,43
1995-02-18,PHL,95,14,36,DEN,89,20,28,34,64
1995-02-18,GOS,117,15,33,SEA,129,34,14,49,47
1995-02-18,SAC,109,27,20,LAC,92,9,41,36,61
1995-02-18,SAN,111,31,16,ATL,97,24,26,55,42
1995-02-18,MIL,118,19,31,CHI,111,25,25,44,56
1995-02-18,NJN,75,21,31,CLE,82,30,19,51,50
1995-02-18,CHH,110,31,19,DET,88,18,31,49,50
1995-02-19,IND,106,29,20,MIA,87,18,31,47,51
1995-02-19,PHX,110,39,11,UTH,107,37,14,76,25
1995-02-19,WAS,92,12,36,DEN,94,20,29,32,65
1995-02-19,NYK,122,32,17,HOU,117,32,17,64,34
1995-02-19,LAL,93,30,17,POR,83,26,22,56,39
1995-02-19,MIN,100,12,38,ORL,95,39,11,51,49
1995-02-20,DET,99,18,32,SAC,93,28,20,46,52
1995-02-20,MIL,104,20,31,ORL,152,39,12,59,43
1995-02-20,GOS,98,15,34,PHL,85,15,36,30,70
1995-02-20,CLE,96,31,19,MIA,103,18,32,49,51
1995-02-20,CHH,115,32,19,CHI,104,25,26,57,45
1995-02-20,SEA,105,35,14,LAL,108,31,17,66,31
1995-02-21,WAS,97,12,37,DAL,102,19,29,31,66
1995-02-21,HOU,97,32,18,SAN,98,32,16,64,34
1995-02-21,NYK,91,33,17,CLE,99,31,20,64,37
1995-02-21,ATL,88,24,27,CHI,105,25,27,49,54
1995-02-21,DEN,118,21,29,LAC,80,9,42,30,71
1995-02-21,POR,99,26,23,MIN,86,13,38,39,61
1995-02-21,PHX,121,40,11,BOS,129,20,30,60,41
1995-02-22,CHH,100,33,19,SAC,89,28,21,61,40
1995-02-22,UTH,118,37,15,LAC,109,9,43,46,58
1995-02-22,SAN,105,33,16,PHX,100,40,12,73,28
1995-02-22,SEA,120,35,15,MIN,104,13,39,48,54
1995-02-22,MIL,100,20,32,WAS,92,12,38,32,70
1995-02-22,GOS,89,16,34,POR,107,27,23,43,57
1995-02-22,LAL,112,32,17,PHL,100,15,37,47,54
1995-02-22,NJN,94,21,32,IND,113,30,20,51,52
1995-02-23,ATL,110,24,28,DAL,92,20,29,44,57
1995-02-23,BOS,119,21,30,ORL,117,40,12,61,42
1995-02-23,DEN,105,22,29,PHL,75,15,38,37,67
1995-02-23,NYK,103,33,18,SAC,90,28,22,61,40
1995-02-23,HOU,110,32,19,DET,99,19,32,51,51
1995-02-24,MIL,86,21,32,IND,98,31,20,52,52
1995-02-24,WAS,92,12,39,ATL,107,25,28,37,67
1995-02-24,POR,114,28,23,UTH,101,38,15,66,38
1995-02-24,SEA,90,36,15,DEN,86,23,29,59,44
1995-02-24,NJN,114,21,33,DAL,104,20,30,41,63
1995-02-24,PHX,118,40,13,LAC,106,9,44,49,57
1995-02-24,MIA,91,19,32,CHI,83,26,27,45,59
1995-02-24,SAN,114,34,16,DET,97,19,33,53,49
1995-02-24,ORL,129,40,13,BOS,103,22,30,62,43
1995-02-24,LAL,95,33,17,CHH,93,34,19,67,36
1995-02-25,WAS,102,12,40,SAC,98,28,23,40,63
1995-02-25,HOU,112,33,19,GOS,105,16,35,49,54
1995-02-25,CLE,105,32,20,NJN,102,22,33,54,53
1995-02-25,LAC,83,9,45,LAL,81,34,17,43,62
1995-02-26,ORL,105,41,13,CHI,103,26,28,67,41
1995-02-26,DEN,96,23,30,UTH,110,38,16,61,46
1995-02-26,PHX,103,41,13,CHH,92,34,20,75,33
1995-02-26,NYK,104,34,18,PHL,99,15,39,49,57
1995-02-26,IND,100,32,20,DAL,92,20,31,52,51
1995-02-26,SAN,129,35,16,GOS,99,16,36,51,52
1995-02-26,MIN,106,13,40,MIA,99,20,32,33,72
1995-02-27,BOS,97,22,31,IND,108,33,20,55,51
1995-02-27,POR,96,29,23,LAC,83,10,45,39,68
1995-02-27,HOU,86,34,19,CLE,78,33,20,67,39
1995-02-27,CHI,108,26,29,NJN,86,22,34,48,63
1995-02-27,DET,97,19,34,MIL,89,21,33,40,67
1995-02-27,SEA,114,37,15,CHH,116,34,21,71,36
1995-02-27,LAL,95,34,18,UTH,101,39,16,73,34
1995-02-27,ATL,118,26,28,SAC,99,28,24,54,52
1995-02-28,MIL,85,21,34,MIA,95,20,33,41,67
1995-02-28,LAC,110,10,46,PHX,99,42,13,52,59
1995-02-28,ORL,118,42,13,NYK,106,35,18,77,31
1995-02-28,DEN,114,23,31,MIN,101,14,40,37,71
1995-02-28,SAN,100,36,16,CLE,83,33,21,69,37
1995-02-28,DAL,102,20,32,HOU,101,35,19,55,51
1995-02-28,WAS,102,13,40,PHL,106,15,40,28,80
1995-03-01,CHI,111,27,29,MIA,85,21,33,48,62
1995-03-01,SAC,87,28,25,MIN,98,14,41,42,66
1995-03-01,BOS,124,22,32,WAS,125,13,41,35,73
1995-03-01,DET,92,20,34,IND,79,34,20,54,54
1995-03-01,GOS,85,16,37,UTH,98,40,16,56,53
1995-03-01,LAL,93,34,19,PHX,101,42,14,76,33
1995-03-02,HOU,96,35,20,ORL,107,43,13,78,33
1995-03-02,MIL,102,21,35,ATL,93,27,28,48,63
1995-03-02,NYK,93,35,19,CHI,89,28,29,63,48
1995-03-02,LAC,88,11,46,SEA,116,37,16,48,62
1995-03-02,POR,99,30,23,CHH,109,35,21,65,44
1995-03-02,DAL,90,21,32,CLE,84,33,22,54,54
1995-03-03,SAN,112,37,16,ORL,111,44,13,81,29
1995-03-03,GOS,86,16,38,CHH,116,36,21,52,59
1995-03-03,DEN,100,24,31,MIA,98,21,34,45,65
1995-03-03,MIN,108,15,41,HOU,105,35,21,50,62
1995-03-03,PHX,122,43,14,SEA,118,38,16,81,30
1995-03-03,BOS,103,22,33,MIL,91,22,35,44,68
1995-03-03,LAL,109,34,20,SAC,104,28,26,62,46
1995-03-03,ATL,94,27,29,DET,78,21,34,48,63
1995-03-03,WAS,111,14,41,IND,106,34,21,48,62
1995-03-03,NJN,98,22,35,PHL,102,16,40,38,75
1995-03-04,CLE,76,33,23,NYK,89,36,19,69,42
1995-03-04,PHL,94,17,40,CHI,106,28,30,45,70
1995-03-04,IND,101,34,22,BOS,107,23,33,57,55
1995-03-04,DAL,91,22,32,DET,98,21,35,43,67
1995-03-04,LAC,89,11,47,DEN,101,25,31,36,78
1995-03-04,UTH,98,41,16,POR,81,30,24,71,40
1995-03-05,ORL,113,44,14,ATL,111,28,29,72,43
1995-03-05,NJN,99,22,36,MIL,94,22,36,44,72
1995-03-05,LAL,105,35,20,MIN,102,16,41,51,61
1995-03-05,SAC,88,28,27,CHH,80,37,21,65,48
1995-03-05,MIA,103,21,35,WAS,90,15,41,36,76
1995-03-05,GOS,112,16,39,PHX,122,44,14,60,53
1995-03-05,SAN,124,38,16,HOU,103,35,22,73,38
1995-03-06,CHI,103,29,30,POR,83,30,25,59,55
1995-03-06,SEA,103,38,17,GOS,106,16,40,54,57
1995-03-06,LAC,101,11,48,MIN,88,16,42,27,90
1995-03-07,CLE,89,33,24,DET,81,22,35,55,59
1995-03-07,SAC,95,29,27,UTH,102,42,16,71,43
1995-03-07,MIA,110,22,35,LAL,104,36,20,58,55
1995-03-07,SAN,100,39,16,IND,117,34,23,73,39
1995-03-07,HOU,102,35,23,PHX,113,45,14,80,37
1995-03-07,DAL,96,22,33,DEN,99,26,31,48,64
1995-03-07,NYK,115,37,19,BOS,110,24,33,61,52
1995-03-07,MIL,100,22,37,POR,106,30,26,52,63
1995-03-08,ATL,99,28,30,DEN,88,27,31,55,61
1995-03-08,UTH,114,43,16,DAL,87,22,34,65,50
1995-03-08,ORL,114,45,14,LAL,110,36,21,81,35
1995-03-08,BOS,100,24,34,NYK,108,38,19,62,53
1995-03-08,GOS,120,17,40,LAC,107,12,48,29,88
1995-03-08,WAS,105,15,42,DET,114,22,36,37,78
1995-03-08,MIN,104,16,43,SEA,118,38,18,54,61
1995-03-08,PHL,108,17,41,NJN,115,23,36,40,77
1995-03-09,CHH,112,37,22,SEA,99,39,18,76,40
1995-03-09,MIA,90,23,35,POR,99,31,26,54,61
1995-03-09,SAC,94,29,28,IND,109,35,23,64,51
1995-03-09,CLE,98,34,24,SAN,100,39,17,73,41
1995-03-10,MIN,109,16,44,LAL,103,36,22,52,66
1995-03-10,DET,88,23,36,DEN,99,27,32,50,68
1995-03-10,ATL,108,29,30,NYK,81,39,19,68,49
1995-03-10,UTH,110,44,16,SAC,93,29,29,73,45
1995-03-10,PHX,97,46,14,IND,112,36,23,82,37
1995-03-10,WAS,111,15,43,MIL,114,22,38,37,81
1995-03-10,BOS,81,24,35,NJN,111,24,36,48,71
1995-03-10,LAC,121,12,49,GOS,102,18,40,30,89
1995-03-10,ORL,97,46,14,POR,85,32,26,78,40
1995-03-10,PHL,94,17,42,SAN,100,40,17,57,59
1995-03-10,CHI,99,30,30,CLE,76,34,25,64,55
1995-03-11,CHI,105,31,30,LAL,108,36,23,67,53
1995-03-11,NYK,84,39,20,SEA,96,39,19,78,39
1995-03-11,CHH,104,38,22,MIA,95,23,36,61,58
1995-03-11,WAS,110,15,44,NJN,102,25,36,40,80
1995-03-11,HOU,109,35,24,DAL,102,22,35,57,59
1995-03-12,PHX,117,46,15,GOS,124,18,41,64,56
1995-03-12,DET,94,23,37,SEA,134,40,19,63,56
1995-03-12,ORL,110,47,14,SAN,104,41,17,88,31
1995-03-12,MIL,93,23,38,DEN,109,28,32,51,70
1995-03-12,MIN,88,17,44,POR,102,32,27,49,71
1995-03-12,MIA,86,23,37,UTH,96,45,16,68,53
1995-03-12,PHL,72,17,43,CLE,92,34,26,51,69
1995-03-12,LAC,93,13,49,SAC,105,29,30,42,79
1995-03-12,BOS,98,24,36,ATL,104,30,30,54,66
1995-03-13,ATL,86,31,30,HOU,97,36,24,67,54
1995-03-13,GOS,125,19,41,DAL,130,22,36,41,77
1995-03-13,CHH,103,39,22,WAS,106,16,44,55,66
1995-03-13,LAL,93,37,23,IND,91,37,23,74,46
1995-03-14,ORL,95,48,14,UTH,107,46,16,94,30
1995-03-14,MIL,99,23,39,CHH,86,39,23,62,62
1995-03-14,PHX,116,46,16,DET,109,23,38,69,54
1995-03-14,WAS,93,17,44,CHI,106,31,31,48,75
1995-03-14,SEA,113,41,19,BOS,93,24,37,65,56
1995-03-14,SAC,90,30,30,DAL,91,23,36,53,66
1995-03-14,SAN,115,41,18,MIN,100,17,45,58,63
1995-03-14,POR,121,33,27,MIA,114,23,38,56,65
1995-03-14,PHL,107,17,44,HOU,136,37,24,54,68
1995-03-14,NYK,94,39,21,DEN,74,29,32,68,53
1995-03-15,LAC,117,13,50,DET,87,23,39,36,89
1995-03-15,IND,117,37,24,MIL,108,24,39,61,63
1995-03-15,CHI,99,32,31,ATL,86,31,31,63,62
1995-03-15,NJN,108,25,37,ORL,99,48,15,73,52
1995-03-15,GOS,119,19,42,LAL,108,38,23,57,65
1995-03-16,HOU,104,38,24,MIN,97,17,46,55,70
1995-03-16,CLE,93,35,26,UTH,85,47,16,82,42
1995-03-16,SEA,103,42,19,MIA,78,23,39,65,58
1995-03-16,CHH,105,39,24,PHX,108,47,16,86,40
1995-03-16,POR,113,34,27,BOS,98,24,38,58,65
1995-03-16,SAN,112,42,18,PHL,86,17,45,59,63
1995-03-16,DEN,123,29,33,SAC,101,30,31,59,64
1995-03-17,DAL,103,24,36,PHL,101,17,46,41,82
1995-03-17,WAS,81,17,45,NYK,89,40,21,57,66
1995-03-17,CHI,87,33,31,MIL,86,24,40,57,71
1995-03-17,MIN,80,17,47,CLE,77,36,26,53,73
1995-03-17,LAC,98,14,50,MIA,120,23,40,37,90
1995-03-17,NJN,98,26,37,UTH,103,47,17,73,54
1995-03-17,LAL,92,38,24,BOS,118,24,39,62,63
1995-03-17,SAC,128,30,32,GOS,110,20,42,50,74
1995-03-17,IND,107,38,24,ORL,97,48,16,86,40
1995-03-18,ATL,122,31,32,PHX,117,48,16,79,48
1995-03-18,SEA,133,43,19,DET,110,23,40,66,59
1995-03-18,SAN,116,43,18,DAL,106,25,36,68,54
1995-03-18,NYK,92,41,21,NJN,91,26,38,67,59
1995-03-18,DEN,110,30,33,POR,90,35,27,65,60
1995-03-19,MIA,117,24,40,PHX,121,48,17,72,57
1995-03-19,GOS,117,20,43,DET,115,23,41,43,84
1995-03-19,HOU,114,39,24,PHL,103,17,47,56,71
1995-03-19,WAS,96,17,46,CLE,90,36,27,53,73
1995-03-19,CHH,108,39,25,UTH,104,48,17,87,42
1995-03-19,LAL,121,38,25,SAC,116,31,32,69,57
1995-03-19,MIN,96,18,47,LAC,93,14,51,32,98
1995-03-19,IND,103,39,24,CHI,96,34,31,73,55
1995-03-19,MIL,95,24,41,BOS,94,25,39,49,80
1995-03-20,ATL,106,32,32,LAC,102,14,52,46,84
1995-03-20,CLE,100,36,28,DAL,102,25,37,61,65
1995-03-20,SAN,104,44,18,SEA,96,44,19,88,37
1995-03-20,SAC,91,31,33,DEN,89,31,33,62,66
1995-03-21,NYK,69,42,21,CHH,78,40,25,82,46
1995-03-21,MIL,115,25,41,GOS,109,21,43,46,84
1995-03-21,ORL,126,48,17,PHX,102,49,17,97,34
1995-03-21,POR,111,35,28,WAS,106,18,46,53,74
1995-03-21,DET,102,23,42,NJN,95,26,39,49,81
1995-03-21,HOU,102,40,24,SEA,104,44,20,84,44
1995-03-21,MIA,97,24,41,IND,95,40,24,64,65
1995-03-22,PHL,119,17,48,GOS,102,21,44,38,92
1995-03-22,UTH,103,48,18,DEN,91,31,34,79,52
1995-03-22,IND,107,40,25,LAC,103,14,53,54,78
1995-03-22,CLE,101,36,29,SAC,89,32,33,68,62
1995-03-22,BOS,107,25,40,CHI,124,34,32,59,72
1995-03-22,MIN,96,19,47,DAL,99,26,37,45,84
1995-03-22,ATL,84,33,32,MIA,98,25,41,58,73
1995-03-22,LAL,121,39,25,POR,114,36,28,75,53
1995-03-22,NJN,85,26,40,SAN,102,45,18,71,58
1995-03-23,MIL,104,26,41,LAC,93,14,54,40,95
1995-03-23,DEN,101,31,35,NYK,104,42,22,73,57
1995-03-23,ORL,105,49,17,CHH,93,41,25,90,42
1995-03-23,HOU,104,40,25,UTH,112,49,18,89,43
1995-03-23,SEA,108,45,20,WAS,103,18,47,63,67
1995-03-23,DET,94,24,42,DAL,102,27,37,51,79
1995-03-24,MIA,115,26,41,GOS,111,21,45,47,86
1995-03-24,LAL,113,40,25,WAS,103,18,48,58,73
1995-03-24,IND,103,41,25,SAC,96,32,34,73,59
1995-03-24,CHI,99,35,32,ORL,106,50,17,85,49
1995-03-24,MIN,97,19,48,SAN,111,46,18,65,66
1995-03-24,CLE,75,37,29,ATL,74,33,33,70,62
1995-03-24,POR,118,36,29,SEA,122,46,20,82,49
1995-03-24,PHL,75,18,48,BOS,107,25,41,43,89
1995-03-24,PHX,97,49,18,HOU,99,40,26,89,44
1995-03-25,LAC,86,14,55,NYK,94,43,22,57,77
1995-03-25,CHH,105,41,26,CLE,97,38,29,79,55
1995-03-25,PHL,75,18,49,IND,84,42,25,60,74
1995-03-25,MIA,95,27,41,NJN,96,26,41,53,82
1995-03-25,DET,104,24,43,BOS,103,26,41,50,84
1995-03-25,ATL,98,33,34,CHI,99,35,33,68,67
1995-03-25,MIL,105,27,41,SAN,113,47,18,74,59
1995-03-25,DAL,117,28,37,UTH,110,50,18,78,55
1995-03-26,POR,98,36,30,DEN,102,31,36,67,66
1995-03-26,MIN,98,19,49,SAC,104,32,35,51,84
1995-03-26,LAL,107,41,25,HOU,96,41,26,82,51
1995-03-26,SEA,93,47,20,NYK,82,44,22,91,42
1995-03-26,ORL,132,51,17,GOS,98,21,46,72,63
1995-03-27,DEN,113,32,36,LAC,104,14,56,46,92
1995-03-27,IND,98,43,25,NJN,87,27,41,70,66
1995-03-27,DET,93,25,43,SAN,114,48,18,73,61
1995-03-27,UTH,128,50,19,WAS,102,18,49,68,68
1995-03-28,POR,91,36,31,ATL,102,33,35,69,66
1995-03-28,NJN,113,27,42,GOS,127,21,47,48,89
1995-03-28,HOU,96,41,27,LAL,106,42,25,83,52
1995-03-28,NYK,111,44,23,CHI,113,36,33,80,56
1995-03-28,MIA,115,27,42,BOS,126,26,42,53,84
1995-03-28,PHX,102,49,19,UTH,111,51,19,100,38
1995-03-28,SAC,117,33,35,ORL,106,52,17,85,52
1995-03-28,DAL,114,29,37,MIL,93,27,42,56,79
1995-03-29,WAS,97,18,50,MIA,101,27,43,45,93
1995-03-29,SEA,109,48,20,MIN,92,19,50,67,70
1995-03-29,IND,107,44,25,CLE,96,38,30,82,55
1995-03-29,PHL,99,18,50,CHH,81,42,26,60,76
1995-03-29,DET,97,25,44,NYK,107,44,24,69,68
1995-03-29,SAN,107,49,18,LAL,84,43,25,92,43
1995-03-30,LAC,96,14,57,HOU,108,41,28,55,85
1995-03-30,CHH,107,42,27,DAL,125,30,37,72,64
1995-03-30,NJN,103,27,43,POR,106,36,32,63,75
1995-03-30,CHI,100,37,33,BOS,82,27,42,64,75
1995-03-30,GOS,80,22,47,ATL,108,34,35,56,82
1995-03-30,SAC,96,34,35,PHX,113,49,20,83,55
1995-03-31,PHX,106,50,20,MIN,96,19,51,69,71
1995-03-31,SEA,120,49,20,SAC,95,34,36,83,56
1995-03-31,SAN,118,50,18,MIL,102,27,43,77,61
1995-03-31,CLE,98,38,31,WAS,88,18,51,56,82
1995-03-31,LAL,121,43,26,ATL,107,35,35,78,61
1995-03-31,PHL,86,19,50,POR,85,37,32,56,82
1995-03-31,NYK,101,45,24,DAL,90,31,37,76,61
1995-03-31,BOS,100,27,43,MIA,99,28,43,55,86
1995-03-31,UTH,98,52,19,ORL,101,52,18,104,37
1995-03-31,IND,92,45,25,DEN,107,33,36,78,61
1995-04-01,CHI,91,38,33,PHL,84,20,50,58,83
1995-04-01,LAC,116,14,58,UTH,98,52,20,66,78
1995-04-01,HOU,87,42,28,MIL,93,27,44,69,72
1995-04-01,GOS,104,22,48,MIN,126,19,52,41,100
1995-04-02,LAL,119,44,26,ORL,112,53,18,97,44
1995-04-02,MIA,92,28,44,CHH,105,42,28,70,72
1995-04-02,BOS,94,28,43,DAL,87,31,38,59,81
1995-04-02,SEA,105,50,20,ATL,83,35,36,85,56
1995-04-02,SAN,109,51,18,PHX,106,51,20,102,38
1995-04-02,IND,104,45,26,POR,93,37,33,82,59
1995-04-02,NJN,85,27,44,NYK,94,46,24,73,68
1995-04-02,CLE,101,39,31,DEN,104,34,36,73,67
1995-04-02,DET,110,25,45,WAS,105,18,52,43,97
1995-04-04,SAC,109,34,37,HOU,105,42,29,76,66
1995-04-04,MIA,95,28,45,PHL,92,20,51,48,96
1995-04-04,GOS,122,22,49,PHX,114,51,21,73,70
1995-04-04,LAC,89,15,58,SAN,113,52,18,67,76
1995-04-04,UTH,114,52,21,SEA,92,51,20,103,41
1995-04-04,POR,95,37,34,MIN,91,20,52,57,86
1995-04-04,CLE,92,39,32,BOS,97,29,43,68,75
1995-04-04,NYK,90,47,24,IND,94,46,26,93,50
1995-04-04,DEN,101,35,36,LAL,104,45,26,80,62
1995-04-05,DAL,130,31,39,LAL,111,46,26,77,65
1995-04-05,ATL,96,35,37,CLE,87,39,33,74,70
1995-04-05,IND,102,47,26,WAS,90,18,53,65,79
1995-04-05,NJN,101,27,45,CHI,108,39,33,66,78
1995-04-05,CHH,84,43,28,PHL,66,20,52,63,80
1995-04-05,ORL,128,53,19,DET,125,26,45,79,64
1995-04-05,MIL,94,28,44,NYK,114,47,25,75,69
1995-04-06,WAS,123,18,54,PHX,127,51,22,69,76
1995-04-06,SAC,94,35,37,SAN,96,53,18,88,55
1995-04-06,GOS,102,23,49,HOU,110,42,30,65,79
1995-04-06,DEN,100,35,37,SEA,106,51,21,86,58
1995-04-07,MIL,107,28,45,NJN,92,27,46,55,91
1995-04-07,BOS,91,30,43,PHL,81,20,53,50,96
1995-04-07,CHI,97,40,33,CLE,88,39,34,79,67
1995-04-07,POR,127,38,34,HOU,109,43,30,81,64
1995-04-07,DAL,111,32,39,MIN,94,20,53,52,92
1995-04-07,ATL,102,36,37,IND,90,48,26,84,63
1995-04-07,WAS,93,18,55,CHH,98,44,28,62,83
1995-04-07,LAL,113,46,27,UTH,90,53,21,99,48
1995-04-07,DET,104,26,46,ORL,94,54,19,80,65
1995-04-08,GOS,99,23,50,SAN,112,54,18,77,68
1995-04-08,NYK,113,48,25,DET,96,27,46,75,71
1995-04-08,DAL,98,33,39,SEA,125,52,21,85,60
1995-04-08,NJN,103,27,47,MIA,93,29,45,56,92
1995-04-08,PHL,109,20,54,ORL,99,54,20,74,74
1995-04-08,SAC,105,35,38,LAC,112,15,59,50,97
1995-04-09,LAL,87,47,27,SAN,101,55,18,102,45
1995-04-09,WAS,98,18,56,BOS,110,31,43,49,99
1995-04-09,DEN,120,35,38,HOU,123,43,31,78,69
1995-04-09,MIL,102,29,45,ATL,99,37,37,66,82
1995-04-09,POR,94,39,34,PHX,104,52,22,91,56
1995-04-09,CLE,79,39,35,CHI,78,41,33,80,68
1995-04-09,IND,97,48,27,CHH,68,45,28,93,55
1995-04-10,CHH,119,45,29,BOS,95,32,43,77,72
1995-04-10,DAL,112,33,40,GOS,123,23,51,56,91
1995-04-10,MIN,107,20,54,DEN,114,35,39,55,93
1995-04-11,UTH,100,53,22,LAL,93,47,28,100,50
1995-04-11,SEA,90,53,21,PHX,96,53,22,106,43
1995-04-11,MIL,114,30,45,DET,109,27,47,57,92
1995-04-11,NYK,112,49,25,MIA,99,29,46,78,71
1995-04-11,LAC,85,16,59,SAC,117,35,39,51,98
1995-04-11,PHL,106,21,54,ATL,110,37,38,58,92
1995-04-11,CHI,96,41,34,IND,89,49,27,90,61
1995-04-11,HOU,147,44,31,DAL,156,33,41,77,72
1995-04-11,ORL,107,54,21,CLE,90,40,35,94,56
1995-04-11,SAN,71,56,18,POR,91,39,35,95,53
1995-04-12,PHX,115,54,22,SAN,111,56,19,110,41
1995-04-12,SAC,109,36,39,LAL,99,47,29,83,68
1995-04-12,DET,113,27,48,CHI,124,42,34,69,82
1995-04-12,CHH,105,46,29,NJN,77,28,47,74,76
1995-04-12,ATL,90,38,38,WAS,82,18,57,56,95
1995-04-12,MIN,109,20,55,GOS,123,24,51,44,106
1995-04-13,UTH,121,54,22,GOS,102,25,51,79,73
1995-04-13,MIA,85,29,47,CLE,84,40,36,69,83
1995-04-13,NYK,110,50,25,WAS,100,18,58,68,83
1995-04-13,HOU,112,44,32,POR,99,40,35,84,67
1995-04-13,LAC,103,16,60,DEN,125,36,39,52,99
1995-04-13,PHL,102,21,55,NJN,94,28,48,49,103
1995-04-13,SEA,133,53,22,DAL,112,34,41,87,63
1995-04-13,BOS,119,32,44,ORL,114,55,21,87,65
1995-04-14,DEN,102,37,39,PHX,87,55,22,92,61
1995-04-14,SAN,98,56,20,SAC,88,37,39,93,59
1995-04-14,CLE,83,40,37,ATL,70,39,38,79,75
1995-04-14,IND,84,49,28,NYK,88,51,25,100,53
1995-04-14,DET,86,27,49,CHH,94,47,29,74,78
1995-04-14,MIN,104,20,56,MIL,100,31,45,51,101
1995-04-15,POR,90,40,36,DAL,102,34,42,74,78
1995-04-15,BOS,129,33,44,DET,104,27,50,60,94
1995-04-15,GOS,99,25,52,SEA,115,54,22,79,74
1995-04-15,WAS,114,18,59,MIL,110,31,46,49,105
1995-04-15,HOU,98,45,32,SAC,84,37,40,82,72
1995-04-15,MIA,123,30,47,ORL,117,55,22,85,69
1995-04-15,NJN,87,28,49,PHL,97,22,55,50,104
1995-04-15,UTH,105,55,22,LAC,83,16,61,71,83
1995-04-15,PHX,119,55,23,LAL,114,47,30,102,53
1995-04-16,DEN,109,38,39,SAN,112,57,20,95,59
1995-04-16,LAL,125,47,31,DAL,111,35,42,82,73
1995-04-16,IND,114,49,29,MIN,75,21,56,70,85
1995-04-16,CHI,111,43,34,NYK,90,52,25,95,59
1995-04-16,CHH,93,48,29,ATL,94,39,39,87,68
1995-04-17,HOU,121,46,32,LAC,111,16,62,62,94
1995-04-17,MIA,93,31,47,CHI,98,44,34,75,81
1995-04-17,ORL,111,55,23,WAS,100,19,59,74,82
1995-04-17,SEA,93,55,22,POR,97,40,37,95,59
1995-04-17,BOS,98,34,44,NJN,96,28,50,62,94
1995-04-17,NYK,93,52,26,MIL,99,31,47,83,73
1995-04-17,PHL,90,23,55,CHH,101,48,30,71,85
1995-04-18,DET,85,27,51,CLE,76,41,37,68,88
1995-04-18,MIN,94,21,57,UTH,113,56,22,77,79
1995-04-18,GOS,103,25,53,POR,102,41,37,66,90
1995-04-18,DAL,104,35,43,LAC,91,16,63,51,106
1995-04-18,LAL,97,48,31,SEA,113,55,23,103,54
1995-04-18,PHX,111,56,23,SAC,101,37,41,93,64
1995-04-18,SAN,107,58,20,DEN,96,38,40,96,60
1995-04-19,NJN,99,28,51,ATL,104,40,39,68,90
1995-04-19,CLE,90,41,38,MIA,79,31,48,72,86
1995-04-19,WAS,123,19,60,ORL,117,56,23,75,83
1995-04-19,UTH,115,57,22,HOU,96,47,32,104,54
1995-04-19,MIL,106,32,47,BOS,97,35,44,67,91
1995-04-19,IND,103,50,29,PHL,91,23,56,73,85
1995-04-19,DEN,106,38,41,MIN,81,21,58,59,99
1995-04-20,SEA,111,56,23,HOU,101,47,33,103,56
1995-04-20,DAL,111,36,43,SAN,112,59,20,95,63
1995-04-20,CHH,86,49,30,NYK,91,52,27,101,57
1995-04-20,POR,111,41,38,LAL,97,48,32,89,70
1995-04-20,GOS,98,26,53,SAC,112,37,42,63,95
1995-04-20,CHI,120,45,34,DET,105,28,51,73,85
1995-04-21,BOS,92,35,45,NYK,99,53,27,88,72
1995-04-21,ATL,128,41,39,DET,111,28,52,69,91
1995-04-21,ORL,110,56,24,IND,86,51,29,107,53
1995-04-21,UTH,99,58,22,MIN,96,21,59,79,81
1995-04-21,CLE,103,42,38,MIL,82,33,47,75,85
1995-04-21,NJN,107,28,52,WAS,106,20,60,48,112
1995-04-21,SAN,107,60,20,LAC,96,16,64,76,84
1995-04-21,PHX,110,57,23,DAL,99,36,44,93,67
1995-04-21,PHL,113,23,57,MIA,106,31,49,54,106
1995-04-21,SAC,105,38,42,SEA,97,57,23,95,65
1995-04-22,GOS,129,26,54,DEN,130,39,41,65,95
1995-04-22,LAL,104,48,33,POR,109,42,38,90,71
1995-04-22,CHI,116,46,34,CHH,100,49,31,95,65
1995-04-23,WAS,106,20,61,PHL,90,24,57,44,118
1995-04-23,HOU,97,47,34,UTH,103,59,22,106,56
1995-04-23,MIN,91,21,60,SAN,97,61,20,82,80
1995-04-23,PHX,105,58,23,SEA,100,57,24,115,47
1995-04-23,POR,116,43,38,GOS,83,26,55,69,93
1995-04-23,MIA,129,31,50,DET,105,28,53,59,103
1995-04-23,MIL,104,33,48,CHI,100,47,34,80,82
1995-04-23,CHH,97,49,32,CLE,72,43,38,92,70
1995-04-23,NYK,113,54,27,ORL,99,57,24,111,51
1995-04-23,IND,103,51,30,ATL,87,42,39,93,69
1995-04-23,DEN,102,40,41,SAC,89,39,42,79,83
1995-04-23,LAC,124,16,65,DAL,102,36,45,52,110
1995-04-23,NJN,102,29,52,BOS,99,35,46,64,98
1995-11-03,CHI,105,0,0,CHH,91,0,0,0,0
1995-11-03,ATL,106,0,0,IND,111,0,0,0,0
1995-11-03,UTH,112,0,0,SEA,94,0,0,0,0
1995-11-03,DET,100,0,0,NYK,106,0,0,0,0
1995-11-03,LAC,112,0,0,PHX,106,0,0,0,0
1995-11-03,HOU,110,0,0,GOS,92,0,0,0,0
1995-11-03,POR,80,0,0,VAN,92,0,0,0,0
1995-11-03,LAL,98,0,0,DEN,96,0,0,0,0
1995-11-03,SAC,95,0,0,MIN,86,0,0,0,0
1995-11-03,ORL,99,0,0,CLE,88,0,0,0,0
1995-11-03,SAN,97,0,0,DAL,103,0,0,0,0
1995-11-03,TOR,94,0,0,NJN,79,0,0,0,0
1995-11-03,BOS,100,0,0,MIL,101,0,0,0,0
1995-11-03,PHL,105,0,0,WAS,103,0,0,0,0
1995-11-04,DAL,99,1,0,GOS,84,0,1,1,1
1995-11-04,SEA,103,0,1,LAL,89,1,0,1,1
1995-11-04,IND,97,1,0,TOR,89,1,0,2,0
1995-11-04,CHI,107,1,0,BOS,85,0,1,1,1
1995-11-04,WAS,100,0,1,DET,89,0,1,0,2
1995-11-04,DEN,108,0,1,SAN,116,0,1,0,2
1995-11-04,ATL,124,0,1,ORL,91,1,0,1,1
1995-11-04,MIA,85,0,0,CLE,71,0,1,0,1
1995-11-04,MIL,71,1,0,NYK,84,1,0,2,0
1995-11-04,CHH,119,0,1,PHL,108,1,0,1,1
1995-11-05,POR,109,0,1,UTH,105,1,0,1,1
1995-11-05,VAN,100,1,0,MIN,98,0,1,1,1
1995-11-05,SAC,99,1,0,LAC,82,1,0,2,0
1995-11-05,PHX,104,0,1,HOU,106,1,0,1,1
1995-11-06,UTH,105,1,1,ATL,96,1,1,2,2
1995-11-06,ORL,105,1,1,WAS,95,1,1,2,2
1995-11-07,DAL,99,2,0,VAN,88,2,0,4,0
1995-11-07,CLE,101,0,2,IND,104,2,0,2,2
1995-11-07,HOU,106,2,0,MIL,89,1,1,3,1
1995-11-07,PHL,106,1,1,SAC,109,2,0,3,1
1995-11-07,CHI,117,2,0,TOR,108,1,1,3,1
1995-11-07,NYK,94,2,0,PHX,102,0,2,2,2
1995-11-07,MIN,93,0,2,LAL,92,1,1,1,3
1995-11-07,NJN,104,0,1,POR,84,1,1,1,2
1995-11-07,GOS,98,0,2,DEN,93,0,2,0,4
1995-11-07,CHH,108,1,1,DET,96,0,2,1,3
1995-11-07,SEA,127,1,1,LAC,108,1,1,2,2
1995-11-08,UTH,108,2,1,LAL,98,1,2,3,3
1995-11-08,MIA,89,1,0,HOU,82,3,0,4,0
1995-11-08,ORL,130,2,1,NJN,122,1,1,3,2
1995-11-08,LAC,92,1,2,ATL,100,1,2,2,4
1995-11-08,TOR,90,1,2,SAC,109,3,0,4,2
1995-11-08,DET,107,0,3,POR,100,1,2,1,5
1995-11-08,DEN,117,0,3,SEA,122,2,1,2,4
1995-11-08,BOS,113,0,2,PHX,109,1,2,1,4
1995-11-08,SAN,111,1,1,VAN,62,2,1,3,2
1995-11-08,WAS,110,1,2,CHH,96,2,1,3,3
1995-11-09,NYK,103,2,1,IND,95,3,0,5,1
1995-11-09,CLE,88,0,3,CHI,106,3,0,3,3
1995-11-09,GOS,121,1,2,ATL,125,2,2,3,4
1995-11-09,DAL,104,3,0,MIL,94,1,2,4,2
1995-11-10,UTH,109,3,1,DEN,86,0,4,3,5
1995-11-10,VAN,91,2,2,LAC,98,1,3,3,5
1995-11-10,LAL,100,1,3,SEA,97,3,1,4,4
1995-11-10,IND,95,3,1,SAC,119,4,0,7,1
1995-11-10,DET,100,1,3,CLE,80,0,4,1,7
1995-11-10,SAN,104,2,1,MIL,90,1,3,3,4
1995-11-10,WAS,109,2,2,NYK,110,3,1,5,3
1995-11-10,MIN,102,1,2,POR,108,1,3,2,5
1995-11-10,PHL,104,1,2,CHH,90,2,2,3,4
1995-11-10,TOR,108,1,3,PHX,112,1,3,2,6
1995-11-10,BOS,94,1,2,ORL,110,3,1,4,3
1995-11-10,MIA,106,2,0,NJN,80,1,2,3,2
1995-11-11,HOU,119,3,1,MIN,97,1,3,4,4
1995-11-11,SEA,117,3,2,VAN,81,2,3,5,5
1995-11-11,CHH,123,2,3,TOR,117,1,4,3,7
1995-11-11,NJN,86,1,3,SAC,84,5,0,6,3
1995-11-11,ORL,94,4,1,MIA,93,3,0,7,1
1995-11-11,DAL,100,4,0,ATL,113,3,2,7,2
1995-11-11,CHI,110,4,0,POR,106,2,3,6,3
1995-11-11,GOS,123,1,3,LAL,105,2,3,3,6
1995-11-12,PHX,112,2,3,GOS,109,2,3,4,6
1995-11-12,NYK,120,4,1,UTH,110,4,1,8,2
1995-11-12,LAC,108,2,3,DEN,103,0,5,2,8
1995-11-12,CLE,81,0,5,SAN,84,3,1,3,6
1995-11-13,TOR,100,1,5,UTH,103,4,2,5,7
1995-11-13,VAN,89,2,4,DAL,94,4,1,6,5
1995-11-14,ATL,111,4,2,CHH,104,3,3,7,5
1995-11-14,GOS,106,2,4,LAC,118,3,3,5,7
1995-11-14,POR,105,2,4,NYK,99,5,1,7,5
1995-11-14,MIL,98,1,4,SAN,84,4,1,5,5
1995-11-14,SAC,100,5,1,LAL,106,2,4,7,5
1995-11-14,PHL,107,2,2,SEA,115,4,2,6,4
1995-11-14,ORL,94,5,1,CHI,88,5,0,10,1
1995-11-15,NJN,90,2,3,CHH,79,3,4,5,7
1995-11-15,BOS,90,1,3,UTH,102,5,2,6,5
1995-11-15,WAS,127,2,3,PHL,95,2,3,4,6
1995-11-15,PHX,127,3,3,DEN,137,0,6,3,9
1995-11-15,MIA,97,3,1,IND,103,3,2,6,3
1995-11-15,DET,94,2,3,SEA,87,5,2,7,5
1995-11-15,LAL,114,3,4,DAL,97,5,1,8,5
1995-11-15,TOR,93,1,6,HOU,96,4,1,5,7
1995-11-15,MIN,96,1,4,SAN,105,4,2,5,6
1995-11-15,CHI,113,5,1,CLE,94,0,6,5,7
1995-11-16,ORL,89,6,1,IND,80,4,2,10,3
1995-11-16,GOS,97,2,5,NYK,120,5,2,7,7
1995-11-16,MIL,87,2,4,HOU,115,5,1,7,5
1995-11-16,POR,102,3,4,SAC,105,5,2,8,6
1995-11-16,LAC,103,4,3,VAN,98,2,5,6,8
1995-11-17,DEN,94,1,6,NYK,103,6,2,7,8
1995-11-17,ATL,88,5,2,MIA,91,3,2,8,4
1995-11-17,CHI,109,6,1,NJN,94,3,3,9,4
1995-11-17,LAC,101,5,3,DAL,90,5,2,10,5
1995-11-17,CHH,96,3,5,SEA,98,5,3,8,8
1995-11-17,DET,81,3,3,UTH,86,6,2,9,5
1995-11-17,BOS,110,1,4,WAS,100,3,3,4,7
1995-11-17,TOR,114,1,7,MIN,96,1,5,2,12
1995-11-17,PHL,82,2,4,CLE,114,0,7,2,11
1995-11-17,VAN,91,2,6,LAL,114,4,4,6,10
1995-11-17,SAC,105,6,2,PHX,96,3,4,9,6
1995-11-18,WAS,102,3,4,TOR,103,2,7,5,11
1995-11-18,MIL,93,2,5,BOS,99,2,4,4,9
1995-11-18,IND,118,4,3,SEA,104,6,3,10,6
1995-11-18,SAN,109,5,2,CHH,107,3,6,8,8
1995-11-18,PHX,107,3,5,POR,102,3,5,6,10
1995-11-18,MIN,102,1,6,UTH,126,7,2,8,8
1995-11-18,HOU,101,6,1,DEN,97,1,7,7,8
1995-11-18,GOS,121,2,6,DAL,108,5,3,7,9
1995-11-18,MIA,93,4,2,ORL,90,7,1,11,3
1995-11-18,CLE,93,1,7,DET,90,3,4,4,11
1995-11-18,NJN,95,3,4,PHL,79,2,5,5,9
1995-11-19,SAC,94,7,2,ATL,108,5,3,12,5
1995-11-19,NYK,98,7,2,VAN,93,2,7,9,9
1995-11-19,LAL,109,5,4,LAC,88,6,3,11,7
1995-11-20,ORL,101,7,2,GOS,95,3,6,10,8
1995-11-20,POR,113,3,6,LAC,94,6,4,9,10
1995-11-20,UTH,105,8,2,NJN,79,4,4,12,6
1995-11-20,BOS,93,3,4,HOU,98,7,1,10,5
1995-11-21,LAL,108,6,4,POR,109,4,6,10,10
1995-11-21,DEN,107,1,8,ATL,99,6,3,7,11
1995-11-21,TOR,102,3,7,SEA,97,6,4,9,11
1995-11-21,DAL,102,5,4,CHI,108,7,1,12,5
1995-11-22,SAN,94,6,2,CHI,103,8,1,14,3
1995-11-22,MIA,103,5,2,GOS,93,3,7,8,9
1995-11-22,CHH,124,3,7,BOS,129,3,5,6,12
1995-11-22,CLE,84,2,7,NYK,94,8,2,10,9
1995-11-22,ORL,95,8,2,VAN,93,2,8,10,10
1995-11-22,MIN,97,1,7,SEA,106,6,5,7,12
1995-11-22,PHX,117,4,5,ATL,112,6,4,10,9
1995-11-22,LAC,125,6,5,NJN,92,4,5,10,10
1995-11-22,DET,97,3,5,WAS,98,3,5,6,10
1995-11-22,MIL,96,2,6,TOR,86,4,7,6,13
1995-11-22,PHL,106,2,6,HOU,115,8,1,10,7
1995-11-22,UTH,116,9,2,SAC,95,7,3,16,5
1995-11-23,IND,108,5,3,HOU,115,9,1,14,4
1995-11-24,BOS,94,4,5,GOS,101,3,8,7,13
1995-11-24,LAL,98,6,5,SAC,99,7,4,13,9
1995-11-24,SEA,112,7,5,SAN,100,6,3,13,8
1995-11-24,IND,93,5,4,CLE,100,2,8,7,12
1995-11-24,DET,101,3,6,PHL,78,2,7,5,13
1995-11-24,WAS,110,4,5,MIA,94,6,2,10,7
1995-11-24,UTH,85,10,2,CHI,90,9,1,19,3
1995-11-24,MIN,98,1,8,ORL,109,9,2,10,10
1995-11-24,DAL,109,5,5,DEN,112,2,8,7,13
1995-11-24,POR,99,5,6,NJN,87,4,6,9,12
1995-11-24,CHH,116,3,8,VAN,104,2,9,5,17
1995-11-25,ATL,114,6,5,TOR,102,4,8,10,13
1995-11-25,MIA,111,6,3,VAN,91,2,10,8,13
1995-11-25,CLE,89,3,8,MIL,87,3,6,6,14
1995-11-25,LAC,91,7,5,SAN,100,6,4,13,9
1995-11-25,DEN,94,3,8,UTH,91,10,3,13,11
1995-11-25,PHX,114,5,5,LAL,113,6,6,11,11
1995-11-25,WAS,112,5,5,ORL,114,10,2,15,7
1995-11-25,PHL,89,2,8,GOS,107,4,8,6,16
1995-11-25,NYK,103,9,2,HOU,88,10,1,19,3
1995-11-26,MIL,102,3,7,MIN,105,1,9,4,16
1995-11-26,BOS,109,4,6,CHH,111,4,8,8,14
1995-11-26,SEA,97,8,5,CHI,92,10,1,18,6
1995-11-26,SAC,99,8,4,NJN,92,4,7,12,11
1995-11-26,DET,102,4,6,HOU,100,10,2,14,8
1995-11-27,TOR,101,4,9,GOS,98,5,8,9,17
1995-11-27,PHX,105,6,5,UTH,114,10,4,16,9
1995-11-27,ORL,96,11,2,DET,95,5,6,16,8
1995-11-27,POR,104,6,6,CHI,107,10,2,16,8
1995-11-28,HOU,116,10,3,LAC,103,7,6,17,9
1995-11-28,NYK,97,10,2,ATL,102,7,5,17,7
1995-11-28,NJN,89,4,8,WAS,84,5,6,9,14
1995-11-28,MIL,98,3,8,CHH,106,5,8,8,16
1995-11-28,CLE,93,4,8,TOR,89,5,9,9,17
1995-11-28,MIA,111,7,3,DAL,89,5,6,12,9
1995-11-28,SAC,91,9,4,DEN,85,4,8,13,12
1995-11-28,MIN,121,2,9,VAN,98,2,11,4,20
1995-11-28,SEA,101,9,5,IND,102,5,5,14,10
1995-11-29,GOS,98,5,9,POR,112,6,7,11,16
1995-11-29,LAL,107,6,7,PHX,96,6,6,12,13
1995-11-29,CHH,115,6,8,NYK,105,10,3,16,11
1995-11-29,BOS,100,4,7,DET,96,5,7,9,14
1995-11-29,SAN,105,7,4,LAC,86,7,7,14,11
1995-11-29,ATL,106,8,5,PHL,81,2,9,10,14
1995-11-30,SAC,105,10,4,IND,95,6,5,16,9
1995-11-30,WAS,85,5,7,CLE,97,5,8,10,15
1995-11-30,HOU,105,11,3,UTH,112,11,4,22,7
1995-11-30,POR,99,7,7,MIL,100,3,9,10,16
1995-11-30,DET,107,5,8,MIA,118,8,3,13,11
1995-11-30,ORL,110,12,2,DAL,96,5,7,17,9
1995-11-30,VAN,88,2,12,CHI,94,11,2,13,14
1995-12-01,TOR,105,5,10,PHL,102,2,10,7,20
1995-12-01,SEA,110,9,6,MIL,99,4,9,13,15
1995-12-01,MIA,108,9,3,CHH,101,7,8,16,11
1995-12-01,PHX,111,6,7,MIN,105,3,9,9,16
1995-12-01,BOS,123,5,7,NJN,131,5,8,10,15
1995-12-01,LAL,113,7,7,VAN,100,2,13,9,20
1995-12-01,ATL,98,9,5,DAL,106,5,8,14,13
1995-12-02,WAS,135,5,8,BOS,107,5,8,10,16
1995-12-02,DEN,109,4,9,MIN,105,3,10,7,19
1995-12-02,NJN,79,6,8,CLE,78,6,8,12,16
1995-12-02,SAN,101,8,4,PHX,93,7,7,15,11
1995-12-02,HOU,113,11,4,CHH,98,7,9,18,13
1995-12-02,GOS,100,5,10,IND,97,6,6,11,16
1995-12-02,PHL,85,2,11,NYK,94,10,4,12,15
1995-12-02,SAC,109,11,4,ORL,106,13,2,24,6
1995-12-02,DET,104,5,9,ATL,96,9,6,14,15
1995-12-02,LAC,98,7,8,CHI,104,12,2,19,10
1995-12-03,TOR,94,6,10,MIA,112,10,3,16,13
1995-12-03,VAN,95,2,14,MIL,109,4,10,6,24
1995-12-03,CLE,108,6,9,DAL,107,6,8,12,17
1995-12-03,LAL,104,8,7,IND,96,6,7,14,14
1995-12-03,NYK,107,11,4,WAS,83,6,8,17,12
1995-12-03,POR,93,7,8,ORL,82,13,3,20,11
1995-12-04,BOS,121,5,9,MIA,120,11,3,16,12
1995-12-04,DEN,85,5,9,DET,82,6,9,11,18
1995-12-05,PHX,112,7,8,VAN,108,2,15,9,23
1995-12-05,SEA,119,10,6,TOR,89,6,11,16,17
1995-12-05,SAN,117,9,4,LAL,89,9,7,18,11
1995-12-05,NYK,92,12,4,DAL,87,6,9,18,13
1995-12-05,UTH,100,12,4,HOU,103,12,4,24,8
1995-12-05,LAC,105,7,9,ORL,114,13,4,20,13
1995-12-05,IND,108,6,8,PHL,91,2,12,8,20
1995-12-06,WAS,96,6,9,ATL,79,9,7,15,16
1995-12-06,MIA,101,11,4,BOS,105,6,9,17,13
1995-12-06,PHL,108,2,13,DAL,87,6,10,8,23
1995-12-06,CHI,101,13,2,NYK,94,13,4,26,6
1995-12-06,GOS,107,6,10,ORL,109,14,4,20,14
1995-12-06,HOU,112,13,4,LAL,99,9,8,22,12
1995-12-06,MIN,108,3,11,NJN,97,7,8,10,19
1995-12-06,CHH,94,7,10,CLE,82,7,9,14,19
1995-12-07,MIL,112,5,10,LAC,103,7,10,12,20
1995-12-07,ATL,102,9,8,SAN,104,10,4,19,12
1995-12-07,POR,96,8,8,TOR,88,6,12,14,20
1995-12-07,UTH,119,12,5,DEN,124,6,9,18,14
1995-12-07,VAN,84,2,16,DET,93,6,10,8,26
1995-12-08,LAL,120,9,9,TOR,103,6,13,15,22
1995-12-08,SAC,103,12,4,SEA,120,11,6,23,10
1995-12-08,ORL,105,15,4,CHH,95,8,10,23,14
1995-12-08,CLE,113,7,10,PHL,85,3,13,10,23
1995-12-08,GOS,114,6,11,DET,121,7,10,13,21
1995-12-08,NJN,91,7,9,IND,89,7,8,14,17
1995-12-08,MIN,112,4,11,LAC,94,7,11,11,22
1995-12-08,HOU,113,14,4,WAS,107,7,9,21,13
1995-12-08,DEN,103,7,9,PHX,98,8,8,15,17
1995-12-08,CHI,106,14,2,SAN,87,11,4,25,6
1995-12-09,MIL,106,6,10,CHI,118,15,2,21,12
1995-12-09,PHL,98,3,14,BOS,124,7,9,10,23
1995-12-09,DAL,94,6,11,WAS,103,7,10,13,21
1995-12-09,UTH,123,12,6,GOS,109,6,12,18,18
1995-12-09,SEA,106,12,6,POR,97,9,8,21,14
1995-12-09,CLE,73,8,10,NJN,85,8,9,16,19
1995-12-09,CHH,114,8,11,MIN,108,5,11,13,22
1995-12-09,PHX,92,8,9,MIA,94,11,5,19,14
1995-12-09,ATL,92,9,9,NYK,101,13,5,22,14
1995-12-10,SAC,110,12,5,MIA,90,12,5,24,10
1995-12-10,BOS,103,8,9,ATL,108,9,10,17,19
1995-12-10,LAL,87,10,9,DET,82,8,10,18,19
1995-12-10,POR,103,9,9,HOU,101,15,4,24,13
1995-12-10,IND,111,7,9,LAC,104,7,12,14,21
1995-12-10,NYK,118,14,5,SAN,112,11,5,25,10
1995-12-10,VAN,81,2,17,TOR,93,6,14,8,31
1995-12-11,UTH,110,13,6,CHH,100,9,11,22,17
1995-12-11,PHL,91,3,15,DEN,104,8,9,11,24
1995-12-12,CLE,97,8,11,LAC,86,7,13,15,24
1995-12-12,TOR,96,7,14,BOS,116,8,10,15,24
1995-12-12,PHX,100,8,10,CHH,115,9,12,17,22
1995-12-12,GOS,105,6,13,MIA,80,12,6,18,19
1995-12-12,ATL,78,10,10,MIN,85,5,12,15,22
1995-12-12,NYK,97,15,5,LAL,82,11,9,26,14
1995-12-12,SAC,93,13,5,HOU,133,15,5,28,10
1995-12-12,NJN,97,9,9,ORL,101,16,4,25,13
1995-12-12,DAL,112,6,12,SEA,101,13,6,19,18
1995-12-12,WAS,108,8,10,MIL,102,6,11,14,21
1995-12-12,IND,125,8,9,DEN,92,9,9,17,18
1995-12-13,BOS,111,9,10,PHL,100,3,16,12,26
1995-12-13,SAN,83,11,6,SEA,88,13,7,24,13
1995-12-13,DET,98,8,11,LAL,101,11,10,19,21
1995-12-13,VAN,89,2,18,HOU,100,16,5,18,23
1995-12-13,CHI,112,16,2,ORL,103,17,4,33,6
1995-12-14,POR,116,10,9,CHH,109,10,12,20,21
1995-12-14,ATL,108,10,11,CHI,127,17,2,27,13
1995-12-14,TOR,100,7,15,IND,102,9,9,16,24
1995-12-14,DAL,111,7,12,SAN,126,11,7,18,19
1995-12-14,NYK,94,16,5,DEN,103,9,10,25,15
1995-12-14,LAC,89,7,14,MIA,84,12,7,19,21
1995-12-15,VAN,104,2,19,POR,100,11,9,13,28
1995-12-15,SEA,108,14,7,GOS,101,7,13,21,20
1995-12-15,DET,105,8,12,NJN,98,9,10,17,22
1995-12-15,ORL,111,17,5,UTH,99,14,6,31,11
1995-12-15,HOU,110,17,5,SAC,114,13,6,30,11
1995-12-15,WAS,122,9,10,LAL,114,12,10,21,20
1995-12-15,BOS,122,10,10,TOR,103,7,16,17,26
1995-12-15,MIN,88,6,12,CLE,100,9,11,15,23
1995-12-15,IND,112,10,9,MIL,95,6,12,16,21
1995-12-16,MIA,74,12,8,UTH,83,14,7,26,15
1995-12-16,LAC,99,8,14,CHH,109,10,13,18,27
1995-12-16,CHI,108,18,2,LAL,88,12,11,30,13
1995-12-16,SAN,122,12,7,SAC,106,14,6,26,13
1995-12-16,VAN,85,3,19,GOS,116,7,14,10,33
1995-12-16,NYK,86,16,6,DET,82,9,12,25,18
1995-12-16,ATL,95,10,12,DEN,86,10,10,20,22
1995-12-16,DAL,108,7,13,PHX,111,8,11,15,24
1995-12-17,TOR,110,7,17,ORL,93,18,5,25,22
1995-12-17,MIN,99,6,13,PHL,101,3,17,9,30
1995-12-17,CLE,92,10,11,DEN,79,10,11,20,22
1995-12-17,MIL,84,6,13,IND,80,11,9,17,22
1995-12-17,POR,100,11,10,WAS,112,10,10,21,20
1995-12-18,SAC,92,14,7,VAN,85,3,20,17,27
1995-12-18,NJN,103,9,11,UTH,110,15,7,24,18
1995-12-18,BOS,114,11,10,CHI,123,19,2,30,12
1995-12-19,LAC,104,8,15,WAS,108,11,10,19,25
1995-12-19,MIL,105,7,13,LAL,109,12,12,19,25
1995-12-19,NYK,89,17,6,MIA,70,12,9,29,15
1995-12-19,CHI,114,20,2,DAL,101,7,14,27,16
1995-12-19,TOR,82,8,17,DET,94,9,13,17,30
1995-12-19,CLE,100,11,11,MIN,95,6,14,17,25
1995-12-19,HOU,103,17,6,PHX,96,9,11,26,17
1995-12-19,GOS,102,8,14,CHH,99,11,13,19,27
1995-12-19,VAN,94,3,21,SEA,93,15,7,18,28
1995-12-19,SAN,111,13,7,POR,103,11,11,24,18
1995-12-20,IND,109,11,10,LAL,98,13,12,24,22
1995-12-20,PHL,108,4,17,UTH,104,16,7,20,24
1995-12-20,DET,102,10,13,MIL,77,7,14,17,27
1995-12-20,ORL,107,18,6,MIN,100,6,15,24,21
1995-12-20,DEN,109,10,12,GOS,104,9,14,19,26
1995-12-20,PHX,106,9,12,WAS,104,12,10,21,22
1995-12-20,NJN,104,9,12,MIA,112,12,10,21,22
1995-12-21,SEA,92,15,8,VAN,68,4,21,19,29
1995-12-21,SAN,114,14,7,DEN,96,11,12,25,19
1995-12-21,CLE,87,12,11,UTH,89,16,8,28,19
1995-12-21,CHH,107,11,14,BOS,97,11,11,22,25
1995-12-21,LAC,103,8,16,SAC,96,15,7,23,23
1995-12-21,HOU,91,18,6,POR,86,11,12,29,18
1995-12-22,PHL,94,5,17,MIL,99,7,15,12,32
1995-12-22,CHI,113,21,2,TOR,104,8,18,29,20
1995-12-22,VAN,80,4,22,PHX,101,10,12,14,34
1995-12-22,IND,90,12,10,DAL,79,7,15,19,25
1995-12-22,GOS,132,9,15,WAS,117,12,11,21,26
1995-12-22,LAL,116,13,13,SAC,83,15,8,28,21
1995-12-22,BOS,114,11,12,MIN,113,6,16,17,28
1995-12-22,ORL,111,19,6,NYK,90,18,6,37,12
1995-12-22,MIA,75,13,10,DET,84,11,13,24,23
1995-12-22,ATL,94,11,12,NJN,91,9,13,20,25
1995-12-23,DEN,92,11,13,LAC,107,9,16,20,29
1995-12-23,MIN,111,6,17,DAL,98,7,16,13,33
1995-12-23,POR,99,11,13,LAL,102,14,13,25,26
1995-12-23,DET,79,12,13,ORL,94,20,6,32,19
1995-12-23,CHH,87,12,14,MIA,75,13,11,25,25
1995-12-23,PHL,85,5,18,NJN,98,9,14,14,32
1995-12-23,SEA,118,16,8,WAS,100,12,12,28,20
1995-12-23,CLE,97,12,12,IND,96,13,10,25,22
1995-12-23,CHI,100,22,2,UTH,86,17,8,39,10
1995-12-23,SAN,110,15,7,HOU,95,19,6,34,13
1995-12-23,MIL,115,8,15,ATL,111,12,12,20,27
1995-12-23,NYK,103,18,7,TOR,91,8,19,26,26
1995-12-25,ORL,92,21,6,HOU,90,19,7,40,13
1995-12-25,PHX,100,11,12,SAN,105,16,7,27,19
1995-12-26,SAC,115,15,9,SAN,98,17,7,32,16
1995-12-26,DET,100,12,14,GOS,90,10,15,22,29
1995-12-26,MIA,96,13,12,NJN,93,10,14,23,26
1995-12-26,UTH,114,17,9,POR,104,11,14,28,23
1995-12-26,ATL,94,12,13,LAC,88,10,16,22,29
1995-12-26,DEN,114,11,14,DAL,102,7,17,18,31
1995-12-26,LAL,102,15,13,BOS,91,12,12,27,25
1995-12-26,HOU,100,19,8,VAN,84,4,23,23,31
1995-12-26,IND,103,13,11,CHI,97,23,2,36,13
1995-12-26,TOR,93,8,20,MIL,87,9,15,17,35
1995-12-27,WAS,115,12,13,GOS,94,10,16,22,29
1995-12-27,SEA,99,17,8,DEN,83,12,14,29,22
1995-12-27,PHX,105,11,13,PHL,90,5,19,16,32
1995-12-27,MIN,93,7,17,MIL,99,9,16,16,33
1995-12-27,CHH,107,13,14,LAC,116,10,17,23,31
1995-12-27,POR,135,11,15,BOS,109,12,13,23,28
1995-12-28,UTH,99,18,9,MIN,83,7,18,25,27
1995-12-28,HOU,97,20,8,NJN,82,10,15,30,23
1995-12-28,DET,113,13,14,TOR,91,9,20,22,34
1995-12-28,LAL,99,16,13,SAN,107,17,8,33,21
1995-12-28,DAL,103,7,18,VAN,101,4,24,11,42
1995-12-28,IND,91,14,11,MIA,77,14,12,28,23
1995-12-28,NYK,76,19,7,CLE,86,13,12,32,19
1995-12-29,PHX,103,12,13,DEN,92,12,15,24,28
1995-12-29,ATL,96,13,13,GOS,117,10,17,23,30
1995-12-29,CHI,120,23,3,IND,93,15,11,38,14
1995-12-29,ORL,122,22,6,LAC,98,11,17,33,23
1995-12-29,CHH,102,13,15,POR,99,12,15,25,30
1995-12-29,WAS,127,13,13,NYK,120,19,8,32,21
1995-12-29,SAC,117,16,9,PHL,97,5,20,21,29
1995-12-29,SEA,124,18,8,BOS,85,12,14,30,22
1995-12-30,UTH,99,19,9,LAL,82,16,14,35,23
1995-12-30,SAN,122,18,8,MIN,84,7,19,25,27
1995-12-30,CLE,124,14,12,POR,121,12,16,26,28
1995-12-30,DEN,108,12,16,PHL,100,5,21,17,37
1995-12-30,PHX,112,13,13,SEA,123,19,8,32,21
1995-12-30,MIL,87,10,16,WAS,96,14,13,24,29
1995-12-30,NJN,110,10,16,GOS,120,11,17,21,33
1995-12-30,VAN,103,4,25,BOS,95,12,15,16,40
1995-12-30,DET,102,14,14,CHH,100,14,15,28,29
1995-12-30,MIA,105,14,13,LAC,96,11,18,25,31
1995-12-30,CHI,95,24,3,ATL,93,13,14,37,17
1995-12-30,DAL,102,8,18,HOU,105,21,8,29,26
1996-01-02,LAL,89,16,15,PHL,90,5,22,21,37
1996-01-02,MIN,100,7,20,HOU,105,22,8,29,28
1996-01-02,NYK,92,19,9,POR,101,12,17,31,26
1996-01-02,DAL,92,8,19,UTH,102,20,9,28,28
1996-01-02,WAS,100,15,13,CLE,108,15,12,30,25
1996-01-02,DEN,87,13,16,IND,102,15,12,28,28
1996-01-02,ATL,88,13,15,SEA,111,20,8,33,23
1996-01-02,NJN,81,10,17,MIL,72,10,17,20,34
1996-01-03,MIL,96,10,18,DET,82,15,14,25,32
1996-01-03,BOS,110,12,16,POR,114,13,17,25,33
1996-01-03,ORL,121,23,6,TOR,110,9,21,32,27
1996-01-03,CHI,100,25,3,HOU,86,23,8,48,11
1996-01-03,SAN,111,19,8,UTH,97,21,9,40,17
1996-01-03,LAC,94,11,19,IND,110,16,12,27,31
1996-01-03,GOS,122,12,17,PHL,111,6,22,18,39
1996-01-04,MIA,81,15,13,SEA,84,21,8,36,21
1996-01-04,CHH,93,14,16,CHI,117,26,3,40,19
1996-01-04,PHX,93,13,14,MIN,98,7,21,20,35
1996-01-04,SAC,126,17,9,DEN,96,13,17,30,26
1996-01-04,ATL,104,13,16,TOR,101,9,22,22,38
1996-01-04,WAS,112,15,14,DAL,100,8,20,23,34
1996-01-04,NYK,105,19,10,NJN,93,11,17,30,27
1996-01-05,VAN,103,5,25,PHL,102,6,23,11,48
1996-01-05,SAN,92,20,8,IND,105,17,12,37,20
1996-01-05,BOS,93,12,17,CLE,77,16,12,28,29
1996-01-05,LAC,94,11,20,PHX,88,13,15,24,35
1996-01-05,GOS,122,13,17,MIN,119,8,21,21,38
1996-01-05,NJN,107,11,18,DAL,99,8,21,19,39
1996-01-05,MIL,113,11,18,POR,96,14,17,25,35
1996-01-05,LAL,116,16,16,UTH,100,21,10,37,26
1996-01-05,ORL,115,24,6,SEA,93,22,8,46,14
1996-01-06,CHH,96,14,17,ATL,90,14,16,28,33
1996-01-06,CHI,113,27,3,MIL,84,12,18,39,21
1996-01-06,SAC,115,18,9,GOS,106,14,17,32,26
1996-01-06,HOU,99,23,9,IND,87,18,12,41,21
1996-01-06,CLE,105,16,13,ORL,94,25,6,41,19
1996-01-06,DEN,86,13,18,MIA,88,15,14,28,32
1996-01-06,DET,90,15,15,WAS,82,16,14,31,29
1996-01-07,POR,113,14,18,MIN,97,8,22,22,40
1996-01-07,LAL,93,17,16,DEN,96,13,19,30,35
1996-01-07,VAN,93,6,25,LAC,101,12,20,18,45
1996-01-07,BOS,96,13,17,DAL,117,8,22,21,39
1996-01-08,CLE,109,17,13,WAS,91,16,15,33,28
1996-01-08,UTH,94,21,11,MIA,92,16,14,37,25
1996-01-09,LAL,106,17,17,MIN,104,8,23,25,40
1996-01-09,TOR,91,9,23,CHH,92,15,17,24,40
1996-01-09,GOS,109,14,18,VAN,103,6,26,20,44
1996-01-09,MIL,92,12,19,SEA,97,22,9,34,28
1996-01-09,PHX,100,13,16,LAC,105,13,20,26,36
1996-01-09,DAL,84,9,22,IND,91,18,13,27,35
1996-01-09,ORL,92,25,7,NJN,84,12,18,37,25
1996-01-09,NYK,98,20,10,BOS,93,13,18,33,28
1996-01-09,HOU,82,24,9,SAN,88,20,9,44,18
1996-01-09,ATL,104,14,17,SAC,88,19,9,33,26
1996-01-10,PHL,93,6,24,WAS,98,16,16,22,40
1996-01-10,CHI,113,28,3,SEA,87,23,9,51,12
1996-01-10,NJN,92,12,19,NYK,79,21,10,33,29
1996-01-10,POR,90,15,18,MIA,89,16,15,31,33
1996-01-10,VAN,85,6,27,DEN,91,14,19,20,46
1996-01-10,SAN,92,21,9,CLE,86,18,13,39,22
1996-01-10,BOS,113,13,19,SAC,104,19,10,32,29
1996-01-11,IND,96,19,13,MIL,88,12,20,31,33
1996-01-11,CHH,93,16,17,DET,95,16,15,32,32
1996-01-11,TOR,79,9,24,ATL,87,15,17,24,41
1996-01-11,GOS,106,15,18,PHX,111,13,17,28,35
1996-01-11,LAC,109,14,20,MIN,89,8,24,22,44
1996-01-12,DEN,90,15,19,CLE,83,18,14,33,33
1996-01-12,SEA,113,23,10,MIA,81,16,16,39,26
1996-01-12,NJN,80,13,19,PHL,107,6,25,19,44
1996-01-12,WAS,117,17,16,SAC,88,19,11,36,27
1996-01-12,LAL,101,18,17,HOU,100,24,10,42,27
1996-01-12,VAN,95,6,28,GOS,104,15,19,21,47
1996-01-12,ORL,93,26,7,MIL,88,12,21,38,28
1996-01-12,PHX,130,14,17,DAL,140,9,23,23,40
1996-01-12,BOS,92,14,19,NYK,105,21,11,35,30
1996-01-12,UTH,94,22,11,SAN,101,22,9,44,20
1996-01-13,NYK,111,22,11,SAC,119,19,12,41,23
1996-01-13,IND,103,20,13,MIN,94,8,25,28,38
1996-01-13,NJN,80,13,20,DET,91,17,15,30,35
1996-01-13,ATL,108,16,17,BOS,105,14,20,30,37
1996-01-13,DEN,117,16,19,POR,118,16,18,32,37
1996-01-13,DAL,83,10,23,CHH,103,16,18,26,41
1996-01-13,PHL,93,7,25,CHI,120,29,3,36,28
1996-01-13,SAN,106,23,9,ORL,105,27,7,50,16
1996-01-13,LAC,104,15,20,HOU,115,24,11,39,31
1996-01-13,VAN,69,6,29,MIA,65,16,17,22,46
1996-01-13,TOR,106,9,25,WAS,100,18,16,27,41
1996-01-14,PHX,74,14,18,CLE,89,18,15,32,33
1996-01-15,DAL,119,10,24,ORL,104,27,8,37,32
1996-01-15,ATL,96,17,17,DET,88,18,15,35,32
1996-01-15,GOS,95,16,19,SEA,104,24,10,40,29
1996-01-15,NYK,92,22,12,MIL,98,12,22,34,34
1996-01-15,NJN,108,13,21,TOR,83,10,25,23,46
1996-01-15,MIN,103,8,26,SAC,94,20,12,28,38
1996-01-15,HOU,107,25,11,UTH,99,22,12,47,23
1996-01-15,WAS,109,18,17,CHI,116,30,3,48,20
1996-01-15,LAL,96,19,17,MIA,88,16,18,35,35
1996-01-16,POR,87,17,18,DEN,69,16,20,33,38
1996-01-16,CHI,116,31,3,PHL,104,7,26,38,29
1996-01-16,TOR,102,10,26,IND,110,21,13,31,39
1996-01-16,SAN,121,24,9,BOS,97,14,21,38,30
1996-01-16,SEA,99,25,10,CLE,90,19,15,44,25
1996-01-17,LAC,81,15,21,NYK,92,22,13,37,34
1996-01-17,CHH,93,17,18,NJN,97,14,21,31,39
1996-01-17,PHL,100,7,27,MIL,111,13,22,20,49
1996-01-17,MIA,96,16,19,WAS,89,18,18,34,37
1996-01-17,MIN,98,9,26,GOS,88,16,20,25,46
1996-01-17,PHX,95,14,19,ORL,113,27,9,41,28
1996-01-17,ATL,102,18,17,IND,93,22,13,40,30
1996-01-17,DEN,112,16,21,HOU,120,26,11,42,32
1996-01-18,MIL,100,14,22,GOS,96,16,21,30,43
1996-01-18,SAC,105,20,13,POR,100,18,18,38,31
1996-01-18,TOR,89,10,27,CHI,92,32,3,42,30
1996-01-18,VAN,90,7,29,CLE,98,19,16,26,45
1996-01-18,HOU,106,27,11,BOS,108,14,22,41,33
1996-01-18,DET,100,18,16,SAN,98,25,9,43,25
1996-01-19,WAS,93,18,19,NJN,87,15,21,33,40
1996-01-19,MIN,100,10,26,SAN,92,25,10,35,36
1996-01-19,PHL,77,7,28,ATL,82,19,17,26,45
1996-01-19,UTH,111,22,13,ORL,99,28,9,50,22
1996-01-19,POR,101,18,19,PHX,84,14,20,32,39
1996-01-19,LAC,100,15,22,LAL,106,20,17,35,39
1996-01-19,SEA,97,26,10,NYK,100,23,13,49,23
1996-01-19,DAL,129,11,24,BOS,124,15,22,26,46
1996-01-19,MIA,106,17,19,CHH,114,17,19,34,38
1996-01-19,IND,89,22,14,DET,81,19,16,41,30
1996-01-20,ATL,98,20,17,MIA,78,17,20,37,37
1996-01-20,VAN,84,7,30,NYK,80,24,13,31,43
1996-01-20,LAC,82,15,23,UTH,106,23,13,38,36
1996-01-20,NJN,103,15,22,MIN,97,11,26,26,48
1996-01-20,CHH,102,18,19,GOS,110,16,22,34,41
1996-01-20,LAL,82,21,17,CLE,93,20,16,41,33
1996-01-20,DEN,110,16,22,SAC,115,21,13,37,35
1996-01-21,TOR,97,10,28,BOS,95,15,23,25,51
1996-01-21,IND,106,23,14,WAS,96,19,19,42,33
1996-01-21,HOU,96,27,12,ORL,97,28,10,55,22
1996-01-21,PHL,88,7,29,SAN,118,25,11,32,40
1996-01-21,DET,96,19,17,CHI,111,33,3,52,20
1996-01-21,SEA,108,26,11,DAL,101,12,24,38,35
1996-01-21,POR,88,19,19,CLE,81,21,16,40,35
1996-01-21,PHX,111,14,21,SAC,97,22,13,36,34
1996-01-22,MIL,92,15,22,VAN,100,8,30,23,52
1996-01-22,ATL,105,21,17,HOU,96,27,13,48,30
1996-01-22,MIA,96,17,21,SAN,89,26,11,43,32
1996-01-23,TOR,86,11,28,NJN,79,16,22,27,50
1996-01-23,ORL,105,29,10,PHL,90,7,30,36,40
1996-01-23,NYK,79,24,14,CHI,99,34,3,58,17
1996-01-23,SAC,109,22,14,DAL,111,12,25,34,39
1996-01-23,IND,117,24,14,PHX,102,15,21,39,35
1996-01-23,UTH,96,24,13,POR,72,20,19,44,32
1996-01-23,CLE,72,21,17,ATL,84,22,17,43,34
1996-01-24,GOS,89,17,22,UTH,100,25,13,42,35
1996-01-24,MIA,79,18,21,NYK,88,24,15,42,36
1996-01-24,MIL,89,15,23,IND,97,25,14,40,37
1996-01-24,SEA,86,27,11,DEN,79,16,23,43,34
1996-01-24,CHI,104,35,3,VAN,84,9,30,44,33
1996-01-24,SAN,84,26,12,DET,85,19,18,45,30
1996-01-24,MIN,91,11,27,PHX,101,15,22,26,49
1996-01-24,NJN,89,16,23,HOU,98,27,14,43,37
1996-01-24,CHH,127,18,20,WAS,113,19,20,37,40
1996-01-24,PHL,88,7,31,CLE,91,21,18,28,49
1996-01-24,BOS,107,15,24,LAL,124,21,18,36,42
1996-01-25,DAL,92,13,25,DET,93,20,18,33,43
1996-01-25,WAS,120,19,21,HOU,85,28,14,47,35
1996-01-25,LAC,94,15,24,DEN,93,16,24,31,48
1996-01-25,TOR,101,12,28,VAN,106,9,31,21,59
1996-01-26,SEA,94,28,11,UTH,93,26,13,54,24
1996-01-26,CHI,102,36,3,MIA,80,18,22,54,25
1996-01-26,ATL,96,23,17,ORL,84,30,10,53,27
1996-01-26,NJN,115,16,24,CHH,107,19,20,35,44
1996-01-26,BOS,90,15,25,IND,107,26,14,41,39
1996-01-26,MIL,97,15,24,PHX,107,16,22,31,46
1996-01-26,PHL,88,7,32,LAL,100,22,18,29,50
1996-01-26,SAN,87,26,13,POR,83,20,20,46,33
1996-01-26,GOS,124,17,23,SAC,118,22,15,39,38
1996-01-27,DAL,103,13,26,POR,112,20,21,33,47
1996-01-27,DEN,93,16,25,TOR,82,12,29,28,54
1996-01-27,NJN,98,17,24,LAL,100,23,18,40,42
1996-01-27,UTH,108,26,14,GOS,91,18,23,44,37
1996-01-27,WAS,102,20,21,VAN,77,10,31,30,52
1996-01-27,HOU,105,28,15,DET,85,21,18,49,33
1996-01-27,CHH,110,19,21,PHL,105,7,33,26,54
1996-01-27,IND,102,27,14,ORL,79,30,11,57,25
1996-01-27,LAC,87,16,24,SEA,96,29,11,45,35
1996-01-27,NYK,104,25,15,MIN,95,11,28,36,43
1996-01-27,CLE,85,22,18,MIA,102,18,23,40,41
1996-01-28,CHI,93,37,3,PHX,82,17,22,54,25
1996-01-29,NYK,94,26,15,MIA,85,19,23,45,38
1996-01-29,CHH,88,20,21,CLE,86,22,19,42,40
1996-01-29,UTH,106,27,14,DET,97,21,19,48,33
1996-01-29,POR,88,21,21,SEA,92,30,11,51,32
1996-01-29,PHL,103,7,34,VAN,92,10,32,17,66
1996-01-30,MIN,86,11,29,DEN,88,17,25,28,54
1996-01-30,SAC,102,22,16,TOR,75,12,30,34,46
1996-01-30,IND,107,28,14,ATL,90,24,17,52,31
1996-01-30,MIA,99,19,24,PHX,114,17,23,36,47
1996-01-30,SEA,97,31,11,NJN,88,17,25,48,36
1996-01-30,ORL,104,30,12,BOS,99,15,26,45,38
1996-01-30,LAL,128,24,18,GOS,118,18,24,42,42
1996-01-30,HOU,87,29,15,CHI,98,38,3,67,18
1996-01-30,DAL,105,13,27,LAC,101,16,25,29,52
1996-01-31,SAN,115,27,13,LAC,106,16,26,43,39
1996-01-31,CLE,81,22,20,MIL,71,15,25,37,45
1996-01-31,ATL,84,24,18,PHX,120,18,23,42,41
1996-01-31,POR,94,21,22,UTH,98,28,14,49,36
1996-01-31,BOS,131,15,27,VAN,98,10,33,25,60
1996-02-01,DET,87,21,20,IND,70,29,14,50,34
1996-02-01,MIA,124,19,25,PHL,104,8,34,27,59
1996-02-01,CHH,111,21,21,HOU,116,29,16,50,37
1996-02-01,DAL,103,14,27,SEA,100,32,11,46,38
1996-02-01,NYK,110,27,15,ORL,102,31,12,58,27
1996-02-01,SAC,85,23,16,CHI,105,39,3,62,19
1996-02-01,MIL,108,15,26,DEN,102,18,25,33,51
1996-02-02,VAN,84,10,34,NJN,93,17,26,27,60
1996-02-02,ORL,108,31,13,ATL,95,24,19,55,32
1996-02-02,UTH,122,29,14,LAC,113,16,27,45,41
1996-02-02,IND,116,29,15,BOS,108,16,27,45,42
1996-02-02,WAS,113,21,21,POR,97,21,23,42,44
1996-02-02,CLE,107,23,20,PHX,85,19,23,42,43
1996-02-02,SAN,101,28,13,MIN,90,11,30,39,43
1996-02-02,LAL,84,25,18,CHI,99,40,3,65,21
1996-02-02,GOS,114,18,25,TOR,111,12,31,30,56
1996-02-03,LAC,113,16,28,TOR,119,12,32,28,60
1996-02-03,DET,85,22,20,SAC,94,23,17,45,37
1996-02-03,MIL,88,16,26,CLE,111,24,20,40,46
1996-02-03,PHL,85,8,35,POR,96,21,24,29,59
1996-02-03,MIA,99,20,25,BOS,100,16,28,36,53
1996-02-03,DAL,96,15,27,MIN,105,11,31,26,58
1996-02-03,HOU,103,30,16,SEA,104,32,12,62,28
1996-02-04,DEN,105,18,26,CHI,99,41,3,59,29
1996-02-04,IND,90,30,15,NYK,83,28,15,58,30
1996-02-04,ATL,106,24,20,CHH,104,21,22,45,42
1996-02-04,GOS,96,19,25,NJN,92,18,26,37,51
1996-02-04,WAS,115,22,21,PHX,123,19,24,41,45
1996-02-04,ORL,122,32,13,SAN,109,29,13,61,26
1996-02-04,LAL,110,25,19,UTH,103,30,14,55,33
1996-02-05,NYK,97,28,16,DET,91,22,21,50,37
1996-02-05,LAC,124,16,29,GOS,128,20,25,36,54
1996-02-05,MIN,104,12,31,DAL,92,15,28,27,59
1996-02-05,MIA,103,20,26,SAC,92,24,17,44,43
1996-02-05,VAN,83,10,35,UTH,92,30,15,40,50
1996-02-05,TOR,87,13,32,POR,90,22,24,35,56
1996-02-06,MIL,114,16,27,DAL,111,15,29,31,56
1996-02-06,CHH,102,21,23,SAN,109,29,14,50,37
1996-02-06,ORL,112,33,13,SAC,102,24,18,57,31
1996-02-06,SEA,99,33,12,HOU,94,30,17,63,29
1996-02-06,DEN,78,19,26,LAL,99,26,19,45,45
1996-02-06,PHX,106,20,24,CHI,96,41,4,61,28
1996-02-06,CLE,91,25,20,BOS,73,17,28,42,48
1996-02-07,MIA,101,21,26,ATL,89,25,20,46,46
1996-02-07,BOS,89,17,29,SAN,99,30,14,47,43
1996-02-07,DET,97,22,22,ORL,83,34,13,56,35
1996-02-07,TOR,88,13,33,MIL,93,17,27,30,60
1996-02-07,NYK,87,29,16,WAS,82,22,22,51,38
1996-02-07,LAL,106,27,19,NJN,96,18,27,45,46
1996-02-07,PHL,102,8,36,IND,101,31,15,39,51
1996-02-07,UTH,102,31,15,VAN,79,10,36,41,51
1996-02-07,GOS,95,21,25,CHI,99,41,5,62,30
1996-02-07,MIN,93,13,31,POR,103,23,24,36,55
1996-02-07,LAC,102,16,30,HOU,110,30,18,46,48
1996-02-08,DEN,115,19,27,LAC,95,16,31,35,58
1996-02-08,ATL,98,25,21,WAS,92,22,23,47,44
1996-02-08,CHH,115,21,24,SAC,105,24,19,45,43
1996-02-08,DAL,136,15,30,UTH,133,32,15,47,45
1996-02-08,PHX,107,21,24,NJN,102,18,28,39,52
1996-02-13,ORL,121,34,14,DEN,93,20,27,54,41
1996-02-13,POR,98,24,24,GOS,99,21,26,45,50
1996-02-13,MIA,87,22,26,TOR,98,13,34,35,60
1996-02-13,IND,92,31,16,NJN,101,18,29,49,45
1996-02-13,MIL,101,18,27,PHL,104,9,36,27,63
1996-02-13,SAN,111,31,14,UTH,114,32,16,63,30
1996-02-13,CLE,110,26,20,CHH,100,22,24,48,44
1996-02-13,SAC,90,24,20,MIN,94,13,32,37,52
1996-02-13,CHI,111,42,5,WAS,98,22,24,64,29
1996-02-13,HOU,121,31,18,DAL,106,16,30,47,48
1996-02-13,PHX,98,22,24,SEA,102,34,12,56,36
1996-02-13,LAC,94,16,32,BOS,108,17,30,33,62
1996-02-14,PHL,83,10,36,DET,102,23,22,33,58
1996-02-14,LAL,87,28,19,ATL,86,26,21,54,40
1996-02-14,VAN,93,10,37,SAC,86,24,21,34,58
1996-02-14,NJN,88,19,29,IND,87,31,17,50,46
1996-02-14,SEA,130,35,12,MIN,93,14,32,49,44
1996-02-14,CHH,120,22,25,NYK,100,30,16,52,41
1996-02-14,GOS,106,22,26,BOS,103,18,30,40,56
1996-02-15,POR,84,24,25,PHX,96,22,25,46,50
1996-02-15,MIA,97,22,27,DEN,91,20,28,42,55
1996-02-15,UTH,106,33,16,DAL,103,16,31,49,47
1996-02-15,HOU,112,32,18,SAN,108,31,15,63,33
1996-02-15,DET,109,24,22,CHI,112,43,5,67,27
1996-02-15,MIL,109,18,28,WAS,98,22,25,40,53
1996-02-15,TOR,76,14,34,CLE,95,27,20,41,54
1996-02-16,VAN,100,11,37,ATL,110,26,22,37,59
1996-02-16,SAC,102,24,22,BOS,130,18,31,42,53
1996-02-16,ORL,121,35,14,MIL,91,19,28,54,42
1996-02-16,LAL,119,29,19,DAL,114,16,32,45,51
1996-02-16,SAN,113,31,16,GOS,95,23,26,54,42
1996-02-16,MIN,100,14,33,CHI,103,44,5,58,38
1996-02-16,WAS,94,22,26,IND,95,31,18,53,44
1996-02-16,NYK,116,30,17,PHL,84,10,37,40,54
1996-02-16,CHH,107,23,25,DEN,100,20,29,43,54
1996-02-16,SEA,117,36,12,PHX,99,23,25,59,37
1996-02-17,CLE,97,28,20,PHL,82,10,38,38,58
1996-02-17,MIA,93,23,27,ORL,95,36,14,59,41
1996-02-17,DET,108,24,23,TOR,95,14,35,38,58
1996-02-17,NJN,82,20,29,NYK,77,31,17,51,46
1996-02-17,LAC,100,16,33,POR,96,24,26,40,59
1996-02-18,POR,90,24,27,ATL,93,27,22,51,49
1996-02-18,MIN,96,14,34,WAS,108,22,27,36,61
1996-02-18,VAN,109,11,38,SEA,118,37,12,48,50
1996-02-18,IND,102,32,18,CHI,110,45,5,77,23
1996-02-18,SAN,93,32,16,HOU,79,33,18,65,34
1996-02-18,CHH,122,24,25,MIL,99,19,29,43,54
1996-02-18,DEN,117,20,30,BOS,93,19,31,39,61
1996-02-19,DET,113,25,23,MIN,83,14,35,39,58
1996-02-19,PHX,98,23,26,VAN,94,11,39,34,65
1996-02-19,HOU,118,33,19,SAC,111,24,23,57,42
1996-02-19,WAS,81,23,27,NJN,99,21,29,44,56
1996-02-19,DAL,100,16,33,GOS,112,23,27,39,60
1996-02-19,CLE,73,29,20,MIA,70,23,28,52,48
1996-02-19,SEA,102,38,12,ATL,94,28,22,66,34
1996-02-20,POR,105,24,28,SAN,108,33,16,57,44
1996-02-20,UTH,112,34,16,BOS,98,19,32,53,48
1996-02-20,LAL,121,30,19,LAC,104,17,33,47,52
1996-02-20,CHI,102,46,5,CLE,76,30,20,76,25
1996-02-20,NYK,87,31,18,MIL,92,19,30,50,48
1996-02-20,ORL,123,37,14,PHL,104,10,39,47,53
1996-02-21,CHH,96,25,25,WAS,92,23,28,48,53
1996-02-21,LAC,108,17,34,LAL,112,31,19,48,53
1996-02-21,PHL,57,10,40,MIA,66,23,29,33,69
1996-02-21,MIN,120,14,36,HOU,101,34,19,48,55
1996-02-21,DAL,93,16,34,SAC,91,24,24,40,58
1996-02-21,IND,97,32,19,ORL,99,38,14,70,33
1996-02-21,GOS,95,24,27,SAN,92,34,16,58,43
1996-02-21,DET,110,26,23,NYK,113,31,19,57,42
1996-02-21,MIL,92,20,30,NJN,94,22,29,42,59
1996-02-21,PHX,120,24,26,BOS,107,19,33,43,59
1996-02-22,POR,107,24,29,DEN,78,21,30,45,59
1996-02-22,UTH,102,35,16,TOR,86,14,36,49,52
1996-02-22,ATL,91,28,23,CHI,96,47,5,75,28
1996-02-22,CLE,80,30,21,HOU,86,34,20,64,41
1996-02-22,SEA,106,39,12,GOS,90,25,27,64,39
1996-02-23,IND,102,32,20,PHL,95,10,41,42,61
1996-02-23,MIA,113,24,29,CHI,104,48,5,72,34
1996-02-23,WAS,94,23,29,CHH,100,26,25,49,54
1996-02-23,SAC,105,24,25,SAN,112,34,17,58,42
1996-02-23,PHX,110,25,26,TOR,105,14,37,39,63
1996-02-23,NYK,97,32,19,ATL,108,28,24,60,43
1996-02-23,DAL,88,17,34,LAL,114,32,19,49,53
1996-02-23,MIL,102,20,31,ORL,115,39,14,59,45
1996-02-23,MIN,94,15,36,DET,93,26,24,41,60
1996-02-24,HOU,96,35,20,LAL,94,33,19,68,39
1996-02-24,DEN,99,21,31,UTH,90,36,16,57,47
1996-02-24,SEA,104,40,12,SAC,91,24,26,64,38
1996-02-24,GOS,86,25,28,LAC,80,17,35,42,63
1996-02-24,CLE,103,30,22,NJN,74,23,29,53,51
1996-02-24,CHH,90,27,25,IND,104,33,20,60,45
1996-02-25,MIA,108,25,29,PHL,101,10,42,35,71
1996-02-25,DAL,105,17,35,TOR,98,14,38,31,73
1996-02-25,POR,81,25,29,DET,93,26,25,51,54
1996-02-25,VAN,84,11,40,SAN,95,35,17,46,57
1996-02-25,LAC,101,17,36,SEA,106,41,12,58,48
1996-02-25,MIN,76,16,36,ATL,92,29,24,45,60
1996-02-25,PHX,113,26,26,NYK,105,32,20,58,46
1996-02-25,WAS,111,23,30,MIL,103,20,32,43,62
1996-02-25,CHI,111,48,6,ORL,91,40,14,88,20
1996-02-25,NJN,111,23,30,BOS,105,19,34,42,64
1996-02-26,LAL,114,33,20,NYK,96,32,21,65,41
1996-02-26,BOS,119,19,35,IND,122,34,20,53,55
1996-02-26,UTH,110,36,17,PHX,87,27,26,63,43
1996-02-26,SAC,78,24,27,DET,93,27,25,51,52
1996-02-27,IND,101,35,20,POR,87,25,30,60,50
1996-02-27,NJN,90,24,30,MIA,93,26,29,50,59
1996-02-27,DAL,115,18,35,PHL,121,10,43,28,78
1996-02-27,LAC,95,17,37,SAN,90,36,17,53,54
1996-02-27,MIL,84,20,33,CHH,88,27,26,47,59
1996-02-27,CLE,92,31,22,GOS,80,26,28,57,50
1996-02-27,HOU,105,36,20,TOR,100,14,39,50,59
1996-02-27,DEN,96,22,31,WAS,92,24,30,46,61
1996-02-27,CHI,120,49,6,MIN,99,16,37,65,43
1996-02-28,BOS,121,19,36,CHH,116,28,26,47,62
1996-02-28,MIN,93,16,38,PHX,117,27,27,43,65
1996-02-28,ATL,90,30,24,POR,88,25,31,55,55
1996-02-28,VAN,80,11,41,LAL,99,34,20,45,61
1996-02-28,UTH,115,37,17,WAS,93,24,31,61,48
1996-02-28,ORL,116,40,15,MIA,112,27,29,67,44
1996-02-28,SAC,90,24,28,NYK,85,32,22,56,50
1996-02-28,SEA,94,42,12,DET,80,28,25,70,37
1996-02-29,LAC,122,18,37,SAC,110,25,28,43,65
1996-02-29,DEN,120,23,31,DAL,137,18,36,41,67
1996-02-29,IND,94,36,20,GOS,85,26,29,62,49
1996-02-29,HOU,109,37,20,PHL,95,11,43,48,63
1996-02-29,MIL,86,20,34,CLE,95,32,22,52,56
1996-02-29,SAN,120,36,18,TOR,95,14,40,50,58
1996-02-29,NJN,98,24,31,ORL,114,41,15,65,46
1996-03-01,MIA,88,27,30,POR,102,25,32,52,62
1996-03-01,CHI,110,50,6,GOS,87,26,30,76,36
1996-03-01,UTH,99,38,17,NYK,88,32,23,70,40
1996-03-01,PHX,97,28,27,DET,102,28,26,56,53
1996-03-01,MIN,105,16,39,CHH,101,28,27,44,66
1996-03-01,LAL,100,35,20,WAS,95,24,32,59,52
1996-03-01,BOS,96,20,36,SEA,106,43,12,63,48
1996-03-01,VAN,111,11,42,DAL,119,19,36,30,78
1996-03-01,ATL,74,31,24,CLE,68,33,22,64,46
1996-03-02,NJN,92,24,32,SEA,103,44,12,68,44
1996-03-02,DEN,108,23,32,VAN,82,11,43,34,75
1996-03-02,LAC,103,19,37,DET,107,29,26,48,63
1996-03-02,MIL,110,20,35,ATL,106,32,24,52,59
1996-03-02,ORL,115,42,15,POR,89,26,32,68,47
1996-03-02,SAN,115,37,18,PHL,101,11,44,48,62
1996-03-02,CHI,107,51,6,BOS,75,20,37,71,43
1996-03-03,MIN,89,17,39,MIA,87,27,31,44,70
1996-03-03,CLE,89,33,23,TOR,100,14,41,47,64
1996-03-03,LAL,107,36,20,HOU,111,38,20,74,40
1996-03-03,IND,103,37,20,CHH,100,28,28,65,48
1996-03-03,SAC,99,25,29,WAS,108,24,33,49,62
1996-03-03,NYK,109,32,24,GOS,94,26,31,58,55
1996-03-03,DAL,114,20,36,PHX,121,28,28,48,64
1996-03-04,PHL,97,11,45,ORL,110,43,15,54,60
1996-03-04,VAN,81,11,44,WAS,96,25,33,36,77
1996-03-04,DET,99,30,26,ATL,93,32,25,62,51
1996-03-04,DEN,90,24,32,SAN,101,38,18,62,50
1996-03-04,BOS,105,20,38,MIL,98,21,35,41,73
1996-03-05,SAC,97,25,30,UTH,112,39,17,64,47
1996-03-05,TOR,84,15,41,DET,105,31,26,46,67
1996-03-05,CHH,97,28,29,ORL,123,44,15,72,44
1996-03-05,POR,93,26,33,HOU,100,39,20,65,53
1996-03-05,CLE,101,33,24,SEA,107,45,12,78,36
1996-03-05,CHI,115,52,6,MIL,106,21,36,73,42
1996-03-05,MIA,113,27,32,MIN,72,18,39,45,71
1996-03-05,GOS,110,26,32,VAN,78,11,45,37,77
1996-03-05,NYK,88,33,24,LAC,105,19,38,52,62
1996-03-05,PHX,108,29,28,IND,95,38,20,67,48
1996-03-05,DAL,127,20,37,NJN,117,24,33,44,70
1996-03-06,WAS,99,26,33,SEA,88,46,12,72,45
1996-03-06,PHL,90,11,46,MIN,103,18,40,29,86
1996-03-06,UTH,101,40,17,IND,94,38,21,78,38
1996-03-06,TOR,82,15,42,NYK,89,33,25,48,67
1996-03-06,BOS,110,21,38,LAC,97,20,38,41,76
1996-03-06,SAN,100,39,18,DEN,90,24,33,63,51
1996-03-07,CHH,119,28,30,DAL,105,21,37,49,67
1996-03-07,GOS,95,27,32,HOU,86,40,20,67,52
1996-03-07,DEN,103,24,34,PHX,92,30,28,54,62
1996-03-07,SAC,89,25,31,LAL,102,36,21,61,52
1996-03-07,CLE,72,33,25,ATL,83,32,26,65,51
1996-03-07,CHI,102,53,6,DET,81,32,26,85,32
1996-03-08,VAN,80,11,46,IND,94,38,22,49,68
1996-03-08,PHL,100,11,47,NYK,92,34,25,45,72
1996-03-08,MIN,112,19,40,SEA,132,46,13,65,53
1996-03-08,UTH,109,41,17,HOU,89,40,21,81,38
1996-03-08,SAN,115,40,18,NJN,100,24,34,64,52
1996-03-08,POR,117,26,34,SAC,105,25,32,51,66
1996-03-08,WAS,89,27,33,LAC,92,20,39,47,72
1996-03-08,MIA,109,28,32,TOR,79,15,43,43,75
1996-03-08,ORL,117,45,15,CHH,112,29,30,74,45
1996-03-08,BOS,91,22,38,CLE,96,33,26,55,64
1996-03-08,PHX,97,30,29,LAL,119,37,21,67,50
1996-03-08,ATL,94,33,26,MIL,91,21,37,54,63
1996-03-09,DET,92,32,27,DAL,91,21,38,53,65
1996-03-09,DEN,102,25,34,GOS,88,28,32,53,66
1996-03-10,MIL,103,21,38,BOS,110,22,39,43,77
1996-03-10,ORL,122,46,15,PHX,106,30,30,76,45
1996-03-10,VAN,89,11,47,HOU,95,40,22,51,69
1996-03-10,PHL,102,12,47,LAC,104,21,39,33,86
1996-03-10,POR,113,27,34,IND,108,39,22,66,56
1996-03-10,DEN,88,26,34,NJN,99,24,35,50,69
1996-03-10,WAS,99,27,34,ATL,91,34,26,61,60
1996-03-10,SEA,105,47,13,SAN,106,41,18,88,31
1996-03-10,NYK,104,34,26,CHI,72,54,6,88,32
1996-03-10,TOR,128,15,44,DAL,112,21,39,36,83
1996-03-10,MIA,88,29,32,CLE,81,34,26,63,58
1996-03-10,MIN,96,19,41,UTH,104,42,17,61,58
1996-03-10,GOS,95,28,33,SAC,96,25,33,53,66
1996-03-11,SAC,92,26,33,VAN,88,11,48,37,81
1996-03-11,DET,100,33,27,LAC,90,22,39,55,66
1996-03-12,ATL,115,34,27,UTH,89,43,17,77,44
1996-03-12,LAL,99,38,21,POR,105,28,34,66,55
1996-03-12,GOS,98,28,34,SAN,106,42,18,70,52
1996-03-12,PHL,118,12,48,TOR,110,16,44,28,92
1996-03-12,DEN,110,26,35,ORL,93,47,15,73,50
1996-03-12,NJN,88,25,35,PHX,98,30,31,55,66
1996-03-12,DAL,118,21,40,MIA,125,30,32,51,72
1996-03-13,CHH,91,29,31,UTH,85,43,18,72,49
1996-03-13,BOS,110,23,39,PHL,100,13,48,36,87
1996-03-13,SEA,100,47,14,ORL,99,47,16,94,30
1996-03-13,CHI,103,54,7,WAS,86,28,34,82,41
1996-03-13,MIN,82,19,42,NYK,106,35,26,54,68
1996-03-13,SAC,104,27,33,MIL,95,21,39,48,72
1996-03-13,DET,118,34,27,PHX,115,31,31,65,58
1996-03-14,NJN,92,25,36,WAS,100,28,35,53,71
1996-03-14,LAC,110,22,40,DAL,106,21,41,43,81
1996-03-14,CLE,98,34,27,BOS,73,24,39,58,66
1996-03-14,GOS,103,28,35,LAL,106,38,22,66,57
1996-03-14,SAN,120,43,18,MIA,100,31,32,74,50
1996-03-14,HOU,114,41,22,ATL,106,35,27,76,49
1996-03-15,DET,80,35,27,CLE,69,35,27,70,54
1996-03-15,VAN,87,11,49,ORL,92,47,17,58,66
1996-03-15,CHH,113,30,31,TOR,101,16,45,46,76
1996-03-15,PHL,102,13,49,PHX,128,31,32,44,81
1996-03-15,LAL,117,39,22,MIL,95,21,40,60,62
1996-03-15,SEA,120,48,14,DAL,97,21,42,69,56
1996-03-15,MIN,113,19,43,SAC,87,28,33,47,76
1996-03-15,IND,86,39,23,UTH,95,43,19,82,42
1996-03-15,POR,86,29,34,LAC,79,23,40,52,74
1996-03-15,CHI,108,55,7,DEN,87,27,35,82,42
1996-03-16,GOS,99,28,36,MIL,94,21,41,49,77
1996-03-16,SAN,119,44,18,ATL,92,35,28,79,46
1996-03-16,WAS,120,29,35,UTH,115,44,19,73,54
1996-03-16,NYK,94,36,26,PHL,88,13,50,49,76
1996-03-16,HOU,97,42,22,MIA,121,31,33,73,55
1996-03-16,NJN,93,25,37,CHI,97,56,7,81,44
1996-03-17,POR,112,30,34,DAL,86,21,43,51,77
1996-03-17,CLE,115,35,28,SAC,84,28,34,63,62
1996-03-17,BOS,107,24,40,NJN,106,25,38,49,78
1996-03-17,CHH,103,31,31,PHX,102,32,32,63,63
1996-03-17,MIN,90,20,43,VAN,85,11,50,31,93
1996-03-17,DET,91,36,27,DEN,81,27,36,63,63
1996-03-17,LAL,97,40,22,ORL,98,48,17,88,39
1996-03-17,IND,105,39,24,TOR,96,16,46,55,70
1996-03-18,TOR,114,16,47,DEN,122,27,37,43,84
1996-03-18,PHL,94,13,51,CHI,98,57,7,70,58
1996-03-18,MIL,90,21,42,UTH,107,44,20,65,62
1996-03-18,SEA,104,49,14,LAC,101,23,41,72,55
1996-03-18,SAN,104,45,18,GOS,98,29,36,74,54
1996-03-19,ORL,113,49,17,DET,91,37,27,86,44
1996-03-19,CHH,102,32,31,IND,94,40,24,72,55
1996-03-19,LAL,94,40,23,SEA,71,50,14,90,37
1996-03-19,NJN,82,25,39,VAN,77,11,51,36,90
1996-03-19,CHI,89,58,7,SAC,67,28,35,86,42
1996-03-19,POR,106,31,34,MIN,78,21,43,52,77
1996-03-19,DAL,72,21,44,CLE,81,36,28,57,72
1996-03-19,HOU,102,42,23,GOS,105,29,37,71,60
1996-03-20,MIA,102,32,33,DET,93,37,28,69,61
1996-03-20,WAS,101,30,35,SAN,112,46,18,76,53
1996-03-20,TOR,107,16,48,CHH,89,33,31,49,79
1996-03-20,ATL,98,35,29,VAN,93,11,52,46,81
1996-03-20,MIL,97,21,43,SAC,122,28,36,49,79
1996-03-20,NYK,102,37,26,IND,99,40,25,77,51
1996-03-20,UTH,107,45,20,PHL,84,13,52,58,72
1996-03-20,LAC,110,23,42,MIN,96,21,44,44,86
1996-03-20,BOS,90,25,40,ORL,112,50,17,75,57
1996-03-21,PHX,104,32,33,GOS,96,30,37,62,70
1996-03-21,NJN,97,26,39,DEN,89,28,37,54,76
1996-03-21,CHI,107,59,7,NYK,86,38,26,97,33
1996-03-21,HOU,85,42,24,CLE,98,37,28,79,52
1996-03-21,SEA,104,50,15,LAL,93,41,23,91,38
1996-03-22,WAS,108,30,36,ORL,111,51,17,81,53
1996-03-22,MIL,106,21,44,MIA,122,33,33,54,77
1996-03-22,BOS,99,25,41,DEN,98,28,38,53,79
1996-03-22,CHH,92,33,32,ATL,117,36,29,69,61
1996-03-22,TOR,108,17,48,SAN,120,47,18,64,66
1996-03-22,IND,111,40,26,VAN,94,11,53,51,79
1996-03-22,LAC,107,24,42,PHL,93,13,53,37,95
1996-03-22,DAL,84,21,45,MIN,110,21,45,42,90
1996-03-22,DET,111,37,29,NJN,96,27,39,64,68
1996-03-22,UTH,88,46,20,CLE,75,38,28,84,48
1996-03-22,SAC,80,29,36,POR,78,32,34,61,70
1996-03-23,ATL,92,37,29,DET,84,38,29,75,58
1996-03-23,HOU,103,42,25,MIN,108,22,45,64,70
1996-03-23,GOS,98,30,38,PHX,89,33,33,63,71
1996-03-23,SEA,129,51,15,PHL,89,13,54,64,69
1996-03-24,MIL,80,21,45,NJN,84,27,40,48,85
1996-03-24,CLE,90,38,29,VAN,85,11,54,49,83
1996-03-24,SAC,110,30,36,SEA,112,52,15,82,51
1996-03-24,PHX,103,33,34,LAC,92,25,42,58,76
1996-03-24,IND,88,41,26,SAN,100,48,18,89,44
1996-03-24,WAS,92,30,37,DEN,90,28,39,58,76
1996-03-24,TOR,109,17,49,CHI,108,60,7,77,56
1996-03-24,DAL,79,21,46,NYK,85,38,27,59,73
1996-03-24,LAL,94,41,24,CHH,103,33,33,74,57
1996-03-24,BOS,95,26,41,MIA,111,34,33,60,74
1996-03-25,POR,94,32,35,PHL,71,13,55,45,90
1996-03-25,NJN,88,28,40,SAN,95,49,18,77,58
1996-03-25,UTH,103,47,20,DAL,86,21,47,68,67
1996-03-26,PHX,102,34,34,SAC,98,30,37,64,71
1996-03-26,IND,103,41,27,BOS,96,26,42,67,69
1996-03-26,TOR,111,18,49,ATL,114,38,29,56,78
1996-03-26,HOU,74,42,26,NYK,83,39,27,81,53
1996-03-26,LAC,103,25,43,MIL,97,21,46,46,89
1996-03-26,GOS,102,31,38,SEA,114,53,15,84,53
1996-03-26,ORL,91,52,17,LAL,113,41,25,93,42
1996-03-26,DET,86,38,30,VAN,75,11,55,49,85
1996-03-26,DEN,112,28,40,CHH,119,34,33,62,73
1996-03-26,CLE,89,39,29,WAS,96,31,37,70,66
1996-03-27,PHL,103,13,56,TOR,94,18,50,31,106
1996-03-27,UTH,98,48,20,MIL,82,21,47,69,67
1996-03-27,SEA,132,54,15,CHH,95,35,33,89,48
1996-03-27,MIA,95,35,33,LAL,106,42,25,77,58
1996-03-27,MIN,116,23,45,BOS,121,26,43,49,88
1996-03-27,SAN,90,50,18,NYK,84,40,27,90,45
1996-03-27,WAS,93,32,37,IND,99,42,27,74,64
1996-03-27,DAL,117,21,48,HOU,114,42,27,63,75
1996-03-28,VAN,88,11,56,DEN,92,28,41,39,97
1996-03-28,CHI,111,60,8,ATL,80,39,29,99,37
1996-03-28,POR,94,33,35,GOS,89,31,39,64,74
1996-03-28,LAC,81,26,43,CLE,83,39,30,65,73
1996-03-29,UTH,105,49,20,VAN,91,11,57,60,77
1996-03-29,SAC,107,30,38,CHH,101,35,34,65,72
1996-03-29,NYK,94,40,28,NJN,78,28,41,68,69
1996-03-29,MIN,93,23,46,IND,91,43,27,66,73
1996-03-29,PHL,95,14,56,BOS,101,27,43,41,99
1996-03-29,ATL,89,39,30,LAL,102,43,25,82,55
1996-03-29,MIA,112,35,34,WAS,93,32,38,67,72
1996-03-29,PHX,108,35,34,MIL,85,21,48,56,82
1996-03-29,TOR,86,18,51,ORL,126,52,18,70,69
1996-03-29,DAL,104,22,48,SAN,119,51,18,73,66
1996-03-30,WAS,107,32,39,PHL,105,14,57,46,96
1996-03-30,HOU,94,42,28,POR,109,34,35,76,63
1996-03-30,GOS,64,31,40,CLE,90,40,30,71,70
1996-03-30,CHI,106,61,8,LAC,85,26,44,87,52
1996-03-30,SEA,100,55,15,UTH,98,50,20,105,35
1996-03-30,DET,85,39,30,MIA,95,36,34,75,64
1996-03-30,DEN,98,29,41,MIL,85,21,49,50,90
1996-03-31,ORL,98,53,18,NYK,79,41,28,94,46
1996-03-31,BOS,92,28,43,ATL,93,39,31,67,74
1996-03-31,DAL,100,22,49,POR,115,35,35,57,84
1996-03-31,SAN,97,52,18,PHX,83,36,34,88,52
1996-03-31,VAN,88,11,58,CHH,121,35,35,46,93
1996-03-31,TOR,106,18,52,LAL,111,44,25,62,77
1996-03-31,SAC,105,31,38,CLE,100,41,30,72,68
1996-03-31,IND,118,43,28,NJN,100,28,42,71,70
1996-03-31,MIN,107,24,46,LAC,110,26,45,50,91
1996-04-02,MIA,92,37,34,CHI,110,62,8,99,42
1996-04-02,TOR,104,18,53,LAC,103,27,45,45,98
1996-04-02,IND,86,44,28,NYK,90,41,29,85,57
1996-04-02,DAL,97,22,50,SAC,104,32,38,54,88
1996-04-02,ATL,109,40,31,BOS,89,28,44,68,75
1996-04-02,GOS,106,31,41,HOU,112,42,29,73,70
1996-04-02,DEN,86,30,41,MIN,78,24,47,54,88
1996-04-02,POR,101,36,35,VAN,85,11,59,47,94
1996-04-02,UTH,91,50,21,SEA,100,56,15,106,36
1996-04-02,CHH,102,36,35,LAL,97,45,25,81,60
1996-04-02,MIL,105,21,50,DET,98,39,31,60,81
1996-04-02,PHX,111,36,35,SAN,104,53,18,89,53
1996-04-03,NYK,85,42,29,ORL,98,54,18,96,47
1996-04-03,PHL,87,14,58,IND,102,44,29,58,87
1996-04-03,NJN,100,28,43,LAC,94,27,46,55,89
1996-04-03,VAN,105,11,60,MIN,103,24,48,35,108
1996-04-03,SAN,117,53,19,SAC,96,33,38,86,57
1996-04-03,DET,98,39,32,CHH,83,37,35,76,67
1996-04-03,CLE,105,41,31,LAL,89,45,26,86,57
1996-04-03,SEA,118,57,15,HOU,103,43,29,100,44
1996-04-04,GOS,98,31,42,DEN,90,31,41,62,83
1996-04-04,TOR,77,19,53,CLE,98,42,31,61,84
1996-04-04,CHI,100,63,8,MIA,92,37,35,100,43
1996-04-04,ATL,110,41,31,WAS,113,33,39,74,70
1996-04-04,PHX,107,37,35,UTH,100,50,22,87,57
1996-04-04,ORL,98,55,18,BOS,100,28,45,83,63
1996-04-05,PHL,87,14,59,DET,108,40,32,54,91
1996-04-05,SAC,96,33,39,HOU,91,43,30,76,69
1996-04-05,MIL,79,22,50,NYK,86,42,30,64,80
1996-04-05,CHH,92,37,36,CHI,126,64,8,101,44
1996-04-05,UTH,99,50,23,MIN,103,24,49,74,72
1996-04-05,DEN,91,31,42,POR,97,37,35,68,77
1996-04-05,SEA,130,58,15,PHX,121,38,35,96,50
1996-04-05,NJN,70,29,43,ATL,82,41,32,70,75
1996-04-05,SAN,84,54,19,WAS,104,34,39,88,58
1996-04-05,LAL,104,45,27,VAN,94,12,60,57,87
1996-04-06,TOR,106,19,54,NYK,139,43,30,62,84
1996-04-06,NJN,88,29,44,MIL,109,22,51,51,95
1996-04-06,ATL,99,42,32,PHL,100,14,60,56,92
1996-04-06,GOS,111,32,42,MIN,106,25,49,57,91
1996-04-06,CLE,89,43,31,CHH,93,37,37,80,68
1996-04-06,DAL,101,22,51,LAC,96,27,47,49,98
1996-04-06,POR,95,38,35,SEA,92,59,15,97,50
1996-04-06,IND,99,45,29,MIA,95,37,36,82,65
1996-04-07,ORL,86,55,19,CHI,90,65,8,120,27
1996-04-07,DEN,111,31,43,HOU,105,43,31,74,74
1996-04-07,SAC,92,34,39,UTH,107,50,24,84,63
1996-04-07,LAL,107,46,27,SAN,97,54,20,100,47
1996-04-07,VAN,92,12,61,PHX,112,38,36,50,97
1996-04-07,BOS,98,29,45,DET,97,41,32,70,77
1996-04-08,NYK,98,44,30,SEA,108,59,16,103,46
1996-04-08,PHL,82,15,60,NJN,79,29,45,44,105
1996-04-08,GOS,102,33,42,DAL,104,23,51,56,93
1996-04-08,IND,97,46,29,ATL,95,42,33,88,62
1996-04-08,MIN,115,25,50,TOR,101,19,55,44,105
1996-04-08,LAC,102,27,48,POR,89,39,35,66,83
1996-04-08,CHI,97,66,8,CHH,98,38,37,104,45
1996-04-08,UTH,91,51,24,SAN,92,54,21,105,45
1996-04-08,WAS,111,35,39,MIA,99,37,37,72,76
1996-04-09,HOU,90,43,32,VAN,84,12,62,55,94
1996-04-09,NYK,97,44,31,BOS,93,30,45,74,76
1996-04-09,NJN,94,29,46,DET,111,41,33,70,79
1996-04-09,PHX,91,39,36,POR,98,39,36,78,72
1996-04-09,MIL,96,23,51,TOR,102,19,56,42,107
1996-04-09,DEN,98,32,43,LAL,91,47,27,79,70
1996-04-09,SAC,95,34,40,DAL,86,24,51,58,91
1996-04-10,UTH,103,51,25,PHX,79,39,37,90,62
1996-04-10,BOS,108,30,46,WAS,122,36,39,66,85
1996-04-10,ORL,116,55,20,CLE,104,43,32,98,52
1996-04-10,CHH,95,39,37,MIA,116,37,38,76,75
1996-04-10,SAN,105,55,21,VAN,82,12,63,67,84
1996-04-10,MIN,90,26,50,LAL,111,47,28,73,78
1996-04-10,DET,92,42,33,PHL,76,16,60,58,93
1996-04-10,SEA,108,60,16,SAC,89,35,40,95,56
1996-04-11,HOU,113,44,32,DEN,109,33,43,77,75
1996-04-11,NJN,100,29,47,CHI,113,66,9,95,56
1996-04-11,LAC,101,28,48,GOS,111,33,43,61,91
1996-04-11,NYK,97,45,31,CLE,101,43,33,88,64
1996-04-11,POR,114,40,36,DAL,99,24,52,64,88
1996-04-11,MIA,115,38,38,MIL,105,23,52,61,90
1996-04-12,VAN,99,12,64,SAC,98,35,41,47,105
1996-04-12,WAS,116,37,39,MIN,106,26,51,63,90
1996-04-12,LAL,94,48,28,GOS,81,34,43,82,71
1996-04-12,CHI,112,67,9,PHL,82,16,61,83,70
1996-04-12,ORL,101,56,20,IND,111,47,29,103,49
1996-04-12,BOS,136,30,47,TOR,108,20,56,50,103
1996-04-12,ATL,104,42,34,MIL,97,23,53,65,87
1996-04-13,SAN,84,56,21,SEA,81,61,16,117,37
1996-04-13,HOU,112,45,32,DAL,111,24,53,69,85
1996-04-13,IND,91,48,29,DET,86,43,33,91,62
1996-04-13,MIA,103,39,38,NYK,95,45,32,84,70
1996-04-13,LAC,91,28,49,UTH,81,52,25,80,74
1996-04-14,PHL,78,16,62,CHH,94,39,38,55,100
1996-04-14,SAC,101,35,42,LAC,96,29,49,64,91
1996-04-14,MIL,114,23,54,ORL,101,56,21,79,75
1996-04-14,WAS,110,38,39,TOR,97,20,57,58,96
1996-04-14,VAN,79,13,64,POR,81,41,36,54,100
1996-04-14,DET,105,43,34,BOS,96,31,47,74,81
1996-04-14,GOS,93,34,44,UTH,82,52,26,86,70
1996-04-14,MIN,91,26,52,DEN,98,33,44,59,96
1996-04-14,LAL,118,49,28,PHX,114,39,38,88,66
1996-04-14,NJN,90,29,48,ATL,99,43,34,72,82
1996-04-14,CLE,72,44,33,CHI,98,68,9,112,42
1996-04-15,HOU,106,46,32,SEA,112,61,17,107,49
1996-04-15,NYK,125,45,33,TOR,79,20,58,65,91
1996-04-15,IND,90,49,29,CHH,87,40,38,89,67
1996-04-15,MIA,110,40,38,NJN,90,29,49,69,87
1996-04-15,DEN,86,34,44,SAC,90,36,42,70,86
1996-04-15,POR,121,42,36,SAN,97,57,21,99,57
1996-04-16,ATL,77,44,34,CLE,80,44,34,88,68
1996-04-16,VAN,86,13,65,SAN,95,57,22,70,87
1996-04-16,PHX,111,39,39,HOU,100,46,33,85,72
1996-04-16,MIL,80,24,54,CHI,86,69,9,93,63
1996-04-16,ORL,113,56,22,WAS,95,39,39,95,61
1996-04-16,UTH,108,52,27,LAC,85,29,50,81,77
1996-04-16,DAL,95,24,54,LAL,113,50,28,74,82
1996-04-17,PHL,90,16,63,MIA,86,41,38,57,101
1996-04-17,WAS,106,39,40,BOS,121,31,48,70,88
1996-04-17,MIN,103,26,53,GOS,109,35,44,61,97
1996-04-17,NJN,107,29,50,TOR,95,20,59,49,109
1996-04-17,SEA,96,62,17,POR,90,43,36,105,53
1996-04-17,DET,102,44,34,IND,93,50,29,94,63
1996-04-17,SAC,103,37,42,PHX,102,40,39,77,81
1996-04-18,SAN,103,58,22,LAL,100,51,28,109,50
1996-04-18,CHH,103,40,39,MIL,111,24,55,64,94
1996-04-18,ORL,119,57,22,ATL,104,44,35,101,57
1996-04-18,CHI,110,70,9,DET,79,45,34,115,43
1996-04-18,HOU,115,46,34,LAC,107,29,51,75,85
1996-04-18,CLE,92,45,34,NYK,77,46,33,91,67
1996-04-18,VAN,79,13,66,UTH,94,53,27,66,93
1996-04-18,DAL,132,24,55,DEN,98,34,45,58,100
1996-04-19,GOS,87,36,44,POR,95,43,37,79,81
1996-04-19,NYK,108,46,34,CHH,115,40,40,86,74
1996-04-19,PHX,123,40,40,DAL,103,25,55,65,95
1996-04-19,PHL,92,17,63,ORL,112,58,22,75,85
1996-04-19,MIL,100,25,55,MIA,106,41,39,66,94
1996-04-19,TOR,107,20,60,WAS,103,39,41,59,101
1996-04-19,DEN,78,34,46,VAN,92,13,67,47,113
1996-04-19,NJN,106,30,50,BOS,112,32,48,62,98
1996-04-19,SEA,94,63,17,MIN,86,26,54,89,71
1996-04-20,UTH,104,54,27,SAC,92,38,42,92,69
1996-04-20,CLE,75,46,34,DET,73,45,35,91,69
1996-04-20,LAL,106,51,29,MIN,82,26,55,77,84
1996-04-20,CHI,99,71,9,IND,100,50,30,121,39
1996-04-20,ATL,121,44,36,NJN,99,30,51,74,87
1996-04-21,MIA,92,42,39,ATL,104,45,36,87,75
1996-04-21,HOU,118,47,34,PHX,110,41,40,88,74
1996-04-21,LAC,101,29,52,VAN,108,14,67,43,119
1996-04-21,DET,108,45,36,MIL,92,25,56,70,92
1996-04-21,CHH,100,41,40,ORL,103,59,22,100,62
1996-04-21,TOR,105,21,60,PHL,109,17,64,38,124
1996-04-21,IND,89,51,30,CLE,88,47,34,98,64
1996-04-21,POR,88,44,37,LAL,92,52,29,96,66
1996-04-21,SAC,107,38,43,GOS,100,36,45,74,88
1996-04-21,BOS,111,33,48,NYK,122,46,35,79,83
1996-04-21,DEN,99,34,47,SEA,88,64,17,98,64
1996-04-21,WAS,93,39,42,CHI,103,71,10,110,52
1996-04-21,SAN,98,59,22,DAL,103,25,56,84,78
1996-11-01,BOS,98,0,0,CHI,107,0,0,0,0
1996-11-01,NJN,77,0,0,CLE,90,0,0,0,0
1996-11-01,PHI,103,0,0,MIL,111,0,0,0,0
1996-11-01,ORL,92,0,0,WAS,96,0,0,0,0
1996-11-01,MIA,94,0,0,ATL,81,0,0,0,0
1996-11-01,TOR,99,0,0,NYK,107,0,0,0,0
1996-11-01,DET,95,0,0,IND,89,0,0,0,0
1996-11-01,MIN,82,0,0,SAS,78,0,0,0,0
1996-11-01,HOU,96,0,0,SAC,85,0,0,0,0
1996-11-01,DEN,91,0,0,DAL,92,0,0,0,0
1996-11-01,UTA,99,0,0,SEA,91,0,0,0,0
1996-11-01,LAL,96,0,0,PHX,82,0,0,0,0
1996-11-01,GSW,85,0,0,LAC,97,0,0,0,0
1996-11-01,VAN,85,0,0,POR,114,0,0,0,0
1996-11-02,WAS,96,1,0,CLE,98,1,0,2,0
1996-11-02,CHH,109,0,0,TOR,98,0,1,0,1
1996-11-02,ATL,78,0,1,DET,90,1,0,1,1
1996-11-02,IND,95,0,1,MIA,97,1,0,1,1
1996-11-02,CHI,115,1,0,PHI,86,0,1,1,1
1996-11-02,MIL,124,1,0,BOS,102,0,1,1,1
1996-11-02,DAL,94,1,0,SAC,107,0,1,1,1
1996-11-02,PHX,95,0,1,HOU,110,1,0,1,1
1996-11-02,LAC,90,1,0,UTA,95,1,0,2,0
1996-11-02,SEA,104,0,1,POR,93,1,0,1,1
1996-11-03,NYK,113,1,0,CHH,86,1,0,2,0
1996-11-03,SAS,79,0,1,DEN,88,0,1,0,2
1996-11-03,LAL,91,1,0,MIN,85,1,0,2,0
1996-11-03,VAN,95,0,1,GSW,105,0,1,0,2
1996-11-04,UTA,72,2,0,HOU,75,2,0,4,0
1996-11-04,POR,76,1,1,ATL,94,0,2,1,3
1996-11-05,NYK,92,2,0,LAL,98,2,0,4,0
1996-11-05,PHI,81,0,2,DET,83,2,0,2,2
1996-11-05,TOR,100,0,2,DAL,96,1,1,1,3
1996-11-05,CLE,68,2,0,SAS,74,0,2,2,2
1996-11-05,CHI,96,2,0,VAN,73,0,2,2,2
1996-11-05,DEN,78,1,1,LAC,82,1,1,2,2
1996-11-05,PHX,95,0,2,MIN,98,1,1,1,3
1996-11-05,GSW,93,1,1,POR,111,1,2,2,3
1996-11-05,SAC,80,1,1,HOU,102,3,0,4,1
1996-11-05,SEA,95,1,1,ATL,117,1,2,2,3
1996-11-06,BOS,94,0,2,IND,84,0,2,0,4
1996-11-06,WAS,96,1,1,SAS,86,1,2,2,3
1996-11-06,MIA,100,2,0,CHI,106,3,0,5,0
1996-11-06,CHH,88,1,1,LAL,78,3,0,4,1
1996-11-06,DET,103,3,0,DAL,84,1,2,4,2
1996-11-06,MIL,105,2,0,VAN,89,0,3,2,3
1996-11-07,NJN,95,0,1,ORL,108,0,1,0,2
1996-11-07,DEN,108,1,2,HOU,110,4,0,5,2
1996-11-07,PHX,98,0,3,SEA,103,1,2,1,5
1996-11-07,GSW,100,1,2,NYK,105,2,1,3,3
1996-11-07,SAC,87,1,2,ATL,91,2,2,3,4
1996-11-07,POR,95,2,2,MIN,94,2,1,4,3
1996-11-08,BOS,105,1,2,PHI,115,0,3,1,5
1996-11-08,WAS,87,2,1,CHH,102,2,1,4,2
1996-11-08,ORL,86,1,1,NJN,82,0,2,1,3
1996-11-08,MIA,101,2,1,MIL,89,3,0,5,1
1996-11-08,TOR,93,1,2,LAL,92,3,1,4,3
1996-11-08,CLE,88,2,1,VAN,72,0,4,2,5
1996-11-08,DET,80,4,0,CHI,98,4,0,8,0
1996-11-08,SAS,75,1,3,SEA,87,2,2,3,5
1996-11-08,DEN,94,1,3,GSW,91,1,3,2,6
1996-11-08,LAC,81,2,1,NYK,88,3,1,5,2
1996-11-09,PHI,112,1,3,PHX,95,0,4,1,7
1996-11-09,CHH,98,3,1,MIL,100,3,1,6,2
1996-11-09,IND,103,0,3,WAS,100,2,2,2,5
1996-11-09,CHI,104,5,0,BOS,92,1,3,6,3
1996-11-09,DAL,84,1,3,MIA,91,3,1,4,4
1996-11-09,HOU,91,5,0,UTA,85,2,1,7,1
1996-11-09,SAC,103,1,3,POR,102,3,2,4,5
1996-11-10,CLE,101,3,1,DEN,86,2,3,5,4
1996-11-10,LAC,81,2,2,MIN,70,2,2,4,4
1996-11-10,LAL,92,3,2,ATL,85,3,2,6,4
1996-11-10,POR,94,3,3,SAS,81,1,4,4,7
1996-11-10,VAN,82,0,5,NYK,101,4,1,4,6
1996-11-11,TOR,93,2,2,DEN,104,2,4,4,6
1996-11-11,CHI,97,6,0,PHX,79,0,5,6,5
1996-11-11,SAC,94,2,3,SEA,110,3,2,5,5
1996-11-12,NYK,97,5,1,PHI,101,2,3,7,4
1996-11-12,WAS,79,2,3,DET,92,4,1,6,4
1996-11-12,MIA,105,4,1,CHH,97,3,2,7,3
1996-11-12,ATL,87,3,3,CLE,83,4,1,7,4
1996-11-12,MIL,99,4,1,PHX,89,0,6,4,7
1996-11-12,MIN,100,2,3,POR,97,4,3,6,6
1996-11-12,DAL,103,1,4,IND,82,1,3,2,7
1996-11-12,HOU,115,6,0,LAL,126,4,2,10,2
1996-11-12,SEA,121,4,2,GSW,102,1,4,5,6
1996-11-12,VAN,92,0,6,LAC,99,3,2,3,8
1996-11-13,BOS,103,1,4,ATL,85,4,3,5,7
1996-11-13,NJN,91,0,3,WAS,106,2,4,2,7
1996-11-13,TOR,110,2,3,PHI,98,3,3,5,6
1996-11-13,CLE,81,4,2,POR,70,4,4,8,6
1996-11-13,DET,95,5,1,DEN,94,3,4,8,5
1996-11-13,CHI,103,7,0,MIA,71,5,1,12,1
1996-11-13,SAS,95,1,6,LAL,83,5,2,6,8
1996-11-13,UTA,105,3,2,SAC,74,2,4,5,6
1996-11-14,NYK,99,5,2,TOR,96,3,3,8,5
1996-11-14,ORL,96,2,1,CHH,89,3,3,5,4
1996-11-14,MIN,100,3,3,DAL,90,2,4,5,7
1996-11-14,HOU,90,6,1,IND,88,1,4,7,5
1996-11-14,LAC,78,4,2,SEA,94,5,2,9,4
1996-11-14,GSW,95,1,5,MIL,86,5,1,6,6
1996-11-14,VAN,92,0,7,PHX,89,0,7,0,14
1996-11-15,BOS,80,2,4,DEN,82,3,5,5,9
1996-11-15,NJN,85,0,4,POR,93,4,5,4,9
1996-11-15,PHI,89,3,4,CLE,105,5,2,8,6
1996-11-15,CHH,87,3,4,CHI,110,8,0,11,4
1996-11-15,ATL,85,4,4,MIA,77,5,2,9,6
1996-11-15,DET,95,6,1,WAS,84,3,4,9,5
1996-11-15,SAS,78,2,6,IND,93,1,5,3,11
1996-11-15,UTA,104,4,2,VAN,96,1,7,5,9
1996-11-15,LAL,107,5,3,LAC,100,4,3,9,6
1996-11-15,SAC,103,2,5,MIL,99,5,2,7,7
1996-11-16,NYK,82,6,2,MIN,79,4,3,10,5
1996-11-16,NJN,106,0,5,DEN,99,4,5,4,10
1996-11-16,WAS,106,3,5,BOS,92,2,5,5,10
1996-11-16,ORL,92,3,1,TOR,87,3,4,6,5
1996-11-16,MIA,89,5,3,PHI,91,3,5,8,8
1996-11-16,CLE,98,6,2,DET,102,7,1,13,3
1996-11-16,CHI,97,9,0,ATL,69,5,4,14,4
1996-11-16,DAL,87,2,5,UTA,88,5,2,7,7
1996-11-16,HOU,115,7,1,GSW,103,2,5,9,6
1996-11-16,SEA,108,6,2,SAC,96,3,5,9,7
1996-11-17,IND,83,2,5,POR,88,5,5,7,10
1996-11-17,SAS,92,2,7,GSW,102,2,6,4,13
1996-11-17,PHX,88,0,8,LAL,102,6,3,6,11
1996-11-17,LAC,102,4,4,MIL,94,5,3,9,7
1996-11-17,SEA,91,7,2,VAN,81,1,8,8,10
1996-11-18,VAN,83,1,9,SAC,84,3,6,4,15
1996-11-19,ORL,88,4,1,NYK,92,7,2,11,3
1996-11-19,TOR,98,3,5,SEA,106,8,2,11,7
1996-11-19,CLE,73,6,3,ATL,63,5,5,11,8
1996-11-19,MIL,100,5,4,DAL,97,2,6,7,10
1996-11-19,HOU,122,8,1,MIN,93,4,4,12,5
1996-11-19,DEN,86,4,6,MIA,104,5,4,9,10
1996-11-19,GSW,109,3,6,LAL,112,7,3,10,9
1996-11-19,POR,92,6,5,SAC,90,4,6,10,11
1996-11-20,BOS,83,2,6,DET,108,8,1,10,7
1996-11-20,PHI,92,4,5,IND,103,2,6,6,11
1996-11-20,WAS,110,4,5,SEA,115,9,2,13,7
1996-11-20,CHH,93,3,5,NYK,86,8,2,11,7
1996-11-20,SAS,81,2,8,LAC,93,5,4,7,12
1996-11-20,PHX,99,0,9,CHI,113,10,0,10,9
1996-11-20,LAL,97,8,3,UTA,113,6,2,14,5
1996-11-20,VAN,75,1,10,MIA,94,6,4,7,14
1996-11-21,ORL,90,4,2,MIN,86,4,5,8,7
1996-11-21,TOR,81,3,6,CLE,89,7,3,10,9
1996-11-21,DET,96,9,1,NJN,88,1,5,10,6
1996-11-21,IND,87,3,6,CHH,90,4,5,7,11
1996-11-21,MIL,65,6,4,ATL,73,5,6,11,10
1996-11-21,DAL,105,2,7,LAC,94,6,4,8,11
1996-11-21,HOU,115,9,1,PHX,105,0,10,9,11
1996-11-21,DEN,92,4,7,CHI,110,11,0,15,7
1996-11-21,UTA,109,7,2,GSW,104,3,7,10,9
1996-11-22,BOS,91,2,7,SEA,118,10,2,12,9
1996-11-22,WAS,88,4,6,PHI,76,4,6,8,12
1996-11-22,LAL,96,8,4,SAS,86,2,9,10,13
1996-11-22,SAC,108,4,7,MIA,111,7,4,11,11
1996-11-23,NJN,114,1,6,DAL,91,3,7,4,13
1996-11-23,PHI,109,4,7,NYK,92,8,3,12,10
1996-11-23,CHH,93,5,5,DET,85,10,1,15,6
1996-11-23,TOR,88,3,7,ATL,91,6,6,9,13
1996-11-23,IND,73,3,7,ORL,76,5,2,8,9
1996-11-23,MIL,90,6,5,WAS,95,5,6,11,11
1996-11-23,MIN,98,4,6,LAC,96,6,5,10,11
1996-11-23,UTA,105,8,2,CHI,100,12,0,20,2
1996-11-23,GSW,115,3,8,HOU,120,10,1,13,9
1996-11-23,POR,105,7,5,DEN,65,4,8,11,13
1996-11-24,BOS,105,2,8,DAL,91,3,8,5,16
1996-11-24,NYK,92,8,4,SEA,102,11,2,19,6
1996-11-24,CLE,103,8,3,SAC,74,4,8,12,11
1996-11-24,PHX,84,0,11,MIA,87,8,4,8,15
1996-11-24,LAL,85,9,4,HOU,90,11,1,20,5
1996-11-24,VAN,96,1,11,SAS,91,2,10,3,21
1996-11-25,WAS,105,6,6,MIN,98,5,6,11,12
1996-11-25,ORL,88,6,2,MIL,100,6,6,12,8
1996-11-25,UTA,108,9,2,NJN,92,2,6,11,8
1996-11-25,LAC,84,6,6,CHI,88,12,1,18,7
1996-11-26,PHI,88,5,7,LAL,100,9,5,14,12
1996-11-26,CHH,97,6,5,SEA,89,12,2,18,7
1996-11-26,ATL,101,7,6,VAN,80,2,11,9,17
1996-11-26,TOR,87,3,8,SAC,98,4,9,7,17
1996-11-26,DAL,105,3,9,SAS,101,2,11,5,20
1996-11-26,HOU,102,12,1,POR,101,8,5,20,6
1996-11-26,DEN,117,4,9,PHX,108,0,12,4,21
1996-11-26,GSW,88,3,9,MIA,107,9,4,12,13
1996-11-27,BOS,110,3,8,LAL,94,10,5,13,13
1996-11-27,ORL,79,6,3,ATL,75,8,6,14,9
1996-11-27,TOR,92,3,9,CHH,88,7,5,10,14
1996-11-27,DET,87,10,2,VAN,78,2,12,12,14
1996-11-27,MIL,92,7,6,CLE,75,9,3,16,9
1996-11-27,MIN,98,5,7,SEA,106,12,3,17,10
1996-11-27,SAS,109,2,12,POR,120,8,6,10,18
1996-11-27,UTA,107,10,2,DEN,103,5,9,15,11
1996-11-27,PHX,99,0,13,NJN,77,2,7,2,20
1996-11-27,LAC,82,6,7,MIA,98,10,4,16,11
1996-11-28,IND,101,3,8,SAC,83,5,9,8,17
1996-11-28,GSW,124,3,10,NJN,118,2,8,5,18
1996-11-29,BOS,94,4,8,HOU,120,13,1,17,9
1996-11-29,PHI,100,5,8,ORL,91,7,3,12,11
1996-11-29,ATL,110,8,7,WAS,81,7,6,15,13
1996-11-29,DET,76,11,2,LAL,84,10,6,21,8
1996-11-29,IND,104,4,8,VAN,94,2,13,6,21
1996-11-29,DAL,97,4,9,CHI,116,13,1,17,10
1996-11-29,DEN,103,5,10,MIN,108,5,8,10,18
1996-11-29,UTA,111,11,2,LAC,94,6,8,17,10
1996-11-29,POR,119,9,6,GSW,93,4,10,13,16
1996-11-29,SEA,105,13,3,PHX,92,1,13,14,16
1996-11-30,NYK,115,8,5,SAC,101,5,10,13,15
1996-11-30,PHI,96,6,8,VAN,90,2,14,8,22
1996-11-30,WAS,99,7,7,HOU,103,14,1,21,8
1996-11-30,MIA,78,11,4,BOS,77,4,9,15,13
1996-11-30,CLE,82,9,4,ORL,86,7,4,16,8
1996-11-30,MIL,87,8,6,CHH,94,7,6,15,12
1996-11-30,MIN,79,6,8,TOR,70,4,9,10,17
1996-11-30,SAS,88,2,13,CHI,97,14,1,16,14
1996-11-30,LAC,95,6,9,NJN,106,2,9,8,18
1996-12-01,DET,95,11,3,SAC,66,5,11,16,14
1996-12-01,LAL,104,11,6,DEN,96,5,11,16,17
1996-12-01,GSW,98,4,11,POR,70,10,6,14,17
1996-12-01,SEA,90,14,3,UTA,96,12,2,26,5
1996-12-02,ORL,102,8,4,DAL,108,4,10,12,14
1996-12-02,TOR,100,4,10,HOU,89,15,1,19,11
1996-12-02,UTA,107,13,2,CHH,97,8,6,21,8
1996-12-03,NYK,75,9,5,MIA,99,12,4,21,9
1996-12-03,ATL,105,9,7,BOS,95,4,10,13,17
1996-12-03,CLE,93,9,5,TOR,74,5,10,14,15
1996-12-03,MIL,104,8,7,CHI,107,15,1,23,8
1996-12-03,MIN,89,7,8,SAC,96,5,12,12,20
1996-12-03,LAC,96,6,10,CHH,89,8,7,14,17
1996-12-03,LAL,110,12,6,SEA,106,14,4,26,10
1996-12-03,GSW,114,5,11,DEN,99,5,12,10,23
1996-12-03,POR,93,10,7,IND,98,5,8,15,15
1996-12-04,NJN,102,3,9,NYK,109,9,6,12,15
1996-12-04,ORL,57,8,5,CLE,84,10,5,18,10
1996-12-04,MIA,101,13,4,DAL,79,5,10,18,14
1996-12-04,DET,100,12,3,ATL,90,10,7,22,10
1996-12-04,HOU,94,15,2,BOS,89,4,11,19,13
1996-12-04,SAS,113,2,14,PHI,103,7,8,9,22
1996-12-04,UTA,101,14,2,LAL,75,13,6,27,8
1996-12-04,PHX,118,1,14,GSW,87,6,11,7,25
1996-12-04,VAN,80,2,15,IND,127,6,8,8,23
1996-12-05,TOR,82,5,11,WAS,80,7,8,12,19
1996-12-05,CHI,114,16,1,LAC,96,7,10,23,11
1996-12-05,DAL,106,5,11,PHI,102,7,9,12,20
1996-12-05,DEN,104,5,13,POR,115,10,8,15,21
1996-12-05,SEA,117,14,5,MIN,86,7,9,21,14
1996-12-06,BOS,108,4,12,NJN,110,3,10,7,22
1996-12-06,MIA,85,14,4,NYK,103,10,6,24,10
1996-12-06,DET,93,13,3,CLE,81,11,5,24,8
1996-12-06,SAS,89,3,14,VAN,105,2,16,5,30
1996-12-06,UTA,106,15,2,MIN,95,7,10,22,12
1996-12-06,LAL,92,13,7,ORL,81,8,6,21,13
1996-12-06,GSW,71,6,12,IND,86,7,8,13,20
1996-12-06,SAC,95,6,12,PHX,101,2,14,8,26
1996-12-06,POR,97,11,8,CHH,93,8,8,19,16
1996-12-07,NYK,89,11,6,LAC,80,7,11,18,17
1996-12-07,NJN,69,4,10,DET,95,14,3,18,13
1996-12-07,WAS,118,7,9,MIL,126,8,8,15,17
1996-12-07,ATL,101,10,8,TOR,75,6,11,16,19
1996-12-07,CHI,80,17,1,MIA,83,14,5,31,6
1996-12-07,DAL,96,6,11,VAN,85,3,16,9,27
1996-12-07,HOU,123,16,2,PHI,108,7,10,23,12
1996-12-07,DEN,91,5,14,UTA,104,16,2,21,16
1996-12-07,SEA,92,15,5,CHH,94,8,9,23,14
1996-12-08,TOR,97,6,12,CHI,89,17,2,23,14
1996-12-08,CLE,90,11,6,LAC,69,7,12,18,18
1996-12-08,MIL,100,9,8,BOS,87,4,13,13,21
1996-12-08,PHX,106,3,14,IND,93,8,8,11,22
1996-12-08,LAL,110,14,7,MIN,86,7,11,21,18
1996-12-08,GSW,114,6,13,SAS,88,3,15,9,28
1996-12-08,SAC,91,6,13,ORL,84,8,7,14,20
1996-12-09,PHI,94,7,11,SEA,118,15,6,22,17
1996-12-09,VAN,91,3,17,CHH,107,9,9,12,26
1996-12-10,NYK,85,12,6,WAS,73,7,10,19,16
1996-12-10,ATL,89,11,8,DEN,88,5,15,16,23
1996-12-10,TOR,91,7,12,GSW,101,7,13,14,25
1996-12-10,CLE,74,12,6,MIA,76,15,5,27,11
1996-12-10,MIL,85,10,8,DET,93,15,3,25,11
1996-12-10,MIN,94,7,12,HOU,96,17,2,24,14
1996-12-10,UTA,110,17,2,IND,86,8,9,25,11
1996-12-10,PHX,93,4,14,SAS,76,3,16,7,30
1996-12-10,LAC,95,7,13,DAL,100,7,11,14,24
1996-12-10,SAC,90,7,13,LAL,92,15,7,22,20
1996-12-10,POR,93,12,8,ORL,99,8,8,20,16
1996-12-11,BOS,115,4,14,TOR,113,7,13,11,27
1996-12-11,NJN,110,4,11,SEA,101,16,6,20,17
1996-12-11,PHI,79,7,12,MIA,84,16,5,23,17
1996-12-11,WAS,106,7,11,CLE,95,12,7,19,18
1996-12-11,CHH,101,10,9,DEN,97,5,16,15,25
1996-12-11,CHI,103,17,3,MIN,86,7,13,24,16
1996-12-11,LAL,79,16,7,IND,76,8,10,24,17
1996-12-12,NYK,90,13,6,GSW,79,8,13,21,19
1996-12-12,MIL,100,10,9,SEA,97,16,7,26,16
1996-12-12,HOU,115,18,2,DET,96,16,3,34,5
1996-12-12,UTA,87,18,2,PHX,95,5,14,23,16
1996-12-12,LAC,97,7,14,SAS,94,3,17,10,31
1996-12-12,SAC,93,7,14,DAL,86,8,11,15,25
1996-12-12,POR,99,12,9,VAN,78,3,18,15,27
1996-12-13,NJN,92,5,11,CHI,113,18,3,23,14
1996-12-13,WAS,108,8,11,DEN,104,5,17,13,28
1996-12-13,CHH,84,11,9,PHI,75,7,13,18,22
1996-12-13,CLE,101,12,8,GSW,87,8,14,20,22
1996-12-13,IND,97,8,11,BOS,94,5,14,13,25
1996-12-13,MIN,108,7,14,PHX,105,6,14,13,28
1996-12-13,LAL,120,17,7,POR,119,13,9,30,16
1996-12-13,VAN,95,3,19,ORL,93,9,8,12,27
1996-12-14,NYK,89,14,6,DEN,82,5,18,19,24
1996-12-14,MIA,89,17,5,TOR,88,7,14,24,19
1996-12-14,ATL,106,12,8,PHI,81,7,14,19,22
1996-12-14,CHI,87,19,3,CHH,82,12,9,31,12
1996-12-14,MIL,101,11,9,NJN,91,5,12,16,21
1996-12-14,MIN,93,8,14,CLE,101,13,8,21,22
1996-12-14,SAS,106,3,18,DAL,105,8,12,11,30
1996-12-14,UTA,101,18,3,ORL,68,9,9,27,12
1996-12-14,LAC,106,8,14,SAC,94,8,14,16,28
1996-12-14,SEA,100,16,8,HOU,109,19,2,35,10
1996-12-15,DET,99,16,4,BOS,89,5,15,21,19
1996-12-15,PHX,103,6,15,VAN,84,4,19,10,34
1996-12-15,GSW,102,8,15,WAS,110,9,11,17,26
1996-12-15,POR,89,13,10,HOU,99,20,2,33,12
1996-12-16,BOS,91,5,16,MIL,107,12,9,17,25
1996-12-16,TOR,92,7,15,DET,98,17,4,24,19
1996-12-16,LAC,122,9,14,PHX,121,7,15,16,29
1996-12-16,SAC,89,8,15,WAS,97,10,11,18,26
1996-12-17,NYK,99,15,6,UTA,94,19,3,34,9
1996-12-17,NJN,88,5,13,TOR,97,7,16,12,29
1996-12-17,PHI,84,7,15,CHH,93,12,10,19,25
1996-12-17,MIA,89,18,5,IND,103,9,11,27,16
1996-12-17,CHI,129,20,3,LAL,123,18,7,38,10
1996-12-17,DAL,73,8,13,ATL,109,13,8,21,21
1996-12-17,SEA,123,16,9,GSW,83,8,16,24,25
1996-12-17,VAN,93,4,20,HOU,92,21,2,25,22
1996-12-18,ORL,95,9,10,IND,102,10,11,19,21
1996-12-18,CLE,99,14,8,NJN,81,5,14,19,22
1996-12-18,DET,112,18,4,NYK,78,16,6,34,10
1996-12-18,MIL,105,13,9,LAL,111,18,8,31,17
1996-12-18,DEN,95,5,19,SAC,79,8,16,13,35
1996-12-18,PHX,114,7,16,WAS,107,11,11,18,27
1996-12-18,GSW,123,8,17,MIN,96,8,15,16,32
1996-12-18,POR,102,13,11,SEA,106,17,9,30,20
1996-12-19,MIA,87,18,6,UTA,94,19,4,37,10
1996-12-19,CHH,72,13,10,CHI,93,21,3,34,13
1996-12-19,TOR,96,8,16,MIL,93,13,10,21,26
1996-12-19,HOU,101,21,3,SAS,115,4,18,25,21
1996-12-19,LAC,93,10,14,WAS,102,11,12,21,26
1996-12-19,SAC,112,8,17,MIN,105,8,16,16,33
1996-12-19,VAN,98,5,20,DAL,105,8,14,13,34
1996-12-20,PHI,103,7,16,NYK,110,16,7,23,23
1996-12-20,ORL,93,9,11,UTA,98,20,4,29,15
1996-12-20,ATL,109,14,8,NJN,95,5,15,19,23
1996-12-20,CLE,91,15,8,TOR,82,9,16,24,24
1996-12-20,IND,75,11,11,DET,84,19,4,30,15
1996-12-20,DEN,108,6,19,VAN,93,5,21,11,40
1996-12-20,POR,107,13,12,DAL,77,9,14,22,26
1996-12-20,SEA,102,18,9,LAC,86,10,15,28,24
1996-12-21,NYK,95,17,7,DET,92,20,4,37,11
1996-12-21,NJN,101,5,16,BOS,100,5,17,10,33
1996-12-21,PHI,105,7,17,CHI,111,22,3,29,20
1996-12-21,CHH,98,13,11,ATL,93,15,8,28,19
1996-12-21,MIL,103,13,11,ORL,85,9,12,22,23
1996-12-21,MIN,103,8,17,LAL,88,19,8,27,25
1996-12-21,HOU,66,21,4,MIA,86,18,7,39,11
1996-12-21,SAS,101,5,18,PHX,88,8,16,13,34
1996-12-21,SAC,101,9,17,POR,99,14,12,23,29
1996-12-22,BOS,98,5,18,CHH,102,14,11,19,29
1996-12-22,CLE,100,16,8,UTA,94,21,4,37,12
1996-12-22,IND,111,11,12,TOR,92,9,17,20,29
1996-12-22,GSW,97,9,17,LAC,91,10,16,19,33
1996-12-22,SEA,93,19,9,DAL,79,9,15,28,24
1996-12-22,VAN,91,5,22,WAS,87,12,12,17,34
1996-12-23,NYK,82,18,7,ATL,76,15,9,33,16
1996-12-23,ORL,89,9,13,CLE,84,17,8,26,21
1996-12-23,CHI,113,23,3,NJN,81,6,16,29,19
1996-12-23,MIN,107,9,17,UTA,98,21,5,30,22
1996-12-23,HOU,76,21,5,MIL,81,14,11,35,16
1996-12-23,SAS,79,6,18,MIA,90,19,7,25,25
1996-12-23,PHX,109,8,17,DEN,112,7,19,15,36
1996-12-23,SAC,100,10,17,LAC,88,10,17,20,34
1996-12-23,POR,84,14,13,WAS,106,12,13,26,26
1996-12-25,CHI,95,24,3,DET,83,20,5,44,8
1996-12-25,PHX,87,8,18,LAL,108,19,9,27,27
1996-12-26,MIA,96,20,7,ORL,76,10,13,30,20
1996-12-26,ATL,108,15,10,CHI,103,25,3,40,13
1996-12-26,TOR,98,9,18,NJN,96,6,17,15,35
1996-12-26,DET,89,20,6,IND,95,12,12,32,18
1996-12-26,MIL,90,15,11,HOU,101,21,6,36,17
1996-12-26,MIN,88,10,17,NYK,80,19,7,29,24
1996-12-26,DAL,108,9,16,GSW,113,10,17,19,33
1996-12-26,DEN,89,8,19,PHI,118,7,18,15,37
1996-12-26,UTA,99,21,6,POR,94,14,14,35,20
1996-12-26,SAC,111,11,17,VAN,88,6,22,17,39
1996-12-26,SEA,94,20,9,SAS,86,6,19,26,28
1996-12-27,NJN,105,6,18,IND,94,13,12,19,30
1996-12-27,WAS,100,13,13,TOR,82,10,18,23,31
1996-12-27,CHH,86,15,11,MIA,101,21,7,36,18
1996-12-27,CLE,94,17,9,MIL,86,15,12,32,21
1996-12-27,LAC,98,10,18,POR,102,14,15,24,33
1996-12-27,LAL,109,20,9,BOS,102,5,19,25,28
1996-12-28,NYK,96,19,8,ORL,85,10,14,29,22
1996-12-28,WAS,97,14,13,ATL,86,16,10,30,23
1996-12-28,DET,97,20,7,CHH,75,15,12,35,19
1996-12-28,CHI,102,25,4,CLE,97,18,9,43,13
1996-12-28,MIN,103,11,17,DEN,96,8,20,19,37
1996-12-28,DAL,95,9,17,SEA,90,21,9,30,26
1996-12-28,HOU,104,22,6,GSW,95,11,17,33,23
1996-12-28,UTA,110,22,6,PHI,84,8,18,30,24
1996-12-28,SAC,126,12,17,BOS,96,5,20,17,37
1996-12-28,VAN,98,6,23,PHX,103,8,19,14,42
1996-12-29,IND,102,13,13,NJN,110,7,18,20,31
1996-12-29,MIL,94,15,13,MIA,95,22,7,37,20
1996-12-29,LAL,115,21,9,PHI,102,8,19,29,28
1996-12-29,POR,110,15,15,SAS,86,6,20,21,35
1996-12-30,NYK,98,20,8,NJN,86,8,18,28,26
1996-12-30,WAS,92,15,13,CHH,101,15,13,30,26
1996-12-30,CLE,108,18,10,MIN,96,12,17,30,27
1996-12-30,DET,97,21,7,ORL,85,10,15,31,22
1996-12-30,CHI,81,26,4,IND,79,13,14,39,18
1996-12-30,HOU,99,23,6,SEA,91,21,10,44,16
1996-12-30,DEN,102,8,21,BOS,104,5,21,13,42
1996-12-30,PHX,100,9,19,SAC,88,13,17,22,36
1996-12-30,LAC,115,10,19,UTA,101,23,6,33,25
1996-12-30,VAN,88,6,24,SAS,95,6,21,12,45
1997-01-02,WAS,80,15,14,NYK,92,21,8,36,22
1997-01-02,ORL,96,10,16,TOR,94,10,19,20,35
1997-01-02,MIA,101,23,7,NJN,91,8,19,31,26
1997-01-02,CHH,107,16,13,DAL,97,10,17,26,30
1997-01-02,CLE,103,19,10,PHX,94,10,19,29,29
1997-01-02,DET,99,22,7,BOS,87,6,21,28,28
1997-01-02,HOU,96,24,6,POR,112,16,15,40,21
1997-01-02,SAS,83,7,21,UTA,80,23,7,30,28
1997-01-02,SAC,83,13,18,LAL,90,22,9,35,27
1997-01-02,SEA,96,21,11,PHI,82,8,20,29,31
1997-01-03,BOS,84,6,22,MIN,94,12,18,18,40
1997-01-03,NJN,85,8,20,ATL,95,16,11,24,31
1997-01-03,IND,117,13,15,PHX,104,10,20,23,35
1997-01-03,CHI,110,27,4,ORL,89,11,16,38,20
1997-01-03,DEN,91,8,22,SAS,93,8,21,16,43
1997-01-03,LAL,100,23,9,SAC,93,13,19,36,28
1997-01-03,GSW,122,11,18,PHI,114,8,21,19,39
1997-01-03,VAN,94,6,25,SEA,108,22,11,28,36
1997-01-04,CHH,93,17,13,WAS,104,15,15,32,28
1997-01-04,ATL,88,17,11,NYK,71,22,8,39,19
1997-01-04,CLE,99,20,10,IND,91,14,15,34,25
1997-01-04,DET,118,23,7,TOR,74,10,20,33,27
1997-01-04,MIL,91,15,14,MIN,97,13,18,28,32
1997-01-04,DAL,104,10,18,POR,110,17,15,27,33
1997-01-04,HOU,91,24,7,LAC,95,11,19,35,26
1997-01-04,UTA,83,23,8,MIA,80,24,7,47,15
1997-01-05,BOS,109,6,23,PHX,102,10,21,16,44
1997-01-05,NYK,97,22,9,MIL,92,15,15,37,24
1997-01-05,SAS,84,9,21,LAC,93,12,19,21,40
1997-01-05,SAC,107,13,20,PHI,106,8,22,21,42
1997-01-05,VAN,82,6,26,LAL,95,24,9,30,35
1997-01-06,CHI,102,28,4,UTA,89,24,8,52,12
1997-01-06,GSW,101,12,18,CHH,109,17,14,29,32
1997-01-06,POR,88,18,15,LAL,84,25,9,43,24
1997-01-07,NYK,102,23,9,DAL,72,10,19,33,28
1997-01-07,NJN,90,8,21,SAS,74,9,22,17,43
1997-01-07,ORL,109,11,17,PHI,88,8,23,19,40
1997-01-07,ATL,105,18,11,PHX,103,10,22,28,33
1997-01-07,TOR,80,10,21,LAC,87,13,19,23,40
1997-01-07,DET,76,24,7,MIL,86,15,16,39,23
1997-01-07,IND,95,14,16,CLE,90,21,10,35,26
1997-01-07,MIN,95,14,18,HOU,104,24,8,38,26
1997-01-07,SAC,96,14,20,DEN,109,8,23,22,43
1997-01-07,SEA,94,23,11,MIA,85,24,8,47,19
1997-01-08,BOS,107,7,23,SAS,83,9,23,16,46
1997-01-08,PHI,93,8,24,DAL,111,10,20,18,44
1997-01-08,WAS,115,16,15,PHX,113,10,23,26,38
1997-01-08,CLE,78,21,11,HOU,81,25,8,46,19
1997-01-08,MIL,119,16,16,UTA,112,24,9,40,25
1997-01-08,DEN,99,9,23,SEA,109,24,11,33,34
1997-01-08,LAL,101,25,10,CHH,97,18,14,43,24
1997-01-08,GSW,95,12,19,VAN,109,6,27,18,46
1997-01-08,POR,81,19,15,MIA,85,24,9,43,24
1997-01-09,NJN,107,9,21,MIN,110,14,19,23,40
1997-01-09,ORL,92,12,17,ATL,97,19,11,31,28
1997-01-09,TOR,110,10,22,UTA,96,24,10,34,32
1997-01-09,VAN,86,7,27,GSW,102,12,20,19,47
1997-01-10,BOS,98,8,23,NYK,111,24,9,32,32
1997-01-10,PHI,99,8,25,HOU,120,26,8,34,33
1997-01-10,WAS,102,17,15,LAC,98,14,19,31,34
1997-01-10,DET,84,24,8,SAS,78,9,24,33,32
1997-01-10,MIL,101,17,16,CHI,116,29,4,46,20
1997-01-10,DEN,89,9,24,IND,108,15,16,24,40
1997-01-10,PHX,102,10,24,CHH,90,18,15,28,39
1997-01-10,LAL,94,26,10,MIA,85,25,9,51,19
1997-01-11,NYK,112,25,9,BOS,99,8,24,33,33
1997-01-11,NJN,106,9,22,TOR,123,11,22,20,44
1997-01-11,ATL,87,20,11,SAS,82,9,25,29,36
1997-01-11,CLE,85,21,12,WAS,98,18,15,39,27
1997-01-11,DET,87,25,8,UTA,77,24,11,49,19
1997-01-11,CHI,110,30,4,HOU,86,27,8,57,12
1997-01-11,MIN,95,15,19,LAC,93,14,20,29,39
1997-01-11,DAL,104,11,20,DEN,99,9,25,20,45
1997-01-11,SEA,92,25,11,IND,82,16,16,41,27
1997-01-11,VAN,101,7,28,SAC,109,14,21,21,49
1997-01-12,TOR,85,12,22,ORL,88,12,18,24,40
1997-01-12,MIL,111,17,17,GSW,93,13,20,30,37
1997-01-12,SAC,93,15,21,CHH,97,18,16,33,37
1997-01-13,NJN,111,9,23,ORL,114,13,18,22,41
1997-01-13,PHI,96,8,26,UTA,97,24,12,32,38
1997-01-13,MIA,98,25,10,WAS,95,19,15,44,25
1997-01-13,CLE,79,21,13,ATL,93,21,11,42,24
1997-01-13,DAL,98,12,20,PHX,105,11,24,23,44
1997-01-13,DEN,100,9,26,CHH,102,19,16,28,42
1997-01-14,BOS,116,8,25,GSW,108,13,21,21,46
1997-01-14,ATL,95,22,11,MIN,93,16,19,38,30
1997-01-14,CHI,108,31,4,WAS,107,19,16,50,20
1997-01-14,HOU,106,27,9,NYK,86,26,9,53,18
1997-01-14,PHX,110,12,24,DEN,101,9,27,21,51
1997-01-14,LAL,91,27,10,VAN,81,7,29,34,39
1997-01-14,SAC,105,15,22,IND,98,16,17,31,39
1997-01-14,POR,95,19,16,DET,86,26,8,45,24
1997-01-15,PHI,111,8,27,GSW,128,13,22,21,49
1997-01-15,CHH,116,20,16,NJN,104,9,24,29,40
1997-01-15,MIN,102,16,20,CHI,112,32,4,48,24
1997-01-15,DAL,66,12,21,ORL,78,14,18,26,39
1997-01-15,SAS,77,9,26,NYK,94,26,10,35,36
1997-01-15,LAC,93,14,21,IND,108,16,18,30,39
1997-01-15,SEA,122,26,11,TOR,78,12,23,38,34
1997-01-15,VAN,79,7,30,DET,103,26,9,33,39
1997-01-16,BOS,94,9,25,MIA,102,26,10,35,35
1997-01-16,ATL,78,23,11,ORL,67,15,18,38,29
1997-01-16,HOU,89,28,9,SAC,80,16,22,44,31
1997-01-16,DEN,88,9,28,CLE,87,21,14,30,42
1997-01-16,UTA,95,25,12,PHX,91,13,24,38,36
1997-01-16,LAL,98,28,10,POR,102,20,16,48,26
1997-01-17,PHI,103,8,28,NJN,105,9,25,17,53
1997-01-17,WAS,92,19,17,MIA,103,27,10,46,27
1997-01-17,IND,91,17,18,GSW,98,14,22,31,40
1997-01-17,CHI,100,33,4,MIL,73,18,17,51,21
1997-01-17,DAL,78,12,22,HOU,88,29,9,41,31
1997-01-17,SAS,96,9,27,SAC,76,16,23,25,50
1997-01-17,POR,92,21,16,TOR,94,12,24,33,40
1997-01-17,SEA,96,27,11,CLE,84,21,15,48,26
1997-01-17,VAN,68,7,31,UTA,106,26,12,33,43
1997-01-18,BOS,106,9,26,WAS,112,19,18,28,44
1997-01-18,NJN,92,10,25,CHH,102,21,16,31,41
1997-01-18,ATL,94,24,11,MIL,71,18,18,42,29
1997-01-18,MIN,108,16,21,GSW,93,15,22,31,43
1997-01-18,DEN,104,10,28,DAL,107,12,23,22,51
1997-01-18,PHX,105,13,25,NYK,98,27,10,40,35
1997-01-18,LAL,97,28,11,DET,100,27,9,55,20
1997-01-19,MIA,87,28,10,ORL,99,15,19,43,29
1997-01-19,IND,111,17,19,PHI,107,8,29,25,48
1997-01-19,HOU,102,30,9,CHI,86,34,4,64,13
1997-01-19,LAC,102,14,22,CLE,107,21,16,35,38
1997-01-19,POR,102,21,17,UTA,96,27,12,48,29
1997-01-19,VAN,100,7,32,TOR,92,13,24,20,56
1997-01-20,NYK,95,27,11,WAS,79,20,18,47,29
1997-01-20,PHI,104,8,30,MIL,114,18,19,26,49
1997-01-20,ATL,106,25,11,CHH,97,22,16,47,27
1997-01-20,MIN,96,17,21,SAS,83,10,27,27,48
1997-01-20,DEN,132,10,29,NJN,123,10,26,20,55
1997-01-20,UTA,94,27,13,CLE,74,22,16,49,29
1997-01-20,PHX,89,14,25,DET,86,28,9,42,34
1997-01-20,LAL,109,28,12,DAL,99,13,23,41,35
1997-01-20,SEA,112,28,11,VAN,96,8,32,36,43
1997-01-21,ORL,93,16,19,WAS,88,20,19,36,38
1997-01-21,MIA,94,28,11,ATL,91,26,11,54,22
1997-01-21,CHH,114,22,17,HOU,108,31,9,53,26
1997-01-21,TOR,118,13,25,MIN,106,18,21,31,46
1997-01-21,CHI,88,34,5,NYK,87,28,11,62,16
1997-01-21,MIL,89,19,19,IND,92,18,19,37,38
1997-01-21,GSW,105,15,23,DAL,93,13,24,28,47
1997-01-21,POR,100,22,17,LAC,82,14,23,36,40
1997-01-22,BOS,125,9,27,PHI,127,8,31,17,58
1997-01-22,SAS,95,10,28,NJN,103,10,27,20,55
1997-01-22,DEN,94,11,29,VAN,84,8,33,19,62
1997-01-22,PHX,99,15,25,UTA,111,28,13,43,38
1997-01-22,SAC,97,16,24,DET,92,28,10,44,34
1997-01-22,SEA,98,29,11,POR,97,23,17,52,28
1997-01-23,ORL,96,17,19,MIL,92,19,20,36,39
1997-01-23,TOR,87,14,25,MIA,99,29,11,43,36
1997-01-23,CLE,71,22,17,CHI,87,35,5,57,22
1997-01-23,IND,90,19,19,NYK,92,28,12,47,31
1997-01-23,HOU,111,31,10,NJN,104,11,27,42,37
1997-01-23,LAC,102,14,24,SEA,100,30,11,44,35
1997-01-23,GSW,79,16,23,DET,94,28,11,44,34
1997-01-23,VAN,76,8,34,MIN,95,18,22,26,56
1997-01-24,BOS,117,9,28,ORL,121,18,19,27,47
1997-01-24,PHI,92,9,31,SAC,107,17,24,26,55
1997-01-24,CHH,113,23,17,NYK,104,29,12,52,29
1997-01-24,ATL,117,26,12,WAS,105,20,20,46,32
1997-01-24,SAS,97,10,29,DAL,87,13,25,23,54
1997-01-24,PHX,105,15,26,POR,115,23,18,38,44
1997-01-24,LAC,114,15,24,DEN,111,12,29,27,53
1997-01-24,LAL,114,29,12,GSW,97,16,24,45,36
1997-01-25,WAS,113,20,21,SAC,105,18,24,38,45
1997-01-25,ATL,95,27,12,BOS,90,9,29,36,41
1997-01-25,CLE,106,22,18,CHH,73,24,17,46,35
1997-01-25,DET,104,29,11,PHI,95,9,32,38,43
1997-01-25,IND,86,19,20,MIL,88,19,21,38,41
1997-01-25,CHI,110,36,5,TOR,98,14,26,50,31
1997-01-25,DAL,92,13,26,NJN,81,11,28,24,54
1997-01-25,HOU,100,32,10,UTA,105,29,13,61,23
1997-01-25,POR,101,24,18,MIN,94,19,22,43,40
1997-01-25,VAN,82,8,35,DEN,83,12,30,20,65
1997-01-26,NYK,95,29,13,MIA,89,30,11,59,24
1997-01-26,MIL,94,20,21,SAS,76,11,29,31,50
1997-01-26,SEA,103,30,12,LAL,104,30,12,60,24
1997-01-27,MIA,125,30,12,PHX,97,15,27,45,39
1997-01-27,GSW,122,16,25,VAN,97,8,36,24,61
1997-01-28,NYK,109,30,13,BOS,107,9,30,39,43
1997-01-28,NJN,62,11,29,CLE,84,23,18,34,47
1997-01-28,WAS,102,21,21,ORL,82,19,19,40,40
1997-01-28,TOR,120,14,27,POR,84,25,18,39,45
1997-01-28,IND,97,19,21,CHH,98,24,18,43,39
1997-01-28,MIL,84,21,21,DET,93,30,11,51,32
1997-01-28,MIN,88,19,23,SAC,91,18,25,37,48
1997-01-28,DAL,83,14,26,LAL,102,31,12,45,38
1997-01-28,UTA,114,30,13,DEN,99,13,30,43,43
1997-01-28,LAC,96,16,24,ATL,112,28,12,44,36
1997-01-28,VAN,96,8,37,CHI,111,37,5,45,42
1997-01-29,PHI,101,9,33,TOR,99,15,27,24,60
1997-01-29,ORL,112,19,20,PHX,105,15,28,34,48
1997-01-29,MIA,103,31,12,BOS,83,9,31,40,43
1997-01-29,CHH,95,25,18,IND,106,19,22,44,40
1997-01-29,CLE,65,24,18,NYK,75,31,13,55,31
1997-01-29,DET,98,31,11,POR,89,25,19,56,30
1997-01-29,SAS,92,11,30,LAL,99,32,12,43,42
1997-01-29,GSW,86,17,25,SEA,111,30,13,47,38
1997-01-30,NJN,113,11,30,PHX,101,15,29,26,59
1997-01-30,DAL,82,14,27,MIN,92,19,24,33,51
1997-01-30,HOU,109,32,11,DEN,113,13,31,45,42
1997-01-30,UTA,102,31,13,ATL,96,29,12,60,25
1997-01-30,LAC,100,16,25,VAN,94,8,38,24,63
1997-01-30,SAC,93,19,25,CHI,111,38,5,57,30
1997-01-31,BOS,111,9,32,POR,105,25,20,34,52
1997-01-31,PHI,99,10,33,ORL,109,20,20,30,53
1997-01-31,CHH,102,25,19,MIL,95,21,22,46,41
1997-01-31,IND,100,20,22,HOU,74,32,12,52,34
1997-01-31,SAS,95,11,31,MIN,97,20,24,31,55
1997-01-31,GSW,92,17,26,CHI,115,39,5,56,31
1997-01-31,SEA,97,31,13,WAS,95,22,21,53,34
1997-01-31,VAN,76,8,39,ATL,87,29,13,37,52
1997-02-01,NJN,75,12,30,DET,90,32,11,44,41
1997-02-01,TOR,110,15,28,PHX,86,15,30,30,58
1997-02-01,CLE,66,24,19,MIA,71,32,12,56,31
1997-02-01,MIL,100,21,23,PHI,109,10,34,31,57
1997-02-01,DAL,100,14,28,UTA,97,32,13,46,41
1997-02-01,DEN,107,14,31,SAC,113,19,26,33,57
1997-02-01,LAC,110,17,25,GSW,98,17,27,34,52
1997-02-02,BOS,92,10,32,VAN,102,8,40,18,72
1997-02-02,NYK,93,32,13,CHH,99,26,19,58,32
1997-02-02,ORL,103,21,20,HOU,90,32,13,53,33
1997-02-02,MIA,80,33,12,CLE,76,24,20,57,32
1997-02-02,DET,97,33,11,PHX,106,15,31,48,42
1997-02-02,IND,92,21,22,NJN,90,12,31,33,53
1997-02-02,MIN,103,21,24,POR,102,25,21,46,45
1997-02-02,DEN,115,14,32,ATL,104,30,13,44,45
1997-02-02,LAL,129,33,12,WAS,99,22,22,55,34
1997-02-02,SEA,84,32,13,CHI,91,40,5,72,18
1997-02-03,TOR,102,16,28,BOS,114,10,33,26,61
1997-02-03,SAS,79,11,32,SAC,85,20,26,31,58
1997-02-03,UTA,111,32,14,WAS,89,22,23,54,37
1997-02-04,NYK,99,32,14,HOU,95,32,14,64,28
1997-02-04,NJN,111,12,32,VAN,105,9,40,21,72
1997-02-04,ORL,111,22,20,IND,87,22,22,44,42
1997-02-04,CHH,115,27,19,MIN,101,22,24,49,43
1997-02-04,MIL,78,21,24,CLE,79,24,21,45,45
1997-02-04,DAL,104,15,28,SAC,96,21,26,36,54
1997-02-04,LAC,108,18,25,LAL,86,34,12,52,37
1997-02-04,GSW,85,17,28,ATL,107,30,14,47,42
1997-02-04,POR,84,25,22,CHI,88,41,5,66,27
1997-02-05,BOS,117,11,33,MIA,118,34,12,45,45
1997-02-05,PHI,113,11,34,SAS,97,11,33,22,67
1997-02-05,TOR,89,16,29,CLE,84,25,21,41,50
1997-02-05,DEN,106,15,32,WAS,104,22,24,37,56
1997-02-05,PHX,99,16,31,ATL,81,31,14,47,45
1997-02-05,LAL,106,34,13,CHI,90,42,5,76,18
1997-02-05,SEA,95,32,14,UTA,99,33,14,65,28
1997-02-06,NYK,96,33,14,SAS,84,11,34,44,48
1997-02-06,NJN,100,13,32,IND,104,22,23,35,55
1997-02-06,ORL,119,23,20,BOS,111,11,34,34,54
1997-02-06,MIA,102,35,12,MIL,90,21,25,56,37
1997-02-06,CHH,115,28,19,SAC,100,21,27,49,46
1997-02-06,DET,96,33,12,HOU,87,32,15,65,27
1997-02-06,MIN,103,22,25,VAN,86,9,41,31,66
1997-02-11,WAS,92,22,25,NYK,97,34,14,56,39
1997-02-11,ORL,98,24,20,NJN,104,13,33,37,53
1997-02-11,MIA,104,36,12,DET,91,34,12,70,24
1997-02-11,CLE,105,25,22,PHI,94,12,34,37,56
1997-02-11,CHI,103,42,6,CHH,100,29,19,71,25
1997-02-11,MIL,101,21,26,TOR,96,17,29,38,55
1997-02-11,DAL,97,16,28,SAS,111,11,35,27,63
1997-02-11,HOU,106,32,16,VAN,97,9,42,41,58
1997-02-11,LAC,116,19,25,BOS,112,11,35,30,60
1997-02-11,SAC,98,21,28,UTA,120,34,14,55,42
1997-02-11,POR,111,25,23,PHX,108,17,31,42,54
1997-02-11,SEA,108,32,15,DEN,81,16,32,48,47
1997-02-12,CHH,113,29,20,NJN,100,14,33,43,53
1997-02-12,ATL,106,31,15,TOR,84,17,30,48,45
1997-02-12,DET,96,34,13,ORL,87,24,21,58,34
1997-02-12,IND,75,23,23,CLE,83,26,22,49,45
1997-02-12,MIN,84,23,25,LAL,100,35,13,58,38
1997-02-12,SAS,101,12,35,VAN,106,9,43,21,78
1997-02-12,PHX,131,17,32,BOS,100,11,36,28,68
1997-02-13,NYK,107,35,14,PHI,92,12,35,47,49
1997-02-13,MIA,106,37,12,IND,90,23,24,60,36
1997-02-13,DAL,99,16,29,GSW,107,17,29,33,58
1997-02-13,DEN,117,16,33,LAL,132,36,13,52,46
1997-02-13,UTA,110,35,14,POR,86,26,23,61,37
1997-02-13,SAC,105,21,29,LAC,98,20,25,41,54
1997-02-14,WAS,125,22,26,NJN,107,14,34,36,60
1997-02-14,CHH,103,30,20,DET,109,35,13,65,33
1997-02-14,ATL,88,32,15,CHI,89,43,6,75,21
1997-02-14,TOR,102,17,31,MIL,106,22,26,39,57
1997-02-14,MIN,104,23,26,ORL,100,24,22,47,48
1997-02-14,SAS,94,12,36,GSW,108,18,29,30,65
1997-02-14,PHX,110,18,32,LAC,93,20,26,38,58
1997-02-14,SEA,105,33,15,HOU,85,33,16,66,31
1997-02-14,VAN,109,10,43,BOS,106,11,37,21,80
1997-02-15,NJN,107,14,35,WAS,86,23,26,37,61
1997-02-15,MIA,125,38,12,PHI,99,12,36,50,48
1997-02-15,MIL,92,23,26,DEN,87,16,34,39,60
1997-02-15,SAS,89,12,37,ATL,109,32,16,44,53
1997-02-15,UTA,99,36,14,DAL,84,16,30,52,44
1997-02-15,POR,109,26,24,HOU,105,33,17,59,41
1997-02-16,NYK,89,36,14,IND,80,23,25,59,39
1997-02-16,PHI,97,12,37,DEN,112,16,35,28,72
1997-02-16,TOR,89,17,32,DET,92,36,13,53,45
1997-02-16,CHI,110,44,6,ORL,89,24,23,68,29
1997-02-16,MIN,107,24,26,PHX,96,19,32,43,58
1997-02-16,LAL,91,37,13,SEA,102,34,15,71,28
1997-02-16,SAC,105,22,29,GSW,85,19,29,41,58
1997-02-16,POR,118,27,24,BOS,106,11,38,38,62
1997-02-17,WAS,95,23,27,MIL,93,24,26,47,53
1997-02-17,CHH,124,30,21,ORL,110,24,24,54,45
1997-02-17,CLE,108,27,22,NJN,101,15,35,42,57
1997-02-17,IND,105,23,26,TOR,103,17,33,40,59
1997-02-17,HOU,127,33,18,ATL,98,33,16,66,34
1997-02-17,SEA,113,35,15,BOS,108,11,39,46,54
1997-02-17,VAN,95,11,43,DAL,100,16,31,27,74
1997-02-18,NYK,95,37,14,PHX,94,19,33,56,47
1997-02-18,PHI,83,12,38,MIA,111,39,12,51,50
1997-02-18,CHI,134,45,6,DEN,123,17,35,62,41
1997-02-18,UTA,113,37,14,SAS,105,12,38,49,52
1997-02-18,LAC,87,20,27,DAL,69,17,31,37,58
1997-02-18,SAC,95,23,29,MIN,84,25,26,48,55
1997-02-19,ORL,95,24,25,POR,84,28,24,52,49
1997-02-19,CHH,123,31,21,PHX,115,19,34,50,55
1997-02-19,ATL,100,33,17,IND,87,24,26,57,43
1997-02-19,DET,100,37,13,WAS,85,24,27,61,40
1997-02-19,SAS,92,12,39,TOR,125,17,34,29,73
1997-02-19,LAL,84,37,14,CLE,103,28,22,65,36
1997-02-19,GSW,112,19,30,BOS,101,11,40,30,70
1997-02-19,VAN,73,11,44,MIN,84,25,27,36,71
1997-02-20,NJN,87,15,36,MIA,92,40,12,55,48
1997-02-20,PHI,101,12,39,LAC,84,21,27,33,66
1997-02-20,IND,92,24,27,DEN,68,17,36,41,63
1997-02-20,DAL,99,17,32,MIL,101,24,27,41,59
1997-02-20,HOU,107,34,18,TOR,97,18,34,52,52
1997-02-20,UTA,122,38,14,BOS,105,11,41,49,55
1997-02-20,SAC,87,24,29,NYK,109,38,14,62,43
1997-02-21,WAS,99,24,28,CHI,103,46,6,70,34
1997-02-21,ORL,99,25,25,DEN,86,17,37,42,62
1997-02-21,MIA,110,41,12,POR,114,28,25,69,37
1997-02-21,CHH,114,32,21,LAC,96,21,28,53,49
1997-02-21,ATL,76,34,17,HOU,74,35,18,69,35
1997-02-21,DET,98,38,13,NJN,84,15,37,53,50
1997-02-21,MIN,101,26,27,GSW,82,20,30,46,57
1997-02-21,SAS,98,12,40,MIL,93,25,27,37,67
1997-02-21,PHX,94,19,35,CLE,88,29,22,48,57
1997-02-21,LAL,99,37,15,VAN,91,11,45,48,60
1997-02-21,SEA,84,36,15,NYK,64,39,14,75,29
1997-02-22,PHI,97,13,39,POR,80,29,25,42,64
1997-02-22,ATL,92,35,17,CHH,93,33,21,68,38
1997-02-22,CHI,120,47,6,GSW,87,20,31,67,37
1997-02-22,DAL,92,17,33,TOR,99,18,35,35,68
1997-02-23,NJN,109,15,38,BOS,93,11,42,26,80
1997-02-23,WAS,79,24,29,DET,85,39,13,63,42
1997-02-23,MIA,95,41,13,DEN,86,17,38,58,51
1997-02-23,IND,90,25,27,ORL,99,26,25,51,52
1997-02-23,MIL,86,25,28,LAC,99,21,29,46,57
1997-02-23,HOU,95,35,19,SAS,85,13,40,48,59
1997-02-23,UTA,87,39,14,SEA,89,37,15,76,29
1997-02-23,PHX,86,20,35,DAL,88,17,34,37,69
1997-02-23,LAL,121,38,15,NYK,127,39,15,77,30
1997-02-23,VAN,84,11,46,CLE,91,29,23,40,69
1997-02-24,ORL,93,27,25,DET,84,40,13,67,38
1997-02-24,ATL,106,35,18,GSW,100,20,32,55,50
1997-02-24,CHI,116,48,6,POR,89,29,26,77,32
1997-02-24,SAS,84,13,41,CHH,96,34,21,47,62
1997-02-25,NJN,97,16,38,SAC,90,24,30,40,68
1997-02-25,WAS,108,24,30,IND,87,25,28,49,58
1997-02-25,CLE,66,30,23,SEA,72,38,15,68,38
1997-02-25,DAL,86,18,34,CHH,84,35,21,53,55
1997-02-25,HOU,100,36,19,LAL,96,38,16,74,35
1997-02-25,DEN,122,17,39,TOR,124,19,35,36,74
1997-02-25,UTA,110,39,15,NYK,99,40,15,79,30
1997-02-25,LAC,98,22,29,PHI,93,14,39,36,68
1997-02-26,BOS,105,11,43,SAC,111,24,31,35,74
1997-02-26,ORL,98,28,25,MIA,86,42,13,70,38
1997-02-26,DET,117,40,14,GSW,84,20,33,60,47
1997-02-26,IND,92,25,29,SEA,78,39,15,64,44
1997-02-26,MIL,72,25,29,ATL,79,36,18,61,47
1997-02-26,SAS,89,13,42,MIN,108,27,27,40,69
1997-02-26,PHX,111,20,36,PHI,104,14,40,34,76
1997-02-26,POR,95,29,27,NYK,96,40,16,69,43
1997-02-26,VAN,80,11,47,LAC,83,23,29,34,76
1997-02-27,WAS,107,25,30,LAL,122,38,17,63,47
1997-02-27,CLE,73,30,24,CHI,70,49,6,79,30
1997-02-27,DAL,105,19,34,MIN,107,28,27,47,61
1997-02-27,HOU,95,37,19,CHH,106,35,22,72,41
1997-02-27,UTA,118,40,15,TOR,114,20,35,60,50
1997-02-28,BOS,100,11,44,DET,106,41,14,52,58
1997-02-28,NJN,108,17,38,GSW,117,20,34,37,72
1997-02-28,ORL,94,29,25,SAS,73,13,43,42,68
1997-02-28,MIA,95,42,14,SEA,96,39,16,81,30
1997-02-28,ATL,86,37,18,LAL,75,39,17,76,35
1997-02-28,IND,104,26,29,MIL,85,25,30,51,59
1997-02-28,CHI,126,49,7,SAC,108,25,31,74,38
1997-02-28,DEN,108,17,40,NYK,112,41,16,58,56
1997-02-28,LAC,94,24,29,TOR,92,20,36,44,65
1997-02-28,POR,115,29,28,UTA,105,41,15,70,43
1997-02-28,VAN,100,11,48,PHI,104,14,41,25,89
1997-03-01,WAS,118,25,31,GSW,108,21,34,46,65
1997-03-01,CLE,99,31,24,BOS,81,11,45,42,69
1997-03-01,MIL,92,25,31,SAC,103,25,32,50,63
1997-03-01,HOU,89,37,20,DAL,80,19,35,56,55
1997-03-02,NYK,90,42,16,CLE,82,32,24,74,40
1997-03-02,ORL,101,30,25,SEA,109,40,16,70,41
1997-03-02,MIA,79,42,15,SAS,72,13,44,55,59
1997-03-02,DET,82,42,14,ATL,75,38,18,80,32
1997-03-02,IND,101,27,29,LAL,85,39,18,66,47
1997-03-02,MIN,96,29,27,CHH,108,36,22,65,49
1997-03-02,DAL,108,19,36,PHX,109,21,36,40,72
1997-03-02,DEN,109,17,41,LAC,107,25,29,42,70
1997-03-02,POR,112,30,28,PHI,95,15,41,45,69
1997-03-02,VAN,86,11,49,UTA,93,41,16,52,65
1997-03-03,TOR,103,20,37,BOS,107,11,46,31,83
1997-03-03,CHI,108,50,7,MIL,90,25,32,75,39
1997-03-03,GSW,104,21,35,UTA,111,42,16,63,51
1997-03-03,SAC,108,26,32,NJN,95,17,39,43,71
1997-03-04,NYK,93,43,16,MIL,86,25,33,68,49
1997-03-04,PHI,106,15,42,WAS,107,26,31,41,73
1997-03-04,CHH,105,37,22,SAS,98,13,45,50,67
1997-03-04,ATL,93,38,19,CLE,88,32,25,70,44
1997-03-04,DET,99,43,14,MIA,108,43,15,86,29
1997-03-04,IND,98,28,29,BOS,95,12,46,40,75
1997-03-04,DAL,92,19,37,LAL,102,39,19,58,56
1997-03-04,LAC,109,25,30,HOU,113,38,20,63,50
1997-03-04,POR,123,31,28,NJN,118,17,40,48,68
1997-03-04,SEA,89,41,16,ORL,101,30,26,71,42
1997-03-05,TOR,94,20,38,NYK,100,44,16,64,54
1997-03-05,CLE,85,32,26,IND,78,29,29,61,55
1997-03-05,CHI,111,51,7,SAS,69,13,46,64,53
1997-03-05,MIN,88,29,28,DET,92,43,15,72,43
1997-03-05,UTA,96,43,16,DAL,65,19,38,62,54
1997-03-05,PHX,99,22,36,POR,121,32,28,54,64
1997-03-05,GSW,85,21,36,HOU,90,39,20,60,56
1997-03-05,SAC,105,27,32,DEN,100,18,41,45,73
1997-03-06,PHI,104,15,43,ATL,117,39,19,54,62
1997-03-06,MIA,95,44,15,WAS,99,27,31,71,46
1997-03-06,CHH,122,38,22,BOS,121,12,47,50,69
1997-03-06,LAC,93,25,31,ORL,94,31,26,56,57
1997-03-06,VAN,96,11,50,NJN,102,17,41,28,91
1997-03-07,BOS,102,12,48,NYK,113,45,16,57,64
1997-03-07,WAS,105,28,31,MIA,108,44,16,72,47
1997-03-07,ATL,90,40,19,MIL,80,25,34,65,53
1997-03-07,TOR,103,20,39,SAS,106,13,47,33,86
1997-03-07,CHI,104,52,7,IND,96,29,30,81,37
1997-03-07,MIN,96,29,29,DEN,83,18,42,47,71
1997-03-07,UTA,95,44,16,DET,88,44,15,88,31
1997-03-07,PHX,104,22,37,SAC,87,28,32,50,69
1997-03-07,LAL,90,40,19,HOU,111,40,20,80,39
1997-03-07,GSW,108,21,37,ORL,101,32,26,53,63
1997-03-07,POR,80,33,28,DAL,69,19,39,52,67
1997-03-07,SEA,109,41,17,NJN,90,18,41,59,58
1997-03-08,CLE,82,33,26,MIL,90,25,35,58,61
1997-03-08,IND,98,29,31,SAS,102,14,47,43,78
1997-03-08,LAC,85,25,32,DET,91,44,16,69,48
1997-03-09,BOS,90,12,49,ATL,114,41,19,53,68
1997-03-09,NYK,97,46,16,CHI,93,53,7,99,23
1997-03-09,WAS,93,28,32,PHI,99,15,44,43,76
1997-03-09,CHH,82,39,22,MIA,76,45,16,84,38
1997-03-09,TOR,81,20,40,VAN,77,11,51,31,91
1997-03-09,MIN,106,30,29,UTA,115,45,16,75,45
1997-03-09,DAL,83,19,40,HOU,88,41,20,60,60
1997-03-09,PHX,121,23,37,ORL,85,32,27,55,64
1997-03-09,LAL,115,40,20,NJN,105,18,42,58,62
1997-03-09,GSW,102,22,37,SAC,98,28,33,50,70
1997-03-09,POR,103,34,28,SEA,93,42,17,76,45
1997-03-10,LAC,112,25,33,GSW,106,23,37,48,70
1997-03-11,BOS,106,12,50,CHI,117,53,8,65,58
1997-03-11,CHH,98,40,22,VAN,92,11,52,51,74
1997-03-11,ATL,106,42,19,UTA,99,46,16,88,35
1997-03-11,MIL,93,26,35,MIA,108,45,17,71,52
1997-03-11,MIN,104,30,30,PHI,100,16,44,46,74
1997-03-11,DAL,91,19,41,NYK,83,47,16,66,57
1997-03-11,SAS,79,15,47,HOU,103,42,20,57,67
1997-03-11,DEN,91,18,43,ORL,96,32,28,50,71
1997-03-11,PHX,101,24,37,TOR,105,21,40,45,77
1997-03-11,SAC,85,28,34,CLE,88,33,27,61,61
1997-03-11,POR,109,35,28,LAC,105,26,33,61,61
1997-03-11,SEA,93,42,18,DET,80,45,16,87,34
1997-03-12,NJN,102,18,43,UTA,117,46,17,64,60
1997-03-12,PHI,104,16,45,CHI,108,54,8,70,53
1997-03-12,WAS,104,28,33,VAN,82,11,53,39,86
1997-03-12,IND,92,29,32,ATL,82,43,19,72,51
1997-03-12,HOU,95,43,20,ORL,96,33,28,76,48
1997-03-12,LAL,109,41,20,GSW,101,23,38,64,58
1997-03-13,MIN,92,31,30,SEA,108,43,18,74,48
1997-03-13,DAL,109,20,41,BOS,107,12,51,32,92
1997-03-13,DEN,82,18,44,DET,102,45,17,63,61
1997-03-13,LAC,96,26,34,PHX,112,24,38,50,72
1997-03-13,GSW,101,23,39,CLE,95,34,27,57,66
1997-03-13,SAC,96,28,35,TOR,103,22,40,50,75
1997-03-14,NJN,99,18,44,CHI,98,55,8,73,52
1997-03-14,PHI,109,16,46,MIN,95,31,31,47,77
1997-03-14,ORL,86,34,28,CHH,81,41,22,75,50
1997-03-14,MIA,88,46,17,VAN,82,11,54,57,71
1997-03-14,ATL,91,43,20,SEA,97,44,18,87,38
1997-03-14,IND,96,30,32,UTA,105,47,17,77,49
1997-03-14,MIL,96,26,36,WAS,105,29,33,55,69
1997-03-14,SAS,103,15,48,BOS,92,12,52,27,100
1997-03-14,LAL,95,42,20,LAC,97,26,35,68,55
1997-03-14,POR,96,36,28,CLE,73,34,28,70,56
1997-03-15,PHI,99,17,46,CHH,107,41,23,58,69
1997-03-15,WAS,93,30,33,UTA,100,48,17,78,50
1997-03-15,CHI,99,55,9,ATL,79,43,21,98,30
1997-03-15,DEN,121,18,45,SAS,105,16,48,34,93
1997-03-15,PHX,101,25,38,DAL,76,21,41,46,79
1997-03-15,GSW,106,24,39,TOR,102,23,40,47,79
1997-03-16,NYK,74,47,17,NJN,89,19,44,66,61
1997-03-16,ORL,100,35,28,VAN,89,11,55,46,83
1997-03-16,MIA,101,47,17,HOU,80,43,21,90,38
1997-03-16,DET,86,46,17,SEA,83,45,18,91,35
1997-03-16,MIL,102,26,37,IND,98,30,33,56,70
1997-03-16,MIN,119,31,32,BOS,101,12,53,43,85
1997-03-16,LAC,94,27,35,POR,106,37,28,64,63
1997-03-16,LAL,98,42,21,TOR,90,23,41,65,62
1997-03-16,SAC,88,28,36,DAL,89,21,42,49,78
1997-03-17,BOS,126,12,54,MIL,117,27,37,39,91
1997-03-17,CHH,93,42,23,UTA,114,49,17,91,40
1997-03-17,ATL,112,43,22,ORL,107,36,28,79,50
1997-03-17,CLE,85,34,29,DET,82,47,17,81,46
1997-03-17,SAS,85,16,49,WAS,109,30,34,46,83
1997-03-17,DEN,94,19,45,LAL,113,43,21,62,66
1997-03-17,GSW,95,25,39,PHX,116,26,38,51,77
1997-03-18,NYK,98,47,18,VAN,73,11,56,58,74
1997-03-18,NJN,89,20,44,HOU,97,43,22,63,66
1997-03-18,TOR,117,23,42,PHI,105,17,47,40,89
1997-03-18,IND,115,30,34,MIN,97,32,32,62,66
1997-03-18,CHI,89,56,9,SEA,87,45,19,101,28
1997-03-18,DAL,85,22,42,WAS,86,31,34,53,76
1997-03-18,PHX,111,27,38,LAC,121,27,36,54,74
1997-03-18,POR,92,38,28,SAC,87,28,37,66,65
1997-03-19,BOS,100,13,54,UTA,113,50,17,63,71
1997-03-19,PHI,100,17,48,NYK,111,48,18,65,66
1997-03-19,MIA,93,48,17,GSW,91,25,40,73,57
1997-03-19,CHH,90,42,24,CLE,72,35,29,77,53
1997-03-19,ATL,107,44,22,IND,95,31,34,75,56
1997-03-19,DET,97,47,18,TOR,99,24,42,71,60
1997-03-19,MIN,95,32,33,VAN,72,11,57,43,90
1997-03-19,LAC,108,28,36,SAC,98,28,38,56,74
1997-03-20,ORL,100,36,29,GSW,95,25,41,61,70
1997-03-20,CLE,76,35,30,LAL,89,44,21,79,51
1997-03-20,MIL,78,27,38,POR,97,39,28,66,66
1997-03-20,HOU,96,44,22,WAS,90,32,34,76,56
1997-03-20,PHX,113,27,39,SAS,106,16,50,43,89
1997-03-20,SEA,123,45,20,DEN,97,19,46,64,66
1997-03-21,BOS,99,13,55,ORL,104,37,29,50,84
1997-03-21,PHI,112,17,49,NJN,110,20,45,37,94
1997-03-21,MIA,98,49,17,LAL,97,45,21,94,38
1997-03-21,ATL,93,45,22,DAL,72,22,43,67,65
1997-03-21,TOR,97,25,42,CHH,102,43,24,68,66
1997-03-21,DET,112,47,19,MIN,98,33,33,80,52
1997-03-21,IND,98,31,35,CHI,117,57,9,88,44
1997-03-21,SAC,114,28,39,SAS,110,16,51,44,90
1997-03-21,VAN,108,11,58,DEN,101,19,47,30,105
1997-03-22,WAS,108,32,35,POR,104,40,28,72,63
1997-03-22,CHH,100,44,24,GSW,93,25,42,69,66
1997-03-22,CHI,103,58,9,DET,88,48,19,106,28
1997-03-22,MIL,80,27,39,NYK,79,49,18,76,57
1997-03-22,DAL,72,22,44,CLE,75,35,31,57,75
1997-03-22,HOU,99,45,22,PHX,104,28,39,73,61
1997-03-22,UTA,107,51,17,LAC,94,29,36,80,53
1997-03-22,SEA,113,46,20,SAC,99,29,39,75,59
1997-03-23,BOS,91,13,56,NJN,100,20,46,33,102
1997-03-23,NYK,88,49,19,POR,94,40,29,89,48
1997-03-23,ORL,110,38,29,LAL,84,45,22,83,51
1997-03-23,TOR,79,25,43,ATL,90,46,22,71,65
1997-03-23,MIN,108,33,34,MIA,113,50,17,83,51
1997-03-23,DEN,103,19,48,UTA,120,52,17,71,65
1997-03-23,LAC,106,29,37,SAS,91,16,52,45,89
1997-03-23,VAN,92,12,58,SEA,106,47,20,59,78
1997-03-24,NJN,84,21,46,LAL,109,45,23,66,69
1997-03-25,ORL,114,39,29,SAC,103,29,40,68,69
1997-03-25,ATL,96,47,22,POR,89,41,29,88,51
1997-03-25,TOR,84,25,44,IND,98,31,36,56,80
1997-03-25,CHI,94,59,9,DAL,92,22,45,81,54
1997-03-25,HOU,112,45,23,MIN,103,33,35,78,58
1997-03-25,SAS,64,16,53,CLE,59,36,31,52,84
1997-03-25,PHX,117,29,39,MIL,112,28,39,57,78
1997-03-25,LAC,110,30,37,VAN,104,12,59,42,96
1997-03-25,GSW,89,25,43,SEA,126,48,20,73,63
1997-03-26,NYK,105,49,20,DET,94,48,20,97,40
1997-03-26,NJN,123,21,47,PHI,105,18,49,39,96
1997-03-26,WAS,105,33,35,BOS,92,13,57,46,92
1997-03-26,MIA,101,51,17,SAC,88,29,41,80,58
1997-03-26,CHH,87,45,24,POR,88,41,30,86,54
1997-03-26,IND,104,32,36,DAL,80,22,46,54,82
1997-03-26,DEN,100,19,49,MIN,102,33,36,52,85
1997-03-26,LAL,106,46,23,MIL,84,28,40,74,63
1997-03-26,SEA,107,49,20,PHX,109,30,39,79,59
1997-03-27,ATL,103,48,22,LAC,88,31,37,79,59
1997-03-27,TOR,83,25,45,CHI,96,60,9,85,54
1997-03-27,HOU,107,46,23,CLE,89,36,32,82,55
1997-03-27,SAS,97,17,53,ORL,93,40,29,57,82
1997-03-27,VAN,98,12,60,LAL,102,47,23,59,83
1997-03-28,NJN,92,22,47,NYK,86,50,20,72,67
1997-03-28,PHI,113,18,50,BOS,105,13,58,31,108
1997-03-28,WAS,113,34,35,TOR,86,25,46,59,81
1997-03-28,MIA,83,52,17,CLE,79,36,33,88,50
1997-03-28,CHH,115,45,25,IND,116,33,36,78,61
1997-03-28,DET,113,48,21,LAC,85,31,38,79,59
1997-03-28,UTA,101,53,17,MIL,96,28,41,81,58
1997-03-28,PHX,122,31,39,GSW,115,25,44,56,83
1997-03-28,POR,115,42,30,VAN,81,12,61,54,91
1997-03-28,SEA,92,49,21,MIN,81,34,36,83,57
1997-03-29,WAS,94,35,35,DAL,87,22,47,57,82
1997-03-29,ATL,88,49,22,SAC,74,29,42,78,64
1997-03-29,CHI,111,61,9,NJN,101,23,47,84,56
1997-03-29,HOU,120,47,23,DEN,105,19,50,66,73
1997-03-29,SAS,102,18,53,UTA,115,54,17,72,70
1997-03-30,ORL,86,40,30,NYK,101,50,21,90,51
1997-03-30,TOR,102,25,47,MIA,97,53,17,78,64
1997-03-30,CLE,84,36,34,DAL,80,22,48,58,82
1997-03-30,DET,92,49,21,PHI,96,19,50,68,71
1997-03-30,IND,103,34,36,LAC,96,31,39,65,75
1997-03-30,DEN,99,19,51,MIL,97,28,42,47,93
1997-03-30,PHX,107,32,39,SEA,106,50,21,82,60
1997-03-30,GSW,102,25,45,MIN,113,34,37,59,82
1997-04-01,ORL,93,40,31,PHI,105,20,50,60,81
1997-04-01,MIA,97,53,18,LAC,87,31,40,84,58
1997-04-01,CLE,88,37,34,NYK,94,51,21,88,55
1997-04-01,IND,100,35,36,WAS,104,36,35,71,71
1997-04-01,CHI,111,62,9,BOS,106,13,59,75,68
1997-04-01,DAL,82,22,49,DET,100,49,22,71,71
1997-04-01,DEN,99,20,51,HOU,116,48,23,68,74
1997-04-01,POR,82,43,30,GSW,91,25,46,68,76
1997-04-01,SEA,97,50,22,LAL,99,48,23,98,45
1997-04-01,VAN,91,12,62,MIL,102,28,43,40,105
1997-04-02,BOS,87,13,60,CLE,96,37,35,50,95
1997-04-02,PHI,90,21,50,TOR,112,26,47,47,97
1997-04-02,CHH,95,45,26,ATL,84,50,22,95,48
1997-04-02,MIN,94,35,37,NJN,89,23,48,58,85
1997-04-02,SAS,92,18,54,DET,99,50,22,68,76
1997-04-02,UTA,118,55,17,SAC,87,29,43,84,60
1997-04-02,PHX,109,33,39,HOU,96,49,23,82,62
1997-04-02,LAL,110,49,23,DEN,85,20,52,69,75
1997-04-03,NJN,87,23,49,CHH,93,46,26,69,75
1997-04-03,WAS,110,37,35,CHI,102,63,9,100,44
1997-04-03,ORL,94,40,32,LAC,113,31,41,71,73
1997-04-03,IND,78,35,37,MIA,92,54,18,89,55
1997-04-03,GSW,106,26,46,DAL,90,22,50,48,96
1997-04-03,SEA,103,50,23,MIL,80,29,43,79,66
1997-04-04,BOS,102,13,61,LAC,117,32,41,45,102
1997-04-04,NYK,84,52,21,ORL,93,40,33,92,54
1997-04-04,PHI,103,21,51,IND,114,35,38,56,89
1997-04-04,ATL,103,50,23,DET,89,51,22,101,45
1997-04-04,CHI,84,63,10,CLE,71,38,35,101,45
1997-04-04,MIN,97,36,37,WAS,95,38,35,74,72
1997-04-04,DEN,113,20,53,PHX,122,34,39,54,92
1997-04-04,UTA,106,56,17,VAN,79,12,63,68,80
1997-04-04,LAL,83,50,23,SAS,94,18,55,68,78
1997-04-04,SAC,94,29,44,HOU,108,49,24,78,68
1997-04-04,POR,108,43,31,MIL,93,29,44,72,75
1997-04-05,MIA,98,55,18,TOR,84,27,47,82,65
1997-04-05,CHH,115,47,26,PHI,113,21,52,68,78
1997-04-05,ATL,97,51,23,NYK,102,52,22,103,45
1997-04-05,GSW,120,27,46,SAS,103,19,55,46,101
1997-04-05,POR,90,44,31,PHX,99,35,39,79,70
1997-04-05,SEA,103,51,23,DAL,84,22,51,73,74
1997-04-06,BOS,114,13,62,WAS,120,38,36,51,98
1997-04-06,NJN,96,23,50,LAC,103,33,41,56,91
1997-04-06,ORL,94,41,33,CHI,110,64,10,105,43
1997-04-06,MIN,83,37,37,IND,94,36,38,73,75
1997-04-06,LAL,87,50,24,DAL,80,22,52,72,76
1997-04-06,GSW,100,28,46,UTA,114,57,17,85,63
1997-04-06,SAC,113,29,45,SEA,101,52,23,81,68
1997-04-06,VAN,85,12,64,HOU,94,50,24,62,88
1997-04-07,UTA,116,2,2,SAS,93,1,5,3,7
1997-04-07,CLE,105,38,36,CHH,110,48,26,86,62
1997-04-07,DET,88,51,23,MIA,94,56,18,107,41
1997-04-07,CHI,128,65,10,PHI,102,21,53,86,63
1997-04-07,DEN,104,20,54,POR,110,44,32,64,86
1997-04-08,NYK,73,53,22,CLE,93,38,37,91,59
1997-04-08,NJN,92,23,51,MIA,94,57,18,80,69
1997-04-08,TOR,100,27,48,WAS,94,39,36,66,84
1997-04-08,MIL,82,29,45,ORL,97,41,34,70,79
1997-04-08,DAL,87,22,53,POR,82,45,32,67,85
1997-04-08,SAS,96,19,56,DEN,90,20,55,39,111
1997-04-08,PHX,115,36,39,MIN,107,37,38,73,77
1997-04-08,LAC,117,34,41,HOU,127,51,24,85,65
1997-04-08,GSW,85,28,47,LAL,109,51,24,79,71
1997-04-08,SAC,109,30,45,VAN,93,12,65,42,110
1997-04-09,PHI,101,21,54,ATL,116,51,24,72,78
1997-04-09,CHH,136,49,26,BOS,111,13,63,62,89
1997-04-09,IND,80,37,38,CHI,86,66,10,103,48
1997-04-09,UTA,101,58,17,LAL,89,52,24,110,41
1997-04-10,NYK,103,53,23,CHI,105,67,10,120,33
1997-04-10,NJN,93,23,52,MIL,88,29,46,52,98
1997-04-10,MIA,93,58,18,DET,83,51,24,109,42
1997-04-10,TOR,69,28,48,ORL,105,42,34,70,82
1997-04-10,DAL,82,23,53,SEA,90,52,24,75,77
1997-04-10,HOU,102,52,24,VAN,94,12,66,64,90
1997-04-10,SAS,81,20,56,POR,98,45,33,65,89
1997-04-10,LAC,96,34,42,MIN,108,37,39,71,81
1997-04-10,GSW,109,28,48,DEN,107,20,56,48,104
1997-04-10,SAC,99,31,45,PHX,101,37,39,68,84
1997-04-11,BOS,103,13,64,CLE,101,39,37,52,101
1997-04-11,WAS,109,39,37,NJN,90,24,52,63,89
1997-04-11,DET,85,51,25,CHH,93,50,26,101,51
1997-04-11,IND,92,37,39,ATL,104,52,24,89,63
1997-04-11,MIL,126,29,47,PHI,118,21,55,50,102
1997-04-11,UTA,104,59,17,HOU,83,53,24,112,41
1997-04-11,LAL,114,52,25,PHX,98,38,39,90,64
1997-04-11,SAC,97,31,46,GSW,87,29,48,60,94
1997-04-12,ORL,121,43,34,BOS,98,14,64,57,98
1997-04-12,MIA,99,59,18,NYK,100,53,24,112,42
1997-04-12,CHH,99,51,26,WAS,97,40,37,91,63
1997-04-12,TOR,89,28,49,IND,100,37,40,65,89
1997-04-12,CLE,125,39,38,PHI,118,21,56,60,94
1997-04-12,MIN,66,38,39,ATL,80,53,24,91,63
1997-04-12,DAL,85,23,54,VAN,96,12,67,35,121
1997-04-12,SAS,91,20,57,SEA,96,53,24,73,81
1997-04-12,LAC,116,34,43,DEN,94,20,57,54,100
1997-04-13,DET,108,51,26,CHI,91,68,10,119,36
1997-04-13,MIL,132,30,47,NJN,123,24,53,54,100
1997-04-13,HOU,113,53,25,SEA,73,54,24,107,49
1997-04-13,LAL,100,53,25,UTA,98,60,17,113,42
1997-04-13,GSW,97,29,49,PHX,105,38,40,67,89
1997-04-14,PHI,110,21,57,WAS,131,40,38,61,95
1997-04-14,ORL,100,44,34,DET,91,52,26,96,60
1997-04-14,MIA,87,59,19,MIN,95,38,40,97,59
1997-04-14,CHH,94,52,26,CLE,82,40,38,92,64
1997-04-14,IND,110,38,40,NYK,107,54,24,92,64
1997-04-14,CHI,117,68,11,TOR,100,28,50,96,61
1997-04-14,DAL,93,23,55,LAC,99,35,43,58,98
1997-04-14,DEN,93,20,58,GSW,103,29,50,49,108
1997-04-14,SAC,120,32,46,SAS,106,20,58,52,104
1997-04-15,ATL,109,54,24,NJN,101,24,54,78,78
1997-04-15,MIL,92,31,47,TOR,85,28,51,59,98
1997-04-15,HOU,123,54,25,LAC,119,36,43,90,68
1997-04-15,PHX,122,39,40,UTA,127,60,18,99,58
1997-04-15,SEA,108,54,25,SAS,88,20,59,74,84
1997-04-16,BOS,102,14,65,CHH,108,53,26,67,91
1997-04-16,NYK,96,54,25,ATL,92,55,24,109,49
1997-04-16,NJN,105,24,55,PHI,113,21,58,45,113
1997-04-16,WAS,103,41,38,IND,90,39,40,80,78
1997-04-16,MIA,102,59,20,CHI,92,69,11,128,31
1997-04-16,CLE,78,40,39,ORL,63,45,34,85,73
1997-04-16,DET,92,52,27,MIL,85,32,47,84,74
1997-04-16,MIN,77,39,40,DAL,92,23,56,62,96
1997-04-16,POR,107,46,33,DEN,63,20,59,66,92
1997-04-17,DEN,104,20,60,SEA,108,55,25,75,85
1997-04-17,UTA,106,61,18,GSW,93,30,50,91,68
1997-04-17,LAL,108,54,25,SAC,99,33,46,87,71
1997-04-17,VAN,73,13,67,POR,105,47,33,60,100
1997-04-18,NYK,97,55,25,IND,89,39,41,94,66
1997-04-18,PHI,113,22,58,BOS,119,14,66,36,124
1997-04-18,WAS,104,42,38,ORL,93,45,35,87,73
1997-04-18,MIA,74,60,20,NJN,86,24,56,84,76
1997-04-18,CHH,100,54,26,TOR,108,28,52,82,78
1997-04-18,DET,75,53,27,CLE,82,41,39,94,66
1997-04-18,MIN,122,39,41,MIL,112,32,48,71,89
1997-04-18,HOU,112,55,25,DAL,102,24,56,79,81
1997-04-18,SAS,95,20,60,PHX,106,39,41,59,101
1997-04-18,LAC,95,36,44,LAL,123,55,25,91,69
1997-04-19,ORL,88,45,36,MIA,102,60,21,105,57
1997-04-19,ATL,136,55,25,PHI,104,22,59,77,84
1997-04-19,CHI,101,69,12,NYK,103,56,25,125,37
1997-04-19,DAL,95,24,57,DEN,100,20,61,44,118
1997-04-19,UTA,101,62,18,MIN,89,40,41,102,59
1997-04-19,PHX,107,40,41,VAN,121,13,68,53,109
1997-04-19,GSW,120,30,51,SAC,122,33,47,63,98
1997-04-19,SEA,125,56,25,LAC,100,36,45,92,70
1997-04-20,BOS,94,15,66,TOR,125,29,52,44,118
1997-04-20,NJN,108,25,56,ATL,92,56,25,81,81
1997-04-20,CLE,81,42,39,WAS,85,43,38,85,77
1997-04-20,IND,120,39,42,DET,124,53,28,92,70
1997-04-20,MIL,120,32,49,CHH,100,54,27,86,76
1997-04-20,SAS,99,20,61,HOU,103,56,25,76,86
1997-04-20,SAC,109,34,47,UTA,113,63,18,97,65
1997-04-20,POR,100,48,33,LAL,96,56,25,104,58
1997-10-31,BOS,92,0,0,CHI,85,0,0,0,0
1997-10-31,NJN,97,0,0,IND,95,0,0,0,0
1997-10-31,PHI,88,0,0,MIL,103,0,0,0,0
1997-10-31,ORL,99,0,0,ATL,105,0,0,0,0
1997-10-31,MIA,114,0,0,TOR,101,0,0,0,0
1997-10-31,CHH,85,0,0,NYK,97,0,0,0,0
1997-10-31,DET,92,0,0,WAS,79,0,0,0,0
1997-10-31,MIN,129,0,0,GSW,113,0,0,0,0
1997-10-31,HOU,94,0,0,CLE,86,0,0,0,0
1997-10-31,DEN,96,0,0,SAS,107,0,0,0,0
1997-10-31,PHX,110,0,0,LAC,100,0,0,0,0
1997-10-31,LAL,104,0,0,UTA,87,0,0,0,0
1997-10-31,POR,83,0,0,SEA,91,0,0,0,0
1997-10-31,VAN,88,0,0,DAL,90,0,0,0,0
1997-11-01,WAS,108,0,1,MIA,109,1,0,1,1
1997-11-01,ATL,90,1,0,TOR,85,0,1,1,1
1997-11-01,IND,96,0,1,GSW,83,0,1,0,2
1997-11-01,CHI,94,0,1,PHI,74,0,1,0,2
1997-11-01,MIL,109,1,0,NJN,113,1,0,2,0
1997-11-01,MIN,106,1,0,CHH,90,0,1,1,1
1997-11-01,SAS,83,1,0,CLE,80,0,1,1,1
1997-11-01,UTA,102,0,1,DEN,84,0,1,0,2
1997-11-01,LAC,74,0,1,POR,82,0,1,0,2
1997-11-01,SEA,81,1,0,DAL,89,1,0,2,0
1997-11-01,VAN,97,0,1,SAC,96,0,0,0,1
1997-11-02,BOS,96,1,0,ORL,107,0,1,1,1
1997-11-02,NYK,86,1,0,DET,94,1,0,2,0
1997-11-02,SAC,77,0,1,HOU,93,1,0,1,1
1997-11-03,MIA,99,2,0,CHH,112,0,2,2,2
1997-11-03,CHI,87,1,1,SAS,83,2,0,3,1
1997-11-03,UTA,86,1,1,WAS,90,0,2,1,3
1997-11-04,NYK,102,1,1,BOS,70,1,1,2,2
1997-11-04,ATL,82,2,0,DET,71,2,0,4,0
1997-11-04,TOR,104,0,2,GSW,86,0,2,0,4
1997-11-04,CLE,80,0,2,IND,77,1,1,1,3
1997-11-04,MIL,110,1,1,ORL,76,1,1,2,2
1997-11-04,DAL,92,2,0,VAN,87,1,1,3,1
1997-11-04,DEN,96,0,2,WAS,120,1,2,1,4
1997-11-04,PHX,106,1,0,UTA,84,1,2,2,2
1997-11-04,SAC,98,0,2,LAL,101,1,0,1,2
1997-11-04,POR,122,1,1,MIN,105,2,0,3,1
1997-11-04,SEA,118,1,1,HOU,94,2,0,3,1
1997-11-05,BOS,74,1,2,MIA,90,2,1,3,3
1997-11-05,NJN,112,2,0,GSW,96,0,3,2,3
1997-11-05,PHI,88,0,2,ATL,93,3,0,3,2
1997-11-05,CHH,110,1,2,DAL,103,3,0,4,2
1997-11-05,DET,87,2,1,IND,99,1,2,3,3
1997-11-05,CHI,94,2,1,ORL,81,1,2,3,3
1997-11-05,SAS,87,2,1,VAN,79,1,2,3,3
1997-11-05,LAC,110,0,2,HOU,124,2,1,2,3
1997-11-06,TOR,92,1,2,SEA,109,2,1,3,3
1997-11-06,MIL,100,2,1,PHI,93,0,3,2,4
1997-11-06,PHX,75,2,0,NYK,105,2,1,4,1
1997-11-07,BOS,92,1,3,CLE,96,1,2,2,5
1997-11-07,NJN,99,3,0,MIA,87,3,1,6,1
1997-11-07,WAS,92,2,2,CHH,107,2,2,4,4
1997-11-07,ATL,80,4,0,CHI,78,3,1,7,1
1997-11-07,DET,84,2,2,ORL,89,1,3,3,5
1997-11-07,IND,93,2,2,SEA,99,3,1,5,3
1997-11-07,HOU,85,3,1,POR,86,2,1,5,2
1997-11-07,DEN,89,0,3,UTA,91,1,3,1,6
1997-11-07,LAL,99,2,0,NYK,94,3,1,5,1
1997-11-07,SAC,85,0,3,LAC,98,0,3,0,6
1997-11-07,VAN,97,1,3,MIN,108,2,1,3,4
1997-11-08,ORL,96,2,3,TOR,87,1,3,3,6
1997-11-08,MIA,114,3,2,WAS,106,2,3,5,5
1997-11-08,CHH,89,3,2,IND,82,2,3,5,5
1997-11-08,CLE,97,2,2,ATL,99,5,0,7,2
1997-11-08,CHI,99,3,2,NJN,86,4,0,7,2
1997-11-08,MIL,105,3,1,BOS,96,1,4,4,5
1997-11-08,DAL,94,3,1,POR,101,3,1,6,2
1997-11-08,SAS,87,3,1,UTA,80,2,3,5,4
1997-11-08,LAC,105,1,3,PHX,123,2,1,3,4
1997-11-08,GSW,90,0,4,MIN,97,3,1,3,5
1997-11-09,PHI,105,0,4,SEA,112,4,1,4,5
1997-11-09,LAL,132,3,0,GSW,97,0,5,3,5
1997-11-09,SAC,86,0,4,NYK,78,3,2,3,6
1997-11-09,VAN,104,1,4,DET,96,2,3,3,7
1997-11-10,TOR,98,1,4,SAS,100,4,1,5,5
1997-11-10,POR,86,4,1,DET,82,2,4,6,5
1997-11-11,NYK,93,3,3,DEN,90,0,4,3,7
1997-11-11,MIA,101,4,2,SAC,82,1,4,5,6
1997-11-11,ATL,89,6,0,SEA,87,5,1,11,1
1997-11-11,CLE,101,2,3,CHI,80,4,2,6,5
1997-11-11,MIN,92,4,1,SAS,93,5,1,9,2
1997-11-11,DAL,96,3,2,LAL,118,4,0,7,2
1997-11-11,VAN,119,2,4,LAC,113,1,4,3,8
1997-11-12,BOS,96,1,5,DEN,86,0,5,1,10
1997-11-12,ORL,89,3,3,SAC,115,1,5,4,8
1997-11-12,TOR,70,1,5,NYK,93,4,3,5,8
1997-11-12,IND,86,2,4,ATL,89,7,0,9,4
1997-11-12,CHI,83,4,3,WAS,90,2,4,6,7
1997-11-12,HOU,100,3,2,PHI,114,0,5,3,7
1997-11-12,UTA,98,2,4,VAN,80,3,4,5,8
1997-11-12,PHX,103,3,1,MIL,95,4,1,7,2
1997-11-12,GSW,71,0,6,DET,102,2,5,2,11
1997-11-13,NJN,74,4,1,CLE,85,3,3,7,4
1997-11-13,MIN,88,4,2,WAS,91,3,4,7,6
1997-11-13,DAL,98,3,3,PHI,99,1,5,4,8
1997-11-13,SAS,100,6,1,LAL,109,5,0,11,1
1997-11-13,LAC,94,1,5,MIL,102,4,2,5,7
1997-11-13,SEA,95,5,2,DET,89,3,5,8,7
1997-11-14,BOS,103,2,5,TOR,99,1,6,3,11
1997-11-14,ORL,103,3,4,DEN,85,0,6,3,10
1997-11-14,ATL,104,8,0,SAC,103,2,5,10,5
1997-11-14,IND,82,2,5,MIA,78,5,2,7,7
1997-11-14,CHI,105,4,4,CHH,92,4,2,8,6
1997-11-14,HOU,103,3,3,LAL,113,6,0,9,3
1997-11-14,UTA,110,3,4,SEA,104,6,2,9,6
1997-11-14,POR,139,5,1,PHX,140,4,1,9,2
1997-11-15,NYK,114,5,3,SAC,87,2,6,7,9
1997-11-15,PHI,101,2,5,BOS,107,3,5,5,10
1997-11-15,WAS,91,4,4,ORL,102,4,4,8,8
1997-11-15,MIA,96,5,3,DEN,93,0,7,5,10
1997-11-15,CHH,130,4,3,LAC,96,1,6,5,9
1997-11-15,TOR,77,1,7,IND,105,3,5,4,12
1997-11-15,DET,96,3,6,NJN,88,4,2,7,8
1997-11-15,CHI,79,5,4,CLE,70,4,3,9,7
1997-11-15,DAL,77,3,4,UTA,85,4,4,7,8
1997-11-15,SAS,94,6,2,MIN,105,4,3,10,5
1997-11-15,GSW,87,0,7,POR,99,5,2,5,9
1997-11-15,VAN,109,3,5,MIL,94,5,2,8,7
1997-11-16,ATL,89,9,0,LAC,83,1,7,10,7
1997-11-16,CLE,72,4,4,NJN,77,4,3,8,7
1997-11-16,PHX,96,5,1,HOU,94,3,4,8,5
1997-11-16,LAL,121,7,0,VAN,95,4,5,11,5
1997-11-16,SEA,119,6,3,MIL,99,5,3,11,6
1997-11-17,POR,120,6,2,DAL,75,3,5,9,7
1997-11-18,ORL,112,5,4,LAC,94,1,8,6,12
1997-11-18,ATL,98,10,0,WAS,89,4,5,14,5
1997-11-18,TOR,109,1,8,BOS,122,4,5,5,13
1997-11-18,MIL,87,5,4,DET,79,4,6,9,10
1997-11-18,HOU,95,3,5,NYK,84,6,3,9,8
1997-11-18,DEN,87,0,8,VAN,100,4,6,4,14
1997-11-18,UTA,92,5,4,LAL,97,8,0,13,4
1997-11-18,PHX,90,6,1,MIN,108,5,3,11,4
1997-11-18,SAC,102,2,7,DAL,95,3,6,5,13
1997-11-19,NJN,108,5,3,BOS,100,5,5,10,8
1997-11-19,PHI,97,2,6,WAS,86,4,6,6,12
1997-11-19,MIA,122,6,3,LAC,113,1,9,7,12
1997-11-19,CHH,106,5,3,POR,92,7,2,12,5
1997-11-19,CLE,93,4,5,ORL,96,6,4,10,9
1997-11-19,SAS,108,6,3,GSW,87,0,8,6,11
1997-11-19,LAL,118,9,0,MIN,93,6,3,15,3
1997-11-19,SEA,107,7,3,VAN,87,5,6,12,9
1997-11-20,ATL,79,11,0,NYK,100,6,4,17,4
1997-11-20,DET,87,4,7,POR,93,7,3,11,10
1997-11-20,MIL,83,6,4,IND,109,4,5,10,9
1997-11-20,DAL,97,3,7,GSW,101,0,9,3,16
1997-11-20,HOU,127,4,5,TOR,97,1,9,5,14
1997-11-20,PHX,89,6,2,CHI,85,6,4,12,6
1997-11-20,SAC,97,3,7,UTA,95,5,5,8,12
1997-11-21,BOS,101,5,6,NJN,93,6,3,11,9
1997-11-21,WAS,82,4,7,NYK,104,7,4,11,11
1997-11-21,CHH,119,6,3,MIA,102,7,3,13,6
1997-11-21,MIN,80,6,4,CLE,103,4,6,10,10
1997-11-21,LAC,102,1,10,CHI,111,6,5,7,15
1997-11-21,SEA,94,8,3,SAS,74,7,3,15,6
1997-11-21,VAN,99,5,7,DEN,96,0,9,5,16
1997-11-22,NJN,93,6,4,POR,87,8,3,14,7
1997-11-22,PHI,94,3,6,ORL,108,7,4,10,10
1997-11-22,MIA,108,7,4,TOR,104,1,10,8,14
1997-11-22,CLE,110,5,6,WAS,101,4,8,9,14
1997-11-22,DET,87,4,8,ATL,85,11,1,15,9
1997-11-22,IND,94,5,5,CHH,95,7,3,12,8
1997-11-22,DAL,62,3,8,MIL,83,6,5,9,13
1997-11-22,HOU,90,5,5,GSW,84,1,9,6,14
1997-11-22,DEN,80,0,10,SEA,84,9,3,9,13
1997-11-22,UTA,103,5,6,SAS,74,7,4,12,10
1997-11-23,BOS,90,6,6,DET,86,5,8,11,14
1997-11-23,NYK,104,8,4,VAN,84,6,7,14,11
1997-11-23,LAL,119,10,0,LAC,102,1,11,11,11
1997-11-23,SAC,88,4,7,CHI,103,7,5,11,12
1997-11-24,ORL,95,8,4,WAS,87,4,9,12,13
1997-11-24,TOR,90,1,11,POR,91,8,4,9,15
1997-11-24,UTA,133,6,6,MIN,124,6,5,12,11
1997-11-25,MIA,103,8,4,LAL,86,11,0,19,4
1997-11-25,CHH,90,8,3,DET,85,5,9,13,12
1997-11-25,DAL,91,3,9,SAS,102,7,5,10,14
1997-11-25,GSW,87,1,10,NJN,101,7,4,8,14
1997-11-25,SAC,97,4,8,DEN,93,0,11,4,19
1997-11-25,SEA,91,10,3,CHI,90,8,5,18,8
1997-11-26,BOS,103,7,6,LAL,118,11,1,18,7
1997-11-26,PHI,89,3,7,CLE,95,6,6,9,13
1997-11-26,ORL,60,9,4,MIA,84,9,4,18,8
1997-11-26,TOR,104,1,12,ATL,109,11,2,12,14
1997-11-26,MIL,101,7,5,VAN,82,6,8,13,13
1997-11-26,MIN,90,6,6,POR,96,9,4,15,10
1997-11-26,SAS,94,8,5,WAS,98,4,10,12,15
1997-11-26,PHX,111,7,2,NJN,99,8,4,15,6
1997-11-26,LAC,99,1,12,SAC,97,5,8,6,20
1997-11-27,IND,106,5,6,VAN,85,6,9,11,15
1997-11-28,BOS,108,7,7,PHX,112,8,2,15,9
1997-11-28,PHI,105,3,8,LAL,95,12,1,15,9
1997-11-28,ORL,94,9,5,MIL,90,8,5,17,10
1997-11-28,CHH,91,9,3,CLE,97,7,6,16,9
1997-11-28,DET,86,5,10,NYK,78,9,4,14,14
1997-11-28,IND,94,6,6,CHI,83,8,6,14,12
1997-11-28,DAL,93,3,10,TOR,91,1,13,4,23
1997-11-28,DEN,95,0,12,MIN,84,6,7,6,19
1997-11-28,UTA,111,7,6,GSW,82,1,11,8,17
1997-11-28,LAC,92,2,12,NJN,104,8,5,10,17
1997-11-28,POR,89,10,4,HOU,98,6,5,16,9
1997-11-28,SEA,113,11,3,SAC,96,5,9,16,12
1997-11-29,NYK,102,9,5,PHX,80,9,2,18,7
1997-11-29,WAS,83,5,10,CHI,88,8,7,13,17
1997-11-29,MIA,87,10,4,MIL,93,8,6,18,10
1997-11-29,ATL,98,12,2,CHH,80,9,4,21,6
1997-11-29,CLE,103,8,6,BOS,97,7,8,15,14
1997-11-29,MIN,106,6,8,VAN,87,6,10,12,18
1997-11-29,SAS,96,8,6,DAL,87,4,10,12,16
1997-11-29,LAC,91,2,13,UTA,94,8,6,10,19
1997-11-29,GSW,100,1,12,HOU,107,7,5,8,17
1997-11-30,ATL,108,13,2,SAS,96,9,6,22,8
1997-11-30,DET,95,6,10,VAN,97,6,11,12,21
1997-11-30,IND,101,7,6,PHI,89,4,8,11,14
1997-11-30,LAL,105,12,2,TOR,99,1,14,13,16
1997-11-30,SAC,73,5,10,NJN,87,9,5,14,15
1997-11-30,SEA,103,12,3,ORL,81,10,5,22,8
1997-12-01,UTA,100,9,6,NJN,95,10,5,19,11
1997-12-02,WAS,95,5,11,SEA,78,13,3,18,14
1997-12-02,CHH,121,9,5,SAC,102,5,11,14,16
1997-12-02,MIL,86,9,6,PHX,90,9,3,18,9
1997-12-02,DAL,79,4,11,ATL,112,14,2,18,13
1997-12-02,HOU,112,8,5,DEN,101,1,12,9,17
1997-12-02,SAS,90,9,7,NYK,84,10,5,19,12
1997-12-02,POR,88,10,5,ORL,89,10,6,20,11
1997-12-03,BOS,87,7,9,CHI,97,9,7,16,16
1997-12-03,NJN,89,10,6,SEA,93,13,4,23,10
1997-12-03,MIA,94,10,5,PHI,90,4,9,14,14
1997-12-03,DET,108,6,11,PHX,103,10,3,16,14
1997-12-03,MIN,90,7,8,IND,94,8,6,15,14
1997-12-03,DEN,89,1,13,LAL,107,13,2,14,15
1997-12-03,UTA,115,10,6,TOR,98,1,15,11,21
1997-12-03,GSW,67,1,13,CLE,95,9,6,10,19
1997-12-03,VAN,97,7,11,ORL,101,11,6,18,17
1997-12-04,WAS,118,6,11,SAC,96,5,12,11,23
1997-12-04,MIL,102,9,7,CHH,92,10,5,19,12
1997-12-04,DAL,105,4,12,NYK,91,10,6,14,18
1997-12-04,HOU,94,9,5,ATL,87,15,2,24,7
1997-12-04,LAC,100,2,14,SAS,96,10,7,12,21
1997-12-05,NJN,107,10,7,PHI,88,4,10,14,17
1997-12-05,MIA,117,11,5,BOS,97,7,10,18,15
1997-12-05,DET,89,7,11,SEA,94,14,4,21,15
1997-12-05,CHI,84,10,7,MIL,62,10,7,20,14
1997-12-05,MIN,101,7,9,SAC,90,5,13,12,22
1997-12-05,DEN,85,1,14,IND,96,9,6,10,20
1997-12-05,PHX,110,10,4,TOR,91,1,16,11,20
1997-12-05,LAL,98,14,2,SAS,88,10,8,24,10
1997-12-05,GSW,104,1,14,ORL,89,12,6,13,20
1997-12-05,POR,94,10,6,UTA,77,11,6,21,12
1997-12-05,VAN,98,7,12,CLE,107,10,6,17,18
1997-12-06,NYK,90,10,7,CHH,79,10,6,20,13
1997-12-06,WAS,114,7,11,MIN,103,8,9,15,20
1997-12-06,DAL,106,5,12,HOU,108,10,5,15,17
1997-12-06,LAC,79,3,14,ORL,83,12,7,15,21
1997-12-07,PHI,93,4,11,NYK,78,11,7,15,18
1997-12-07,TOR,83,1,17,DET,93,7,12,8,29
1997-12-07,MIL,97,10,8,SEA,91,15,4,25,12
1997-12-07,DEN,100,1,15,LAC,92,3,15,4,30
1997-12-07,PHX,97,11,4,IND,99,10,6,21,10
1997-12-07,LAL,84,15,2,CLE,94,11,6,26,8
1997-12-07,SAC,99,5,14,GSW,84,2,14,7,28
1997-12-08,ORL,95,13,7,PHI,86,5,11,18,18
1997-12-08,MIA,105,12,5,NJN,97,11,7,23,12
1997-12-08,UTA,106,11,7,IND,97,11,6,22,13
1997-12-08,POR,105,11,6,LAL,99,15,3,26,9
1997-12-09,WAS,120,8,11,NJN,99,11,8,19,19
1997-12-09,ATL,81,15,3,MIA,97,13,5,28,8
1997-12-09,TOR,82,1,18,CHH,95,10,7,11,25
1997-12-09,DET,92,8,12,DEN,83,2,15,10,27
1997-12-09,CHI,100,11,7,NYK,82,11,8,22,15
1997-12-09,MIN,99,8,10,SEA,108,15,5,23,15
1997-12-09,DAL,92,5,13,LAC,99,3,16,8,29
1997-12-09,HOU,108,11,5,SAS,78,10,9,21,14
1997-12-09,PHX,107,11,5,VAN,85,7,13,18,18
1997-12-09,SAC,113,6,14,UTA,101,12,7,18,21
1997-12-10,BOS,96,7,11,MIL,91,11,8,18,19
1997-12-10,PHI,97,5,12,TOR,104,1,19,6,31
1997-12-10,ORL,106,14,7,CHI,98,12,7,26,14
1997-12-10,CHH,104,11,7,WAS,101,9,11,20,18
1997-12-10,CLE,102,12,6,DEN,83,2,16,14,22
1997-12-10,SAS,102,10,10,LAC,87,4,16,14,26
1997-12-10,GSW,93,2,15,LAL,92,15,4,17,19
1997-12-10,POR,93,12,6,IND,85,11,7,23,13
1997-12-11,NYK,107,11,9,MIN,103,8,11,19,20
1997-12-11,DET,103,9,12,NJN,99,11,9,20,21
1997-12-11,MIL,77,11,9,CLE,79,13,6,24,15
1997-12-11,DAL,90,5,14,ORL,100,15,7,20,21
1997-12-11,PHX,94,12,5,ATL,78,15,4,27,9
1997-12-12,BOS,97,8,11,WAS,88,9,12,17,23
1997-12-12,PHI,106,5,13,DEN,91,2,17,7,30
1997-12-12,CHH,79,12,7,CHI,77,12,8,24,15
1997-12-12,IND,104,11,8,MIA,89,14,5,25,13
1997-12-12,UTA,68,12,8,DAL,66,5,15,17,23
1997-12-12,LAC,74,4,17,ATL,83,15,5,19,22
1997-12-12,LAL,119,15,5,HOU,102,12,5,27,10
1997-12-12,SEA,111,16,5,POR,98,13,6,29,11
1997-12-12,VAN,95,7,14,GSW,88,3,15,10,29
1997-12-13,NYK,95,12,9,PHI,83,6,13,18,22
1997-12-13,NJN,133,11,10,DEN,95,2,18,13,28
1997-12-13,CLE,84,14,6,CHH,85,13,7,27,13
1997-12-13,DET,93,10,12,BOS,77,9,11,19,23
1997-12-13,IND,109,12,8,WAS,92,9,13,21,21
1997-12-13,CHI,97,12,9,TOR,70,2,19,14,28
1997-12-13,MIL,84,11,10,MIA,87,14,6,25,16
1997-12-13,MIN,112,8,12,PHX,101,13,5,21,17
1997-12-13,SAS,107,11,10,ORL,78,16,7,27,17
1997-12-13,GSW,95,3,16,SAC,91,7,14,10,30
1997-12-14,LAL,119,16,5,DAL,89,5,16,21,21
1997-12-14,SAC,89,7,15,ATL,93,16,5,23,20
1997-12-14,SEA,107,17,5,LAC,101,4,18,21,23
1997-12-14,VAN,110,8,14,HOU,105,12,6,20,20
1997-12-15,BOS,100,9,12,PHI,83,6,14,15,26
1997-12-15,WAS,88,9,14,UTA,86,13,8,22,22
1997-12-15,TOR,101,2,20,IND,108,13,8,15,28
1997-12-15,CHI,111,13,9,PHX,104,13,6,26,15
1997-12-15,POR,90,13,7,ATL,99,17,5,30,12
1997-12-16,NYK,83,13,9,DET,78,11,12,24,21
1997-12-16,MIA,95,15,6,UTA,103,13,9,28,15
1997-12-16,CLE,103,14,7,PHX,90,13,7,27,14
1997-12-16,MIN,96,9,12,LAL,109,17,5,26,17
1997-12-16,HOU,118,12,7,VAN,91,9,14,21,21
1997-12-16,DEN,85,2,19,SAS,99,12,10,14,29
1997-12-16,LAC,94,4,19,SEA,109,18,5,22,24
1997-12-16,GSW,103,4,16,DAL,92,5,17,9,33
1997-12-16,SAC,94,7,16,POR,87,13,8,20,24
1997-12-17,NJN,105,12,10,DET,101,11,13,23,23
1997-12-17,PHI,90,6,15,MIN,94,9,13,15,28
1997-12-17,WAS,88,10,14,MIA,74,15,7,25,21
1997-12-17,CHH,99,14,7,MIL,90,11,11,25,18
1997-12-17,ATL,94,18,5,CLE,83,15,7,33,12
1997-12-17,TOR,83,2,21,BOS,88,10,12,12,33
1997-12-17,IND,87,14,8,NYK,80,14,9,28,17
1997-12-17,CHI,104,14,9,LAL,83,18,5,32,14
1997-12-17,SAS,98,13,10,VAN,87,9,15,22,25
1997-12-18,ORL,73,16,8,UTA,85,14,9,30,17
1997-12-18,DAL,75,5,18,PHX,89,13,8,18,26
1997-12-18,LAC,82,4,20,GSW,78,5,16,9,36
1997-12-18,SEA,119,19,5,DEN,106,2,20,21,25
1997-12-19,PHI,84,6,16,MIA,91,15,8,21,24
1997-12-19,WAS,106,11,14,CHH,86,15,7,26,21
1997-12-19,ATL,96,19,5,LAL,98,18,6,37,11
1997-12-19,TOR,92,2,22,MIL,91,11,12,13,34
1997-12-19,CLE,77,15,8,NYK,104,14,10,29,18
1997-12-19,IND,98,15,8,DET,90,11,14,26,22
1997-12-19,HOU,116,13,7,SAC,98,8,16,21,23
1997-12-19,POR,96,13,9,VAN,91,9,16,22,25
1997-12-20,NJN,92,13,10,CHI,100,15,9,28,19
1997-12-20,ORL,92,16,9,IND,95,16,8,32,17
1997-12-20,MIA,99,16,8,ATL,92,19,6,35,14
1997-12-20,CHH,100,15,8,LAL,109,19,6,34,14
1997-12-20,TOR,92,3,22,WAS,94,12,14,15,36
1997-12-20,DET,115,11,15,PHI,78,6,17,17,32
1997-12-20,MIL,98,11,13,NYK,78,15,10,26,23
1997-12-20,MIN,92,10,13,LAC,91,5,20,15,33
1997-12-20,DAL,88,5,19,SAC,89,8,17,13,36
1997-12-20,SAS,100,14,10,HOU,87,14,7,28,17
1997-12-20,DEN,81,2,21,PHX,102,14,8,16,29
1997-12-20,SEA,108,20,5,GSW,89,5,17,25,22
1997-12-21,BOS,99,11,12,LAC,77,5,21,16,33
1997-12-21,CLE,106,15,9,UTA,101,15,9,30,18
1997-12-21,VAN,88,9,17,POR,86,14,9,23,26
1997-12-22,NYK,79,15,11,DAL,67,5,20,20,31
1997-12-22,PHI,92,6,18,DET,96,12,15,18,33
1997-12-22,ORL,88,16,10,NJN,99,13,11,29,21
1997-12-22,CHH,81,15,9,TOR,79,3,23,18,32
1997-12-22,ATL,99,19,7,UTA,101,15,10,34,17
1997-12-22,MIL,79,12,13,WAS,110,13,14,25,27
1997-12-22,HOU,83,14,8,LAL,94,20,6,34,14
1997-12-22,PHX,91,15,8,GSW,76,5,18,20,26
1997-12-22,SAC,89,9,17,MIN,79,11,13,20,30
1997-12-23,BOS,102,12,12,CHH,96,16,9,28,21
1997-12-23,CLE,99,16,9,DAL,85,5,21,21,30
1997-12-23,CHI,94,16,9,LAC,89,5,22,21,31
1997-12-23,SAS,91,15,10,IND,79,17,8,32,18
1997-12-23,GSW,87,5,19,DEN,75,2,22,7,41
1997-12-23,POR,93,14,10,SAC,82,10,17,24,27
1997-12-23,SEA,103,21,5,MIN,112,11,14,32,19
1997-12-25,CHI,90,17,9,MIA,80,17,8,34,17
1997-12-25,UTA,107,16,10,HOU,103,14,9,30,19
1997-12-26,CHH,96,16,10,CLE,88,17,9,33,19
1997-12-26,DET,74,13,15,MIA,88,17,9,30,24
1997-12-26,IND,107,17,9,ORL,81,16,11,33,20
1997-12-26,MIL,99,12,14,ATL,94,19,8,31,22
1997-12-26,MIN,116,12,14,NJN,96,14,11,26,25
1997-12-26,DAL,95,5,22,WAS,97,14,14,19,36
1997-12-26,SAS,101,16,10,BOS,86,13,12,29,22
1997-12-26,DEN,69,2,23,GSW,81,6,19,8,42
1997-12-26,LAL,118,21,6,LAC,114,5,23,26,29
1997-12-26,SAC,95,10,18,SEA,111,21,6,31,24
1997-12-26,VAN,100,10,17,PHX,118,16,8,26,25
1997-12-27,NYK,94,16,11,TOR,97,3,24,19,35
1997-12-27,NJN,112,14,12,MIL,104,13,14,27,26
1997-12-27,ORL,96,16,12,CHH,87,17,10,33,22
1997-12-27,CHI,97,18,9,ATL,90,19,9,37,18
1997-12-27,HOU,111,14,10,WAS,101,15,14,29,24
1997-12-27,UTA,91,17,10,POR,102,15,10,32,20
1997-12-27,LAC,105,5,24,DEN,103,2,24,7,48
1997-12-27,GSW,78,7,19,PHI,85,6,19,13,38
1997-12-28,MIA,101,18,9,IND,90,18,9,36,18
1997-12-28,DET,89,13,16,MIN,93,13,14,26,30
1997-12-28,PHX,97,17,8,SEA,106,22,6,39,14
1997-12-28,LAL,102,22,6,BOS,108,13,13,35,19
1997-12-28,SAC,92,10,19,PHI,90,7,19,17,38
1997-12-28,POR,82,16,10,SAS,79,17,10,33,20
1997-12-28,VAN,88,10,18,UTA,89,17,11,27,29
1997-12-29,NJN,99,15,12,WAS,91,15,15,30,27
1997-12-29,CHI,111,19,9,DAL,105,5,23,24,32
1997-12-29,HOU,101,15,10,CHH,120,17,11,32,21
1997-12-30,ORL,79,17,12,NYK,84,16,12,33,24
1997-12-30,CLE,78,17,10,MIA,90,19,9,36,19
1997-12-30,DET,100,13,17,TOR,95,4,24,17,41
1997-12-30,IND,109,18,10,NJN,91,16,12,34,22
1997-12-30,MIL,105,13,15,DAL,98,5,24,18,39
1997-12-30,MIN,99,14,14,CHI,95,20,9,34,23
1997-12-30,DEN,99,2,25,UTA,132,18,11,20,36
1997-12-30,PHX,100,17,9,BOS,90,14,13,31,22
1997-12-30,LAL,93,22,7,SAC,80,11,19,33,26
1997-12-30,GSW,87,7,20,SEA,101,23,6,30,26
1997-12-30,POR,96,17,10,PHI,86,7,20,24,30
1997-12-30,VAN,115,10,19,SAS,124,17,11,27,30
1997-12-31,WAS,118,15,16,TOR,91,4,25,19,41
1998-01-01,VAN,104,10,20,PHI,115,7,21,17,41
1998-01-02,BOS,93,14,14,MIN,89,15,14,29,28
1998-01-02,NJN,103,16,13,NYK,98,17,12,33,25
1998-01-02,WAS,81,16,16,IND,99,19,10,35,26
1998-01-02,ORL,71,17,13,CLE,81,17,11,34,24
1998-01-02,CHH,99,18,11,MIA,88,20,9,38,20
1998-01-02,TOR,88,4,26,DET,91,14,17,18,43
1998-01-02,CHI,114,20,10,MIL,100,14,15,34,25
1998-01-02,SAS,85,18,11,POR,69,18,10,36,21
1998-01-02,DEN,115,2,26,HOU,116,15,11,17,37
1998-01-02,PHX,92,18,9,DAL,85,5,25,23,34
1998-01-02,LAL,116,23,7,ATL,106,19,10,42,17
1998-01-02,GSW,79,7,21,LAC,94,6,24,13,45
1998-01-02,SAC,94,11,20,VAN,80,10,21,21,41
1998-01-02,SEA,90,24,6,PHI,73,8,21,32,27
1998-01-03,NYK,88,17,13,ORL,84,17,14,34,27
1998-01-03,MIA,77,20,10,SAS,84,19,11,39,21
1998-01-03,CLE,95,18,11,NJN,81,17,13,35,24
1998-01-03,DET,96,15,17,CHI,105,21,10,36,27
1998-01-03,IND,89,20,10,TOR,77,4,27,24,37
1998-01-03,MIL,99,14,16,BOS,106,15,14,29,30
1998-01-03,MIN,109,15,15,DEN,87,2,27,17,42
1998-01-03,HOU,95,16,11,POR,97,18,11,34,22
1998-01-03,UTA,97,19,11,ATL,82,19,11,38,22
1998-01-03,LAC,97,7,24,DAL,88,5,26,12,50
1998-01-04,WAS,109,16,17,PHX,99,19,9,35,26
1998-01-04,LAL,107,24,7,PHI,113,8,22,32,29
1998-01-04,SAC,106,12,20,CHH,90,19,11,31,31
1998-01-04,VAN,108,10,22,SEA,120,25,6,35,28
1998-01-05,NYK,106,18,13,WAS,113,17,17,35,30
1998-01-05,ORL,69,17,15,SAS,74,20,11,37,26
1998-01-05,TOR,96,4,28,HOU,120,16,12,20,40
1998-01-05,POR,92,19,11,MIL,98,14,17,33,28
1998-01-06,CLE,100,19,11,HOU,70,17,12,36,23
1998-01-06,IND,80,21,10,PHX,81,19,10,40,20
1998-01-06,CHI,90,22,10,BOS,79,16,14,38,24
1998-01-06,DAL,108,5,27,DEN,90,2,28,7,55
1998-01-06,UTA,98,20,11,PHI,95,9,22,29,33
1998-01-06,SAC,105,13,20,LAC,89,8,24,21,44
1998-01-06,SEA,102,26,6,CHH,81,19,12,45,18
1998-01-06,VAN,87,10,23,LAL,100,24,8,34,31
1998-01-07,NYK,89,18,14,NJN,88,17,14,35,28
1998-01-07,WAS,110,18,17,BOS,108,16,15,34,32
1998-01-07,MIA,99,20,11,CHI,72,23,10,43,21
1998-01-07,TOR,81,4,29,ORL,83,17,16,21,45
1998-01-07,MIN,77,16,15,PHX,92,20,10,36,25
1998-01-07,SAS,96,21,11,DEN,89,2,29,23,40
1998-01-07,LAC,110,8,25,VAN,102,10,24,18,49
1998-01-07,LAL,114,25,8,MIL,102,15,17,40,25
1998-01-07,GSW,86,7,22,ATL,106,19,12,26,34
1998-01-07,POR,89,19,12,CHH,91,19,13,38,25
1998-01-08,NJN,89,17,15,ORL,87,18,16,35,31
1998-01-08,CLE,84,20,11,SEA,109,27,6,47,17
1998-01-08,DAL,92,6,27,SAC,103,14,20,20,47
1998-01-08,HOU,80,17,13,IND,87,21,11,38,24
1998-01-08,UTA,116,21,11,MIL,109,15,18,36,29
1998-01-09,BOS,92,16,16,SEA,111,28,6,44,22
1998-01-09,NYK,89,19,14,CHI,90,23,11,42,25
1998-01-09,ATL,82,20,12,WAS,77,19,17,39,29
1998-01-09,DET,101,15,18,GSW,72,7,23,22,41
1998-01-09,MIN,96,16,16,POR,91,19,13,35,29
1998-01-09,DEN,79,2,30,MIA,98,21,11,23,41
1998-01-09,PHX,100,21,10,SAS,79,22,11,43,21
1998-01-09,LAC,115,9,25,LAL,125,26,8,35,33
1998-01-09,VAN,90,10,25,CHH,98,20,13,30,38
1998-01-10,NJN,101,18,15,MIN,108,17,16,35,31
1998-01-10,ORL,90,18,17,BOS,82,16,17,34,34
1998-01-10,CLE,93,20,12,TOR,102,4,30,24,42
1998-01-10,CHI,87,24,11,GSW,82,7,24,31,35
1998-01-10,MIL,95,15,19,POR,90,19,14,34,33
1998-01-10,DAL,79,6,28,IND,84,22,11,28,39
1998-01-10,HOU,84,17,14,UTA,111,22,11,39,25
1998-01-10,SAS,109,22,12,SAC,67,15,20,37,32
1998-01-11,NYK,92,19,15,SEA,91,29,6,48,21
1998-01-11,WAS,102,19,18,ATL,107,21,12,40,30
1998-01-11,DET,113,16,18,LAC,85,9,26,25,44
1998-01-11,LAL,93,27,8,CHH,98,21,13,48,21
1998-01-11,VAN,90,10,26,MIA,96,22,11,32,37
1998-01-12,TOR,100,5,30,NJN,108,18,16,23,46
1998-01-12,MIL,110,16,19,LAC,95,9,27,25,46
1998-01-12,MIN,103,18,16,GSW,87,7,25,25,41
1998-01-12,UTA,106,23,11,CLE,99,20,13,43,24
1998-01-12,SAC,96,15,21,PHX,90,22,10,37,31
1998-01-13,BOS,88,16,18,SAS,97,23,12,39,30
1998-01-13,NYK,89,20,15,ATL,91,22,12,42,27
1998-01-13,PHI,107,9,23,VAN,89,10,27,19,50
1998-01-13,CHH,68,22,13,NJN,81,19,16,41,29
1998-01-13,CHI,101,25,11,SEA,91,29,7,54,18
1998-01-13,HOU,100,17,15,DAL,87,6,29,23,44
1998-01-13,DEN,84,2,31,ORL,98,19,17,21,48
1998-01-13,PHX,84,22,11,CLE,102,20,14,42,25
1998-01-13,POR,68,19,15,MIA,76,23,11,42,26
1998-01-14,WAS,79,19,19,SAS,89,24,12,43,31
1998-01-14,ATL,108,23,12,DAL,82,6,30,29,42
1998-01-14,TOR,109,5,31,LAC,101,9,28,14,59
1998-01-14,IND,100,23,11,DET,93,17,18,40,29
1998-01-14,MIL,101,17,19,GSW,95,7,26,24,45
1998-01-14,LAL,132,27,9,DEN,114,2,32,29,41
1998-01-14,SAC,108,16,21,ORL,96,20,17,36,38
1998-01-15,BOS,97,16,19,VAN,93,10,28,26,47
1998-01-15,NJN,116,20,16,LAC,119,9,29,29,45
1998-01-15,PHI,106,10,23,CHI,96,26,11,36,34
1998-01-15,DET,95,17,19,CHH,94,22,14,39,33
1998-01-15,SEA,103,29,8,MIA,85,24,11,53,19
1998-01-16,WAS,112,19,20,VAN,110,10,29,29,49
1998-01-16,CHH,71,22,15,SAS,76,25,12,47,27
1998-01-16,ATL,102,24,12,GSW,89,7,27,31,39
1998-01-16,IND,117,24,11,SAC,92,17,21,41,32
1998-01-16,MIL,86,18,19,CHI,96,26,12,44,31
1998-01-16,HOU,115,18,15,MIN,116,19,16,37,31
1998-01-16,DEN,74,2,33,CLE,99,21,14,23,47
1998-01-16,PHX,111,22,12,ORL,86,20,18,42,30
1998-01-16,POR,96,19,16,UTA,86,24,11,43,27
1998-01-17,NJN,97,20,17,ATL,81,25,12,45,29
1998-01-17,PHI,112,11,23,GSW,84,7,28,18,51
1998-01-17,WAS,108,20,20,LAC,99,10,29,30,49
1998-01-17,TOR,82,6,31,NYK,93,20,16,26,47
1998-01-17,DAL,110,6,31,MIN,113,20,16,26,47
1998-01-17,UTA,107,24,12,ORL,93,20,19,44,31
1998-01-17,LAL,108,28,9,MIA,99,24,12,52,21
1998-01-17,SEA,99,30,8,CLE,91,22,14,52,22
1998-01-18,BOS,96,17,19,IND,103,25,11,42,30
1998-01-18,CHI,106,27,12,HOU,100,18,16,45,28
1998-01-18,MIL,92,18,20,SAS,98,26,12,44,32
1998-01-18,PHX,96,23,12,MIA,87,24,13,47,25
1998-01-18,POR,94,20,16,DEN,82,2,34,22,50
1998-01-19,NYK,98,21,16,BOS,82,17,20,38,36
1998-01-19,NJN,95,21,17,SAS,84,27,12,48,29
1998-01-19,PHI,98,12,23,SAC,85,17,22,29,45
1998-01-19,CHH,109,22,16,TOR,88,6,32,28,48
1998-01-19,MIN,117,21,16,LAC,109,10,30,31,46
1998-01-19,HOU,80,18,17,SEA,114,31,8,49,25
1998-01-19,UTA,98,25,12,DET,89,18,19,43,31
1998-01-19,LAL,92,29,9,ORL,89,20,20,49,29
1998-01-20,ATL,103,25,13,MIL,93,18,21,43,34
1998-01-20,CLE,84,22,15,POR,86,21,16,43,31
1998-01-20,DAL,107,6,32,SEA,98,32,8,38,40
1998-01-20,GSW,69,7,29,PHX,87,24,12,31,41
1998-01-20,VAN,88,10,30,DEN,77,2,35,12,65
1998-01-21,NYK,97,22,16,IND,89,26,11,48,27
1998-01-21,NJN,117,22,17,HOU,112,18,18,40,35
1998-01-21,WAS,87,21,20,POR,100,22,16,43,36
1998-01-21,ORL,84,20,21,MIL,91,18,22,38,43
1998-01-21,MIA,92,24,14,PHI,87,13,23,37,37
1998-01-21,TOR,99,6,33,SAC,98,17,23,23,56
1998-01-21,CHI,110,28,12,CHH,79,23,16,51,28
1998-01-21,MIN,104,22,16,BOS,95,17,21,39,37
1998-01-21,SAS,90,27,13,ATL,76,26,13,53,26
1998-01-21,DEN,67,2,36,DET,87,18,20,20,56
1998-01-21,UTA,98,26,12,GSW,85,7,30,33,42
1998-01-21,PHX,109,25,12,LAL,119,30,9,55,21
1998-01-22,CHH,93,23,17,HOU,86,18,19,41,36
1998-01-22,CLE,112,22,16,SAC,96,17,24,39,40
1998-01-22,LAC,76,10,31,DET,94,19,20,29,51
1998-01-23,NJN,98,23,17,CHI,100,29,12,52,29
1998-01-23,PHI,98,13,24,POR,87,23,16,36,40
1998-01-23,MIA,102,25,14,ORL,90,20,22,45,36
1998-01-23,ATL,85,26,14,BOS,89,17,22,43,36
1998-01-23,IND,106,26,12,UTA,102,27,12,53,24
1998-01-23,SAS,81,28,13,DAL,75,7,32,35,45
1998-01-23,PHX,93,25,13,DEN,77,2,37,27,50
1998-01-23,GSW,80,7,31,VAN,88,11,30,18,61
1998-01-24,WAS,104,21,21,NJN,87,23,18,44,39
1998-01-24,ATL,77,26,15,POR,92,23,17,49,32
1998-01-24,TOR,113,7,33,MIN,107,23,16,30,49
1998-01-24,CLE,111,23,16,PHI,92,14,24,37,40
1998-01-24,DET,92,20,20,NYK,99,23,16,43,36
1998-01-24,IND,95,27,12,BOS,88,18,22,45,34
1998-01-24,MIL,101,19,22,SAC,97,17,25,36,47
1998-01-24,DAL,92,7,33,CHH,94,24,17,31,50
1998-01-24,HOU,112,18,20,SAS,87,29,13,47,33
1998-01-24,LAC,81,10,32,DEN,99,2,38,12,70
1998-01-24,SEA,101,32,9,LAL,95,31,9,63,18
1998-01-24,VAN,107,12,30,GSW,96,7,32,19,62
1998-01-25,CHI,94,30,12,UTA,101,27,13,57,25
1998-01-26,BOS,94,18,23,NYK,85,24,16,42,39
1998-01-26,MIA,93,26,14,CLE,94,24,16,50,30
1998-01-26,ATL,91,26,16,PHX,96,26,13,52,29
1998-01-26,TOR,91,8,33,PHI,87,14,25,22,58
1998-01-26,SAS,115,29,14,HOU,90,19,20,48,34
1998-01-26,SAC,111,17,26,SEA,92,33,9,50,35
1998-01-27,CHH,120,25,17,PHX,113,27,13,52,30
1998-01-27,IND,85,28,12,WAS,84,22,21,50,33
1998-01-27,MIL,83,20,22,DET,81,20,21,40,43
1998-01-27,MIN,113,23,17,ATL,96,26,17,49,34
1998-01-27,DAL,84,7,34,CLE,77,25,16,32,50
1998-01-27,HOU,115,19,21,LAC,109,10,33,29,54
1998-01-27,DEN,87,3,38,NJN,120,23,19,26,57
1998-01-27,POR,78,24,17,GSW,82,7,33,31,50
1998-01-27,VAN,85,13,30,CHI,103,30,13,43,43
1998-01-28,BOS,104,19,23,WAS,102,22,22,41,45
1998-01-28,PHI,90,14,26,IND,93,29,12,43,38
1998-01-28,MIA,86,26,15,NYK,82,24,17,50,32
1998-01-28,DET,91,20,22,ORL,86,20,23,40,45
1998-01-28,SAS,109,30,14,LAC,86,10,34,40,48
1998-01-28,UTA,93,28,13,SEA,101,33,10,61,23
1998-01-28,LAL,95,31,10,NJN,106,24,19,55,29
1998-01-29,NYK,112,24,18,MIL,115,21,22,45,40
1998-01-29,ATL,109,26,18,PHI,99,14,27,40,45
1998-01-29,HOU,88,20,21,ORL,95,20,24,40,45
1998-01-29,DEN,80,3,39,TOR,84,9,33,12,72
1998-01-29,POR,87,24,18,CHI,100,31,13,55,31
1998-01-29,SEA,109,34,10,GSW,97,8,33,42,43
1998-01-29,VAN,106,13,31,MIN,112,24,17,37,48
1998-01-30,BOS,95,20,23,CHH,97,26,17,46,40
1998-01-30,MIA,71,27,15,PHX,74,27,14,54,29
1998-01-30,DET,95,21,22,WAS,102,22,23,43,45
1998-01-30,IND,89,30,12,CLE,83,25,17,55,29
1998-01-30,UTA,104,28,14,DAL,94,8,34,36,48
1998-01-30,LAC,87,10,35,SAS,97,31,14,41,49
1998-01-30,LAL,121,31,11,MIN,114,25,17,56,28
1998-01-30,GSW,80,8,34,CHI,87,32,13,40,47
1998-01-30,SAC,123,18,26,TOR,97,10,33,28,59
1998-01-31,PHI,86,14,28,HOU,102,20,22,34,50
1998-01-31,ORL,94,21,24,PHX,96,28,14,49,38
1998-01-31,CHH,83,27,17,ATL,103,27,18,54,35
1998-01-31,CLE,90,25,18,DET,88,21,23,46,41
1998-01-31,DEN,110,3,40,DAL,98,8,35,11,75
1998-01-31,VAN,106,13,32,NJN,116,25,19,38,51
1998-02-01,BOS,107,20,24,HOU,96,21,22,41,46
1998-02-01,NYK,89,24,19,MIA,83,27,16,51,35
1998-02-01,MIN,110,25,18,MIL,118,22,22,47,40
1998-02-01,LAC,92,10,36,IND,99,31,12,41,48
1998-02-01,LAL,112,32,11,CHI,87,33,13,65,24
1998-02-01,GSW,88,8,35,UTA,115,29,14,37,49
1998-02-01,SAC,97,19,26,SAS,103,32,14,51,40
1998-02-01,POR,97,24,19,TOR,90,10,34,34,53
1998-02-01,SEA,97,35,10,NJN,87,26,19,61,29
1998-02-02,PHI,97,14,29,PHX,106,29,14,43,43
1998-02-02,WAS,113,23,23,DET,101,21,24,44,47
1998-02-02,MIA,90,27,17,ATL,83,28,18,55,35
1998-02-02,CLE,109,26,18,MIN,99,25,19,51,37
1998-02-02,DAL,104,8,36,VAN,90,13,33,21,69
1998-02-02,DEN,72,4,40,CHI,111,33,14,37,54
1998-02-03,ORL,91,21,25,ATL,90,28,19,49,44
1998-02-03,CHH,93,27,18,BOS,89,21,24,48,42
1998-02-03,TOR,105,10,35,PHX,110,30,14,40,49
1998-02-03,MIL,82,23,22,NYK,78,25,19,48,41
1998-02-03,HOU,110,21,23,VAN,97,13,34,34,57
1998-02-03,LAC,111,10,37,UTA,102,30,14,40,51
1998-02-03,GSW,96,8,36,SAS,105,33,14,41,50
1998-02-03,SAC,93,19,27,IND,115,32,12,51,39
1998-02-03,POR,98,25,19,NJN,97,26,20,51,39
1998-02-04,BOS,110,21,25,DAL,99,9,36,30,61
1998-02-04,PHI,84,14,30,MIA,98,28,17,42,47
1998-02-04,WAS,104,24,23,CLE,88,27,18,51,41
1998-02-04,MIN,95,25,20,NYK,88,25,20,50,40
1998-02-04,DEN,99,4,41,SAC,101,19,28,23,69
1998-02-04,UTA,101,30,15,CHI,93,34,14,64,29
1998-02-04,LAL,122,33,11,POR,115,26,19,59,30
1998-02-04,SEA,104,36,10,IND,97,33,12,69,22
1998-02-05,NJN,106,26,21,PHX,94,31,14,57,35
1998-02-05,ORL,93,22,25,WAS,83,25,23,47,48
1998-02-05,CHH,108,28,18,VAN,93,13,35,41,53
1998-02-05,TOR,101,10,36,DAL,93,9,37,19,73
1998-02-05,CLE,94,27,19,ATL,108,28,20,55,39
1998-02-05,DET,104,21,25,HOU,92,22,23,43,48
1998-02-05,MIL,87,24,22,MIA,91,29,17,53,39
1998-02-10,NYK,99,25,21,CHH,91,29,18,54,39
1998-02-10,NJN,90,27,21,DAL,81,9,38,36,59
1998-02-10,CLE,81,27,20,MIA,91,30,17,57,37
1998-02-10,IND,85,33,13,ORL,66,23,25,56,38
1998-02-10,CHI,93,34,15,TOR,86,11,36,45,51
1998-02-10,MIL,100,24,23,ATL,108,29,20,53,43
1998-02-10,HOU,97,22,24,SEA,83,37,10,59,34
1998-02-10,DEN,112,4,42,BOS,99,22,25,26,67
1998-02-10,UTA,106,31,15,LAC,98,11,37,42,52
1998-02-10,PHX,88,31,15,SAC,86,20,28,51,43
1998-02-10,GSW,87,8,37,WAS,99,25,24,33,61
1998-02-10,POR,117,26,20,LAL,105,34,11,60,31
1998-02-11,PHI,91,14,31,DAL,90,9,39,23,70
1998-02-11,MIA,101,31,17,IND,110,34,13,65,30
1998-02-11,CHH,90,29,19,CHI,92,35,15,64,34
1998-02-11,DET,95,22,25,MIL,83,24,24,46,49
1998-02-11,MIN,89,26,20,ORL,96,23,26,49,46
1998-02-11,SAS,105,34,14,SEA,106,37,11,71,25
1998-02-11,LAC,104,11,38,WAS,110,26,24,37,62
1998-02-11,LAL,105,34,12,GSW,99,8,38,42,50
1998-02-12,TOR,94,11,37,CLE,103,27,21,38,58
1998-02-12,UTA,118,32,15,BOS,100,22,26,54,41
1998-02-12,PHX,110,32,15,POR,115,27,20,59,35
1998-02-12,SAC,87,20,29,DEN,84,5,42,25,71
1998-02-12,VAN,103,13,36,HOU,112,23,24,36,60
1998-02-13,NJN,130,28,21,TOR,115,11,38,39,59
1998-02-13,ORL,83,24,26,NYK,99,26,21,50,47
1998-02-13,MIA,100,31,18,DET,86,23,25,54,43
1998-02-13,CHH,103,29,20,PHI,96,15,31,44,51
1998-02-13,IND,82,35,13,DAL,85,9,40,44,53
1998-02-13,CHI,112,36,15,ATL,110,30,20,66,35
1998-02-13,DEN,80,5,43,MIN,107,26,21,31,64
1998-02-13,LAC,96,11,39,BOS,97,22,27,33,66
1998-02-13,LAL,108,35,12,SEA,113,38,11,73,23
1998-02-13,GSW,92,8,39,SAC,109,21,29,29,68
1998-02-13,POR,105,28,20,HOU,81,24,24,52,44
1998-02-14,PHI,98,15,32,NJN,105,29,21,44,53
1998-02-14,ATL,92,30,21,IND,96,35,14,65,35
1998-02-14,CLE,93,28,21,MIL,99,24,25,52,46
1998-02-14,SAS,81,34,15,PHX,94,32,16,66,31
1998-02-14,SEA,91,39,11,UTA,111,33,15,72,26
1998-02-14,VAN,110,13,37,WAS,108,27,24,40,61
1998-02-15,NYK,102,27,21,CLE,91,28,22,55,43
1998-02-15,TOR,95,11,39,MIA,116,32,18,43,57
1998-02-15,CHI,99,37,15,DET,90,23,26,60,41
1998-02-15,MIN,105,27,21,DAL,99,10,40,37,61
1998-02-15,LAL,88,35,13,HOU,90,24,25,59,38
1998-02-15,GSW,101,8,40,BOS,87,23,27,31,67
1998-02-15,SAC,88,22,29,WAS,86,27,25,49,54
1998-02-15,POR,117,29,20,DEN,82,5,44,34,64
1998-02-16,NJN,103,30,21,MIL,92,25,25,55,46
1998-02-16,ATL,81,30,22,ORL,85,24,27,54,49
1998-02-16,UTA,96,34,15,CHH,90,30,20,64,35
1998-02-16,LAC,99,11,40,HOU,121,25,25,36,65
1998-02-17,PHI,98,15,33,CLE,97,28,23,43,56
1998-02-17,MIA,110,33,18,MIN,84,28,21,61,39
1998-02-17,CHI,105,38,15,IND,97,36,14,74,29
1998-02-17,DAL,77,10,41,PHX,95,33,16,43,57
1998-02-17,SAS,95,34,16,DET,94,23,27,57,43
1998-02-17,DEN,77,5,45,NYK,91,28,21,33,66
1998-02-17,SAC,102,23,29,BOS,99,23,28,46,57
1998-02-17,POR,101,30,20,GSW,83,9,40,39,60
1998-02-18,WAS,98,27,26,MIL,108,25,26,52,52
1998-02-18,ORL,115,25,27,MIN,102,28,22,53,49
1998-02-18,ATL,114,30,23,NJN,104,31,21,61,44
1998-02-18,UTA,94,35,15,NYK,78,29,21,64,36
1998-02-18,PHX,110,34,16,LAL,103,35,14,69,30
1998-02-18,GSW,88,9,41,CHH,77,30,21,39,62
1998-02-18,SEA,101,39,12,POR,95,31,20,70,32
1998-02-18,VAN,105,14,37,BOS,114,23,29,37,66
1998-02-19,TOR,86,11,40,CHI,123,39,15,50,55
1998-02-19,IND,82,36,15,PHI,77,16,33,52,48
1998-02-19,DAL,81,10,42,SAS,87,35,16,45,58
1998-02-19,HOU,100,26,25,DET,90,23,28,49,53
1998-02-19,LAC,80,11,41,MIA,89,34,18,45,59
1998-02-19,LAL,131,35,15,DEN,92,5,46,40,61
1998-02-20,NJN,95,31,22,CLE,109,28,24,59,46
1998-02-20,ORL,93,26,27,IND,91,37,15,63,42
1998-02-20,ATL,115,31,23,VAN,92,14,38,45,61
1998-02-20,MIL,94,26,26,TOR,89,11,41,37,67
1998-02-20,MIN,100,28,23,HOU,95,27,25,55,48
1998-02-20,PHX,115,35,16,CHH,99,30,22,65,38
1998-02-20,GSW,95,10,41,DEN,88,5,47,15,88
1998-02-20,SAC,77,24,29,MIA,91,35,18,59,47
1998-02-20,POR,89,31,21,NYK,98,29,22,60,43
1998-02-20,SEA,96,40,12,BOS,106,24,29,64,41
1998-02-21,NJN,89,31,23,PHI,98,16,34,47,57
1998-02-21,WAS,88,27,27,CHI,94,40,15,67,42
1998-02-21,DAL,82,10,43,DET,94,23,29,33,72
1998-02-21,SAS,77,36,16,UTA,79,36,15,72,31
1998-02-21,LAC,98,11,42,CHH,111,30,23,41,65
1998-02-22,NYK,92,30,22,HOU,74,27,26,57,48
1998-02-22,PHI,92,17,34,IND,97,37,16,54,50
1998-02-22,ORL,96,27,27,LAL,94,36,15,63,42
1998-02-22,TOR,113,11,42,VAN,105,14,39,25,81
1998-02-22,MIL,79,27,26,CLE,71,29,24,56,50
1998-02-22,MIN,113,29,23,SAC,95,24,30,53,53
1998-02-22,PHX,97,36,16,SAS,79,36,17,72,33
1998-02-22,GSW,82,11,41,MIA,90,36,18,47,59
1998-02-22,POR,121,31,22,BOS,96,25,29,56,51
1998-02-22,SEA,88,40,13,DEN,68,5,48,45,61
1998-02-23,DET,111,24,29,SAC,85,24,31,48,60
1998-02-23,CHI,97,41,15,CLE,75,29,25,70,40
1998-02-23,DEN,98,5,49,CHH,118,31,23,36,72
1998-02-23,LAC,100,11,43,SEA,101,41,13,52,56
1998-02-24,NYK,82,31,22,GSW,87,11,42,42,64
1998-02-24,NJN,110,31,24,VAN,101,14,40,45,64
1998-02-24,WAS,124,27,28,HOU,112,27,27,54,55
1998-02-24,MIL,81,28,26,LAL,98,36,16,64,42
1998-02-24,SAS,105,36,18,MIN,99,30,23,66,41
1998-02-24,UTA,102,37,15,MIA,104,37,18,74,33
1998-02-24,PHX,84,37,16,PHI,85,17,35,54,51
1998-02-25,BOS,111,25,30,SAC,94,24,32,49,62
1998-02-25,ORL,100,28,27,DAL,79,10,44,38,71
1998-02-25,CLE,106,29,26,VAN,101,14,41,43,67
1998-02-25,DET,88,25,29,CHH,98,32,23,57,52
1998-02-25,IND,89,38,16,LAL,96,37,16,75,32
1998-02-25,CHI,101,42,15,POR,106,32,22,74,37
1998-02-25,DEN,88,5,50,ATL,112,32,23,37,73
1998-02-25,LAC,117,11,44,PHI,108,18,35,29,79
1998-02-26,NYK,102,31,23,MIL,90,28,27,59,50
1998-02-26,NJN,102,32,24,SAC,99,24,33,56,57
1998-02-26,WAS,110,28,28,GSW,87,12,42,40,70
1998-02-26,MIA,91,38,18,DAL,72,10,45,48,63
1998-02-26,HOU,118,27,28,MIN,98,30,24,57,52
1998-02-26,SAS,97,37,18,TOR,86,12,42,49,60
1998-02-26,UTA,108,37,16,PHX,97,37,17,74,33
1998-02-27,BOS,120,26,30,GSW,88,12,43,38,73
1998-02-27,ORL,107,29,27,TOR,115,12,43,41,70
1998-02-27,DET,90,25,30,CLE,87,30,26,55,56
1998-02-27,IND,124,38,17,POR,59,33,22,71,39
1998-02-27,MIN,91,30,25,LAL,104,38,16,68,41
1998-02-27,DEN,78,5,51,PHI,79,18,36,23,87
1998-02-27,LAC,99,12,44,PHX,104,37,18,49,62
1998-02-27,SEA,90,42,13,ATL,88,33,23,75,36
1998-02-28,NJN,93,33,24,MIA,95,39,18,72,42
1998-02-28,WAS,77,29,28,DAL,103,10,46,39,74
1998-02-28,CHH,90,33,23,ORL,80,29,28,62,51
1998-02-28,CHI,109,42,16,SAC,94,24,34,66,50
1998-02-28,SAS,100,38,18,PHI,88,19,36,57,54
1998-03-01,BOS,102,27,30,POR,101,33,23,60,53
1998-03-01,NYK,101,32,23,LAL,89,39,16,71,39
1998-03-01,MIA,85,40,18,NJN,84,33,25,73,43
1998-03-01,CLE,102,30,27,GSW,82,12,44,42,71
1998-03-01,IND,90,39,17,DEN,63,5,52,44,69
1998-03-01,MIN,115,30,26,DET,113,26,30,56,56
1998-03-01,HOU,100,28,28,UTA,106,38,16,66,44
1998-03-01,SEA,89,43,13,PHX,87,38,18,81,31
1998-03-01,VAN,76,14,42,ATL,101,33,24,47,66
1998-03-02,WAS,96,29,29,LAL,86,39,17,68,46
1998-03-02,CHH,112,34,23,GSW,83,12,45,46,68
1998-03-02,DET,100,26,31,DAL,94,11,46,37,77
1998-03-02,SAC,95,24,35,SAS,116,39,18,63,53
1998-03-03,NYK,94,33,23,NJN,91,33,26,66,49
1998-03-03,MIA,91,41,18,SEA,97,44,13,85,31
1998-03-03,TOR,93,13,43,UTA,108,39,16,52,59
1998-03-03,CHI,118,43,16,DEN,90,5,53,48,69
1998-03-03,MIN,99,31,26,DAL,110,11,47,42,73
1998-03-03,HOU,107,28,29,LAC,97,12,45,40,74
1998-03-03,POR,98,33,24,PHX,93,38,19,71,43
1998-03-03,VAN,103,14,43,IND,111,40,17,54,60
1998-03-04,BOS,94,28,30,UTA,110,40,16,68,46
1998-03-04,PHI,87,19,37,MIL,80,28,28,47,65
1998-03-04,ORL,96,29,29,SEA,83,45,13,74,42
1998-03-04,CHH,112,35,23,MIN,102,31,27,66,50
1998-03-04,CLE,122,31,27,TOR,88,13,44,44,71
1998-03-04,LAL,104,39,18,IND,95,41,17,80,35
1998-03-04,GSW,90,12,46,SAS,83,40,18,52,64
1998-03-04,SAC,109,24,36,DET,89,27,31,51,67
1998-03-05,WAS,103,30,29,NYK,90,34,23,64,52
1998-03-05,MIL,104,28,29,DEN,87,5,54,33,83
1998-03-05,DAL,119,12,47,LAC,109,12,46,24,93
1998-03-05,HOU,93,29,29,MIA,117,41,19,70,48
1998-03-05,PHX,102,38,20,DET,93,27,32,65,52
1998-03-06,BOS,108,28,31,WAS,98,31,29,59,60
1998-03-06,NJN,115,33,27,UTA,122,41,16,74,43
1998-03-06,PHI,80,20,37,NYK,71,34,24,54,61
1998-03-06,ORL,91,30,29,CLE,89,32,27,62,56
1998-03-06,CHH,104,36,23,SEA,98,45,14,81,37
1998-03-06,ATL,115,34,24,DEN,94,5,55,39,79
1998-03-06,MIN,113,31,28,TOR,91,13,45,44,73
1998-03-06,LAL,91,40,18,SAS,84,40,19,80,37
1998-03-06,GSW,87,13,46,IND,101,41,18,54,64
1998-03-06,VAN,96,14,44,SAC,98,25,36,39,80
1998-03-07,MIL,92,29,29,UTA,110,42,16,71,45
1998-03-07,DAL,88,13,47,MIA,94,42,19,55,66
1998-03-07,PHX,89,39,20,HOU,108,29,30,68,50
1998-03-08,NYK,89,34,25,CHI,102,44,16,78,41
1998-03-08,NJN,100,33,28,CHH,109,37,23,70,51
1998-03-08,WAS,100,31,30,PHI,91,21,37,52,67
1998-03-08,ATL,101,35,24,CLE,96,32,28,67,52
1998-03-08,IND,104,42,18,BOS,100,29,31,71,49
1998-03-08,MIN,98,32,28,SEA,99,45,15,77,43
1998-03-08,DEN,89,5,56,LAC,100,12,47,17,103
1998-03-08,LAL,96,41,18,DET,89,27,33,68,51
1998-03-08,POR,78,34,24,SAS,82,40,20,74,44
1998-03-08,VAN,113,14,45,TOR,106,13,46,27,91
1998-03-09,PHI,78,21,38,ORL,88,31,29,52,67
1998-03-09,UTA,100,43,16,HOU,93,30,30,73,46
1998-03-09,PHX,134,39,21,LAC,105,13,47,52,68
1998-03-09,SAC,88,26,36,GSW,93,13,47,39,83
1998-03-10,NYK,85,34,26,ORL,78,32,29,66,55
1998-03-10,CHI,106,45,16,MIA,91,43,19,88,35
1998-03-10,MIL,77,29,30,WAS,93,32,30,61,60
1998-03-10,HOU,97,30,31,DAL,91,13,48,43,79
1998-03-10,SAS,79,41,20,NJN,78,33,29,74,49
1998-03-10,DEN,76,5,57,PHX,100,40,21,45,78
1998-03-10,SEA,111,46,15,TOR,93,13,47,59,62
1998-03-11,BOS,105,29,32,ATL,110,36,24,65,56
1998-03-11,PHI,88,21,39,WAS,86,33,30,54,69
1998-03-11,CHH,85,38,23,NYK,78,35,26,73,49
1998-03-11,CLE,95,32,29,MIL,83,29,31,61,60
1998-03-11,DET,122,27,34,IND,91,43,18,70,52
1998-03-11,UTA,110,44,16,SAC,95,26,37,70,53
1998-03-11,LAL,121,42,18,POR,107,34,25,76,43
1998-03-11,GSW,84,14,47,MIN,113,32,29,46,76
1998-03-12,MIA,97,43,20,CLE,74,33,29,76,49
1998-03-12,DAL,104,13,49,CHI,97,46,16,59,65
1998-03-12,HOU,115,31,31,NJN,104,33,30,64,61
1998-03-12,SAS,97,42,20,SAC,86,26,38,68,58
1998-03-12,DEN,98,5,58,VAN,93,15,45,20,103
1998-03-12,LAC,85,13,48,LAL,108,43,18,56,66
1998-03-12,POR,95,34,26,MIN,92,33,29,67,55
1998-03-13,BOS,92,29,33,DET,96,28,34,57,67
1998-03-13,PHI,107,22,39,ATL,86,37,24,59,63
1998-03-13,ORL,82,32,30,CHH,100,39,23,71,53
1998-03-13,IND,96,43,19,MIL,76,29,32,72,51
1998-03-13,UTA,110,45,16,VAN,101,15,46,60,62
1998-03-13,PHX,101,41,21,GSW,77,14,48,55,69
1998-03-13,LAC,152,13,49,TOR,120,13,48,26,97
1998-03-14,CHH,80,40,23,WAS,83,33,31,73,54
1998-03-14,CLE,88,33,30,NYK,85,35,27,68,57
1998-03-14,MIL,89,29,33,PHI,93,23,39,52,72
1998-03-14,DAL,93,14,49,NJN,108,33,31,47,80
1998-03-14,HOU,89,32,31,SAC,86,26,39,58,70
1998-03-14,SAS,86,43,20,CHI,96,46,17,89,37
1998-03-14,DEN,92,6,58,POR,82,35,26,41,84
1998-03-14,SEA,114,47,15,MIN,80,33,30,80,45
1998-03-15,NYK,86,35,28,IND,91,44,19,79,47
1998-03-15,ORL,76,32,31,MIA,79,44,20,76,51
1998-03-15,ATL,93,37,25,BOS,77,29,34,66,59
1998-03-15,DET,98,29,34,UTA,109,46,16,75,50
1998-03-15,PHX,100,42,21,DAL,90,14,50,56,71
1998-03-15,GSW,98,14,49,TOR,100,13,49,27,98
1998-03-15,POR,103,35,27,LAC,92,14,49,49,76
1998-03-15,VAN,110,15,47,LAL,119,44,18,59,65
1998-03-16,MIA,90,45,20,DET,103,29,35,74,55
1998-03-16,CHH,109,40,24,DEN,87,7,58,47,82
1998-03-16,CHI,88,47,17,NJN,72,34,31,81,48
1998-03-16,MIN,96,33,31,UTA,102,47,16,80,47
1998-03-16,SAS,96,43,21,MIL,85,29,34,72,55
1998-03-16,SEA,101,48,15,LAL,89,45,18,93,33
1998-03-17,NYK,100,35,29,PHI,96,24,39,59,68
1998-03-17,WAS,89,34,31,DEN,90,7,59,41,90
1998-03-17,ORL,99,32,32,VAN,92,15,48,47,80
1998-03-17,TOR,105,14,49,ATL,117,38,25,52,74
1998-03-17,IND,84,45,19,CHI,90,48,17,93,36
1998-03-17,DAL,99,14,51,BOS,93,29,35,43,86
1998-03-17,HOU,96,33,31,MIL,91,29,35,62,66
1998-03-17,PHX,107,43,21,SAC,80,26,40,69,61
1998-03-17,GSW,102,14,50,LAC,107,14,50,28,100
1998-03-17,POR,82,36,27,CLE,96,34,30,70,57
1998-03-18,MIA,94,45,21,VAN,91,15,49,60,70
1998-03-18,CHH,111,41,24,UTA,85,48,16,89,40
1998-03-18,DET,96,30,35,PHI,104,24,40,54,75
1998-03-18,MIN,76,33,32,SAS,92,44,21,77,53
1998-03-18,LAL,99,45,19,PHX,93,44,21,89,40
1998-03-18,SEA,99,49,15,LAC,80,15,50,64,65
1998-03-19,NYK,77,36,29,POR,82,36,28,72,57
1998-03-19,NJN,93,34,32,ORL,87,33,32,67,64
1998-03-19,WAS,91,34,32,IND,95,45,20,79,52
1998-03-19,ATL,84,39,25,MIL,81,29,36,68,61
1998-03-19,TOR,104,14,50,DEN,103,8,59,22,109
1998-03-19,DAL,88,15,51,GSW,82,14,51,29,102
1998-03-19,HOU,105,34,31,BOS,96,29,36,63,67
1998-03-19,SAC,85,26,41,CLE,90,35,30,61,71
1998-03-20,NYK,109,36,30,ATL,108,40,25,76,55
1998-03-20,PHI,79,25,40,UTA,91,48,17,73,57
1998-03-20,ORL,102,33,33,POR,87,37,28,70,61
1998-03-20,MIA,93,46,21,GSW,87,14,52,60,73
1998-03-20,DET,105,30,36,TOR,99,15,50,45,86
1998-03-20,IND,99,46,20,NJN,92,35,32,81,52
1998-03-20,CHI,98,49,17,VAN,92,15,50,64,67
1998-03-20,MIN,104,33,33,DEN,88,8,60,41,93
1998-03-20,SAS,82,45,21,CHH,92,42,24,87,45
1998-03-20,LAL,93,46,19,SEA,80,50,15,96,34
1998-03-21,MIN,102,34,33,VAN,88,15,51,49,84
1998-03-21,DAL,95,16,51,HOU,103,35,31,51,82
1998-03-21,PHX,109,44,22,SEA,102,50,16,94,38
1998-03-21,LAC,79,15,51,CLE,100,36,30,51,81
1998-03-22,BOS,108,29,37,PHI,90,25,41,54,78
1998-03-22,NYK,119,37,30,UTA,124,49,17,86,47
1998-03-22,NJN,100,35,33,WAS,102,34,33,69,66
1998-03-22,ORL,92,34,33,GSW,83,14,53,48,86
1998-03-22,MIA,112,47,21,POR,80,37,29,84,50
1998-03-22,TOR,100,15,51,CHI,102,50,17,65,68
1998-03-22,DET,105,31,36,ATL,98,40,26,71,62
1998-03-22,MIL,94,29,37,IND,96,47,20,76,57
1998-03-22,SAS,93,45,22,PHX,83,45,22,90,44
1998-03-22,SAC,93,26,42,LAL,96,47,19,73,61
1998-03-23,PHI,79,25,42,DET,94,32,36,57,78
1998-03-23,CHI,111,51,17,BOS,88,30,37,81,54
1998-03-23,DAL,91,16,52,MIN,87,35,33,51,85
1998-03-23,DEN,86,8,61,LAL,107,48,19,56,80
1998-03-23,SEA,109,50,17,SAC,83,26,43,76,60
1998-03-23,VAN,106,15,52,LAC,95,15,52,30,104
1998-03-24,ATL,85,40,27,ORL,73,35,33,75,60
1998-03-24,TOR,89,15,52,CHH,106,43,24,58,76
1998-03-24,CLE,85,37,30,SAS,86,46,22,83,52
1998-03-24,MIL,118,29,38,HOU,108,36,31,65,69
1998-03-24,UTA,92,50,17,PHX,73,45,23,95,40
1998-03-24,GSW,75,14,54,NYK,88,37,31,51,85
1998-03-24,POR,87,37,30,WAS,99,35,33,72,63
1998-03-25,BOS,91,30,38,MIA,105,48,21,78,59
1998-03-25,PHI,86,25,43,NJN,91,35,34,60,77
1998-03-25,ORL,70,35,34,CHI,85,52,17,87,51
1998-03-25,DET,103,33,36,SAS,94,47,22,80,58
1998-03-25,IND,81,48,20,HOU,86,36,32,84,52
1998-03-25,DEN,94,8,62,DAL,105,17,52,25,114
1998-03-25,PHX,97,45,24,MIN,99,35,34,80,58
1998-03-25,LAC,76,15,53,NYK,77,38,31,53,84
1998-03-25,LAL,114,49,19,SAC,91,26,44,75,63
1998-03-25,SEA,133,51,17,WAS,109,36,33,87,50
1998-03-26,CHH,94,44,24,MIL,80,30,38,74,62
1998-03-26,TOR,96,15,53,CLE,97,37,31,52,84
1998-03-26,GSW,98,14,55,SEA,91,52,17,66,72
1998-03-26,POR,108,37,31,VAN,102,16,52,53,83
1998-03-27,NJN,76,36,34,BOS,82,30,39,66,73
1998-03-27,PHI,85,25,44,SAS,110,47,23,72,67
1998-03-27,ORL,100,35,35,HOU,75,37,32,72,67
1998-03-27,MIA,102,49,21,MIL,77,30,39,79,60
1998-03-27,ATL,74,41,27,CHI,89,53,17,94,44
1998-03-27,CLE,88,38,31,DET,87,34,36,72,67
1998-03-27,IND,133,48,21,CHH,96,45,24,93,45
1998-03-27,DAL,90,18,52,UTA,99,51,17,69,69
1998-03-27,DEN,97,8,63,GSW,89,15,55,23,118
1998-03-27,PHX,89,45,25,WAS,85,36,34,81,59
1998-03-27,LAC,98,15,54,MIN,100,36,34,51,88
1998-03-27,SAC,73,26,45,POR,90,38,31,64,76
1998-03-27,VAN,89,16,53,NYK,97,39,31,55,84
1998-03-28,UTA,106,52,17,LAL,91,50,19,102,36
1998-03-28,SEA,104,52,18,NYK,78,40,31,92,49
1998-03-29,PHI,99,25,45,BOS,94,31,39,56,84
1998-03-29,MIA,109,50,21,HOU,77,37,33,87,54
1998-03-29,ATL,118,41,28,DET,95,34,37,75,65
1998-03-29,TOR,68,15,54,ORL,95,36,35,51,89
1998-03-29,CLE,97,39,31,CHH,82,45,25,84,56
1998-03-29,IND,55,49,21,SAS,74,48,23,97,44
1998-03-29,MIL,87,30,40,CHI,104,54,17,84,57
1998-03-29,PHX,106,46,25,VAN,98,16,54,62,79
1998-03-29,LAC,108,15,55,DAL,86,18,53,33,108
1998-03-29,LAL,116,50,20,WAS,89,36,35,86,55
1998-03-29,GSW,83,15,56,POR,99,39,31,54,87
1998-03-29,SAC,96,26,46,MIN,104,37,34,63,80
1998-03-31,NYK,78,40,32,SAS,95,49,23,89,55
1998-03-31,NJN,105,36,35,ATL,90,42,28,78,63
1998-03-31,MIA,121,51,21,BOS,95,31,40,82,61
1998-03-31,CHH,101,45,26,PHI,93,26,45,71,71
1998-03-31,TOR,105,15,55,LAL,114,51,20,66,75
1998-03-31,CLE,93,40,31,ORL,86,37,35,77,66
1998-03-31,IND,128,49,22,LAC,106,16,55,65,77
1998-03-31,CHI,106,55,17,DET,101,34,38,89,55
1998-03-31,HOU,86,37,34,PHX,97,47,25,84,59
1998-03-31,GSW,89,15,57,MIL,94,30,41,45,98
1998-03-31,SEA,88,53,18,UTA,86,53,17,106,35
1998-03-31,VAN,101,16,55,DAL,104,18,54,34,109
1998-04-01,WAS,91,36,36,PHI,112,26,46,62,82
1998-04-01,ORL,87,37,36,BOS,98,31,41,68,77
1998-04-01,ATL,105,42,29,TOR,91,15,56,57,85
1998-04-01,DET,90,34,39,CLE,92,41,31,75,70
1998-04-01,DEN,100,9,63,MIL,106,31,41,40,104
1998-04-01,UTA,98,53,18,POR,89,40,31,93,49
1998-04-02,NYK,81,40,33,LAC,70,16,56,56,89
1998-04-02,NJN,106,37,35,LAL,117,52,20,89,55
1998-04-02,IND,111,50,22,MIN,108,38,34,88,56
1998-04-02,HOU,94,37,35,GSW,104,15,58,52,93
1998-04-02,SAS,103,50,23,MIA,89,52,21,102,44
1998-04-02,SEA,107,54,18,DAL,86,19,54,73,72
1998-04-03,PHI,93,27,46,LAC,78,16,57,43,103
1998-04-03,WAS,120,36,37,TOR,112,15,57,51,94
1998-04-03,CHH,96,46,26,IND,89,51,22,97,48
1998-04-03,ATL,107,43,29,HOU,87,37,36,80,65
1998-04-03,CLE,93,42,31,LAL,105,53,20,95,51
1998-04-03,DET,100,34,40,BOS,101,32,41,66,81
1998-04-03,CHI,107,56,17,MIN,93,38,35,94,52
1998-04-03,UTA,97,54,18,DEN,75,9,64,63,82
1998-04-03,SAC,86,26,47,MIL,87,32,41,58,88
1998-04-03,POR,109,40,32,DAL,102,19,55,59,87
1998-04-03,VAN,98,16,56,SEA,138,55,18,71,74
1998-04-04,NJN,97,37,36,NYK,94,41,33,78,69
1998-04-04,MIA,101,52,22,CHH,88,47,26,99,48
1998-04-04,SAS,88,51,23,GSW,80,16,58,67,81
1998-04-04,PHX,90,48,25,POR,83,41,32,89,57
1998-04-05,BOS,102,33,41,NYK,92,41,34,74,75
1998-04-05,PHI,116,28,46,TOR,104,15,58,43,104
1998-04-05,WAS,88,37,37,ORL,85,37,37,74,74
1998-04-05,ATL,96,44,29,MIN,97,38,36,82,65
1998-04-05,CLE,94,42,32,LAC,93,16,58,58,90
1998-04-05,DET,103,34,41,LAL,105,54,20,88,61
1998-04-05,IND,93,51,23,MIL,92,33,41,84,64
1998-04-05,HOU,94,37,37,CHI,109,57,17,94,54
1998-04-05,DEN,83,9,65,SEA,87,56,18,65,83
1998-04-05,SAC,105,26,48,DAL,99,19,56,45,104
1998-04-05,VAN,93,16,57,UTA,99,55,18,71,75
1998-04-06,NJN,125,38,36,CHH,115,47,27,85,63
1998-04-06,ORL,113,37,38,PHI,92,29,46,66,84
1998-04-06,SAS,75,52,23,POR,79,41,33,93,56
1998-04-06,SEA,92,57,18,PHX,102,49,25,106,43
1998-04-07,ATL,92,44,30,NYK,79,41,35,85,65
1998-04-07,IND,82,52,23,CLE,80,43,32,95,55
1998-04-07,CHI,103,58,17,WAS,85,38,37,96,54
1998-04-07,MIL,114,33,42,TOR,105,15,59,48,101
1998-04-07,MIN,92,39,36,MIA,89,53,22,92,58
1998-04-07,DAL,91,19,57,POR,99,42,33,61,90
1998-04-07,DEN,87,9,66,HOU,104,37,38,46,104
1998-04-07,LAC,94,16,59,VAN,110,16,58,32,117
1998-04-07,GSW,99,16,59,UTA,101,56,18,72,77
1998-04-07,SAC,97,27,48,PHX,103,50,25,77,73
1998-04-08,BOS,104,34,41,NJN,117,39,36,73,77
1998-04-08,NYK,83,41,36,MIA,80,53,23,94,59
1998-04-08,PHI,109,29,47,CHH,101,47,28,76,75
1998-04-08,ORL,95,38,38,DET,87,34,42,72,80
1998-04-08,TOR,100,15,60,MIL,107,34,42,49,102
1998-04-08,UTA,98,57,18,SAS,88,52,24,109,42
1998-04-08,LAL,113,55,20,VAN,102,17,58,72,78
1998-04-09,WAS,83,38,38,DET,102,34,43,72,81
1998-04-09,ATL,102,45,30,IND,105,53,23,98,53
1998-04-09,CLE,91,43,33,CHI,85,59,17,102,50
1998-04-09,DAL,101,19,58,SEA,103,57,19,76,77
1998-04-09,DEN,128,9,67,SAC,103,27,49,36,116
1998-04-09,LAC,95,16,60,POR,99,43,33,59,93
1998-04-09,GSW,89,16,60,HOU,93,38,38,54,98
1998-04-10,BOS,82,34,42,ORL,80,39,38,73,80
1998-04-10,CHH,87,47,29,ATL,99,45,31,92,60
1998-04-10,TOR,105,15,61,MIA,111,53,24,68,85
1998-04-10,MIN,107,40,36,PHI,102,30,47,70,83
1998-04-10,SAS,99,52,25,SEA,84,58,19,110,44
1998-04-10,UTA,126,58,18,LAC,109,16,61,74,79
1998-04-10,LAL,105,56,20,PHX,114,51,25,107,45
1998-04-10,SAC,85,27,50,HOU,97,39,38,66,88
1998-04-11,CLE,106,44,33,PHI,95,30,48,74,81
1998-04-11,CHI,87,59,18,ORL,78,39,39,98,57
1998-04-11,MIL,117,35,42,NJN,124,40,36,75,78
1998-04-11,MIN,110,41,36,UTA,103,59,18,100,54
1998-04-11,DAL,99,19,59,DEN,81,10,67,29,126
1998-04-11,GSW,84,16,61,LAL,96,56,21,72,82
1998-04-11,VAN,105,17,59,POR,96,44,33,61,92
1998-04-12,BOS,87,35,42,IND,93,54,23,89,65
1998-04-12,WAS,81,38,39,ATL,91,46,31,84,70
1998-04-12,MIA,82,54,24,NYK,81,42,36,96,60
1998-04-12,CHH,88,47,30,DET,86,35,43,82,73
1998-04-12,TOR,109,15,62,NJN,116,41,36,56,98
1998-04-12,SEA,103,58,20,HOU,95,40,38,98,58
1998-04-12,VAN,106,18,59,PHX,129,52,25,70,84
1998-04-13,CHI,105,60,18,IND,114,55,23,115,41
1998-04-13,SAS,75,53,25,LAL,99,57,21,110,46
1998-04-13,LAC,88,16,62,MIN,107,42,36,58,98
1998-04-13,GSW,97,16,62,PHX,105,53,25,69,87
1998-04-14,NYK,102,42,37,WAS,104,38,40,80,77
1998-04-14,NJN,92,42,36,TOR,96,15,63,57,99
1998-04-14,ATL,95,47,31,PHI,94,30,49,77,80
1998-04-14,CLE,95,45,33,BOS,86,35,43,80,76
1998-04-14,MIL,82,35,43,CHH,104,48,30,83,73
1998-04-14,DAL,95,20,59,LAL,111,58,21,78,80
1998-04-14,HOU,94,40,39,DEN,88,10,68,50,107
1998-04-14,UTA,126,59,19,MIN,109,43,36,102,55
1998-04-14,POR,92,44,34,SAC,66,27,51,71,85
1998-04-14,SEA,110,59,20,VAN,98,18,60,77,80
1998-04-15,BOS,109,35,44,MIL,117,35,44,70,88
1998-04-15,WAS,101,39,40,CLE,93,46,33,85,73
1998-04-15,MIA,87,55,24,ORL,99,39,40,94,64
1998-04-15,CHH,109,49,30,NJN,103,42,37,91,67
1998-04-15,DET,87,35,44,CHI,79,60,19,95,63
1998-04-15,IND,82,56,23,ATL,70,48,31,104,54
1998-04-15,PHX,96,54,25,DEN,89,10,69,64,94
1998-04-15,LAC,80,16,63,GSW,92,16,63,32,126
1998-04-16,NYK,108,42,38,TOR,79,16,63,58,101
1998-04-16,UTA,99,60,19,SAC,86,27,52,87,71
1998-04-16,GSW,88,17,63,DAL,82,20,60,37,123
1998-04-16,POR,99,45,34,LAC,90,16,64,61,98
1998-04-16,VAN,97,18,61,SAS,110,53,26,71,87
1998-04-17,BOS,78,35,45,CLE,71,46,34,81,79
1998-04-17,PHI,80,30,50,CHI,87,60,20,90,70
1998-04-17,ORL,121,40,40,NJN,109,42,38,82,78
1998-04-17,MIA,89,55,25,WAS,97,40,40,95,65
1998-04-17,ATL,121,48,32,CHH,104,50,30,98,62
1998-04-17,DET,108,36,44,MIL,102,36,44,72,88
1998-04-17,IND,107,57,23,TOR,98,16,64,73,87
1998-04-17,MIN,102,43,37,HOU,95,41,39,84,76
1998-04-17,DEN,109,10,70,POR,101,46,34,56,104
1998-04-17,PHX,99,55,25,UTA,102,61,19,116,44
1998-04-17,LAL,124,59,21,DAL,95,20,61,79,82
1998-04-17,SEA,87,60,20,SAS,89,54,26,114,46
1998-04-18,WAS,112,41,40,BOS,95,36,45,77,85
1998-04-18,CLE,96,46,35,IND,92,58,23,104,58
1998-04-18,CHI,111,61,20,NYK,109,43,38,104,58
1998-04-18,MIL,109,36,45,MIN,111,44,37,80,82
1998-04-18,LAC,83,16,65,SAC,77,27,53,43,118
1998-04-18,GSW,112,18,63,VAN,100,18,62,36,125
1998-04-19,NJN,114,42,39,DET,101,37,44,79,83
1998-04-19,CHH,89,50,31,ORL,76,41,40,91,71
1998-04-19,ATL,101,49,32,MIA,89,55,26,104,58
1998-04-19,TOR,78,16,65,PHI,107,30,51,46,116
1998-04-19,HOU,93,41,40,PHX,123,55,26,96,66
1998-04-19,SAS,96,55,26,DEN,82,11,70,66,96
1998-04-19,LAL,102,60,21,UTA,98,62,19,122,40
1998-04-19,SAC,108,27,54,VAN,112,18,63,45,117
1998-04-19,POR,82,46,35,SEA,90,60,21,106,56
1999-02-05,BOS,92,0,0,TOR,103,0,0,0,0
1999-02-05,ORL,93,0,0,NYK,85,0,0,0,0
1999-02-05,MIA,81,0,0,DET,95,0,0,0,0
1999-02-05,CHH,66,0,0,PHI,78,0,0,0,0
1999-02-05,ATL,100,0,0,CLE,83,0,0,0,0
1999-02-05,IND,96,0,0,WAS,81,0,0,0,0
1999-02-05,SAS,101,0,0,SAC,83,0,0,0,0
1999-02-05,DEN,92,0,0,MIN,110,0,0,0,0
1999-02-05,UTA,104,0,0,CHI,96,0,0,0,0
1999-02-05,LAC,92,0,0,PHX,101,0,0,0,0
1999-02-05,LAL,99,0,0,HOU,91,0,0,0,0
1999-02-05,SEA,92,0,0,DAL,86,0,0,0,0
1999-02-06,BOS,77,0,1,CLE,73,0,1,0,2
1999-02-06,PHI,95,1,0,ORL,75,1,0,2,0
1999-02-06,WAS,98,0,1,TOR,97,1,0,1,1
1999-02-06,CHH,107,0,1,MIL,113,0,0,0,1
1999-02-06,ATL,111,1,0,NJN,106,0,0,1,0
1999-02-06,SAS,96,1,0,MIN,82,1,0,2,0
1999-02-06,GSW,84,0,0,HOU,86,0,1,0,1
1999-02-07,NYK,79,0,1,MIA,83,0,1,0,2
1999-02-07,NJN,79,0,1,ATL,69,2,0,2,1
1999-02-07,DET,107,1,0,IND,98,1,0,2,0
1999-02-07,PHX,115,1,0,DEN,108,0,1,1,1
1999-02-07,LAC,84,0,1,CHI,89,0,1,0,2
1999-02-07,LAL,91,1,0,UTA,100,1,0,2,0
1999-02-07,GSW,99,0,1,DAL,102,0,1,0,2
1999-02-07,SAC,109,0,1,VAN,87,0,0,0,1
1999-02-07,SEA,91,1,0,POR,88,0,0,1,0
1999-02-08,ORL,107,1,1,BOS,90,1,1,2,2
1999-02-08,CHH,94,0,2,MIA,91,1,1,1,3
1999-02-08,CLE,89,0,2,IND,95,1,1,1,3
1999-02-08,DET,106,2,0,WAS,103,1,1,3,1
1999-02-08,HOU,99,1,1,DEN,80,0,2,1,3
1999-02-08,SAS,75,2,0,LAL,80,1,1,3,1
1999-02-08,VAN,76,0,1,POR,95,0,1,0,2
1999-02-09,PHI,90,2,0,DET,86,3,0,5,0
1999-02-09,MIA,101,1,2,BOS,108,1,2,2,4
1999-02-09,TOR,77,1,1,MIL,91,1,0,2,1
1999-02-09,CHI,71,1,1,ATL,87,2,1,3,2
1999-02-09,MIN,74,1,1,SAS,70,2,1,3,2
1999-02-09,DAL,79,1,1,UTA,90,2,0,3,1
1999-02-09,PHX,95,2,0,SAC,112,1,1,3,1
1999-02-09,SEA,90,2,0,GSW,71,0,2,2,2
1999-02-10,NYK,101,0,2,WAS,88,1,2,1,4
1999-02-10,NJN,81,1,1,ORL,89,2,1,3,2
1999-02-10,CHH,77,1,2,CLE,87,0,3,1,5
1999-02-10,HOU,92,2,1,SAC,82,2,1,4,2
1999-02-10,DEN,98,0,3,LAL,103,2,1,2,4
1999-02-10,GSW,82,0,3,SEA,89,3,0,3,3
1999-02-10,POR,100,1,1,IND,92,2,1,3,2
1999-02-10,VAN,105,0,2,LAC,99,0,2,0,4
1999-02-11,MIA,102,1,3,TOR,84,1,2,2,5
1999-02-11,ATL,100,3,1,CHH,88,1,3,4,4
1999-02-11,CLE,99,1,3,SAS,89,2,2,3,5
1999-02-11,DET,81,3,1,ORL,87,3,1,6,2
1999-02-11,CHI,68,1,2,NYK,73,1,2,2,4
1999-02-11,MIL,95,2,0,NJN,75,1,2,3,2
1999-02-11,MIN,86,2,1,LAL,75,3,1,5,2
1999-02-11,DAL,95,1,2,HOU,105,3,1,4,3
1999-02-11,PHX,74,2,1,UTA,82,3,0,5,1
1999-02-11,VAN,97,1,2,IND,101,2,2,3,4
1999-02-12,PHI,94,3,0,SAS,98,2,3,5,3
1999-02-12,DEN,100,0,4,DAL,94,1,3,1,7
1999-02-12,GSW,81,0,4,UTA,97,4,0,4,4
1999-02-13,PHX,107,2,2,LAC,104,0,3,2,5
1999-02-13,SEA,105,4,0,DEN,92,1,4,5,4
1999-02-14,PHI,78,3,1,ATL,70,4,1,7,2
1999-02-14,ORL,85,4,1,MIL,82,3,0,7,1
1999-02-14,CHI,76,1,3,SAS,89,3,3,4,6
1999-02-14,LAC,73,0,4,MIN,95,3,1,3,5
1999-02-14,LAL,99,3,2,IND,101,3,2,6,4
1999-02-14,GSW,105,0,5,POR,100,2,1,2,6
1999-02-14,VAN,96,1,3,DAL,92,1,4,2,7
1999-02-15,NYK,78,2,2,DET,69,3,2,5,4
1999-02-15,MIA,95,2,3,NJN,72,1,3,3,6
1999-02-15,DEN,106,1,5,PHX,115,3,2,4,7
1999-02-15,UTA,120,5,0,SAC,112,2,2,7,2
1999-02-15,GSW,101,1,5,MIN,99,4,1,5,6
1999-02-15,POR,99,2,2,DAL,84,1,5,3,7
1999-02-16,NYK,95,3,2,TOR,85,1,3,4,5
1999-02-16,NJN,97,1,4,DET,82,3,3,4,7
1999-02-16,PHI,92,4,1,MIL,93,3,1,7,2
1999-02-16,CLE,90,2,3,ORL,78,5,1,7,4
1999-02-16,IND,78,4,2,MIA,89,3,3,7,5
1999-02-16,CHI,67,1,4,ATL,83,4,2,5,6
1999-02-16,HOU,109,4,1,PHX,92,4,2,8,3
1999-02-16,LAC,89,0,5,VAN,93,2,3,2,8
1999-02-16,LAL,116,3,3,CHH,88,1,4,4,7
1999-02-16,SAC,101,2,3,BOS,98,2,2,4,5
1999-02-16,SEA,71,5,0,UTA,56,6,0,11,0
1999-02-17,ORL,96,5,2,WAS,85,1,3,6,5
1999-02-17,DET,80,3,4,MIA,91,4,3,7,7
1999-02-17,MIL,91,4,1,CHI,83,1,5,5,6
1999-02-17,MIN,116,4,2,HOU,102,5,1,9,3
1999-02-17,SAS,76,4,3,PHX,79,4,3,8,6
1999-02-17,LAL,101,4,3,DAL,88,1,6,5,9
1999-02-17,GSW,96,2,5,CHH,87,1,5,3,10
1999-02-17,POR,100,3,2,DEN,85,1,6,4,8
1999-02-17,SEA,106,6,0,SAC,109,3,3,9,3
1999-02-17,VAN,129,3,3,BOS,131,2,3,5,6
1999-02-18,NJN,92,2,4,HOU,93,5,2,7,6
1999-02-18,TOR,88,1,4,WAS,95,1,4,2,8
1999-02-18,CLE,98,3,3,NYK,74,4,2,7,5
1999-02-18,IND,99,4,3,PHI,95,4,2,8,5
1999-02-18,UTA,97,6,1,DEN,86,1,7,7,8
1999-02-19,PHI,67,4,3,NYK,78,4,3,8,6
1999-02-19,WAS,93,2,4,CHI,91,1,6,3,10
1999-02-19,ATL,94,5,2,ORL,99,6,2,11,4
1999-02-19,TOR,90,1,5,MIL,82,5,1,6,6
1999-02-19,MIN,115,5,2,VAN,96,3,4,8,6
1999-02-19,PHX,93,5,3,DET,101,3,5,8,8
1999-02-19,LAL,106,5,3,SAS,94,4,4,9,7
1999-02-19,GSW,84,3,5,DAL,79,1,7,4,12
1999-02-19,SAC,106,4,3,CHH,95,1,6,5,9
1999-02-19,POR,106,4,2,BOS,86,3,3,7,5
1999-02-20,PHI,69,4,4,ATL,76,5,3,9,7
1999-02-20,MIA,81,5,3,HOU,71,6,2,11,5
1999-02-20,CLE,89,4,3,NJN,84,2,5,6,8
1999-02-20,MIL,80,5,2,IND,82,5,3,10,5
1999-02-20,UTA,110,7,1,SEA,80,6,1,13,2
1999-02-20,LAC,90,0,6,DAL,105,1,8,1,14
1999-02-20,POR,90,5,2,GSW,84,4,5,9,7
1999-02-21,NYK,79,5,3,CHI,63,1,7,6,10
1999-02-21,WAS,86,3,4,BOS,75,3,4,6,8
1999-02-21,ORL,109,7,2,HOU,83,6,3,13,5
1999-02-21,TOR,102,2,5,VAN,87,3,5,5,10
1999-02-21,IND,80,6,3,NJN,79,2,6,8,9
1999-02-21,MIN,102,6,2,SAC,90,5,3,11,5
1999-02-21,SAS,85,4,5,DET,64,4,5,8,10
1999-02-21,SEA,92,6,2,LAL,89,6,3,12,5
1999-02-22,ORL,107,8,2,SAC,96,5,4,13,6
1999-02-22,ATL,68,6,3,CHI,77,1,8,7,11
1999-02-22,CLE,97,5,3,PHI,106,4,5,9,8
1999-02-22,MIN,95,7,2,SAS,89,5,5,12,7
1999-02-22,DEN,117,1,8,LAL,113,6,4,7,12
1999-02-22,UTA,104,8,1,LAC,89,0,7,8,8
1999-02-22,PHX,101,5,4,DAL,83,2,8,7,12
1999-02-23,NYK,82,6,3,NJN,74,2,7,8,10
1999-02-23,WAS,80,4,4,MIA,96,6,3,10,7
1999-02-23,DET,106,4,6,TOR,80,3,5,7,11
1999-02-23,CHI,88,2,8,MIL,90,5,3,7,11
1999-02-23,DAL,89,2,9,ATL,85,6,4,8,13
1999-02-23,HOU,98,6,4,SEA,86,7,2,13,6
1999-02-23,LAC,89,0,8,GSW,94,4,6,4,14
1999-02-23,VAN,93,3,6,LAL,83,6,5,9,11
1999-02-24,BOS,111,3,5,ORL,79,9,2,12,7
1999-02-24,NJN,85,2,8,POR,94,6,2,8,10
1999-02-24,PHI,94,5,5,SAC,81,5,5,10,10
1999-02-24,CHH,83,1,7,MIA,91,7,3,8,10
1999-02-24,DET,89,5,6,CLE,73,5,4,10,10
1999-02-24,IND,104,7,3,TOR,84,3,6,10,9
1999-02-24,SAS,99,5,6,SEA,81,7,3,12,9
1999-02-24,DEN,97,2,8,UTA,87,9,1,11,9
1999-02-25,NYK,115,7,3,MIN,113,8,2,15,5
1999-02-25,WAS,105,4,5,SAC,115,5,6,9,11
1999-02-25,CLE,74,5,5,IND,81,8,3,13,8
1999-02-25,CHI,80,2,9,PHI,98,6,5,8,14
1999-02-25,DAL,90,3,9,DEN,81,3,8,6,17
1999-02-25,HOU,87,7,4,ATL,93,6,5,13,9
1999-02-25,LAC,100,0,9,LAL,115,6,6,6,15
1999-02-25,VAN,86,4,6,PHX,94,6,4,10,10
1999-02-26,BOS,94,4,5,NYK,80,8,3,12,8
1999-02-26,ORL,103,9,3,IND,100,9,3,18,6
1999-02-26,CHH,97,1,8,POR,95,7,2,8,10
1999-02-26,TOR,102,3,7,MIN,92,8,3,11,10
1999-02-26,DET,95,6,6,MIA,93,8,3,14,9
1999-02-26,DEN,96,3,9,MIL,95,6,3,9,12
1999-02-26,UTA,80,9,2,DAL,65,4,9,13,11
1999-02-26,LAL,99,7,6,LAC,83,0,10,7,16
1999-02-26,GSW,94,5,6,PHX,90,7,4,12,10
1999-02-26,SEA,92,7,4,SAS,82,6,6,13,10
1999-02-27,NJN,92,2,9,BOS,101,5,5,7,14
1999-02-27,WAS,81,4,6,POR,82,7,3,11,9
1999-02-27,CHI,94,2,10,CHH,77,2,8,4,18
1999-02-27,DAL,97,4,10,SAC,90,6,6,10,16
1999-02-27,LAC,74,0,11,ATL,103,7,5,7,16
1999-02-27,VAN,74,4,7,HOU,86,7,5,11,12
1999-02-28,MIA,84,8,4,ORL,78,10,3,18,7
1999-02-28,TOR,88,4,7,CHI,90,3,10,7,17
1999-02-28,DET,89,7,6,NYK,68,8,4,15,10
1999-02-28,MIL,76,6,4,PHI,87,7,5,13,9
1999-02-28,MIN,93,8,4,POR,100,8,3,16,7
1999-02-28,SAS,87,6,7,UTA,101,10,2,16,9
1999-02-28,DEN,116,4,9,VAN,112,4,8,8,17
1999-02-28,PHX,102,7,5,GSW,89,6,6,13,11
1999-02-28,LAL,106,8,6,HOU,90,8,5,16,11
1999-03-01,BOS,97,6,5,NJN,99,2,10,8,15
1999-03-01,NYK,85,8,5,CLE,78,5,6,13,11
1999-03-01,WAS,91,4,7,PHI,104,8,5,12,12
1999-03-01,ORL,70,10,4,ATL,67,8,5,18,9
1999-03-01,CHH,91,2,9,TOR,88,4,8,6,17
1999-03-01,PHX,91,8,5,LAL,97,9,6,17,11
1999-03-01,SAC,102,6,7,SEA,105,8,4,14,11
1999-03-02,NJN,86,3,10,MIL,94,6,5,9,15
1999-03-02,MIA,85,9,4,NYK,84,9,5,18,9
1999-03-02,ATL,77,8,6,WAS,97,4,8,12,14
1999-03-02,CLE,116,5,7,BOS,99,6,6,11,13
1999-03-02,IND,88,9,4,DEN,81,5,9,14,13
1999-03-02,CHI,78,4,10,DET,108,8,6,12,16
1999-03-02,MIN,89,8,5,GSW,78,6,7,14,12
1999-03-02,DAL,112,5,10,LAC,99,0,12,5,22
1999-03-02,HOU,82,8,6,SAS,99,6,8,14,14
1999-03-02,POR,102,9,3,UTA,100,11,2,20,5
1999-03-02,VAN,101,4,9,SAC,111,6,8,10,17
1999-03-03,PHI,102,9,5,CHI,86,4,11,13,16
1999-03-03,WAS,95,5,8,IND,106,10,4,15,12
1999-03-03,ORL,93,11,4,CHH,76,3,9,14,13
1999-03-03,MIL,106,7,5,GSW,78,6,8,13,13
1999-03-03,UTA,109,11,3,VAN,86,4,10,15,13
1999-03-03,LAL,101,10,6,PHX,95,8,6,18,12
1999-03-03,SAC,93,7,8,POR,97,10,3,17,11
1999-03-04,NJN,82,3,11,CHH,96,3,10,6,21
1999-03-04,MIA,95,10,4,DEN,87,5,10,15,14
1999-03-04,ATL,77,8,7,TOR,86,4,9,12,16
1999-03-04,CLE,84,6,7,DET,99,9,6,15,13
1999-03-04,DAL,79,6,10,SAS,95,7,8,13,18
1999-03-04,HOU,96,8,7,LAC,77,0,13,8,20
1999-03-04,SEA,93,9,4,PHX,101,8,7,17,11
1999-03-04,VAN,93,4,11,MIN,102,9,5,13,16
1999-03-05,BOS,102,6,7,DEN,94,5,11,11,18
1999-03-05,PHI,78,10,5,MIA,89,11,4,21,9
1999-03-05,WAS,86,5,9,CHH,85,4,10,9,19
1999-03-05,TOR,84,5,9,ORL,89,12,4,17,13
1999-03-05,IND,83,11,4,GSW,102,6,9,17,13
1999-03-05,MIL,88,8,5,NYK,87,9,6,17,11
1999-03-05,UTA,106,12,3,DAL,95,6,11,18,14
1999-03-05,LAL,103,11,6,SEA,100,9,5,20,11
1999-03-05,POR,97,11,3,MIN,85,10,5,21,8
1999-03-06,ORL,87,13,4,DET,82,10,6,23,10
1999-03-06,CLE,97,6,8,GSW,80,7,9,13,17
1999-03-06,SAS,114,8,8,LAC,85,0,14,8,22
1999-03-06,PHX,99,9,7,SAC,111,7,9,16,16
1999-03-06,VAN,92,4,12,HOU,107,9,7,13,19
1999-03-07,NYK,97,9,7,NJN,86,3,12,12,19
1999-03-07,PHI,95,10,6,WAS,103,6,9,16,15
1999-03-07,TOR,105,5,10,BOS,92,7,7,12,17
1999-03-07,IND,85,11,5,MIA,72,12,4,23,9
1999-03-07,DEN,96,5,12,SAS,106,9,8,14,20
1999-03-07,UTA,89,13,3,LAL,97,12,6,25,9
1999-03-07,SAC,94,8,9,DAL,89,6,12,14,21
1999-03-07,POR,111,12,3,HOU,71,10,7,22,10
1999-03-07,SEA,77,9,6,MIN,88,10,6,19,12
1999-03-08,ORL,110,14,4,ATL,114,8,8,22,12
1999-03-08,MIA,91,12,5,PHI,89,10,7,22,12
1999-03-08,DET,75,10,7,WAS,71,7,9,17,16
1999-03-08,MIL,81,9,5,CHI,76,4,12,13,17
1999-03-08,VAN,73,4,13,POR,92,13,3,17,16
1999-03-09,NYK,86,10,7,MIL,87,10,5,20,12
1999-03-09,CHH,105,4,11,BOS,87,7,8,11,19
1999-03-09,CHI,103,4,13,NJN,87,3,13,7,26
1999-03-09,MIN,85,11,6,SEA,84,9,7,20,13
1999-03-09,DAL,91,6,13,PHX,103,9,8,15,21
1999-03-09,HOU,84,10,8,DEN,75,5,13,15,21
1999-03-09,UTA,88,13,4,CLE,75,7,8,20,12
1999-03-09,LAC,99,0,15,LAL,103,13,6,13,21
1999-03-09,GSW,92,7,10,VAN,82,4,14,11,24
1999-03-09,POR,103,14,3,SAC,98,9,9,23,12
1999-03-10,PHI,85,10,8,CHH,70,5,11,15,19
1999-03-10,WAS,97,7,10,DET,87,11,7,18,17
1999-03-10,MIA,88,13,5,ATL,78,9,8,22,13
1999-03-10,IND,93,12,5,NJN,82,3,14,15,19
1999-03-10,MIL,101,11,5,SEA,97,9,8,20,13
1999-03-10,SAS,81,10,8,ORL,79,14,5,24,13
1999-03-10,PHX,73,10,8,CLE,86,7,9,17,17
1999-03-10,LAL,94,14,6,LAC,75,0,16,14,22
1999-03-11,NYK,98,10,8,WAS,86,8,10,18,18
1999-03-11,MIA,83,14,5,TOR,73,6,10,20,15
1999-03-11,ATL,99,9,9,BOS,85,7,9,16,18
1999-03-11,CHI,83,5,13,SEA,92,9,9,14,22
1999-03-11,DAL,93,6,14,ORL,76,14,6,20,20
1999-03-11,HOU,102,11,8,VAN,91,4,15,15,23
1999-03-11,UTA,94,14,4,DEN,89,5,14,19,18
1999-03-11,LAC,106,0,17,SAC,92,9,10,9,27
1999-03-11,GSW,89,8,10,MIN,82,12,6,20,16
1999-03-12,PHI,100,11,8,NJN,93,3,15,14,23
1999-03-12,WAS,83,8,11,CHH,92,5,12,13,23
1999-03-12,DET,93,11,8,BOS,83,7,10,18,18
1999-03-12,IND,109,13,5,MIL,104,12,5,25,10
1999-03-12,CHI,76,5,14,NYK,63,11,8,16,22
1999-03-12,PHX,97,10,9,SAS,99,11,8,21,17
1999-03-12,LAL,89,15,6,GSW,78,9,10,24,16
1999-03-12,SAC,95,9,11,MIN,101,12,7,21,18
1999-03-12,POR,77,15,3,UTA,91,15,4,30,7
1999-03-13,ATL,86,10,9,TOR,75,6,11,16,20
1999-03-13,DAL,91,7,14,VAN,74,4,16,11,30
1999-03-13,HOU,100,12,8,CLE,89,8,9,20,17
1999-03-13,SAS,92,12,8,DEN,61,5,15,17,23
1999-03-13,UTA,99,16,4,MIN,72,13,7,29,11
1999-03-13,LAC,96,1,17,POR,106,15,4,16,21
1999-03-13,GSW,74,9,11,ORL,87,14,7,23,18
1999-03-14,NYK,94,11,9,CHH,86,6,12,17,21
1999-03-14,WAS,98,8,12,MIL,86,12,6,20,18
1999-03-14,MIA,102,15,5,NJN,76,3,16,18,21
1999-03-14,DET,72,12,8,ATL,85,11,9,23,17
1999-03-14,IND,99,14,5,BOS,96,7,11,21,16
1999-03-14,PHX,104,10,10,HOU,90,13,8,23,18
1999-03-14,SAC,105,9,12,LAL,101,16,6,25,18
1999-03-14,SEA,108,10,9,LAC,89,1,18,11,27
1999-03-15,ORL,74,15,7,PHI,73,12,8,27,15
1999-03-15,TOR,89,6,12,CHH,82,6,13,12,25
1999-03-15,CHI,85,6,14,CLE,89,8,10,14,24
1999-03-15,MIL,102,12,7,NYK,108,12,9,24,16
1999-03-15,MIN,83,13,8,UTA,90,17,4,30,12
1999-03-15,DAL,91,8,14,POR,106,16,4,24,18
1999-03-15,DEN,110,5,16,VAN,84,4,17,9,33
1999-03-15,GSW,105,9,12,SAC,111,10,12,19,24
1999-03-16,NYK,113,13,9,LAC,89,1,19,14,28
1999-03-16,MIA,94,16,5,WAS,85,9,12,25,17
1999-03-16,TOR,100,7,12,NJN,85,3,17,10,29
1999-03-16,CLE,86,9,10,DET,82,12,9,21,19
1999-03-16,IND,79,15,5,ATL,85,12,9,27,14
1999-03-16,MIL,92,12,8,PHX,110,11,10,23,18
1999-03-16,MIN,101,13,9,LAL,107,16,7,29,16
1999-03-16,HOU,101,13,9,POR,93,17,4,30,13
1999-03-16,SAC,109,11,12,SAS,121,13,8,24,20
1999-03-16,SEA,87,11,9,VAN,85,4,18,15,27
1999-03-17,BOS,118,7,12,LAC,84,1,20,8,32
1999-03-17,NJN,88,3,18,DAL,87,8,15,11,33
1999-03-17,PHI,114,12,9,IND,110,15,6,27,15
1999-03-17,ORL,103,16,7,CHI,94,6,15,22,22
1999-03-17,CHH,119,6,14,PHX,111,12,10,18,24
1999-03-17,ATL,85,13,9,MIA,86,17,5,30,14
1999-03-17,DET,101,12,10,TOR,103,8,12,20,22
1999-03-17,DEN,109,6,16,HOU,114,14,9,20,25
1999-03-17,GSW,78,9,13,SAS,82,14,8,23,21
1999-03-18,NYK,78,14,9,ORL,86,17,7,31,16
1999-03-18,WAS,87,9,13,UTA,95,18,4,27,17
1999-03-18,CLE,100,10,10,LAL,93,17,7,27,17
1999-03-18,CHI,104,6,16,NJN,95,4,18,10,34
1999-03-18,MIL,99,12,9,BOS,83,8,12,20,21
1999-03-18,SAC,78,11,13,POR,88,17,5,28,18
1999-03-18,VAN,86,4,19,MIN,81,13,10,17,29
1999-03-19,PHI,105,13,9,LAL,90,17,8,30,17
1999-03-19,CHH,83,7,14,UTA,82,19,4,26,18
1999-03-19,ATL,93,13,10,PHX,85,12,11,25,21
1999-03-19,TOR,93,9,12,LAC,82,1,21,10,33
1999-03-19,DET,94,12,11,DAL,87,8,16,20,27
1999-03-19,IND,96,15,7,CHI,87,7,16,22,23
1999-03-19,DEN,101,6,17,MIN,105,13,11,19,28
1999-03-19,GSW,90,9,14,SEA,78,12,9,21,23
1999-03-19,POR,90,18,5,SAS,85,15,8,33,13
1999-03-20,NYK,96,14,10,BOS,78,8,13,22,23
1999-03-20,WAS,113,9,14,CLE,83,11,10,20,24
1999-03-20,MIA,89,18,5,IND,94,16,7,34,12
1999-03-20,ATL,77,14,10,MIL,83,13,9,27,19
1999-03-20,DAL,104,8,17,SAC,90,11,14,19,31
1999-03-20,HOU,103,15,9,PHX,93,12,12,27,21
1999-03-20,VAN,88,5,19,SAS,92,15,9,20,28
1999-03-21,BOS,92,8,14,CHI,95,7,17,15,31
1999-03-21,ORL,104,18,7,LAL,115,17,9,35,16
1999-03-21,TOR,85,10,12,NYK,81,15,10,25,22
1999-03-21,CLE,88,11,11,NJN,85,4,19,15,30
1999-03-21,DET,104,13,11,UTA,101,19,5,32,16
1999-03-21,MIL,87,14,9,CHH,94,8,14,22,23
1999-03-21,MIN,85,14,11,LAC,100,1,22,15,33
1999-03-21,DEN,102,6,18,SEA,98,12,10,18,28
1999-03-21,POR,91,19,5,PHI,75,14,9,33,14
1999-03-22,NYK,71,15,11,ATL,80,14,11,29,22
1999-03-22,NJN,106,4,20,TOR,87,11,12,15,32
1999-03-22,IND,90,17,7,WAS,86,10,14,27,21
1999-03-22,MIL,115,14,10,DET,86,14,11,28,21
1999-03-22,DAL,93,9,17,LAL,96,18,9,27,26
1999-03-22,HOU,110,16,9,SAC,100,11,15,27,24
1999-03-22,PHX,89,12,13,VAN,84,5,20,17,33
1999-03-22,SEA,92,12,11,PHI,76,14,10,26,21
1999-03-23,ORL,86,18,8,CHH,78,9,14,27,22
1999-03-23,CLE,113,12,11,BOS,86,8,15,20,26
1999-03-23,CHI,90,8,17,TOR,113,11,13,19,30
1999-03-23,SAS,112,16,9,DEN,82,7,18,23,27
1999-03-23,UTA,84,19,6,MIA,81,18,6,37,12
1999-03-23,POR,79,20,5,GSW,72,10,14,30,19
1999-03-24,BOS,68,8,16,MIN,87,14,12,22,28
1999-03-24,NJN,71,5,20,DET,84,14,12,19,32
1999-03-24,CHH,110,9,15,CHI,81,8,18,17,33
1999-03-24,ATL,103,15,11,IND,102,18,7,33,18
1999-03-24,MIL,76,15,10,MIA,84,18,7,33,17
1999-03-24,DAL,78,9,18,HOU,88,17,9,26,27
1999-03-24,LAC,80,2,22,GSW,92,10,15,12,37
1999-03-24,LAL,101,19,9,PHX,106,13,13,32,22
1999-03-24,SAC,92,11,16,NYK,91,15,12,26,28
1999-03-24,SEA,92,13,11,WAS,96,10,15,23,26
1999-03-24,VAN,90,5,21,PHI,95,14,11,19,32
1999-03-25,ORL,96,19,8,CLE,86,13,11,32,19
1999-03-25,HOU,113,18,9,TOR,104,12,13,30,22
1999-03-25,DEN,65,7,19,SAS,86,17,9,24,28
1999-03-25,POR,97,21,5,PHX,84,14,13,35,18
1999-03-26,NJN,91,5,21,IND,100,18,8,23,29
1999-03-26,PHI,84,15,11,BOS,90,8,17,23,28
1999-03-26,CHH,90,10,15,ORL,82,20,8,30,23
1999-03-26,ATL,93,16,11,CHI,81,8,19,24,30
1999-03-26,DET,90,15,12,MIL,85,15,11,30,23
1999-03-26,MIN,100,15,12,MIA,93,19,7,34,19
1999-03-26,DAL,98,9,19,DEN,79,7,20,16,39
1999-03-26,SAS,91,18,9,TOR,93,12,14,30,23
1999-03-26,PHX,87,14,14,NYK,94,15,13,29,27
1999-03-26,LAL,109,19,10,SAC,111,12,16,31,26
1999-03-26,GSW,100,11,15,WAS,96,11,15,22,30
1999-03-26,SEA,104,13,12,LAC,98,2,23,15,35
1999-03-26,VAN,80,5,22,UTA,85,20,6,25,28
1999-03-27,NJN,99,5,22,CLE,109,13,12,18,34
1999-03-27,ATL,103,17,11,PHI,99,15,12,32,23
1999-03-27,SAS,99,18,10,DAL,77,10,19,28,29
1999-03-27,DEN,100,7,21,WAS,112,11,16,18,37
1999-03-27,LAC,103,2,24,UTA,77,21,6,23,30
1999-03-27,GSW,86,12,15,HOU,87,19,9,31,24
1999-03-28,BOS,93,9,17,IND,101,19,8,28,25
1999-03-28,ORL,94,20,9,MIA,87,19,8,39,17
1999-03-28,CHH,105,11,15,CLE,84,14,12,25,27
1999-03-28,TOR,91,13,14,CHI,78,8,20,21,34
1999-03-28,DET,104,16,12,SEA,87,14,12,30,24
1999-03-28,MIN,85,16,12,MIL,94,15,12,31,24
1999-03-28,PHX,86,14,15,POR,88,22,5,36,20
1999-03-28,LAL,99,19,11,NYK,91,16,13,35,24
1999-03-28,SAC,93,13,16,HOU,107,20,9,33,25
1999-03-29,IND,82,20,8,ATL,83,18,11,38,19
1999-03-29,DAL,101,10,20,SEA,109,14,13,24,33
1999-03-29,DEN,100,7,22,LAC,88,3,24,10,46
1999-03-29,LAL,116,20,11,VAN,98,5,23,25,34
1999-03-30,NYK,94,16,14,IND,93,20,9,36,23
1999-03-30,ORL,100,21,9,NJN,98,5,23,26,32
1999-03-30,CHH,99,12,15,BOS,109,9,18,21,33
1999-03-30,ATL,77,19,11,DET,93,17,12,36,23
1999-03-30,CLE,91,14,13,TOR,101,14,14,28,27
1999-03-30,CHI,91,8,21,PHI,81,15,13,23,34
1999-03-30,MIL,107,16,12,WAS,105,12,16,28,28
1999-03-30,MIN,98,16,13,DAL,78,10,21,26,34
1999-03-30,SAS,95,19,10,SEA,87,15,13,34,23
1999-03-30,LAC,95,3,25,HOU,104,21,9,24,34
1999-03-30,GSW,93,12,16,POR,90,23,5,35,21
1999-03-30,SAC,104,13,17,UTA,101,21,7,34,24
1999-03-30,VAN,101,5,24,DEN,87,8,22,13,46
1999-03-31,BOS,72,10,18,DET,87,18,12,28,30
1999-03-31,WAS,84,12,17,ORL,73,22,9,34,26
1999-03-31,CHH,94,12,16,MIL,102,17,12,29,28
1999-03-31,PHX,93,14,16,GSW,78,13,16,27,32
1999-03-31,POR,100,23,6,SAC,86,14,17,37,23
1999-04-01,NYK,78,17,14,CLE,74,14,14,31,28
1999-04-01,NJN,90,5,24,ATL,85,19,12,24,36
1999-04-01,MIA,84,19,9,PHI,88,15,14,34,23
1999-04-01,TOR,88,15,14,IND,87,20,10,35,24
1999-04-01,DET,107,19,12,CHI,75,9,21,28,33
1999-04-01,DAL,93,10,22,LAC,84,3,26,13,48
1999-04-01,SAS,103,20,10,VAN,91,6,24,26,34
1999-04-01,DEN,113,8,23,SEA,110,15,14,23,37
1999-04-01,UTA,88,21,8,HOU,87,22,9,43,17
1999-04-02,BOS,83,10,19,MIL,84,18,12,28,31
1999-04-02,PHI,80,16,14,CLE,85,14,15,30,29
1999-04-02,CHH,81,12,17,IND,87,20,11,32,28
1999-04-02,ATL,84,19,13,VAN,81,6,25,25,38
1999-04-02,CHI,68,9,22,ORL,115,22,10,31,32
1999-04-02,MIN,107,17,13,DEN,88,9,23,26,36
1999-04-02,PHX,90,15,16,LAL,91,21,11,36,27
1999-04-02,GSW,85,13,17,UTA,92,22,8,35,25
1999-04-02,POR,107,24,6,SEA,95,15,15,39,21
1999-04-03,NJN,88,6,24,MIA,77,19,10,25,34
1999-04-03,TOR,87,16,14,WAS,85,13,17,29,31
1999-04-03,DET,77,20,12,ORL,92,23,10,43,22
1999-04-03,MIN,105,18,13,SAC,96,14,18,32,31
1999-04-03,SAS,103,21,10,LAC,82,3,27,24,37
1999-04-03,LAL,76,22,11,GSW,81,13,18,35,29
1999-04-03,POR,98,25,6,PHX,93,15,17,40,23
1999-04-04,BOS,79,10,20,NJN,91,7,24,17,44
1999-04-04,WAS,79,13,18,MIA,90,19,11,32,29
1999-04-04,ATL,85,20,13,CHH,83,12,18,32,31
1999-04-04,TOR,97,17,14,PHI,82,16,15,33,29
1999-04-04,CLE,98,15,15,MIL,74,19,12,34,27
1999-04-04,IND,108,21,11,NYK,95,18,14,39,25
1999-04-04,CHI,88,9,23,VAN,87,6,26,15,49
1999-04-04,DEN,82,9,24,LAC,80,3,28,12,52
1999-04-04,SEA,101,15,16,HOU,84,22,10,37,26
1999-04-05,ORL,106,24,10,BOS,99,10,21,34,31
1999-04-05,CHH,71,12,19,ATL,77,21,13,33,32
1999-04-05,DET,86,20,13,IND,88,22,11,42,24
1999-04-05,MIN,100,19,13,DAL,93,11,22,30,35
1999-04-05,SAS,93,22,10,GSW,86,14,18,36,28
1999-04-05,LAL,117,22,12,DEN,104,10,24,32,36
1999-04-06,NYK,72,18,15,ORL,81,25,10,43,25
1999-04-06,PHI,95,16,16,MIL,87,19,13,35,29
1999-04-06,WAS,93,13,19,NJN,97,8,24,21,43
1999-04-06,TOR,70,18,14,MIA,92,20,11,38,25
1999-04-06,CLE,96,16,15,CHI,89,10,23,26,38
1999-04-06,HOU,111,22,11,GSW,74,14,19,36,30
1999-04-06,LAC,83,3,29,PHX,88,15,18,18,47
1999-04-06,LAL,93,23,12,UTA,106,23,8,46,20
1999-04-06,POR,98,26,6,VAN,89,6,27,32,33
1999-04-06,SEA,106,16,16,SAC,112,14,19,30,35
1999-04-07,BOS,108,10,22,WAS,87,13,20,23,42
1999-04-07,NJN,92,9,24,PHI,96,17,16,26,40
1999-04-07,MIA,93,21,11,DAL,87,11,23,32,34
1999-04-07,CHH,106,12,20,NYK,82,18,16,30,36
1999-04-07,DET,89,20,14,ATL,82,22,13,42,27
1999-04-07,CHI,74,10,24,IND,91,23,11,33,35
1999-04-07,MIL,99,19,14,CLE,91,17,15,36,29
1999-04-07,PHX,90,16,18,MIN,82,20,13,36,31
1999-04-07,SAC,89,15,19,LAL,104,23,13,38,32
1999-04-07,VAN,84,6,28,DEN,87,10,25,16,53
1999-04-08,TOR,89,18,15,BOS,101,11,22,29,37
1999-04-08,CLE,69,17,16,ORL,73,26,10,43,26
1999-04-08,HOU,83,23,11,SAS,92,23,10,46,21
1999-04-08,UTA,92,24,8,GSW,85,14,20,38,28
1999-04-08,LAC,99,3,30,MIN,91,20,14,23,44
1999-04-08,SEA,87,16,17,POR,86,27,6,43,23
1999-04-09,BOS,67,12,22,PHI,83,18,16,30,38
1999-04-09,NJN,106,9,25,TOR,99,18,16,27,41
1999-04-09,ORL,95,27,10,MIL,83,20,14,47,24
1999-04-09,CHH,90,13,20,WAS,88,13,21,26,41
1999-04-09,ATL,78,22,14,NYK,86,18,17,40,31
1999-04-09,IND,101,24,11,DET,102,21,14,45,25
1999-04-09,UTA,93,25,8,PHX,92,17,18,42,26
1999-04-09,LAL,96,24,13,MIN,89,20,15,44,28
1999-04-09,VAN,98,6,29,SEA,93,17,17,23,46
1999-04-10,CLE,81,17,17,ATL,67,22,15,39,32
1999-04-10,IND,90,24,12,CHH,92,14,20,38,32
1999-04-10,CHI,49,10,25,MIA,82,22,11,32,36
1999-04-10,DAL,90,11,24,GSW,91,14,21,25,45
1999-04-10,PHX,110,17,19,SAS,84,24,10,41,29
1999-04-10,LAC,70,4,30,POR,97,27,7,31,37
1999-04-10,SAC,110,15,20,DEN,104,11,25,26,45
1999-04-11,BOS,87,12,23,CHI,81,10,26,22,49
1999-04-11,NJN,78,10,25,NYK,93,19,17,29,42
1999-04-11,WAS,105,13,22,PHI,98,19,16,32,38
1999-04-11,MIA,95,23,11,MIL,92,20,15,43,26
1999-04-11,MIN,88,20,16,DET,79,22,14,42,30
1999-04-11,UTA,85,26,8,HOU,76,23,12,49,20
1999-04-11,LAL,109,25,13,SEA,113,17,18,42,31
1999-04-11,POR,83,28,7,LAC,89,4,31,32,38
1999-04-11,VAN,88,7,29,SAC,91,16,20,23,49
1999-04-12,BOS,103,13,23,CLE,89,18,17,31,40
1999-04-12,TOR,99,18,17,IND,109,24,13,42,30
1999-04-12,DET,86,22,15,CHH,92,15,20,37,35
1999-04-12,MIN,90,21,16,HOU,95,23,13,44,29
1999-04-12,SAS,94,24,11,PHX,77,18,19,42,30
1999-04-12,DEN,96,11,26,GSW,104,15,21,26,47
1999-04-12,UTA,98,27,8,VAN,80,7,30,34,38
1999-04-13,NYK,91,20,17,PHI,72,19,17,39,34
1999-04-13,MIA,90,24,11,CHI,74,10,27,34,38
1999-04-13,CLE,86,18,18,WAS,77,14,22,32,40
1999-04-13,MIL,91,20,16,ATL,84,22,16,42,32
1999-04-13,DAL,92,11,25,SAS,86,25,11,36,36
1999-04-13,LAC,109,5,31,NJN,101,10,26,15,57
1999-04-13,SAC,100,17,20,UTA,105,28,8,45,28
1999-04-13,POR,113,28,8,LAL,86,25,14,53,22
1999-04-14,BOS,70,14,23,ATL,77,22,17,36,40
1999-04-14,PHI,96,19,18,TOR,78,18,18,37,36
1999-04-14,WAS,95,14,23,NYK,89,21,17,35,40
1999-04-14,CHH,83,16,20,DET,79,22,16,38,36
1999-04-14,IND,83,25,13,ORL,80,28,10,53,23
1999-04-14,CHI,81,10,28,CLE,89,19,18,29,46
1999-04-14,MIL,98,21,16,MIA,86,25,11,46,27
1999-04-14,HOU,102,24,13,VAN,85,7,31,31,44
1999-04-14,SAS,95,25,12,MIN,79,21,17,46,29
1999-04-14,DEN,120,11,27,NJN,97,10,27,21,54
1999-04-14,SEA,94,18,18,PHX,101,18,20,36,38
1999-04-15,DAL,101,12,25,MIN,95,21,18,33,43
1999-04-15,HOU,86,25,13,POR,76,29,8,54,21
1999-04-15,LAC,89,6,31,UTA,103,29,8,35,39
1999-04-15,GSW,85,16,21,DEN,79,12,27,28,48
1999-04-15,SAC,98,17,21,SEA,99,18,19,35,40
1999-04-16,BOS,82,14,24,MIA,81,25,12,39,36
1999-04-16,PHI,93,20,18,IND,83,26,13,46,31
1999-04-16,WAS,87,15,23,CHI,70,10,29,25,52
1999-04-16,ATL,91,23,17,ORL,79,28,11,51,28
1999-04-16,TOR,90,18,19,CLE,91,20,18,38,37
1999-04-16,DET,80,22,17,NYK,71,21,18,43,35
1999-04-16,MIL,94,22,16,CHH,95,17,20,39,36
1999-04-16,MIN,89,21,19,VAN,75,7,32,28,51
1999-04-16,SAS,81,26,12,POR,80,29,9,55,21
1999-04-16,PHX,92,19,20,DAL,85,13,25,32,45
1999-04-16,GSW,83,17,21,LAC,86,6,32,23,53
1999-04-16,SEA,91,19,19,NJN,121,10,28,29,47
1999-04-17,NYK,90,21,19,TOR,93,18,20,39,39
1999-04-17,CLE,82,21,18,CHH,90,18,20,39,38
1999-04-17,DAL,94,13,26,POR,102,29,10,42,36
1999-04-17,UTA,109,30,8,LAL,93,25,15,55,23
1999-04-17,SAC,119,17,22,DEN,97,12,28,29,50
1999-04-18,NJN,86,11,28,PHI,79,21,18,32,46
1999-04-18,WAS,98,16,23,BOS,101,15,24,31,47
1999-04-18,ORL,88,28,12,DET,81,23,17,51,29
1999-04-18,MIA,92,25,13,IND,88,26,14,51,27
1999-04-18,CHI,79,10,30,MIL,77,22,17,32,47
1999-04-18,MIN,76,22,19,UTA,97,31,8,53,27
1999-04-18,SAS,86,27,12,HOU,83,26,13,53,25
1999-04-18,PHX,99,20,20,SEA,93,19,20,39,40
1999-04-18,LAC,101,7,32,DEN,103,12,29,19,61
1999-04-18,VAN,85,7,33,GSW,90,17,22,24,55
1999-04-19,BOS,104,16,24,IND,120,26,15,42,39
1999-04-19,NJN,113,12,28,CHH,120,19,20,31,48
1999-04-19,PHI,72,21,19,NYK,67,21,20,42,39
1999-04-19,TOR,90,19,20,ORL,72,29,12,48,32
1999-04-19,CLE,87,21,19,MIA,94,26,13,47,32
1999-04-19,HOU,120,26,14,SEA,113,19,21,45,35
1999-04-19,LAC,98,7,33,SAC,102,18,22,25,55
1999-04-19,LAL,117,25,16,VAN,102,7,34,32,50
1999-04-20,TOR,81,20,20,ATL,103,24,17,44,37
1999-04-20,CHI,83,11,30,WAS,77,16,24,27,54
1999-04-20,MIL,95,22,18,ORL,83,29,13,51,31
1999-04-20,DAL,104,13,27,PHX,100,21,20,34,47
1999-04-20,UTA,69,32,8,SAS,83,28,12,60,20
1999-04-20,GSW,102,18,22,LAL,106,26,16,44,38
1999-04-21,BOS,78,16,25,PHI,80,22,19,38,44
1999-04-21,NJN,99,12,29,CHI,87,12,30,24,59
1999-04-21,WAS,91,16,25,TOR,107,20,21,36,46
1999-04-21,MIA,93,27,13,CLE,80,21,20,48,33
1999-04-21,CHH,88,20,20,DET,85,23,18,43,38
1999-04-21,IND,108,27,15,MIL,100,23,18,50,33
1999-04-21,HOU,95,27,14,DAL,109,14,27,41,41
1999-04-21,PHX,91,21,21,UTA,82,32,9,53,30
1999-04-21,SAC,103,19,22,GSW,94,18,23,37,45
1999-04-21,POR,88,31,10,LAL,82,27,16,58,26
1999-04-21,SEA,119,19,22,MIN,105,22,20,41,42
1999-04-21,VAN,97,7,35,LAC,94,7,34,14,69
1999-04-22,ORL,70,29,14,MIA,75,28,13,57,27
1999-04-22,ATL,106,25,17,BOS,94,16,26,41,43
1999-04-22,DET,96,23,19,PHI,104,23,19,46,38
1999-04-22,SAS,103,29,12,DAL,76,15,27,44,39
1999-04-23,NYK,110,21,21,CHH,105,21,20,42,41
1999-04-23,WAS,78,16,26,ATL,89,26,17,42,43
1999-04-23,ORL,88,29,15,TOR,95,21,21,50,36
1999-04-23,CHI,71,12,31,BOS,100,16,27,28,58
1999-04-23,MIL,79,23,19,CLE,75,21,21,44,40
1999-04-23,DEN,96,13,30,GSW,84,18,24,31,54
1999-04-23,UTA,96,32,10,POR,85,32,10,64,20
1999-04-23,LAC,106,7,35,HOU,101,27,15,34,50
1999-04-23,SAC,105,20,22,MIN,97,22,21,42,43
1999-04-23,VAN,84,8,35,SEA,97,20,22,28,57
1999-04-24,CHH,97,21,21,NJN,82,13,29,34,50
1999-04-24,IND,87,28,15,CHI,69,12,32,40,47
1999-04-24,SAS,108,30,12,LAL,81,27,17,57,29
1999-04-24,LAC,105,8,35,VAN,96,8,36,16,71
1999-04-24,GSW,93,18,25,DEN,74,14,30,32,55
1999-04-24,SAC,105,21,22,DAL,102,15,28,36,50
1999-04-25,BOS,113,17,27,WAS,84,16,27,33,54
1999-04-25,NJN,120,13,30,IND,98,29,15,42,45
1999-04-25,PHI,103,24,19,ORL,86,29,16,53,35
1999-04-25,MIA,80,29,13,NYK,82,22,21,51,34
1999-04-25,ATL,85,27,17,MIL,70,24,19,51,36
1999-04-25,TOR,83,22,21,DET,91,23,20,45,41
1999-04-25,UTA,98,33,10,SEA,81,21,22,54,32
1999-04-25,PHX,95,22,21,HOU,71,27,16,49,37
1999-04-25,POR,100,32,11,MIN,84,22,22,54,33
1999-04-26,CHH,84,22,21,NYK,91,23,21,45,42
1999-04-26,CLE,65,21,22,MIA,90,29,14,50,36
1999-04-26,MIL,99,24,20,WAS,91,16,28,40,48
1999-04-26,DAL,101,15,29,CHI,93,12,33,27,62
1999-04-26,HOU,102,27,17,LAL,80,27,18,54,35
1999-04-26,UTA,85,34,10,PHX,99,23,21,57,31
1999-04-26,LAC,88,9,35,SAS,94,31,12,40,47
1999-04-26,GSW,114,19,25,SAC,89,22,22,41,47
1999-04-26,POR,93,33,11,DEN,77,14,31,47,42
1999-04-27,BOS,85,18,27,DET,92,24,20,42,47
1999-04-27,NJN,76,14,30,MIA,95,30,14,44,44
1999-04-27,PHI,80,25,19,CLE,71,21,23,46,42
1999-04-27,TOR,98,22,22,CHH,108,22,22,44,44
1999-04-27,IND,87,29,16,ORL,88,29,17,58,33
1999-04-27,DAL,84,16,29,VAN,75,8,37,24,66
1999-04-27,SAC,104,22,23,SAS,100,32,12,54,35
1999-04-27,SEA,90,21,23,UTA,85,34,11,55,34
1999-04-28,ORL,93,30,17,WAS,86,16,29,46,46
1999-04-28,ATL,76,28,17,NYK,73,24,21,52,38
1999-04-28,DET,101,25,20,NJN,93,14,31,39,51
1999-04-28,MIL,115,25,20,TOR,102,22,23,47,43
1999-04-28,MIN,97,22,23,PHX,92,24,21,46,44
1999-04-28,POR,119,34,11,SEA,84,22,23,56,34
1999-04-29,NYK,85,24,22,PHI,70,26,19,50,41
1999-04-29,WAS,97,16,30,CLE,86,21,24,37,54
1999-04-29,MIA,96,31,14,BOS,107,18,28,49,42
1999-04-29,IND,115,29,17,CHH,110,23,22,52,39
1999-04-29,HOU,81,28,17,DAL,91,17,29,45,46
1999-04-29,DEN,87,14,32,PHX,98,24,22,38,54
1999-04-29,UTA,96,34,12,GSW,85,20,25,54,37
1999-04-29,LAL,108,27,19,POR,89,35,11,62,30
1999-04-29,SAC,103,23,23,LAC,81,9,36,32,59
1999-04-29,VAN,72,8,38,SAS,99,32,13,40,51
1999-04-30,ORL,107,31,17,NJN,95,14,32,45,49
1999-04-30,CHH,92,23,23,CHI,88,12,34,35,57
1999-04-30,ATL,90,29,17,IND,92,30,17,59,34
1999-04-30,CLE,91,21,25,TOR,83,22,24,43,49
1999-04-30,MIL,76,26,20,DET,81,26,20,52,40
1999-04-30,MIN,90,23,23,GSW,85,20,26,43,49
1999-04-30,HOU,78,28,18,UTA,91,35,12,63,30
1999-04-30,SEA,111,22,24,DEN,101,14,33,36,57
1999-05-01,BOS,79,19,28,MIL,88,26,21,45,49
1999-05-01,NJN,102,14,33,WAS,91,17,30,31,63
1999-05-01,PHI,103,26,20,TOR,96,22,25,48,45
1999-05-01,MIA,86,31,15,CHI,101,12,35,43,50
1999-05-01,MIN,103,24,23,LAC,93,9,37,33,60
1999-05-01,DAL,105,18,29,GSW,94,20,27,38,56
1999-05-01,SAS,98,33,13,POR,90,35,12,68,25
1999-05-01,PHX,107,25,22,VAN,77,8,39,33,61
1999-05-02,DEN,102,13,29,POR,110,30,10,43,39
1999-05-02,MIA,100,31,16,CHH,93,24,23,55,39
1999-05-02,CLE,65,22,25,ATL,76,29,18,51,43
1999-05-02,DET,100,27,20,PHI,96,27,20,54,40
1999-05-02,IND,94,31,17,NYK,71,25,22,56,39
1999-05-02,HOU,110,28,19,LAC,84,9,38,37,57
1999-05-02,SAS,84,34,13,UTA,78,36,12,70,25
1999-05-02,SAC,111,24,23,PHX,100,26,22,50,45
1999-05-02,SEA,84,23,24,LAL,91,28,19,51,43
1999-05-03,NYK,95,25,23,BOS,88,19,29,44,52
1999-05-03,WAS,113,17,31,NJN,102,15,33,32,64
1999-05-03,CHI,71,13,35,DET,115,28,20,41,55
1999-05-03,DEN,104,14,34,SAC,112,25,23,39,57
1999-05-03,LAL,115,29,19,DAL,102,19,29,48,48
1999-05-03,VAN,83,8,40,GSW,91,20,28,28,68
1999-05-04,MIA,93,32,16,ATL,79,30,18,62,34
1999-05-04,CHH,117,24,24,PHI,110,27,21,51,45
1999-05-04,IND,100,32,17,CLE,78,22,26,54,43
1999-05-04,MIL,99,27,21,TOR,86,22,26,49,47
1999-05-04,HOU,100,29,19,MIN,83,25,23,54,42
1999-05-04,UTA,99,36,13,LAC,82,9,39,45,52
1999-05-04,POR,81,35,13,SAS,87,35,13,70,26
1999-05-04,SEA,110,23,25,DAL,100,19,30,42,55
1999-05-05,BOS,129,19,30,CHH,133,25,24,44,54
1999-05-05,NYK,101,26,23,MIA,88,33,16,59,39
1999-05-05,NJN,115,15,34,MIL,107,28,21,43,55
1999-05-05,PHI,105,27,22,DET,100,29,20,56,42
1999-05-05,ATL,100,30,19,WAS,92,18,31,48,50
1999-05-05,TOR,96,22,27,CLE,87,22,27,44,54
1999-05-05,CHI,83,13,36,ORL,103,32,17,45,53
1999-05-05,DEN,88,14,35,HOU,95,30,19,44,54
1999-05-05,PHX,100,26,23,MIN,96,25,24,51,47
1999-05-05,LAC,105,9,40,SEA,107,24,25,33,65
1999-05-05,LAL,119,30,19,POR,91,35,14,65,33
1999-05-05,GSW,81,21,28,SAS,88,36,13,57,41
1999-05-05,SAC,99,26,23,VAN,95,8,41,34,64
1999-11-02,NYK,92,0,0,CLE,84,0,0,0,0
1999-11-02,NJN,112,0,0,IND,119,0,0,0,0
1999-11-02,WAS,94,0,0,ATL,87,0,0,0,0
1999-11-02,MIA,128,0,0,DET,122,0,0,0,0
1999-11-02,CHH,100,0,0,ORL,86,0,0,0,0
1999-11-02,TOR,90,0,0,BOS,103,0,0,0,0
1999-11-02,DAL,108,0,0,GSW,96,0,0,0,0
1999-11-02,HOU,93,0,0,MIL,98,0,0,0,0
1999-11-02,SAS,89,0,0,PHI,76,0,0,0,0
1999-11-02,DEN,107,0,0,PHX,102,0,0,0,0
1999-11-02,UTA,84,0,0,LAL,91,0,0,0,0
1999-11-02,LAC,92,0,0,SEA,104,0,0,0,0
1999-11-02,VAN,86,0,0,POR,106,0,0,0,0
1999-11-03,BOS,112,1,0,WAS,101,1,0,2,0
1999-11-03,ORL,103,0,1,DET,94,0,1,0,2
1999-11-03,CLE,97,0,1,NJN,90,0,1,0,2
1999-11-03,CHI,74,0,0,NYK,84,1,0,1,0
1999-11-03,LAL,103,1,0,VAN,88,0,1,1,1
1999-11-03,POR,121,1,0,LAC,98,0,1,1,1
1999-11-04,CHH,98,1,0,IND,89,1,0,2,0
1999-11-04,ATL,109,0,1,MIL,119,1,0,1,1
1999-11-04,TOR,97,0,1,MIA,86,1,0,1,1
1999-11-04,SAS,104,1,0,GSW,81,0,1,1,1
1999-11-04,UTA,98,0,1,HOU,82,0,1,0,2
1999-11-04,PHX,84,0,1,PHI,80,0,1,0,2
1999-11-04,SEA,106,1,0,DAL,96,1,0,2,0
1999-11-05,BOS,103,2,0,CHH,100,2,0,4,0
1999-11-05,NJN,92,0,2,TOR,112,1,1,1,3
1999-11-05,ORL,99,1,1,CLE,104,1,1,2,2
1999-11-05,DET,91,0,2,NYK,103,2,0,2,2
1999-11-05,CHI,87,0,1,MIA,105,1,1,1,2
1999-11-05,HOU,85,0,2,SAS,95,2,0,2,2
1999-11-05,LAC,91,0,2,PHI,81,0,2,0,4
1999-11-05,SAC,100,0,0,MIN,95,0,0,0,0
1999-11-05,POR,95,2,0,DEN,83,1,0,3,0
1999-11-06,WAS,104,1,1,ORL,107,1,2,2,3
1999-11-06,ATL,113,0,2,CHI,97,0,2,0,4
1999-11-06,CLE,102,2,1,NYK,93,3,0,5,1
1999-11-06,IND,115,1,1,BOS,108,3,0,4,1
1999-11-06,MIL,121,2,0,DET,111,0,3,2,3
1999-11-06,MIN,114,0,1,SAC,101,1,0,1,1
1999-11-06,GSW,97,0,2,DAL,120,1,1,1,3
1999-11-06,POR,97,3,0,LAL,82,2,0,5,0
1999-11-06,SEA,99,2,0,UTA,94,1,1,3,1
1999-11-06,VAN,109,0,2,DEN,94,1,1,1,3
1999-11-07,NJN,112,0,3,WAS,87,1,2,1,5
1999-11-07,TOR,109,2,1,CHH,99,2,1,4,2
1999-11-07,PHX,77,1,1,SAS,74,3,0,4,1
1999-11-07,LAL,105,2,1,DAL,97,2,1,4,2
1999-11-08,NYK,111,3,1,MIL,101,3,0,6,1
1999-11-08,PHI,117,0,3,SEA,98,3,0,3,3
1999-11-08,HOU,97,0,3,ORL,102,2,2,2,5
1999-11-08,DEN,115,1,2,ATL,100,1,2,2,4
1999-11-08,LAC,79,1,2,UTA,94,1,2,2,4
1999-11-09,MIA,113,2,1,IND,101,2,1,4,2
1999-11-09,CHI,80,0,3,PHX,103,2,1,2,4
1999-11-09,DAL,101,2,2,LAL,123,3,1,5,3
1999-11-09,UTA,92,2,2,POR,87,4,0,6,2
1999-11-09,GSW,89,0,3,SAS,118,3,1,3,4
1999-11-10,BOS,92,3,1,DET,110,0,4,3,5
1999-11-10,NJN,89,1,3,PHX,104,3,1,4,4
1999-11-10,WAS,95,1,3,SEA,109,3,1,4,4
1999-11-10,ORL,110,3,2,PHI,105,1,3,4,5
1999-11-10,CHH,117,2,2,MIL,111,3,1,5,3
1999-11-10,HOU,88,0,4,LAL,89,4,1,4,5
1999-11-10,LAC,94,1,3,SAS,99,4,1,5,4
1999-11-10,VAN,102,1,2,ATL,97,1,3,2,5
1999-11-11,MIA,128,3,1,DAL,105,2,3,5,4
1999-11-11,CLE,103,3,1,SEA,109,4,1,7,2
1999-11-11,DET,106,1,4,TOR,123,3,1,4,5
1999-11-11,IND,116,2,2,ORL,101,4,2,6,4
1999-11-11,MIN,93,1,1,NYK,90,4,1,5,2
1999-11-12,BOS,80,3,2,NYK,74,4,2,7,4
1999-11-12,PHI,92,1,4,CHI,86,0,4,1,8
1999-11-12,WAS,95,1,4,MIA,104,4,1,5,5
1999-11-12,CHH,96,3,2,NJN,92,1,4,4,6
1999-11-12,MIL,107,3,2,PHX,92,4,1,7,3
1999-11-12,DEN,78,2,2,POR,93,4,1,6,3
1999-11-12,LAL,81,5,1,HOU,97,0,5,5,6
1999-11-12,SAC,105,1,1,UTA,92,3,2,4,3
1999-11-12,VAN,93,2,2,GSW,103,0,4,2,6
1999-11-13,CLE,117,3,2,MIL,112,4,2,7,4
1999-11-13,DET,107,1,5,SEA,99,5,1,6,6
1999-11-13,IND,105,3,2,WAS,83,1,5,4,7
1999-11-13,CHI,92,0,5,BOS,91,4,2,4,7
1999-11-13,MIN,111,2,1,PHX,100,4,2,6,3
1999-11-13,DAL,125,2,4,ORL,117,4,3,6,7
1999-11-13,SAS,95,5,1,CHH,79,4,2,9,3
1999-11-13,GSW,95,1,4,HOU,103,1,5,2,9
1999-11-13,POR,131,5,1,ATL,95,1,4,6,5
1999-11-14,NYK,88,4,3,MIA,94,5,1,9,4
1999-11-14,TOR,90,4,1,PHI,93,2,4,6,5
1999-11-14,LAL,93,5,2,ATL,88,1,5,6,7
1999-11-14,SAC,126,2,1,DEN,116,2,3,4,4
1999-11-14,VAN,109,2,3,LAC,89,1,4,3,7
1999-11-15,NJN,92,1,5,SEA,100,5,2,6,7
1999-11-15,HOU,87,2,5,IND,96,4,2,6,7
1999-11-15,UTA,91,3,3,SAS,85,6,1,9,4
1999-11-15,PHX,82,4,3,LAL,91,6,2,10,5
1999-11-16,WAS,73,1,6,PHI,95,3,4,4,10
1999-11-16,MIA,96,6,1,POR,101,6,1,12,2
1999-11-16,ATL,103,1,6,CHH,98,4,3,5,9
1999-11-16,TOR,89,4,2,DET,85,2,5,6,7
1999-11-16,MIL,101,4,3,LAC,93,1,5,5,8
1999-11-16,DAL,114,3,4,HOU,95,2,6,5,10
1999-11-16,SAS,90,6,2,IND,87,5,2,11,4
1999-11-16,DEN,95,2,4,NYK,102,4,4,6,8
1999-11-16,GSW,99,1,5,CHI,79,1,5,2,10
1999-11-16,SAC,81,3,1,VAN,77,3,3,6,4
1999-11-17,BOS,114,4,3,CLE,103,4,2,8,5
1999-11-17,PHI,93,4,4,MIA,98,6,2,10,6
1999-11-17,ORL,79,4,4,POR,81,7,1,11,5
1999-11-17,CHH,104,4,4,DAL,99,4,4,8,8
1999-11-17,DET,109,2,6,NJN,107,1,6,3,12
1999-11-17,MIN,85,3,1,LAC,89,1,6,4,7
1999-11-17,UTA,98,4,3,NYK,90,5,4,9,7
1999-11-17,PHX,105,4,4,CHI,81,1,6,5,10
1999-11-17,SEA,111,6,2,GSW,108,2,5,8,7
1999-11-18,WAS,92,1,7,TOR,81,5,2,6,9
1999-11-18,MIL,99,5,3,SAS,88,7,2,12,5
1999-11-18,HOU,110,2,7,SAC,128,4,1,6,8
1999-11-18,DEN,93,2,5,LAL,82,7,2,9,7
1999-11-18,VAN,108,3,4,SEA,110,7,2,10,6
1999-11-19,BOS,109,5,3,NJN,96,1,7,6,10
1999-11-19,PHI,91,4,5,POR,97,8,1,12,6
1999-11-19,ORL,92,4,5,CHH,103,5,4,9,9
1999-11-19,TOR,106,5,3,LAC,100,2,6,7,9
1999-11-19,DET,101,3,6,CLE,90,4,3,7,9
1999-11-19,IND,99,5,3,ATL,105,2,6,7,9
1999-11-19,MIN,89,3,2,UTA,84,5,3,8,5
1999-11-19,DAL,94,4,5,SAC,103,5,1,9,6
1999-11-19,PHX,96,5,4,NYK,81,5,5,10,9
1999-11-19,LAL,103,7,3,CHI,95,1,7,8,10
1999-11-20,NJN,96,1,8,PHI,100,4,6,5,14
1999-11-20,WAS,89,2,7,LAC,98,2,7,4,14
1999-11-20,MIA,110,7,2,BOS,92,6,3,13,5
1999-11-20,CHH,96,6,4,POR,100,9,1,15,5
1999-11-20,ATL,103,3,6,ORL,107,4,6,7,12
1999-11-20,CLE,98,4,4,IND,107,5,4,9,8
1999-11-20,MIL,100,6,3,UTA,111,5,4,11,7
1999-11-20,SAS,106,7,3,DAL,90,4,6,11,9
1999-11-20,DEN,95,3,5,CHI,86,1,8,4,13
1999-11-20,GSW,79,2,6,NYK,86,5,6,7,12
1999-11-20,SEA,110,8,2,HOU,107,2,8,10,10
1999-11-21,DET,113,4,6,MIL,94,6,4,10,10
1999-11-21,PHX,99,6,4,SEA,86,9,2,15,6
1999-11-21,LAL,102,8,3,TOR,111,6,3,14,6
1999-11-21,SAC,110,6,1,HOU,105,2,9,8,10
1999-11-21,VAN,81,3,5,MIN,105,4,2,7,7
1999-11-22,BOS,95,6,4,IND,85,6,4,12,8
1999-11-22,PHI,91,5,6,SAS,94,8,3,13,9
1999-11-22,UTA,108,6,4,MIN,93,5,2,11,6
1999-11-23,WAS,89,2,8,VAN,87,3,6,5,14
1999-11-23,ATL,113,3,7,MIA,106,8,2,11,9
1999-11-23,CLE,103,4,5,POR,100,10,1,14,6
1999-11-23,HOU,119,2,10,DAL,99,4,7,6,17
1999-11-23,PHX,94,7,4,TOR,93,7,3,14,7
1999-11-23,LAC,100,3,7,NYK,95,6,6,9,13
1999-11-23,SAC,105,7,1,NJN,92,1,9,8,10
1999-11-24,BOS,98,7,4,SAS,121,9,3,16,7
1999-11-24,PHI,93,5,7,WAS,101,3,8,8,15
1999-11-24,ORL,112,5,6,DAL,100,4,8,9,14
1999-11-24,MIA,93,8,3,ATL,91,4,7,12,10
1999-11-24,CHH,89,6,5,VAN,73,3,7,9,12
1999-11-24,MIL,102,6,5,CHI,95,1,9,7,14
1999-11-24,MIN,81,5,3,POR,88,10,2,15,5
1999-11-24,DEN,109,4,5,TOR,84,7,4,11,9
1999-11-24,LAL,90,8,4,UTA,82,7,4,15,8
1999-11-24,GSW,84,2,7,NJN,92,1,10,3,17
1999-11-25,IND,99,6,5,DET,107,5,6,11,11
1999-11-26,BOS,112,7,5,MIL,114,7,5,14,10
1999-11-26,PHI,106,5,8,CLE,83,5,5,10,13
1999-11-26,CHH,118,7,5,WAS,85,4,8,11,13
1999-11-26,DET,93,6,6,ATL,91,4,8,10,14
1999-11-26,IND,105,6,6,VAN,86,3,8,9,14
1999-11-26,SAS,101,10,3,CHI,78,1,10,11,13
1999-11-26,DEN,114,5,5,MIN,105,5,4,10,9
1999-11-26,UTA,87,7,5,TOR,100,7,5,14,10
1999-11-26,LAL,103,9,4,NJN,80,2,10,11,14
1999-11-26,SAC,124,8,1,GSW,95,2,8,10,9
1999-11-26,POR,91,11,2,HOU,88,3,10,14,12
1999-11-26,SEA,98,9,3,LAC,93,4,7,13,10
1999-11-27,NYK,99,6,7,ORL,96,6,6,12,13
1999-11-27,MIA,89,9,3,WAS,86,4,9,13,12
1999-11-27,ATL,94,4,9,BOS,84,7,6,11,15
1999-11-27,CLE,106,5,6,CHH,89,8,5,13,11
1999-11-27,MIL,79,8,5,PHI,82,6,8,14,13
1999-11-27,MIN,113,5,5,VAN,82,3,9,8,14
1999-11-27,DAL,95,4,9,CHI,83,1,11,5,20
1999-11-27,SAS,106,11,3,DEN,87,6,5,17,8
1999-11-27,PHX,129,8,4,NJN,90,2,11,10,15
1999-11-27,LAC,71,4,8,POR,88,12,2,16,10
1999-11-27,GSW,88,2,9,TOR,106,8,5,10,14
1999-11-28,DET,99,7,6,ORL,108,6,7,13,13
1999-11-28,SEA,102,10,3,IND,91,7,6,17,9
1999-11-29,NYK,107,7,7,DAL,82,5,9,12,16
1999-11-29,MIA,98,10,3,SAC,88,9,1,19,4
1999-11-29,UTA,115,7,6,GSW,99,2,10,9,16
1999-11-29,POR,91,13,2,IND,93,7,7,20,9
1999-11-29,VAN,110,3,10,HOU,118,3,11,6,21
1999-11-30,NJN,78,2,12,WAS,85,4,10,6,22
1999-11-30,PHI,74,7,8,NYK,70,8,7,15,15
1999-11-30,ORL,102,7,7,SAC,111,9,2,16,9
1999-11-30,TOR,89,9,5,ATL,107,5,9,14,14
1999-11-30,CLE,106,6,6,DAL,99,5,10,11,16
1999-11-30,MIN,109,6,5,DEN,92,6,6,12,11
1999-11-30,SAS,106,12,3,DET,87,7,7,19,10
1999-11-30,LAC,80,4,9,PHX,94,9,4,13,13
1999-11-30,SEA,77,11,3,LAL,101,10,4,21,7
1999-12-01,WAS,108,5,10,CLE,111,7,6,12,16
1999-12-01,MIA,90,11,3,PHI,83,8,8,19,11
1999-12-01,DEN,100,6,7,DET,96,7,8,13,15
1999-12-01,PHX,128,10,4,HOU,122,4,11,14,15
1999-12-01,LAL,93,11,4,GSW,75,2,11,13,15
1999-12-01,POR,94,13,3,CHH,90,8,6,21,9
1999-12-01,VAN,89,3,11,IND,96,8,7,11,18
1999-12-02,NJN,94,2,13,SAS,96,13,3,15,16
1999-12-02,ATL,110,6,9,SAC,100,10,2,16,11
1999-12-02,CHI,95,1,12,DAL,101,5,11,6,23
1999-12-02,MIL,80,8,6,NYK,84,8,8,16,14
1999-12-02,MIN,93,7,5,ORL,103,7,8,14,13
1999-12-02,LAC,96,4,10,HOU,109,4,12,8,22
1999-12-02,GSW,108,2,12,SEA,117,11,4,13,16
1999-12-03,BOS,96,7,7,MIA,84,12,3,19,10
1999-12-03,TOR,95,9,6,WAS,93,5,11,14,17
1999-12-03,CLE,100,8,6,PHI,102,8,9,16,15
1999-12-03,DET,102,7,9,SAS,80,14,3,21,12
1999-12-03,DEN,100,7,7,ORL,112,8,8,15,15
1999-12-03,UTA,75,8,6,IND,100,9,7,17,13
1999-12-03,LAL,93,12,4,POR,80,14,3,26,7
1999-12-03,VAN,94,3,12,CHH,113,8,7,11,19
1999-12-04,NJN,82,2,14,NYK,92,9,8,11,22
1999-12-04,PHI,77,9,9,BOS,74,8,7,17,16
1999-12-04,WAS,104,5,12,SAC,114,10,3,15,15
1999-12-04,ATL,112,7,9,DET,110,8,9,15,18
1999-12-04,CHI,91,1,13,MIL,92,8,7,9,20
1999-12-04,MIN,84,7,6,DAL,103,6,11,13,17
1999-12-04,HOU,105,5,12,PHX,95,11,4,16,16
1999-12-04,LAC,89,4,11,SEA,102,12,4,16,15
1999-12-04,GSW,82,2,13,UTA,94,8,7,10,20
1999-12-05,NYK,78,10,8,DEN,80,7,8,17,16
1999-12-05,TOR,98,10,6,SAS,92,14,4,24,10
1999-12-05,MIL,103,9,7,DAL,97,7,11,16,18
1999-12-05,PHX,90,11,5,POR,92,14,4,25,9
1999-12-05,LAL,117,13,4,ORL,100,9,8,22,12
1999-12-05,SEA,81,13,4,CHH,103,9,7,22,11
1999-12-06,NJN,109,2,15,SAC,95,11,3,13,18
1999-12-06,PHI,77,10,9,DEN,94,8,8,18,17
1999-12-06,HOU,102,6,12,VAN,99,3,13,9,25
1999-12-06,UTA,102,9,7,WAS,96,5,13,14,20
1999-12-06,LAC,91,4,12,MIA,99,12,4,16,16
1999-12-07,NYK,89,10,9,GSW,83,2,14,12,23
1999-12-07,TOR,101,11,6,CLE,98,8,7,19,13
1999-12-07,IND,83,10,7,SAS,77,14,5,24,12
1999-12-07,MIL,112,10,7,DET,116,8,10,18,17
1999-12-07,DAL,95,7,12,VAN,104,3,14,10,26
1999-12-07,PHX,110,11,6,ORL,107,9,9,20,15
1999-12-07,LAL,91,14,4,WAS,80,5,14,19,18
1999-12-07,POR,76,15,4,MIA,86,13,4,28,8
1999-12-08,BOS,115,8,8,DEN,90,9,8,17,16
1999-12-08,NJN,107,3,15,MIL,90,10,8,13,23
1999-12-08,PHI,83,10,10,HOU,73,7,12,17,22
1999-12-08,CHH,113,10,7,GSW,106,2,15,12,22
1999-12-08,ATL,99,8,9,LAC,81,4,13,12,22
1999-12-08,CLE,107,8,8,CHI,93,1,14,9,22
1999-12-08,UTA,85,10,7,DAL,79,7,13,17,20
1999-12-08,SAC,103,11,4,LAL,91,15,4,26,8
1999-12-08,SEA,110,13,5,MIN,94,7,7,20,12
1999-12-09,SAS,99,14,6,VAN,91,4,14,18,20
1999-12-09,PHX,99,12,6,WAS,85,5,15,17,21
1999-12-09,POR,90,15,5,MIN,86,7,8,22,13
1999-12-10,BOS,100,9,8,HOU,96,7,13,16,21
1999-12-10,NYK,85,11,9,PHI,78,11,10,22,19
1999-12-10,CHH,106,11,7,DEN,99,9,9,20,16
1999-12-10,ATL,99,9,9,GSW,107,2,16,11,25
1999-12-10,TOR,91,12,6,MIL,107,10,9,22,15
1999-12-10,DET,107,9,10,LAC,83,4,14,13,24
1999-12-10,IND,136,11,7,CLE,88,9,8,20,15
1999-12-10,CHI,71,1,15,NJN,69,4,15,5,30
1999-12-10,UTA,101,11,7,SEA,83,14,5,25,12
1999-12-10,SAC,97,12,4,MIA,107,14,4,26,8
1999-12-11,NJN,106,4,16,HOU,94,7,14,11,30
1999-12-11,PHI,84,11,11,CHH,106,12,7,23,18
1999-12-11,ORL,108,9,10,CHI,87,2,15,11,25
1999-12-11,CLE,127,9,9,ATL,116,9,10,18,19
1999-12-11,IND,108,12,7,LAC,90,4,15,16,22
1999-12-11,MIL,99,11,9,DEN,101,9,10,20,19
1999-12-11,MIN,76,7,9,GSW,104,3,16,10,25
1999-12-11,DAL,120,7,14,PHX,115,13,6,20,20
1999-12-11,SAS,89,15,6,WAS,99,5,16,20,22
1999-12-11,SAC,96,12,5,POR,101,16,5,28,10
1999-12-11,SEA,92,14,6,MIA,88,15,4,29,10
1999-12-11,VAN,94,4,15,LAL,106,15,5,19,20
1999-12-12,NYK,99,12,9,BOS,97,10,8,22,17
1999-12-12,TOR,88,12,7,UTA,103,12,7,24,14
1999-12-12,LAL,101,16,5,DET,93,10,10,26,15
1999-12-13,LAC,102,4,16,VAN,90,4,16,8,32
1999-12-14,WAS,80,6,16,UTA,101,13,7,19,23
1999-12-14,ATL,105,9,11,MIN,94,7,10,16,21
1999-12-14,TOR,105,12,8,IND,97,13,7,25,15
1999-12-14,CLE,115,10,9,BOS,88,10,9,20,18
1999-12-14,DAL,93,8,14,SAS,111,15,7,23,21
1999-12-14,HOU,90,7,15,NYK,101,13,9,20,24
1999-12-14,PHX,114,13,7,DET,104,10,11,23,18
1999-12-14,LAL,95,17,5,LAC,68,5,16,22,21
1999-12-14,GSW,102,4,16,MIA,97,15,5,19,21
1999-12-14,SEA,109,15,6,DEN,84,10,10,25,16
1999-12-15,BOS,86,10,10,UTA,96,14,7,24,17
1999-12-15,NJN,111,5,16,CLE,101,11,9,16,25
1999-12-15,PHI,93,11,12,TOR,91,13,8,24,20
1999-12-15,ORL,99,10,10,MIL,116,11,10,21,20
1999-12-15,CHH,103,13,7,MIN,98,7,11,20,18
1999-12-15,IND,102,13,8,CHI,91,2,16,15,24
1999-12-15,SAS,83,16,7,HOU,77,7,16,23,23
1999-12-15,VAN,106,4,17,SAC,109,12,6,16,23
1999-12-16,WAS,108,6,17,NJN,104,6,16,12,33
1999-12-16,MIA,95,15,6,MIL,96,12,10,27,16
1999-12-16,ATL,88,10,11,LAL,95,18,5,28,16
1999-12-16,DAL,93,8,15,NYK,100,14,9,22,24
1999-12-16,DEN,116,10,11,SAC,106,13,6,23,17
1999-12-16,GSW,108,5,16,DET,116,10,12,15,28
1999-12-16,SEA,81,16,6,POR,107,17,5,33,11
1999-12-17,PHI,77,12,12,CHI,74,2,17,14,29
1999-12-17,ORL,112,10,11,TOR,98,13,9,23,20
1999-12-17,CHH,99,14,7,CLE,86,11,10,25,17
1999-12-17,IND,89,14,8,UTA,74,15,7,29,15
1999-12-17,MIN,88,7,12,LAL,97,19,5,26,17
1999-12-17,SAS,103,17,7,BOS,94,10,11,27,18
1999-12-17,LAC,92,5,17,GSW,91,5,17,10,34
1999-12-17,POR,102,18,5,PHX,110,14,7,32,12
1999-12-18,NYK,83,15,9,WAS,95,7,17,22,26
1999-12-18,MIA,89,15,7,CHH,106,15,7,30,14
1999-12-18,ATL,96,10,12,UTA,106,15,8,25,20
1999-12-18,CLE,74,11,11,NJN,98,6,17,17,28
1999-12-18,DET,104,11,12,PHI,91,13,12,24,24
1999-12-18,CHI,74,2,18,ORL,83,11,11,13,29
1999-12-18,MIL,109,13,10,IND,95,15,8,28,18
1999-12-18,DAL,104,8,16,MIN,108,7,13,15,29
1999-12-18,HOU,100,7,17,BOS,94,10,12,17,29
1999-12-18,DEN,86,11,11,SAS,84,18,7,29,18
1999-12-18,PHX,119,15,7,SAC,103,13,7,28,14
1999-12-18,SEA,112,16,7,VAN,89,4,18,20,25
1999-12-19,NJN,96,7,17,ATL,88,10,13,17,30
1999-12-19,TOR,88,13,10,LAL,94,20,5,33,15
1999-12-19,VAN,85,4,19,LAC,84,6,17,10,36
1999-12-20,BOS,90,10,13,LAL,99,21,5,31,18
1999-12-20,NYK,112,15,10,CHH,109,16,7,31,17
1999-12-20,PHI,122,13,13,DET,121,12,12,25,25
1999-12-20,ORL,104,12,11,UTA,102,16,8,28,19
1999-12-20,CLE,94,11,12,MIN,100,8,13,19,25
1999-12-20,CHI,84,2,19,SEA,93,17,7,19,26
1999-12-20,DAL,89,8,17,MIA,92,15,8,23,25
1999-12-20,DEN,97,12,11,POR,88,18,6,30,17
1999-12-20,PHX,108,16,7,MIL,101,14,10,30,17
1999-12-20,GSW,111,5,18,SAC,99,13,8,18,26
1999-12-21,TOR,116,13,11,NJN,87,8,17,21,28
1999-12-21,DET,83,12,13,WAS,97,8,17,20,30
1999-12-21,IND,113,15,9,SEA,103,18,7,33,16
1999-12-21,HOU,79,8,17,POR,89,18,7,26,24
1999-12-21,SAS,91,18,8,PHX,90,17,7,35,15
1999-12-21,SAC,108,13,9,MIL,95,14,11,27,20
1999-12-22,BOS,98,10,14,ATL,81,10,14,20,28
1999-12-22,NYK,91,16,10,TOR,90,14,11,30,21
1999-12-22,MIA,74,16,8,UTA,72,16,9,32,17
1999-12-22,CLE,97,11,13,ORL,103,13,11,24,24
1999-12-22,CHI,86,2,20,MIN,106,9,13,11,33
1999-12-22,GSW,99,6,18,LAC,103,6,18,12,36
1999-12-23,NJN,99,8,18,PHI,94,14,13,22,31
1999-12-23,CHH,106,16,8,ORL,110,14,11,30,19
1999-12-23,ATL,108,10,15,CLE,90,11,14,21,29
1999-12-23,MIN,109,10,13,SEA,102,18,8,28,21
1999-12-23,HOU,105,8,18,WAS,89,9,17,17,35
1999-12-23,SAS,91,19,8,MIL,94,14,12,33,20
1999-12-23,PHX,110,17,8,DAL,111,8,18,25,26
1999-12-23,LAC,97,7,18,SAC,91,14,9,21,27
1999-12-23,POR,111,19,7,GSW,91,6,19,25,26
1999-12-23,VAN,93,5,19,DEN,91,13,11,18,30
1999-12-25,IND,101,16,9,NYK,90,17,10,33,19
1999-12-25,LAL,99,22,5,SAS,93,19,9,41,14
1999-12-26,NJN,103,9,18,CHI,76,2,21,11,39
1999-12-26,WAS,103,9,18,HOU,92,9,18,18,36
1999-12-26,CLE,95,11,15,TOR,98,14,12,25,27
1999-12-26,DET,114,12,14,CHH,96,16,9,28,23
1999-12-26,MIL,93,15,12,MIA,85,17,8,32,20
1999-12-26,DEN,109,13,12,VAN,86,6,19,19,31
1999-12-26,PHX,108,17,9,GSW,88,6,20,23,29
1999-12-26,LAC,103,8,18,BOS,100,11,14,19,32
1999-12-26,SAC,118,14,10,DAL,111,9,18,23,28
1999-12-26,SEA,86,18,9,PHI,92,14,14,32,23
1999-12-27,ORL,105,15,11,MIN,107,11,13,26,24
1999-12-27,CHH,108,16,10,ATL,104,11,15,27,25
1999-12-27,CHI,91,2,22,IND,103,17,9,19,31
1999-12-27,UTA,92,16,10,PHX,91,18,9,34,19
1999-12-27,LAL,108,23,5,DAL,106,9,19,32,24
1999-12-27,GSW,83,6,21,SAS,105,19,10,25,31
1999-12-27,VAN,93,6,20,PHI,100,15,14,21,34
1999-12-28,NJN,89,10,18,NYK,83,17,11,27,29
1999-12-28,MIA,89,17,9,MIN,78,12,13,29,22
1999-12-28,HOU,99,9,19,TOR,100,15,12,24,31
1999-12-28,DEN,128,14,12,LAC,105,9,18,23,30
1999-12-28,SAC,114,15,10,BOS,101,11,15,26,25
1999-12-28,POR,94,20,7,SEA,89,18,10,38,17
1999-12-29,ORL,106,15,12,MIA,109,18,9,33,21
1999-12-29,CHH,109,17,10,MIL,105,16,12,33,22
1999-12-29,ATL,89,11,16,IND,116,18,9,29,25
1999-12-29,CLE,96,11,16,WAS,94,10,18,21,34
1999-12-29,CHI,77,2,23,DET,91,13,14,15,37
1999-12-29,UTA,101,17,10,VAN,90,6,21,23,31
1999-12-29,LAL,103,24,5,PHX,87,18,10,42,15
1999-12-29,GSW,94,6,22,PHI,97,16,14,22,36
1999-12-29,SEA,104,18,11,SAC,113,16,10,34,21
1999-12-30,NJN,102,11,18,ORL,92,15,13,26,31
1999-12-30,WAS,86,10,19,NYK,89,17,12,27,31
1999-12-30,DET,106,14,14,ATL,105,11,17,25,31
1999-12-30,IND,109,19,9,CHH,99,18,10,37,19
1999-12-30,MIL,91,16,13,CLE,90,12,16,28,29
1999-12-30,MIN,94,12,14,CHI,76,2,24,14,38
1999-12-30,DAL,104,9,20,TOR,109,16,12,25,32
1999-12-30,HOU,122,9,20,LAC,100,9,19,18,39
1999-12-30,DEN,94,15,12,BOS,102,11,16,26,28
1999-12-30,POR,108,21,7,PHI,90,17,14,38,21
1999-12-30,VAN,88,6,22,SAS,98,20,10,26,32
2000-01-02,MIA,111,19,9,ORL,103,15,14,34,23
2000-01-03,BOS,105,12,16,CLE,98,12,17,24,33
2000-01-03,PHI,124,17,15,MIL,120,17,13,34,28
2000-01-03,WAS,99,10,20,GSW,87,6,23,16,43
2000-01-03,ORL,106,15,15,DET,118,15,14,30,29
2000-01-03,CHI,63,2,25,POR,88,22,7,24,32
2000-01-03,UTA,109,18,10,DEN,89,15,13,33,23
2000-01-04,NYK,96,18,12,BOS,88,13,16,31,28
2000-01-04,MIA,87,20,9,VAN,91,6,23,26,32
2000-01-04,TOR,90,17,12,POR,114,23,7,40,19
2000-01-04,CLE,107,12,18,SAC,111,17,10,29,28
2000-01-04,IND,116,20,9,NJN,111,12,18,32,27
2000-01-04,MIL,116,17,14,ATL,113,11,18,28,32
2000-01-04,MIN,91,13,14,SAS,88,21,10,34,24
2000-01-04,HOU,96,10,20,SEA,103,18,12,28,32
2000-01-04,DEN,98,15,14,DAL,96,9,21,24,35
2000-01-04,PHX,86,18,11,CHH,80,18,11,36,22
2000-01-04,LAC,98,9,20,LAL,122,25,5,34,25
2000-01-05,PHI,113,18,15,GSW,92,6,24,24,39
2000-01-05,ORL,116,15,16,VAN,96,7,23,22,39
2000-01-05,ATL,108,11,19,DET,120,16,14,27,33
2000-01-05,CHI,77,2,26,WAS,66,11,20,13,46
2000-01-05,SAS,96,21,11,SEA,99,19,12,40,23
2000-01-05,UTA,118,19,10,CHH,96,18,12,37,22
2000-01-05,LAL,118,26,5,LAC,101,9,21,35,26
2000-01-06,MIA,111,20,10,HOU,99,10,21,30,31
2000-01-06,TOR,101,17,13,SAC,89,18,10,35,23
2000-01-06,CLE,90,12,19,GSW,75,6,25,18,44
2000-01-06,DET,101,17,14,MIL,95,18,14,35,28
2000-01-06,MIN,98,14,14,POR,96,24,7,38,21
2000-01-06,DAL,92,9,22,UTA,105,20,10,29,32
2000-01-06,DEN,87,16,14,IND,102,21,9,37,23
2000-01-07,BOS,101,13,17,SAC,93,18,11,31,28
2000-01-07,NJN,91,12,19,VAN,101,7,24,19,43
2000-01-07,WAS,103,11,21,CHI,110,3,26,14,47
2000-01-07,ORL,86,16,16,NYK,94,19,12,35,28
2000-01-07,ATL,105,11,20,TOR,97,18,13,29,33
2000-01-07,PHX,83,19,11,SAS,102,21,12,40,23
2000-01-07,LAL,87,27,5,CHH,83,18,13,45,18
2000-01-08,NYK,86,20,12,CLE,89,13,19,33,31
2000-01-08,MIA,89,21,10,NJN,90,12,20,33,30
2000-01-08,DET,105,18,14,MIN,110,15,14,33,28
2000-01-08,CHI,96,4,26,BOS,79,14,17,18,43
2000-01-08,MIL,130,18,15,WAS,129,11,22,29,37
2000-01-08,DAL,95,9,23,ATL,85,12,20,21,43
2000-01-08,HOU,87,10,22,UTA,103,21,10,31,32
2000-01-08,SAS,127,22,12,ORL,92,16,17,38,29
2000-01-08,DEN,97,16,15,CHH,92,18,14,34,29
2000-01-08,LAC,107,9,22,IND,94,22,9,31,31
2000-01-08,POR,96,24,8,PHX,91,19,12,43,20
2000-01-08,SEA,100,20,12,LAL,110,28,5,48,17
2000-01-09,PHI,112,19,15,MIN,123,16,14,35,29
2000-01-09,TOR,97,18,14,VAN,107,8,24,26,38
2000-01-09,GSW,95,6,26,SEA,100,20,13,26,39
2000-01-09,SAC,116,18,12,IND,113,22,10,40,22
2000-01-10,BOS,103,14,18,VAN,112,9,24,23,42
2000-01-10,ORL,94,16,18,NJN,100,13,20,29,38
2000-01-10,CLE,111,14,19,LAC,106,10,22,24,41
2000-01-10,MIL,137,19,15,CHH,87,18,15,37,30
2000-01-10,SAS,93,23,12,UTA,86,22,10,45,22
2000-01-10,LAL,130,29,5,DEN,95,17,15,46,20
2000-01-10,POR,107,25,8,DAL,94,10,23,35,31
2000-01-11,NYK,95,20,13,CHI,88,5,26,25,39
2000-01-11,WAS,117,11,23,TOR,89,18,15,29,38
2000-01-11,MIN,106,17,14,MIA,116,21,11,38,25
2000-01-11,GSW,102,6,27,DAL,109,10,24,16,51
2000-01-11,SAC,110,19,12,HOU,93,10,23,29,35
2000-01-11,SEA,101,21,13,PHX,88,19,13,40,26
2000-01-12,BOS,95,14,19,LAC,88,10,23,24,42
2000-01-12,TOR,108,18,16,ORL,102,16,19,34,35
2000-01-12,DET,114,18,15,NYK,108,21,13,39,28
2000-01-12,IND,117,22,11,WAS,102,12,23,34,34
2000-01-12,MIL,94,20,15,LAL,103,30,5,50,20
2000-01-12,DEN,93,17,16,SEA,103,22,13,39,29
2000-01-12,POR,95,26,8,CLE,75,15,19,41,27
2000-01-12,VAN,92,10,24,PHX,95,19,14,29,38
2000-01-13,NJN,110,14,20,LAC,105,10,24,24,44
2000-01-13,MIN,103,17,15,BOS,85,15,19,32,34
2000-01-13,UTA,93,22,11,MIA,83,22,11,44,22
2000-01-13,GSW,100,6,28,HOU,108,10,24,16,52
2000-01-13,SAC,107,20,12,SAS,103,24,12,44,24
2000-01-14,PHI,102,19,16,ORL,100,16,20,35,36
2000-01-14,TOR,115,19,16,MIL,110,20,16,39,32
2000-01-14,DET,105,19,15,WAS,98,12,24,31,39
2000-01-14,IND,111,23,11,LAL,102,31,5,54,16
2000-01-14,CHI,83,5,28,ATL,89,12,21,17,49
2000-01-14,DEN,87,17,17,MIA,92,22,12,39,29
2000-01-14,PHX,83,20,14,POR,105,27,8,47,22
2000-01-14,SEA,91,23,13,SAS,85,24,13,47,26
2000-01-14,VAN,80,10,25,CLE,82,15,20,25,45
2000-01-15,NYK,91,21,15,CHH,79,20,16,41,31
2000-01-15,NJN,96,15,20,BOS,99,15,20,30,40
2000-01-15,WAS,107,12,25,DET,112,20,15,32,40
2000-01-15,ORL,89,16,21,IND,96,24,11,40,32
2000-01-15,ATL,98,13,21,PHI,101,20,16,33,37
2000-01-15,CHI,90,5,29,HOU,93,11,24,16,53
2000-01-15,MIL,118,20,17,TOR,97,20,16,40,33
2000-01-15,MIN,91,18,15,LAL,104,31,6,49,21
2000-01-15,DAL,113,11,24,POR,105,28,8,39,32
2000-01-15,UTA,112,23,11,LAC,75,10,25,33,36
2000-01-15,GSW,99,6,29,SAC,114,21,12,27,41
2000-01-16,PHX,113,20,15,DEN,100,17,18,37,33
2000-01-16,SAC,113,22,12,CLE,102,16,20,38,32
2000-01-16,VAN,83,10,26,MIA,94,23,12,33,38
2000-01-17,NYK,105,22,15,DET,94,21,15,43,30
2000-01-17,PHI,101,21,16,NJN,96,15,21,36,37
2000-01-17,WAS,101,12,26,BOS,105,16,20,28,46
2000-01-17,CHH,115,20,17,TOR,94,20,17,40,34
2000-01-17,ATL,101,13,22,MIL,107,21,17,34,39
2000-01-17,MIN,101,18,16,IND,100,25,11,43,27
2000-01-17,DAL,111,12,24,HOU,121,12,24,24,48
2000-01-17,LAC,93,10,26,SAS,99,24,14,34,40
2000-01-17,LAL,81,32,6,SEA,82,24,13,56,19
2000-01-17,GSW,113,6,30,ORL,100,16,22,22,52
2000-01-18,MIA,85,24,12,CHI,92,5,30,29,42
2000-01-18,HOU,90,13,24,POR,89,28,9,41,33
2000-01-18,SAC,104,23,12,LAC,98,10,27,33,39
2000-01-18,SEA,99,25,13,CLE,80,16,21,41,34
2000-01-19,BOS,94,17,20,TOR,90,20,18,37,38
2000-01-19,NYK,90,23,15,NJN,89,15,22,38,37
2000-01-19,PHI,107,22,16,ATL,89,13,23,35,39
2000-01-19,WAS,86,12,27,DAL,104,12,25,24,52
2000-01-19,IND,106,25,12,MIL,84,22,17,47,29
2000-01-19,CHI,86,6,30,CHH,96,21,17,27,47
2000-01-19,SAS,95,25,14,POR,105,28,10,53,24
2000-01-19,UTA,88,24,11,MIN,91,19,16,43,27
2000-01-19,LAL,95,32,7,CLE,86,16,22,48,29
2000-01-20,NJN,122,15,23,DET,120,21,16,36,39
2000-01-20,CHH,109,22,17,PHI,100,23,16,45,33
2000-01-20,MIL,96,22,18,SEA,104,26,13,48,31
2000-01-20,HOU,122,14,24,DEN,115,17,19,31,43
2000-01-20,SAC,111,24,12,ORL,103,16,23,40,35
2000-01-20,VAN,89,10,27,UTA,94,24,12,34,39
2000-01-21,BOS,111,18,20,SEA,86,27,13,45,33
2000-01-21,WAS,123,12,28,IND,113,26,12,38,40
2000-01-21,MIA,101,24,13,ATL,79,13,24,37,37
2000-01-21,DEN,99,17,20,PHX,101,21,15,38,35
2000-01-21,LAC,89,10,28,MIN,95,20,16,30,44
2000-01-21,GSW,115,7,30,CLE,103,16,23,23,53
2000-01-22,NJN,98,16,23,DAL,95,13,25,29,48
2000-01-22,PHI,103,23,17,IND,97,26,13,49,30
2000-01-22,CHH,110,23,17,BOS,96,19,20,42,37
2000-01-22,ATL,111,13,25,WAS,93,13,28,26,53
2000-01-22,CHI,98,6,31,DET,92,21,17,27,48
2000-01-22,SAS,96,25,15,NYK,83,24,15,49,30
2000-01-22,PHX,101,22,15,CLE,88,16,24,38,39
2000-01-22,LAL,91,33,7,POR,95,29,10,62,17
2000-01-22,SAC,101,25,12,UTA,104,25,12,50,24
2000-01-22,VAN,82,10,28,ORL,85,16,24,26,52
2000-01-23,TOR,94,20,19,SEA,77,27,14,47,33
2000-01-23,DET,91,21,18,DAL,99,13,26,34,44
2000-01-23,HOU,101,15,24,MIA,88,25,13,40,37
2000-01-23,LAC,89,10,29,ORL,102,17,24,27,53
2000-01-23,GSW,81,8,30,MIN,99,21,16,29,46
2000-01-24,NYK,112,24,16,SEA,106,27,15,51,31
2000-01-24,CHI,83,7,31,IND,82,26,14,33,45
2000-01-24,DEN,110,17,21,VAN,98,10,29,27,50
2000-01-24,UTA,105,26,12,LAL,101,33,8,59,20
2000-01-24,POR,101,30,10,NJN,87,17,23,47,33
2000-01-25,MIA,115,25,14,BOS,89,19,21,44,35
2000-01-25,CHH,99,24,17,SAC,110,25,13,49,30
2000-01-25,ATL,96,14,25,CHI,89,8,31,22,56
2000-01-25,CLE,116,16,25,DET,107,21,19,37,44
2000-01-25,IND,93,26,15,PHX,87,23,15,49,30
2000-01-25,DAL,117,14,26,GSW,103,8,31,22,57
2000-01-25,HOU,84,16,24,MIN,92,22,16,38,40
2000-01-25,SAS,105,26,15,LAC,82,10,30,36,45
2000-01-26,PHI,87,24,17,PHX,93,23,16,47,33
2000-01-26,ORL,111,18,24,BOS,89,19,22,37,46
2000-01-26,TOR,120,21,19,WAS,105,14,29,35,48
2000-01-26,MIL,112,22,19,SAC,104,26,13,48,32
2000-01-26,UTA,99,27,12,VAN,116,10,30,37,42
2000-01-26,SEA,95,27,16,NJN,92,17,24,44,40
2000-01-27,CHH,117,24,18,DET,102,21,20,45,38
2000-01-27,CLE,102,17,25,ORL,90,19,24,36,49
2000-01-27,DAL,99,15,26,LAC,90,10,31,25,57
2000-01-27,HOU,110,16,25,GSW,115,8,32,24,57
2000-01-27,SAS,92,27,15,MIN,80,23,16,50,31
2000-01-27,POR,85,31,10,UTA,75,27,13,58,23
2000-01-27,VAN,108,11,30,NJN,106,17,25,28,55
2000-01-28,BOS,91,19,23,PHX,88,24,16,43,39
2000-01-28,ATL,98,15,25,NYK,96,25,17,40,42
2000-01-28,TOR,108,22,19,MIA,93,26,14,48,33
2000-01-28,CHI,90,8,32,SAC,102,26,14,34,46
2000-01-28,DEN,104,18,21,HOU,98,16,26,34,47
2000-01-28,LAL,117,33,9,MIL,89,23,19,56,28
2000-01-29,WAS,103,14,30,CLE,98,18,25,32,55
2000-01-29,ORL,103,19,25,ATL,87,16,25,35,50
2000-01-29,CHH,100,25,18,PHX,79,24,17,49,35
2000-01-29,DET,90,21,21,PHI,88,24,18,45,39
2000-01-29,IND,94,27,15,MIA,84,26,15,53,30
2000-01-29,CHI,89,8,33,TOR,106,23,19,31,52
2000-01-29,MIN,96,23,17,UTA,94,27,14,50,31
2000-01-29,DAL,107,16,26,DEN,96,19,21,35,47
2000-01-29,LAC,98,10,32,NJN,93,17,26,27,58
2000-01-29,POR,81,32,10,SAS,67,28,15,60,25
2000-01-29,SEA,99,28,16,MIL,101,23,20,51,36
2000-01-30,NYK,120,25,18,SAC,111,27,14,52,32
2000-01-30,HOU,89,16,27,LAL,83,34,9,50,36
2000-01-31,ORL,113,20,25,PHX,117,24,18,44,43
2000-01-31,MIA,104,26,16,DET,82,22,21,48,37
2000-01-31,MIN,105,24,17,SAC,90,27,15,51,32
2000-01-31,DEN,83,19,22,PHI,80,24,19,43,41
2000-01-31,VAN,87,12,30,MIL,92,24,20,36,50
2000-02-01,NYK,77,26,18,ORL,98,20,26,46,44
2000-02-01,CLE,112,18,26,WAS,108,15,30,33,56
2000-02-01,IND,99,28,15,BOS,96,20,23,48,38
2000-02-01,DAL,100,17,26,PHI,101,24,20,41,46
2000-02-01,HOU,99,17,27,CHH,83,26,18,43,45
2000-02-01,SAS,105,28,16,LAL,81,34,10,62,26
2000-02-01,UTA,96,27,15,SEA,104,28,17,55,32
2000-02-01,LAC,76,11,32,GSW,107,9,32,20,64
2000-02-01,POR,92,33,10,CHI,81,8,34,41,44
2000-02-02,BOS,103,20,24,MIA,105,27,16,47,40
2000-02-02,NJN,89,17,27,ATL,97,16,26,33,53
2000-02-02,WAS,103,15,31,MIN,93,25,17,40,48
2000-02-02,DET,110,22,22,SAC,113,27,16,49,38
2000-02-02,DEN,135,20,22,MIL,112,25,20,45,42
2000-02-02,PHX,114,25,18,LAC,68,11,33,36,51
2000-02-02,GSW,101,10,32,VAN,95,12,31,22,63
2000-02-02,SEA,81,29,17,CHI,88,8,35,37,52
2000-02-03,NYK,98,26,19,POR,88,34,10,60,29
2000-02-03,DAL,106,17,27,CHH,96,26,19,43,46
2000-02-03,HOU,109,18,27,PHI,106,25,20,43,47
2000-02-03,SAS,112,29,16,TOR,95,24,19,53,35
2000-02-03,UTA,99,27,16,MIL,102,25,21,52,37
2000-02-04,BOS,100,20,25,NJN,95,17,28,37,53
2000-02-04,MIA,99,28,16,WAS,92,16,31,44,47
2000-02-04,ATL,90,17,26,POR,97,34,11,51,37
2000-02-04,DET,105,22,23,CLE,96,19,26,41,49
2000-02-04,IND,104,29,15,SAC,94,28,16,57,31
2000-02-04,MIN,102,25,18,HOU,85,19,27,44,45
2000-02-04,LAL,113,34,11,UTA,67,27,17,61,28
2000-02-04,GSW,103,11,32,DEN,101,21,22,32,54
2000-02-04,SEA,94,29,18,PHX,86,26,18,55,36
2000-02-04,VAN,101,12,32,CHI,76,9,35,21,67
2000-02-05,WAS,102,16,32,CHH,110,26,20,42,52
2000-02-05,ORL,107,21,26,IND,102,30,15,51,41
2000-02-05,CLE,94,19,27,ATL,102,17,27,36,54
2000-02-05,MIL,95,26,21,TOR,98,24,20,50,41
2000-02-05,DEN,97,21,23,MIN,105,26,18,47,41
2000-02-05,LAC,106,11,34,DAL,119,18,27,29,61
2000-02-06,BOS,94,21,25,POR,100,35,11,56,36
2000-02-06,NYK,94,27,19,MIA,80,29,16,56,35
2000-02-06,NJN,110,17,29,GSW,90,12,32,29,61
2000-02-06,PHI,119,25,21,SAC,108,28,17,53,38
2000-02-06,DET,109,23,23,HOU,105,19,28,42,51
2000-02-06,UTA,93,27,18,SAS,90,30,16,57,34
2000-02-06,PHX,105,26,19,SEA,93,30,18,56,37
2000-02-06,LAC,90,11,35,CHI,100,9,36,20,71
2000-02-06,VAN,99,13,32,DAL,103,19,27,32,59
2000-02-07,CHH,95,19,16,NYK,85,21,14,40,30
2000-02-07,ORL,120,22,26,GSW,100,12,33,34,59
2000-02-07,IND,109,30,16,PHI,84,26,21,56,37
2000-02-07,MIL,111,26,22,POR,115,36,11,62,33
2000-02-07,LAL,106,35,11,DEN,98,21,24,56,35
2000-02-08,NJN,131,18,29,BOS,113,21,26,39,55
2000-02-08,TOR,109,25,20,ATL,88,18,27,43,47
2000-02-08,HOU,91,19,29,CLE,83,19,28,38,57
2000-02-08,SAS,79,30,17,SEA,77,30,19,60,36
2000-02-08,PHX,94,27,19,VAN,76,13,33,40,52
2000-02-08,SAC,119,28,18,CHI,80,10,36,38,54
2000-02-09,BOS,104,21,27,IND,113,31,16,52,43
2000-02-09,PHI,92,26,22,NJN,90,19,29,45,51
2000-02-09,ORL,107,23,26,WAS,96,16,33,39,59
2000-02-09,MIA,115,29,17,GSW,100,12,34,41,51
2000-02-09,CHH,103,27,20,CLE,95,19,29,46,49
2000-02-09,ATL,116,18,28,HOU,100,20,29,38,57
2000-02-09,DET,115,24,23,TOR,108,26,20,50,43
2000-02-09,MIL,103,26,23,NYK,109,28,19,54,42
2000-02-09,DAL,106,20,27,SEA,117,30,20,50,47
2000-02-09,DEN,97,21,25,SAS,106,31,17,52,42
2000-02-09,UTA,113,28,18,CHI,86,10,37,38,55
2000-02-09,LAL,114,36,11,MIN,81,27,18,63,29
2000-02-09,POR,107,37,11,LAC,100,11,36,48,47
2000-02-10,PHX,101,28,19,MIN,85,27,19,55,38
2000-02-10,LAC,90,11,37,VAN,112,13,34,24,71
2000-02-10,SAC,96,29,18,DEN,84,21,26,50,44
2000-02-15,PHI,93,27,22,CHH,95,28,20,55,42
2000-02-15,MIA,107,30,17,LAC,88,11,38,41,55
2000-02-15,ATL,103,19,28,NJN,86,19,30,38,58
2000-02-15,TOR,91,26,21,NYK,70,29,19,55,40
2000-02-15,CLE,92,19,30,SAS,81,32,17,51,47
2000-02-15,CHI,76,10,38,LAL,88,37,11,47,49
2000-02-15,MIN,104,27,20,DEN,107,21,27,48,47
2000-02-15,DAL,99,20,28,MIL,112,26,24,46,52
2000-02-15,HOU,107,20,30,DET,102,25,23,45,53
2000-02-15,UTA,99,29,18,BOS,101,21,28,50,46
2000-02-15,GSW,83,12,35,POR,92,38,11,50,46
2000-02-15,SAC,108,30,18,PHX,117,29,19,59,37
2000-02-15,SEA,114,31,20,WAS,85,16,34,47,54
2000-02-16,NYK,93,29,20,MIN,89,27,21,56,41
2000-02-16,ORL,129,24,26,LAC,96,11,39,35,65
2000-02-16,CHH,85,29,20,LAL,92,38,11,67,31
2000-02-16,IND,109,32,16,TOR,101,27,21,59,37
2000-02-16,POR,99,39,11,GSW,95,12,36,51,47
2000-02-16,VAN,92,14,34,WAS,87,16,35,30,69
2000-02-17,CLE,119,20,30,DEN,101,22,27,42,57
2000-02-17,CHI,83,10,39,MIA,76,31,17,41,56
2000-02-17,MIL,90,27,24,IND,92,33,16,60,40
2000-02-17,DAL,106,20,29,DET,97,25,24,45,53
2000-02-17,UTA,119,29,19,SAC,108,30,19,59,38
2000-02-18,NJN,91,19,31,MIA,84,31,18,50,49
2000-02-18,PHI,104,27,23,CLE,75,21,30,48,53
2000-02-18,ORL,99,25,26,LAL,107,39,11,64,37
2000-02-18,CHH,115,29,21,LAC,87,11,40,40,61
2000-02-18,TOR,91,27,22,DEN,95,22,28,49,50
2000-02-18,MIN,103,27,22,VAN,91,15,34,42,56
2000-02-18,SAS,116,32,18,HOU,92,21,30,53,48
2000-02-18,PHX,85,30,19,ATL,73,20,28,50,47
2000-02-18,GSW,122,12,37,BOS,100,22,28,34,65
2000-02-18,SAC,118,30,20,SEA,85,32,20,62,40
2000-02-18,POR,93,40,11,WAS,85,16,36,56,47
2000-02-19,NYK,87,30,20,IND,73,34,16,64,36
2000-02-19,CHI,74,11,39,LAC,72,11,41,22,80
2000-02-19,MIL,100,27,25,VAN,111,15,35,42,60
2000-02-19,UTA,91,30,19,DET,87,25,25,55,44
2000-02-19,SEA,94,32,21,BOS,91,22,29,54,50
2000-02-20,PHI,84,28,23,LAL,87,40,11,68,34
2000-02-20,CHH,80,30,21,MIA,85,31,19,61,40
2000-02-20,TOR,96,27,23,DAL,100,21,29,48,52
2000-02-20,MIN,89,28,22,NJN,91,20,31,48,53
2000-02-20,HOU,111,21,31,SAS,113,33,18,54,49
2000-02-20,GSW,112,13,37,WAS,103,16,37,29,74
2000-02-20,SAC,103,31,20,POR,108,41,11,72,31
2000-02-21,NYK,87,31,20,LAC,76,11,42,42,62
2000-02-21,CLE,109,21,31,VAN,108,16,35,37,66
2000-02-21,DET,95,25,26,MIA,87,32,19,57,45
2000-02-21,IND,94,34,17,DAL,93,22,29,56,46
2000-02-21,SAS,89,34,18,PHX,98,31,19,65,37
2000-02-21,DEN,123,23,28,SAC,117,31,21,54,49
2000-02-21,UTA,96,31,19,ATL,94,20,29,51,48
2000-02-21,POR,105,42,11,BOS,92,22,30,64,41
2000-02-22,NJN,89,21,31,LAL,97,41,11,62,42
2000-02-22,WAS,126,16,38,MIL,101,27,26,43,64
2000-02-22,CHH,102,30,22,HOU,97,21,32,51,54
2000-02-22,CHI,81,12,39,VAN,85,16,36,28,75
2000-02-22,MIN,112,28,23,GSW,89,14,37,42,60
2000-02-22,PHX,86,32,19,DEN,67,24,28,56,47
2000-02-22,SEA,127,33,21,ORL,91,25,27,58,48
2000-02-23,NYK,88,32,20,TOR,99,27,24,59,44
2000-02-23,PHI,94,28,24,LAC,78,11,43,39,67
2000-02-23,MIA,99,32,20,NJN,85,21,32,53,52
2000-02-23,CLE,98,22,31,LAL,116,42,11,64,42
2000-02-23,DET,111,26,26,IND,118,35,17,61,43
2000-02-23,MIL,86,27,27,GSW,91,14,38,41,65
2000-02-23,SAC,94,31,22,ATL,100,20,30,51,52
2000-02-24,WAS,83,17,38,PHX,92,33,19,50,57
2000-02-24,CHH,70,31,22,SAS,72,34,19,65,41
2000-02-24,IND,100,36,17,CHI,83,12,40,48,57
2000-02-24,MIN,116,29,23,LAC,91,11,44,40,67
2000-02-24,DAL,85,22,30,UTA,92,32,19,54,49
2000-02-24,HOU,97,21,33,DEN,106,24,29,45,62
2000-02-24,POR,111,43,11,ORL,92,25,28,68,39
2000-02-24,VAN,77,17,36,BOS,101,22,31,39,67
2000-02-25,NYK,84,32,21,PHX,79,34,19,66,40
2000-02-25,MIA,87,33,20,CLE,82,22,32,55,52
2000-02-25,TOR,85,28,24,MIN,107,30,23,58,47
2000-02-25,DET,131,26,27,GSW,99,15,38,41,65
2000-02-25,CHI,78,12,41,SAS,91,35,19,47,60
2000-02-25,MIL,83,27,28,PHI,97,29,24,56,52
2000-02-25,UTA,96,33,19,ORL,88,25,29,58,48
2000-02-25,LAL,109,43,11,BOS,96,23,31,66,42
2000-02-25,SEA,87,34,21,ATL,95,21,30,55,51
2000-02-26,NJN,104,21,33,CHH,93,31,23,52,56
2000-02-26,WAS,88,17,39,MIA,98,34,20,51,59
2000-02-26,IND,104,37,17,GSW,88,15,39,52,56
2000-02-26,DAL,98,22,31,DEN,96,25,29,47,60
2000-02-26,LAC,78,11,45,ATL,77,22,30,33,75
2000-02-26,VAN,102,17,37,SAC,90,31,23,48,60
2000-02-27,NYK,89,33,21,PHI,88,30,24,63,45
2000-02-27,TOR,103,28,25,PHX,102,34,20,62,45
2000-02-27,DET,93,27,27,CHI,90,12,42,39,69
2000-02-27,MIL,102,27,29,ORL,95,25,30,52,59
2000-02-27,MIN,102,31,23,SAS,98,36,19,67,42
2000-02-27,LAL,101,44,11,HOU,85,21,34,65,45
2000-02-27,POR,101,44,11,UTA,92,34,19,78,30
2000-02-28,BOS,100,23,32,DAL,108,23,31,46,63
2000-02-28,MIA,85,35,20,NYK,76,34,21,69,41
2000-02-28,CHH,81,31,24,SEA,84,34,22,65,46
2000-02-28,UTA,106,34,20,NJN,101,22,33,56,53
2000-02-28,LAC,77,12,45,HOU,96,21,35,33,80
2000-02-28,GSW,80,15,40,ATL,75,22,31,37,71
2000-02-29,PHI,106,30,25,DAL,87,24,31,54,56
2000-02-29,ORL,103,25,31,SEA,94,35,22,60,53
2000-02-29,TOR,87,29,25,CHI,80,12,43,41,68
2000-02-29,CLE,93,22,33,PHX,100,34,21,56,54
2000-02-29,IND,115,38,17,DET,105,28,27,66,44
2000-02-29,MIN,87,32,23,CHH,92,31,25,63,48
2000-02-29,SAS,93,36,20,MIA,69,36,20,72,40
2000-02-29,SAC,112,31,24,VAN,87,18,37,49,61
2000-02-29,POR,87,45,11,LAL,90,45,11,90,22
2000-03-01,BOS,94,23,33,TOR,96,30,25,53,58
2000-03-01,ATL,83,22,32,WAS,102,17,40,39,72
2000-03-01,DET,94,28,28,UTA,107,35,20,63,48
2000-03-01,DEN,81,25,30,NJN,94,22,34,47,64
2000-03-01,LAL,103,46,11,VAN,91,18,38,64,49
2000-03-02,NYK,109,34,22,MIL,94,28,29,62,51
2000-03-02,WAS,84,18,40,PHI,87,31,25,49,65
2000-03-02,ORL,104,26,31,CHH,96,32,25,58,56
2000-03-02,MIA,101,36,21,SEA,83,35,23,71,44
2000-03-02,CHI,110,12,44,CLE,114,22,34,34,78
2000-03-02,DAL,102,24,32,NJN,103,23,34,47,66
2000-03-02,HOU,102,22,35,SAC,99,32,24,54,59
2000-03-02,SAS,102,37,20,MIN,108,32,24,69,44
2000-03-02,PHX,118,35,21,IND,87,39,17,74,38
2000-03-03,CHH,87,32,26,UTA,89,36,20,68,46
2000-03-03,ATL,83,22,33,NYK,70,35,22,57,55
2000-03-03,TOR,114,31,25,BOS,104,23,34,54,59
2000-03-03,DEN,122,25,31,GSW,88,16,40,41,71
2000-03-03,LAL,107,47,11,IND,92,39,18,86,29
2000-03-03,POR,101,45,12,VAN,91,18,39,63,51
2000-03-04,WAS,100,18,41,DET,94,28,29,46,70
2000-03-04,ATL,81,23,33,SEA,93,35,24,58,57
2000-03-04,CHI,84,12,45,PHI,95,32,25,44,70
2000-03-04,MIL,84,28,30,MIN,91,33,24,61,54
2000-03-04,HOU,99,23,35,NJN,92,24,34,47,69
2000-03-04,SAS,103,37,21,SAC,108,32,25,69,46
2000-03-04,PHX,110,36,21,DAL,96,24,33,60,54
2000-03-04,LAC,99,12,46,CLE,109,23,34,35,80
2000-03-05,CHH,100,18,16,CHI,94,5,27,23,43
2000-03-05,BOS,97,23,35,ORL,91,27,31,50,66
2000-03-05,NYK,79,35,23,UTA,88,37,20,72,43
2000-03-05,MIN,105,34,24,SEA,100,36,24,70,48
2000-03-05,DEN,92,26,31,CLE,100,24,34,50,65
2000-03-05,LAL,93,48,11,MIA,80,37,21,85,32
2000-03-05,GSW,95,16,41,IND,114,39,19,55,60
2000-03-05,VAN,92,18,40,TOR,94,32,25,50,65
2000-03-06,WAS,85,19,41,ORL,87,27,32,46,73
2000-03-06,MIL,111,28,31,ATL,78,23,34,51,65
2000-03-06,SAS,106,37,22,NJN,104,24,35,61,57
2000-03-06,PHX,100,37,21,MIA,92,37,22,74,43
2000-03-06,LAC,103,12,47,LAL,123,49,11,61,58
2000-03-06,SAC,130,33,25,DAL,109,24,34,57,59
2000-03-06,POR,90,46,12,TOR,109,33,25,79,37
2000-03-07,NYK,111,35,24,VAN,86,18,41,53,65
2000-03-07,IND,90,40,19,DEN,89,26,32,66,51
2000-03-07,CHI,89,12,46,ATL,82,23,35,35,81
2000-03-07,MIN,86,35,24,WAS,90,19,42,54,66
2000-03-07,HOU,101,24,35,PHX,108,38,21,62,56
2000-03-07,UTA,113,38,20,CLE,95,25,34,63,54
2000-03-07,GSW,99,16,42,CHH,102,32,27,48,69
2000-03-07,SEA,101,36,25,DAL,86,24,35,60,60
2000-03-08,WAS,118,13,29,NYK,113,25,16,38,45
2000-03-08,BOS,112,24,35,MIL,101,29,31,53,66
2000-03-08,NJN,115,24,36,POR,103,46,13,70,49
2000-03-08,PHI,107,33,25,VAN,90,18,42,51,67
2000-03-08,ORL,103,28,32,CHI,67,13,46,41,78
2000-03-08,DET,130,28,30,DEN,116,26,33,54,63
2000-03-08,LAC,94,12,48,TOR,95,34,25,46,73
2000-03-08,SAC,105,34,25,CHH,92,33,27,67,52
2000-03-09,ATL,79,23,36,SAS,105,38,22,61,58
2000-03-09,IND,127,41,19,POR,119,46,14,87,33
2000-03-09,DAL,79,24,36,MIN,100,35,25,59,61
2000-03-09,UTA,101,39,20,HOU,82,24,36,63,56
2000-03-09,GSW,92,16,43,LAL,109,50,11,66,54
2000-03-10,BOS,104,25,35,CHI,74,13,47,38,82
2000-03-10,PHI,77,34,25,NYK,82,36,24,70,49
2000-03-10,WAS,99,20,42,SAS,106,39,22,59,64
2000-03-10,MIA,96,37,23,DEN,88,26,34,63,57
2000-03-10,CLE,92,25,35,IND,95,42,19,67,54
2000-03-10,DET,111,29,30,VAN,97,18,43,47,73
2000-03-10,MIL,80,29,32,NJN,108,25,36,54,68
2000-03-10,PHX,96,39,21,UTA,99,40,20,79,41
2000-03-10,LAC,101,12,49,CHH,118,33,28,45,77
2000-03-10,SAC,103,35,25,TOR,88,35,25,70,50
2000-03-10,SEA,99,37,25,GSW,85,16,44,53,69
2000-03-11,ORL,110,29,32,DEN,107,26,35,55,67
2000-03-11,ATL,91,23,37,VAN,86,18,44,41,81
2000-03-11,DET,94,30,30,POR,99,46,15,76,45
2000-03-11,DAL,104,24,37,PHX,99,39,22,63,59
2000-03-11,HOU,86,24,37,MIN,100,36,25,60,62
2000-03-12,BOS,93,26,35,PHI,77,34,26,60,61
2000-03-12,NYK,93,37,24,SAS,80,40,22,77,46
2000-03-12,NJN,129,26,36,ORL,91,30,32,56,68
2000-03-12,WAS,86,20,43,POR,102,47,15,67,58
2000-03-12,IND,96,43,19,MIA,105,38,23,81,42
2000-03-12,MIL,103,29,33,CLE,72,25,36,54,69
2000-03-12,LAL,109,51,11,SAC,106,36,25,87,36
2000-03-12,GSW,103,16,45,LAC,112,12,50,28,95
2000-03-12,SEA,97,38,25,TOR,99,35,26,73,51
2000-03-13,DET,124,30,31,BOS,115,27,35,57,66
2000-03-13,CHI,79,13,48,UTA,87,41,20,54,68
2000-03-13,DEN,108,26,36,LAL,118,52,11,78,47
2000-03-13,VAN,103,18,45,SEA,113,38,26,56,71
2000-03-14,NYK,91,38,24,HOU,85,24,38,62,62
2000-03-14,ORL,107,30,33,WAS,98,20,44,50,77
2000-03-14,MIA,108,39,23,MIL,104,30,33,69,56
2000-03-14,TOR,85,36,26,GSW,78,16,46,52,72
2000-03-14,CLE,97,25,37,PHI,98,34,27,59,64
2000-03-14,DAL,111,25,37,IND,90,43,20,68,57
2000-03-14,SAS,94,40,23,ATL,79,24,37,64,60
2000-03-14,PHX,107,39,23,MIN,100,37,25,76,48
2000-03-14,LAC,110,13,50,DEN,106,26,37,39,87
2000-03-14,POR,96,48,15,SAC,91,36,26,84,41
2000-03-15,BOS,121,27,36,GSW,104,16,47,43,83
2000-03-15,CHH,77,34,28,CHI,74,13,49,47,77
2000-03-15,ATL,107,24,38,IND,113,43,21,67,59
2000-03-15,DET,113,31,31,ORL,91,31,33,62,64
2000-03-15,SAC,98,36,27,LAC,78,14,50,50,77
2000-03-16,WAS,109,20,45,LAL,102,53,11,73,56
2000-03-16,MIA,92,40,23,PHI,77,35,27,75,50
2000-03-16,CLE,86,25,38,UTA,107,42,20,67,58
2000-03-16,MIL,106,30,34,HOU,96,24,39,54,73
2000-03-16,SAS,88,41,23,DAL,110,26,37,67,60
2000-03-16,POR,92,49,15,MIN,96,37,26,86,41
2000-03-16,SEA,117,39,26,VAN,103,18,46,57,72
2000-03-17,PHI,99,35,28,UTA,97,43,20,78,48
2000-03-17,CHH,99,35,28,NYK,118,39,24,74,52
2000-03-17,ATL,90,24,39,BOS,114,28,36,52,75
2000-03-17,TOR,95,37,26,ORL,91,31,34,68,60
2000-03-17,DET,82,32,31,LAL,110,53,12,85,43
2000-03-17,IND,111,44,21,HOU,102,24,40,68,61
2000-03-17,CHI,92,13,50,GSW,95,16,48,29,98
2000-03-17,DEN,114,26,38,LAC,87,14,51,40,89
2000-03-17,VAN,86,18,47,PHX,101,40,23,58,70
2000-03-18,NJN,92,27,36,MIL,90,31,34,58,70
2000-03-18,WAS,101,21,45,CHI,88,13,51,34,96
2000-03-18,CLE,90,25,39,MIA,92,41,23,66,62
2000-03-18,IND,113,45,21,CHH,99,35,29,80,50
2000-03-18,DAL,99,27,37,BOS,104,29,36,56,73
2000-03-18,SAS,102,41,24,DEN,82,27,38,68,62
2000-03-18,LAC,83,14,52,SAC,104,37,27,51,79
2000-03-18,SEA,96,40,26,POR,97,49,16,89,42
2000-03-19,NYK,85,40,24,LAL,92,54,12,94,36
2000-03-19,NJN,88,28,36,UTA,92,43,21,71,57
2000-03-19,PHI,89,36,28,ORL,85,31,35,67,63
2000-03-19,ATL,85,24,40,DAL,89,27,38,51,78
2000-03-19,TOR,100,38,26,HOU,98,24,41,62,67
2000-03-19,MIN,109,38,26,MIL,82,31,35,69,61
2000-03-19,GSW,82,17,48,PHX,99,41,23,58,71
2000-03-19,VAN,99,18,48,DET,101,32,32,50,80
2000-03-20,MIA,89,42,23,LAL,100,55,12,97,35
2000-03-20,CHH,96,35,30,PHI,102,37,28,72,58
2000-03-20,CLE,98,25,40,HOU,85,24,42,49,82
2000-03-20,CHI,86,13,52,ORL,88,31,36,44,88
2000-03-20,PHX,110,42,23,BOS,106,30,36,72,59
2000-03-20,LAC,93,14,53,WAS,105,22,45,36,98
2000-03-21,ATL,82,24,41,MIA,77,42,24,66,65
2000-03-21,TOR,93,39,26,NJN,100,28,37,67,63
2000-03-21,IND,95,46,21,NYK,91,40,25,86,46
2000-03-21,MIN,111,39,26,CLE,107,26,40,65,66
2000-03-21,DAL,97,28,38,SAS,96,42,24,70,62
2000-03-21,UTA,96,44,21,DEN,83,27,39,71,60
2000-03-21,SAC,98,38,27,WAS,86,23,45,61,72
2000-03-21,SEA,90,40,27,DET,100,33,32,73,59
2000-03-21,VAN,98,18,49,GSW,82,17,49,35,98
2000-03-22,BOS,106,30,37,MIN,109,40,26,70,63
2000-03-22,NYK,78,40,26,CHI,67,13,53,53,79
2000-03-22,PHI,106,38,28,TOR,93,39,27,77,55
2000-03-22,ORL,103,32,36,ATL,90,25,41,57,77
2000-03-22,CHH,119,35,31,NJN,103,29,37,64,68
2000-03-22,SAS,103,42,25,LAC,78,14,54,56,79
2000-03-22,PHX,114,43,23,SAC,93,39,27,82,50
2000-03-22,LAL,119,56,12,GSW,96,17,50,73,62
2000-03-22,POR,95,50,16,DET,104,34,32,84,48
2000-03-23,IND,84,47,21,MIL,105,31,36,78,57
2000-03-23,DAL,98,29,38,CLE,104,26,41,55,79
2000-03-23,HOU,110,24,43,LAC,95,14,55,38,98
2000-03-23,DEN,86,27,40,WAS,100,23,46,50,86
2000-03-24,NYK,95,41,26,ATL,83,25,42,66,68
2000-03-24,NJN,115,29,38,MIN,116,41,26,70,64
2000-03-24,PHI,117,39,28,BOS,115,30,38,69,66
2000-03-24,ORL,112,33,36,HOU,96,25,43,58,79
2000-03-24,TOR,84,39,28,CHH,102,36,31,75,59
2000-03-24,CHI,70,13,54,DEN,68,27,41,40,95
2000-03-24,MIL,87,32,36,MIA,99,42,25,74,61
2000-03-24,LAL,109,57,12,PHX,101,44,23,101,35
2000-03-24,GSW,83,17,51,POR,96,50,17,67,68
2000-03-24,SAC,113,39,28,DET,103,35,32,74,60
2000-03-24,SEA,95,40,28,UTA,98,45,21,85,49
2000-03-25,ATL,70,25,43,CHH,86,37,31,62,74
2000-03-25,DAL,86,29,39,WAS,93,24,46,53,85
2000-03-25,SAS,96,43,25,CLE,76,27,41,70,66
2000-03-25,LAC,107,14,56,DET,126,35,33,49,89
2000-03-25,VAN,75,19,49,UTA,84,46,21,65,70
2000-03-26,NJN,110,29,39,DEN,112,27,42,56,81
2000-03-26,ORL,94,34,36,MIA,69,43,25,77,61
2000-03-26,IND,101,47,22,PHI,111,40,28,87,50
2000-03-26,MIL,99,32,37,BOS,84,30,39,62,76
2000-03-26,MIN,106,42,26,TOR,101,39,29,81,55
2000-03-26,HOU,123,25,44,CHI,78,14,54,39,98
2000-03-26,PHX,90,44,24,GSW,82,17,52,61,76
2000-03-26,SAC,89,40,28,LAL,90,58,12,98,40
2000-03-26,POR,89,51,17,NYK,93,42,26,93,43
2000-03-27,UTA,105,47,21,DAL,113,29,40,76,61
2000-03-27,SEA,82,40,29,SAS,90,44,25,84,54
2000-03-28,NJN,111,29,40,IND,106,47,23,76,63
2000-03-28,ORL,122,35,36,BOS,87,30,40,65,76
2000-03-28,MIA,81,43,26,PHX,78,45,24,88,50
2000-03-28,ATL,116,25,44,DEN,111,28,42,53,86
2000-03-28,CLE,96,27,42,TOR,99,39,30,66,72
2000-03-28,MIN,100,43,26,PHI,102,41,28,84,54
2000-03-28,HOU,121,26,44,GSW,86,17,53,43,97
2000-03-28,LAC,102,14,57,DAL,112,30,40,44,97
2000-03-28,SAC,103,40,29,NYK,95,43,26,83,55
2000-03-28,POR,85,51,18,SAS,89,45,25,96,43
2000-03-29,WAS,93,25,46,DEN,101,28,43,53,89
2000-03-29,DET,91,36,33,CHH,98,38,31,74,64
2000-03-29,CHI,81,14,55,CLE,86,27,43,41,98
2000-03-29,UTA,98,47,22,PHI,84,42,28,89,50
2000-03-29,SEA,95,40,30,NYK,110,43,27,83,57
2000-03-29,VAN,99,19,50,LAL,108,59,12,78,62
2000-03-30,NJN,107,30,40,TOR,103,40,30,70,70
2000-03-30,MIA,105,44,26,CHI,80,14,56,58,82
2000-03-30,ATL,74,26,44,PHX,118,45,25,71,69
2000-03-30,MIN,122,43,27,HOU,90,27,44,70,71
2000-03-30,SAS,102,46,25,GSW,90,17,54,63,79
2000-03-30,LAC,85,14,58,MIL,104,33,37,47,95
2000-03-30,POR,96,51,19,DAL,85,31,40,82,59
2000-03-31,BOS,102,30,41,WAS,104,25,47,55,88
2000-03-31,ORL,103,36,36,NJN,97,31,40,67,76
2000-03-31,CHH,110,39,31,TOR,101,40,31,79,62
2000-03-31,DET,97,36,34,PHX,98,46,25,82,59
2000-03-31,IND,109,47,24,MIN,85,44,27,91,51
2000-03-31,UTA,114,48,22,GSW,97,17,55,65,77
2000-03-31,LAL,100,60,12,PHI,88,42,29,102,41
2000-03-31,SEA,123,40,31,SAC,108,41,29,81,60
2000-03-31,VAN,83,19,51,NYK,89,44,27,63,78
2000-04-01,CLE,109,28,43,BOS,103,30,42,58,85
2000-04-01,CHI,87,14,57,CHH,90,40,31,54,88
2000-04-01,HOU,115,27,45,ATL,93,26,45,53,90
2000-04-01,DEN,112,29,43,UTA,92,49,22,78,65
2000-04-01,POR,113,52,19,MIL,79,34,37,86,56
2000-04-02,NJN,92,31,41,DET,113,36,35,67,76
2000-04-02,MIA,88,45,26,SAS,84,47,25,92,51
2000-04-02,TOR,83,40,32,IND,104,48,24,88,56
2000-04-02,CLE,74,29,43,CHI,83,14,58,43,101
2000-04-02,MIN,86,44,28,PHX,87,47,25,91,53
2000-04-02,LAL,106,61,12,NYK,82,45,27,106,39
2000-04-02,GSW,113,17,56,MIL,117,34,38,51,94
2000-04-02,SAC,117,41,30,PHI,95,42,30,83,60
2000-04-02,POR,95,53,19,SEA,82,41,31,94,50
2000-04-02,VAN,86,19,52,DAL,100,31,41,50,93
2000-04-04,WAS,102,26,47,NJN,93,31,42,57,89
2000-04-04,ORL,107,37,36,SAS,97,47,26,84,62
2000-04-04,MIA,111,46,26,CLE,85,29,44,75,70
2000-04-04,CHH,112,41,31,BOS,105,30,43,71,74
2000-04-04,TOR,88,40,33,DET,104,37,35,77,68
2000-04-04,MIL,92,35,38,CHI,73,15,58,50,96
2000-04-04,MIN,86,44,29,ATL,76,26,46,70,75
2000-04-04,DAL,105,32,41,SAC,102,42,30,74,71
2000-04-04,PHX,83,48,25,LAL,84,62,12,110,37
2000-04-04,LAC,93,14,59,UTA,103,49,23,63,82
2000-04-04,SEA,106,41,32,DEN,93,30,43,71,75
2000-04-04,VAN,102,19,53,HOU,100,28,45,47,98
2000-04-05,PHI,107,42,31,ATL,86,26,47,68,78
2000-04-05,DET,111,38,35,BOS,106,30,44,68,79
2000-04-05,IND,105,49,24,NJN,101,31,43,80,67
2000-04-05,SAS,98,47,27,SAC,108,42,31,89,58
2000-04-05,GSW,104,17,57,LAL,111,63,12,80,69
2000-04-05,POR,105,54,19,HOU,118,28,46,82,65
2000-04-06,NYK,101,45,28,WAS,92,27,47,72,75
2000-04-06,MIA,76,47,26,CHH,70,42,31,89,57
2000-04-06,CHI,90,15,59,MIL,88,36,38,51,97
2000-04-06,DEN,115,30,44,DAL,116,33,41,63,85
2000-04-06,UTA,105,50,23,PHX,85,48,26,98,49
2000-04-06,LAC,90,14,60,MIN,112,45,29,59,89
2000-04-06,VAN,89,20,53,POR,87,54,20,74,73
2000-04-07,BOS,97,30,45,PHI,102,43,31,73,76
2000-04-07,NJN,85,31,44,MIA,103,48,26,79,70
2000-04-07,ORL,89,38,36,NYK,96,46,28,84,64
2000-04-07,CHH,82,42,32,DET,97,39,35,81,67
2000-04-07,ATL,84,26,48,TOR,104,40,34,66,82
2000-04-07,IND,95,50,24,CLE,94,29,45,79,69
2000-04-07,GSW,84,17,58,UTA,105,51,23,68,81
2000-04-07,SAC,92,43,31,MIN,95,46,29,89,60
2000-04-07,SEA,116,42,32,HOU,119,29,46,71,78
2000-04-08,WAS,108,27,48,ATL,98,26,49,53,97
2000-04-08,CLE,117,29,46,DET,98,40,35,69,81
2000-04-08,CHI,79,16,59,TOR,98,41,34,57,93
2000-04-08,MIL,109,36,39,NJN,101,31,45,67,84
2000-04-08,DAL,98,34,41,LAC,96,14,61,48,102
2000-04-08,DEN,105,30,45,SEA,97,42,33,72,78
2000-04-08,LAL,80,64,12,SAS,98,47,28,111,40
2000-04-08,POR,98,54,21,VAN,85,21,53,75,74
2000-04-09,ORL,92,38,37,PHI,80,44,31,82,68
2000-04-09,MIA,95,49,26,NYK,94,47,28,96,54
2000-04-09,CHH,96,42,33,IND,80,51,24,93,57
2000-04-09,HOU,99,30,46,UTA,90,52,23,82,69
2000-04-09,GSW,117,17,59,DEN,103,31,45,48,104
2000-04-09,SAC,97,43,32,PHX,102,48,27,91,59
2000-04-09,VAN,99,21,54,SAS,107,48,28,69,82
2000-04-10,BOS,99,30,46,ATL,94,26,50,56,96
2000-04-10,NYK,83,47,29,IND,81,51,25,98,54
2000-04-10,PHI,96,44,32,MIA,80,50,26,94,58
2000-04-10,WAS,105,28,48,CHH,107,43,33,71,81
2000-04-10,TOR,112,42,34,CLE,103,30,46,72,80
2000-04-10,MIL,104,37,39,ORL,87,39,37,76,76
2000-04-10,MIN,102,47,29,DET,100,40,36,87,65
2000-04-10,UTA,86,52,24,POR,90,55,21,107,45
2000-04-10,LAL,106,64,13,SEA,103,42,34,106,47
2000-04-11,CHI,100,16,60,NJN,93,31,46,47,106
2000-04-11,DAL,92,35,41,POR,81,56,21,91,62
2000-04-11,DEN,93,31,46,HOU,103,31,46,62,92
2000-04-11,LAC,88,14,62,PHX,95,49,27,63,89
2000-04-11,GSW,109,18,59,VAN,97,21,55,39,114
2000-04-11,SAC,92,43,33,SAS,98,49,28,92,61
2000-04-12,BOS,95,31,46,ORL,91,39,38,70,84
2000-04-12,NYK,91,48,29,NJN,89,31,47,79,76
2000-04-12,PHI,93,45,32,WAS,84,28,49,73,81
2000-04-12,CHH,119,44,33,ATL,87,26,51,70,84
2000-04-12,CLE,100,30,47,MIL,101,38,39,68,86
2000-04-12,DET,90,40,37,MIA,73,50,27,90,64
2000-04-12,IND,77,51,26,TOR,73,43,34,94,60
2000-04-12,UTA,102,52,25,LAC,93,14,63,66,88
2000-04-12,PHX,122,50,27,VAN,116,21,56,71,83
2000-04-12,SEA,110,42,35,MIN,83,48,29,90,64
2000-04-13,CHI,103,17,60,WAS,109,28,50,45,110
2000-04-13,HOU,111,32,46,DAL,102,36,41,68,87
2000-04-13,SAS,77,50,28,POR,93,56,22,106,50
2000-04-13,SAC,130,43,34,GSW,107,19,59,62,93
2000-04-14,BOS,106,32,46,CHI,91,17,61,49,107
2000-04-14,NJN,88,31,48,ORL,96,39,39,70,87
2000-04-14,MIA,101,50,28,IND,105,52,26,102,54
2000-04-14,ATL,92,26,52,PHI,104,46,32,72,84
2000-04-14,TOR,86,43,35,NYK,71,49,29,92,64
2000-04-14,MIL,106,39,39,CHH,109,45,33,84,72
2000-04-14,DAL,117,36,42,SEA,103,43,35,79,77
2000-04-14,DEN,105,31,47,GSW,97,19,60,50,107
2000-04-14,PHX,112,51,27,LAC,88,14,64,65,91
2000-04-14,LAL,121,65,13,SAC,114,44,34,109,47
2000-04-14,VAN,94,21,57,MIN,104,48,30,69,87
2000-04-15,PHI,100,47,32,DET,94,41,37,88,69
2000-04-15,WAS,116,29,50,MIL,120,39,40,68,90
2000-04-15,CLE,106,30,48,NYK,96,49,30,79,78
2000-04-15,SAS,106,50,29,UTA,83,53,25,103,54
2000-04-15,LAC,114,14,65,DEN,115,32,47,46,112
2000-04-16,BOS,102,33,46,CHH,105,46,33,79,79
2000-04-16,MIA,95,50,29,ORL,84,40,39,90,68
2000-04-16,ATL,104,26,53,CLE,101,31,48,57,101
2000-04-16,TOR,85,44,35,CHI,84,17,62,61,97
2000-04-16,DET,101,41,38,IND,112,53,26,94,64
2000-04-16,DAL,114,37,42,VAN,106,21,58,58,100
2000-04-16,HOU,112,33,46,SEA,121,43,36,76,82
2000-04-16,PHX,82,52,27,UTA,96,53,26,105,53
2000-04-16,LAL,101,66,13,MIN,95,49,30,115,43
2000-04-16,POR,102,57,22,SAC,95,44,35,101,57
2000-04-17,PHI,90,48,32,IND,92,54,26,102,58
2000-04-17,ORL,83,40,40,MIL,85,40,40,80,80
2000-04-17,SAS,100,51,29,VAN,93,21,59,72,88
2000-04-17,GSW,96,19,61,MIN,101,49,31,68,92
2000-04-18,NYK,100,49,31,DET,88,41,39,90,70
2000-04-18,WAS,81,29,51,BOS,114,33,47,62,98
2000-04-18,MIA,97,51,29,TOR,73,45,35,96,64
2000-04-18,ATL,111,27,53,NJN,109,31,49,58,102
2000-04-18,CLE,88,31,49,CHH,103,47,33,78,82
2000-04-18,CHI,89,17,63,PHI,93,48,33,65,96
2000-04-18,DAL,112,38,42,LAL,102,67,13,105,55
2000-04-18,DEN,105,33,47,UTA,104,54,26,87,73
2000-04-18,PHX,98,52,28,HOU,107,33,47,85,75
2000-04-18,LAC,100,14,66,POR,116,58,22,72,88
2000-04-18,SAC,112,44,36,SEA,119,44,36,88,72
2000-04-19,BOS,112,34,47,NYK,85,50,31,84,78
2000-04-19,NJN,108,31,50,CLE,111,31,50,62,100
2000-04-19,ORL,106,40,41,TOR,100,45,36,85,77
2000-04-19,CHH,83,48,33,MIA,73,52,29,100,62
2000-04-19,DET,112,41,40,CHI,91,17,64,58,104
2000-04-19,IND,111,55,26,ATL,92,28,53,83,79
2000-04-19,MIL,110,41,40,WAS,105,29,52,70,92
2000-04-19,MIN,107,50,31,DAL,113,39,42,89,73
2000-04-19,HOU,92,34,47,VAN,96,21,60,55,107
2000-04-19,SAS,103,52,29,LAL,98,67,14,119,43
2000-04-19,UTA,95,54,27,SAC,86,44,37,98,64
2000-04-19,GSW,88,19,62,PHX,99,52,29,71,91
2000-04-19,POR,95,59,22,DEN,96,34,47,93,69
2000-04-19,SEA,106,45,36,LAC,114,14,67,59,103
2000-10-31,NYK,72,0,0,PHI,101,0,0,0,0
2000-10-31,NJN,82,0,0,CLE,86,0,0,0,0
2000-10-31,ORL,97,0,0,WAS,86,0,0,0,0
2000-10-31,ATL,82,0,0,CHH,106,0,0,0,0
2000-10-31,TOR,95,0,0,DET,104,0,0,0,0
2000-10-31,CHI,81,0,0,SAC,100,0,0,0,0
2000-10-31,DAL,97,0,0,MIL,93,0,0,0,0
2000-10-31,HOU,98,0,0,MIN,106,0,0,0,0
2000-10-31,SAS,98,0,0,IND,85,0,0,0,0
2000-10-31,UTA,107,0,0,LAC,94,0,0,0,0
2000-10-31,GSW,96,0,0,PHX,94,0,0,0,0
2000-10-31,POR,86,0,0,LAL,96,0,0,0,0
2000-10-31,VAN,94,0,0,SEA,88,0,0,0,0
2000-11-01,BOS,103,0,0,DET,83,1,0,1,0
2000-11-01,PHI,104,1,0,TOR,98,0,1,1,1
2000-11-01,MIA,105,0,0,ORL,79,1,0,1,0
2000-11-01,CHH,77,1,0,WAS,95,0,1,1,1
2000-11-01,CLE,102,1,0,SAC,100,1,0,2,0
2000-11-01,LAL,92,1,0,UTA,97,1,0,2,0
2000-11-01,SEA,112,0,1,DEN,99,0,0,0,1
2000-11-02,NYK,94,0,1,ATL,69,0,1,0,2
2000-11-02,DAL,94,1,0,IND,88,0,1,1,1
2000-11-02,HOU,115,0,1,MIL,93,0,1,0,2
2000-11-02,SAS,103,1,0,MIN,91,1,0,2,0
2000-11-02,DEN,101,0,1,GSW,97,1,0,1,1
2000-11-02,PHX,108,0,1,POR,82,0,1,0,2
2000-11-02,LAC,91,0,1,VAN,99,1,0,1,1
2000-11-03,BOS,93,1,0,TOR,91,0,2,1,2
2000-11-03,WAS,76,1,1,NYK,80,1,1,2,2
2000-11-03,ORL,80,1,1,PHI,87,2,0,3,1
2000-11-03,CHH,83,1,1,MIA,79,1,0,2,1
2000-11-03,DET,93,1,1,SAC,100,1,1,2,2
2000-11-03,CHI,82,0,1,NJN,92,0,1,0,2
2000-11-04,NJN,87,1,1,CHH,98,2,1,3,2
2000-11-04,MIA,82,1,1,PHI,84,3,0,4,1
2000-11-04,ATL,104,0,2,ORL,107,1,2,1,4
2000-11-04,TOR,103,0,3,WAS,96,1,2,1,5
2000-11-04,CLE,91,2,0,BOS,89,2,0,4,0
2000-11-04,IND,94,0,2,CHI,81,0,2,0,4
2000-11-04,MIL,97,0,2,DET,88,1,2,1,4
2000-11-04,MIN,99,1,1,SAC,91,2,1,3,2
2000-11-04,DAL,106,2,0,UTA,112,2,0,4,0
2000-11-04,DEN,99,1,1,PHX,102,1,1,2,2
2000-11-04,LAC,77,0,2,HOU,74,1,1,1,3
2000-11-04,GSW,105,1,1,SAS,117,2,0,3,1
2000-11-04,SEA,90,1,1,POR,97,0,2,1,3
2000-11-04,VAN,89,2,0,LAL,98,1,1,3,1
2000-11-05,PHX,104,2,1,HOU,99,1,2,3,3
2000-11-05,LAL,108,2,1,LAC,103,1,2,3,3
2000-11-06,ORL,110,2,2,SEA,99,1,2,3,4
2000-11-06,DEN,96,1,2,DAL,108,2,1,3,3
2000-11-06,UTA,98,3,0,MIN,92,2,1,5,1
2000-11-06,SAC,79,2,2,POR,75,1,2,3,4
2000-11-06,VAN,97,2,1,ATL,87,0,3,2,4
2000-11-07,TOR,105,1,3,BOS,75,2,1,3,4
2000-11-07,CHI,83,0,3,WAS,88,1,3,1,6
2000-11-07,MIL,89,1,2,NYK,103,2,1,3,3
2000-11-07,HOU,84,1,3,LAL,74,3,1,4,4
2000-11-07,PHX,100,3,1,SAS,81,3,0,6,1
2000-11-07,POR,97,1,3,ATL,88,0,4,1,7
2000-11-08,NYK,97,3,1,CLE,99,3,0,6,1
2000-11-08,PHI,103,4,0,DET,94,1,3,5,3
2000-11-08,WAS,86,2,3,NJN,102,1,2,3,5
2000-11-08,ORL,90,3,2,CHH,96,3,1,6,3
2000-11-08,MIA,87,1,2,SEA,81,1,3,2,5
2000-11-08,IND,108,1,2,MIL,97,1,3,2,5
2000-11-08,DAL,74,3,1,VAN,101,3,1,6,2
2000-11-08,SAS,91,3,1,LAL,81,3,2,6,3
2000-11-08,DEN,109,1,3,MIN,107,2,2,3,5
2000-11-08,LAC,87,1,3,UTA,93,4,0,5,3
2000-11-08,SAC,115,3,2,GSW,84,1,2,4,4
2000-11-09,NJN,94,2,2,DET,108,1,4,3,6
2000-11-09,CHH,94,4,1,SEA,102,1,4,5,5
2000-11-09,CHI,95,0,4,ORL,90,3,3,3,7
2000-11-09,MIN,82,2,3,PHI,84,5,0,7,3
2000-11-09,HOU,85,2,3,VAN,78,4,1,6,4
2000-11-09,PHX,88,4,1,ATL,79,0,5,4,6
2000-11-09,POR,107,2,3,DEN,91,2,3,4,6
2000-11-10,BOS,101,2,2,NYK,103,3,2,5,4
2000-11-10,WAS,74,2,4,IND,86,2,2,4,6
2000-11-10,TOR,115,2,3,CLE,88,4,0,6,3
2000-11-10,DAL,79,3,2,SAS,77,4,1,7,3
2000-11-10,UTA,80,5,0,MIA,87,2,2,7,2
2000-11-10,LAC,115,1,4,ATL,106,0,6,1,10
2000-11-10,GSW,107,1,3,SAC,114,4,2,5,5
2000-11-11,NYK,81,4,2,CHH,67,4,2,8,4
2000-11-11,NJN,126,2,3,SEA,91,2,4,4,7
2000-11-11,PHI,85,6,0,BOS,83,2,3,8,3
2000-11-11,CLE,86,4,1,WAS,73,2,5,6,6
2000-11-11,IND,94,3,2,DET,84,2,4,5,6
2000-11-11,CHI,75,1,4,TOR,98,3,3,4,7
2000-11-11,MIL,92,1,4,MIN,103,2,4,3,8
2000-11-11,SAS,91,4,2,VAN,78,4,2,8,4
2000-11-11,PHX,84,5,1,MIA,82,3,2,8,3
2000-11-11,POR,111,3,3,HOU,88,3,3,6,6
2000-11-12,DET,101,2,5,SEA,92,2,5,4,10
2000-11-12,DEN,95,2,4,LAC,79,2,4,4,8
2000-11-12,LAL,105,3,3,HOU,99,3,4,6,7
2000-11-12,GSW,99,1,4,ORL,105,3,4,4,8
2000-11-12,SAC,109,5,2,DAL,84,4,2,9,4
2000-11-13,NJN,82,3,3,POR,94,4,3,7,6
2000-11-13,LAC,76,2,5,DAL,90,4,3,6,8
2000-11-14,MIA,89,3,3,CHH,86,4,3,7,6
2000-11-14,ATL,99,0,7,POR,97,5,3,5,10
2000-11-14,CLE,96,5,1,GSW,86,1,5,6,6
2000-11-14,HOU,110,3,5,CHI,83,1,5,4,10
2000-11-14,SAS,86,5,2,UTA,79,5,1,10,3
2000-11-14,LAL,119,4,3,DEN,103,3,4,7,7
2000-11-14,SAC,96,6,2,ORL,82,4,4,10,6
2000-11-14,SEA,96,2,6,NYK,75,5,2,7,8
2000-11-15,BOS,116,2,4,WAS,109,2,6,4,10
2000-11-15,NJN,93,3,4,MIA,91,4,3,7,7
2000-11-15,PHI,107,7,0,CLE,98,6,1,13,1
2000-11-15,DET,88,3,5,IND,92,4,2,7,7
2000-11-15,MIL,84,1,5,ATL,74,1,7,2,12
2000-11-15,MIN,92,3,4,GSW,90,1,6,4,10
2000-11-15,PHX,99,6,1,DAL,78,5,3,11,4
2000-11-15,LAC,78,2,6,NYK,74,5,3,7,9
2000-11-16,WAS,95,2,7,SAS,99,6,2,8,9
2000-11-16,TOR,80,4,3,POR,86,5,4,9,7
2000-11-16,HOU,84,4,5,CHH,80,4,4,8,9
2000-11-16,DEN,89,3,5,CHI,85,1,6,4,11
2000-11-16,UTA,99,5,2,ORL,84,4,5,9,7
2000-11-16,SAC,110,7,2,LAL,112,5,3,12,5
2000-11-16,VAN,72,4,3,LAC,76,3,6,7,9
2000-11-17,BOS,106,3,4,ATL,99,1,8,4,12
2000-11-17,PHI,94,8,0,MIA,73,4,4,12,4
2000-11-17,CHH,89,4,5,DET,96,3,6,7,11
2000-11-17,IND,90,5,2,GSW,92,1,7,6,9
2000-11-17,MIL,89,2,5,CLE,76,6,2,8,7
2000-11-17,MIN,99,4,4,SAS,94,7,2,11,6
2000-11-17,PHX,85,7,1,NYK,90,5,4,12,5
2000-11-17,SEA,95,3,6,DAL,99,5,4,8,10
2000-11-18,NJN,97,4,4,IND,92,5,3,9,7
2000-11-18,WAS,109,2,8,BOS,89,4,4,6,12
2000-11-18,MIA,86,4,5,POR,80,6,4,10,9
2000-11-18,ATL,84,1,9,MIN,94,5,4,6,13
2000-11-18,TOR,111,4,4,MIL,102,3,5,7,9
2000-11-18,HOU,94,5,5,PHX,89,7,2,12,7
2000-11-18,DEN,87,4,5,LAL,86,6,3,10,8
2000-11-18,UTA,109,6,2,CHI,64,1,7,7,9
2000-11-18,LAC,83,4,6,SEA,86,3,7,7,13
2000-11-18,VAN,88,4,4,DAL,91,6,4,10,8
2000-11-19,NYK,88,6,4,GSW,71,2,7,8,11
2000-11-19,ORL,102,4,6,POR,110,6,5,10,11
2000-11-19,DET,96,4,6,CHH,105,4,6,8,12
2000-11-19,LAL,104,6,4,CHI,96,1,8,7,12
2000-11-20,BOS,90,4,5,PHI,114,9,0,13,5
2000-11-20,TOR,64,5,4,CHH,100,5,6,10,10
2000-11-20,UTA,98,7,2,DAL,107,7,4,14,6
2000-11-20,LAC,85,4,7,NJN,86,5,4,9,11
2000-11-20,VAN,92,4,5,DEN,95,5,5,9,10
2000-11-21,WAS,94,3,8,POR,104,7,5,10,13
2000-11-21,ORL,84,4,7,NYK,85,7,4,11,11
2000-11-21,CLE,117,6,3,DET,98,4,7,10,10
2000-11-21,IND,89,5,4,HOU,101,6,5,11,9
2000-11-21,DAL,110,8,4,SEA,116,4,7,12,11
2000-11-21,GSW,89,2,8,CHI,77,1,9,3,17
2000-11-22,BOS,96,4,6,HOU,81,7,5,11,11
2000-11-22,MIA,67,5,5,CLE,86,7,3,12,8
2000-11-22,CHH,88,6,6,PHI,73,10,0,16,6
2000-11-22,ATL,78,1,10,NYK,74,8,4,9,14
2000-11-22,MIL,84,3,6,POR,93,8,5,11,11
2000-11-22,MIN,101,6,4,VAN,100,4,6,10,10
2000-11-22,SAS,112,7,3,SEA,85,5,7,12,10
2000-11-22,UTA,116,7,3,DEN,78,6,5,13,8
2000-11-22,PHX,97,7,3,NJN,85,6,4,13,7
2000-11-22,LAL,111,7,4,GSW,91,3,8,10,12
2000-11-22,SAC,100,7,3,CHI,71,1,10,8,13
2000-11-23,IND,91,5,5,TOR,111,5,5,10,10
2000-11-24,BOS,103,5,6,ORL,98,4,8,9,14
2000-11-24,ATL,67,2,10,PHI,76,10,1,12,11
2000-11-24,CLE,85,8,3,MIA,80,5,6,13,9
2000-11-24,DET,118,4,8,VAN,96,4,7,8,15
2000-11-24,IND,99,5,6,WAS,87,3,9,8,15
2000-11-24,MIL,90,3,7,CHH,106,7,6,10,13
2000-11-24,DEN,102,6,6,SAS,92,8,3,14,9
2000-11-24,UTA,97,8,3,NJN,85,6,5,14,8
2000-11-24,PHX,80,8,3,GSW,74,3,9,11,12
2000-11-24,LAL,115,8,4,MIN,108,7,4,15,8
2000-11-24,SEA,98,5,8,LAC,81,4,8,9,16
2000-11-25,NYK,75,8,5,TOR,79,6,5,14,10
2000-11-25,WAS,107,3,10,MIL,100,3,8,6,18
2000-11-25,ORL,114,4,9,ATL,92,2,11,6,20
2000-11-25,MIA,80,5,7,HOU,91,7,6,12,13
2000-11-25,CHH,109,8,6,CLE,98,9,3,17,9
2000-11-25,DAL,108,8,5,DEN,84,7,6,15,11
2000-11-25,SAS,96,8,4,PHI,76,11,1,19,5
2000-11-25,LAC,89,4,9,PHX,95,9,3,13,12
2000-11-25,GSW,114,3,10,MIN,93,7,5,10,15
2000-11-25,SAC,125,8,3,SEA,101,6,8,14,11
2000-11-25,POR,86,9,5,NJN,84,6,6,15,11
2000-11-26,BOS,87,6,6,VAN,98,4,8,10,14
2000-11-26,TOR,101,7,5,CHI,89,1,11,8,16
2000-11-26,DET,79,5,8,UTA,94,9,3,14,11
2000-11-27,NYK,97,8,6,VAN,72,5,8,13,14
2000-11-27,ORL,95,5,9,MIL,104,3,9,8,18
2000-11-27,LAC,83,4,10,LAL,98,9,4,13,14
2000-11-28,NJN,92,6,7,UTA,98,10,3,16,10
2000-11-28,WAS,75,4,10,ATL,102,2,12,6,22
2000-11-28,MIA,101,5,8,MIL,102,4,9,9,17
2000-11-28,CLE,72,9,4,BOS,87,6,7,15,11
2000-11-28,CHI,76,1,12,MIN,96,7,6,8,18
2000-11-28,DAL,107,9,5,TOR,93,8,5,17,10
2000-11-28,HOU,81,8,6,SAC,88,9,3,17,9
2000-11-28,LAL,124,10,4,IND,107,6,6,16,10
2000-11-28,POR,93,10,5,SEA,105,6,9,16,14
2000-11-29,NYK,81,9,6,MIA,84,5,9,14,15
2000-11-29,PHI,93,11,2,WAS,87,4,11,15,13
2000-11-29,ORL,86,5,10,UTA,88,11,3,16,13
2000-11-29,CHH,103,9,6,TOR,79,8,6,17,12
2000-11-29,DET,97,5,9,NJN,76,6,8,11,17
2000-11-29,MIN,100,8,6,DEN,107,7,7,15,13
2000-11-29,SAS,82,9,4,SAC,79,10,3,19,7
2000-11-29,LAC,106,4,11,GSW,83,4,10,8,21
2000-11-29,VAN,109,5,9,PHX,106,10,3,15,12
2000-11-30,ATL,82,3,12,CHI,91,1,13,4,25
2000-11-30,MIL,108,5,9,BOS,97,7,7,12,16
2000-11-30,DEN,105,8,7,HOU,109,8,7,16,14
2000-11-30,GSW,99,4,11,IND,95,6,7,10,18
2000-11-30,POR,95,10,6,DAL,84,10,5,20,11
2000-11-30,SEA,121,7,9,LAL,88,11,4,18,13
2000-12-01,BOS,98,7,8,MIN,102,8,7,15,15
2000-12-01,PHI,95,12,2,CHH,74,10,6,22,8
2000-12-01,ORL,83,5,11,NJN,80,6,9,11,20
2000-12-01,MIA,92,6,9,UTA,94,12,3,18,12
2000-12-01,TOR,104,8,7,LAC,95,5,11,13,18
2000-12-01,DET,103,6,9,CLE,93,9,5,15,14
2000-12-01,CHI,86,2,13,NYK,91,9,7,11,20
2000-12-01,LAL,109,11,5,SAS,100,10,4,21,9
2000-12-01,SAC,105,10,4,PHX,98,10,4,20,8
2000-12-01,VAN,76,6,9,IND,86,6,8,12,17
2000-12-02,NYK,100,10,7,MIN,90,9,7,19,14
2000-12-02,NJN,74,6,10,ORL,95,6,11,12,21
2000-12-02,WAS,90,4,12,MIA,93,6,10,10,22
2000-12-02,CHH,94,10,7,UTA,89,13,3,23,10
2000-12-02,ATL,101,3,13,MIL,94,6,9,9,22
2000-12-02,CLE,78,9,6,PHI,112,13,2,22,8
2000-12-02,HOU,85,9,7,POR,96,11,6,20,13
2000-12-02,DEN,103,8,8,SEA,92,8,9,16,17
2000-12-02,GSW,78,5,11,DAL,97,10,6,15,17
2000-12-03,BOS,96,7,9,LAC,87,5,12,12,21
2000-12-03,DET,93,7,9,WAS,87,4,13,11,22
2000-12-03,MIL,92,6,10,IND,80,7,8,13,18
2000-12-03,PHX,84,10,5,POR,79,12,6,22,11
2000-12-03,LAL,99,12,5,DAL,97,11,6,23,11
2000-12-03,SEA,118,8,10,GSW,102,5,12,13,22
2000-12-03,VAN,79,6,10,SAS,97,10,5,16,15
2000-12-04,NYK,106,11,7,LAC,78,5,13,16,20
2000-12-04,DEN,105,9,8,PHI,98,14,2,23,10
2000-12-05,ORL,101,7,11,BOS,98,8,9,15,20
2000-12-05,ATL,92,4,13,MIA,100,7,10,11,23
2000-12-05,CLE,71,9,7,CHH,66,11,7,20,14
2000-12-05,IND,88,7,9,NJN,64,6,11,13,20
2000-12-05,MIN,100,9,8,CHI,90,2,14,11,22
2000-12-05,HOU,109,9,8,DAL,102,11,7,20,15
2000-12-05,UTA,98,13,4,TOR,84,9,7,22,11
2000-12-05,LAL,96,13,5,PHI,85,14,3,27,8
2000-12-05,SAC,81,11,4,SAS,75,11,5,22,9
2000-12-05,VAN,91,6,11,DET,83,8,9,14,20
2000-12-06,NJN,87,6,12,MIL,109,7,10,13,22
2000-12-06,WAS,88,4,14,LAC,93,5,14,9,28
2000-12-06,MIA,95,8,10,DEN,78,10,8,18,18
2000-12-06,CHH,91,11,8,IND,88,8,9,19,17
2000-12-06,CHI,88,2,15,CLE,92,10,7,12,22
2000-12-06,DAL,94,11,8,NYK,85,12,7,23,15
2000-12-06,GSW,125,5,13,LAL,122,14,5,19,18
2000-12-06,POR,95,12,7,TOR,88,9,8,21,15
2000-12-06,SEA,99,9,10,DET,112,8,10,17,20
2000-12-07,ORL,103,8,11,DEN,93,10,9,18,20
2000-12-07,MIL,96,8,10,PHX,104,11,5,19,15
2000-12-07,MIN,105,10,8,WAS,88,4,15,14,23
2000-12-07,SAS,83,11,6,NYK,86,12,8,23,14
2000-12-07,UTA,98,14,4,VAN,87,7,11,21,15
2000-12-08,BOS,91,8,10,IND,104,8,10,16,20
2000-12-08,NJN,86,6,13,PHX,84,12,5,18,18
2000-12-08,MIA,80,9,10,ATL,76,4,14,13,24
2000-12-08,CHH,92,12,8,LAC,87,6,14,18,22
2000-12-08,DAL,105,12,8,CHI,86,2,16,14,24
2000-12-08,LAL,95,14,6,SEA,103,9,11,23,17
2000-12-08,GSW,92,6,13,TOR,108,9,9,15,22
2000-12-08,SAC,111,12,4,HOU,98,10,8,22,12
2000-12-08,POR,94,13,7,PHI,107,14,4,27,11
2000-12-09,NYK,96,13,8,DEN,88,10,10,23,18
2000-12-09,CLE,97,11,7,ATL,90,4,15,15,22
2000-12-09,IND,99,9,10,CHH,96,13,8,22,18
2000-12-09,MIL,99,8,11,WAS,91,4,16,12,27
2000-12-09,MIN,85,11,8,LAC,73,6,15,17,23
2000-12-09,SAS,105,11,7,CHI,81,2,17,13,24
2000-12-09,UTA,125,15,4,GSW,114,6,14,21,18
2000-12-09,POR,114,13,8,DET,83,9,10,22,18
2000-12-09,SEA,104,10,11,HOU,111,10,9,20,20
2000-12-09,VAN,79,7,12,PHI,83,15,4,22,16
2000-12-10,BOS,104,8,11,DEN,102,10,11,18,22
2000-12-10,NJN,73,7,13,DAL,99,13,8,20,21
2000-12-10,TOR,87,10,9,PHX,95,12,6,22,15
2000-12-10,LAL,112,14,7,DET,88,9,11,23,18
2000-12-10,SAC,101,13,4,MIA,97,10,10,23,14
2000-12-11,PHI,91,16,4,MIN,96,12,8,28,12
2000-12-11,CHI,80,2,18,PHX,86,13,6,15,24
2000-12-11,UTA,83,16,4,SAS,91,12,7,28,11
2000-12-11,LAC,92,6,16,ORL,80,9,11,15,27
2000-12-11,VAN,75,7,13,HOU,82,11,9,18,22
2000-12-12,NJN,116,7,14,MIN,94,13,8,20,22
2000-12-12,ATL,107,4,16,SAC,99,14,4,18,20
2000-12-12,TOR,104,10,10,IND,90,10,10,20,20
2000-12-12,CLE,92,12,7,DAL,87,14,8,26,15
2000-12-12,DEN,85,10,12,MIA,96,10,11,20,23
2000-12-12,LAL,105,15,7,MIL,109,9,11,24,18
2000-12-12,GSW,93,6,15,POR,101,14,8,20,23
2000-12-12,SEA,97,10,12,ORL,92,9,12,19,24
2000-12-13,BOS,86,9,11,CHI,104,2,19,11,30
2000-12-13,WAS,82,4,17,PHI,102,16,5,20,22
2000-12-13,CHH,101,13,9,SAC,90,14,5,27,14
2000-12-13,DET,92,9,12,ATL,69,5,16,14,28
2000-12-13,IND,97,10,11,DAL,92,14,9,24,20
2000-12-13,UTA,102,16,5,MIL,111,10,11,26,16
2000-12-13,PHX,103,14,6,SAS,93,13,7,27,13
2000-12-13,LAC,88,7,16,MIA,94,11,11,18,27
2000-12-13,POR,96,15,8,LAL,86,15,8,30,16
2000-12-13,VAN,93,7,14,SEA,94,11,12,18,26
2000-12-14,TOR,70,11,10,NYK,68,14,8,25,18
2000-12-14,SAS,96,13,8,DEN,102,10,13,23,21
2000-12-14,GSW,95,6,16,HOU,98,12,9,18,25
2000-12-15,BOS,81,9,12,SAC,104,14,6,23,18
2000-12-15,NYK,58,14,9,UTA,89,16,6,30,15
2000-12-15,PHI,94,17,5,DAL,112,14,10,31,15
2000-12-15,WAS,89,4,18,CHH,103,14,9,18,27
2000-12-15,DET,90,10,12,MIN,99,13,9,23,21
2000-12-15,IND,95,11,11,CLE,103,13,7,24,18
2000-12-15,CHI,74,3,19,ATL,85,5,17,8,36
2000-12-15,MIL,104,11,11,TOR,97,12,10,23,21
2000-12-15,PHX,88,15,6,LAC,98,7,17,22,23
2000-12-15,LAL,98,15,9,VAN,76,7,15,22,24
2000-12-15,POR,106,16,8,ORL,96,9,13,25,21
2000-12-15,SEA,99,12,12,MIA,81,12,11,24,23
2000-12-16,CHH,99,15,9,BOS,87,9,13,24,22
2000-12-16,ATL,83,6,17,NJN,89,8,14,14,31
2000-12-16,CLE,99,14,7,UTA,92,17,6,31,13
2000-12-16,CHI,91,3,20,PHI,99,17,6,20,26
2000-12-16,MIN,113,14,9,IND,110,11,12,25,21
2000-12-16,HOU,100,13,9,DEN,102,11,13,24,22
2000-12-16,SAS,90,13,9,PHX,82,15,7,28,16
2000-12-16,GSW,85,6,17,MIA,93,12,12,18,29
2000-12-17,NYK,100,14,10,MIL,97,12,11,26,21
2000-12-17,NJN,79,9,14,SAC,95,15,6,24,20
2000-12-17,TOR,101,12,11,LAL,104,16,9,28,20
2000-12-17,DET,90,10,13,DAL,99,15,10,25,23
2000-12-17,LAC,94,8,17,WAS,103,4,19,12,36
2000-12-17,VAN,91,7,16,ORL,101,9,14,16,30
2000-12-18,BOS,98,9,14,DAL,106,16,10,25,24
2000-12-19,MIA,79,13,12,LAL,81,17,9,30,21
2000-12-19,ATL,87,6,18,NYK,77,15,10,21,28
2000-12-19,TOR,103,12,12,UTA,95,17,7,29,19
2000-12-19,CHI,85,3,21,IND,90,11,13,14,34
2000-12-19,HOU,79,13,10,SAS,86,14,9,27,19
2000-12-19,PHX,84,15,8,DET,89,10,14,25,22
2000-12-19,GSW,120,6,18,MIN,99,15,9,21,27
2000-12-19,SAC,106,16,6,WAS,72,5,19,21,25
2000-12-20,BOS,99,9,15,NJN,86,9,15,18,30
2000-12-20,PHI,89,18,6,UTA,91,17,8,35,14
2000-12-20,CHH,65,16,9,MIA,56,13,13,29,22
2000-12-20,IND,98,12,13,TOR,99,13,12,25,25
2000-12-20,DAL,106,17,10,POR,101,17,8,34,18
2000-12-20,SAS,94,15,9,CLE,77,15,7,30,16
2000-12-20,DEN,108,12,13,DET,106,11,14,23,27
2000-12-20,LAC,103,8,18,MIN,96,15,10,23,28
2000-12-20,SEA,89,13,12,SAC,85,17,6,30,18
2000-12-20,VAN,118,7,17,WAS,104,5,20,12,37
2000-12-21,NYK,86,15,11,BOS,92,10,15,25,26
2000-12-21,ORL,99,10,14,CHI,88,3,22,13,36
2000-12-21,MIL,80,12,12,NJN,78,9,16,21,28
2000-12-21,HOU,94,13,11,LAL,99,18,9,31,20
2000-12-22,PHI,71,18,7,NYK,91,15,12,33,19
2000-12-22,MIA,103,13,14,CLE,95,15,8,28,22
2000-12-22,TOR,72,14,12,ATL,78,7,18,21,30
2000-12-22,IND,101,12,14,UTA,109,18,8,30,22
2000-12-22,MIN,74,15,11,CHH,83,17,9,32,20
2000-12-22,DAL,103,18,10,LAL,108,19,9,37,19
2000-12-22,SAS,105,16,9,GSW,87,7,18,23,27
2000-12-22,DEN,116,13,13,POR,96,17,9,30,22
2000-12-22,SEA,107,14,12,WAS,87,5,21,19,33
2000-12-22,VAN,93,8,17,SAC,95,17,7,25,24
2000-12-23,NJN,80,9,17,MIA,86,14,14,23,31
2000-12-23,ORL,111,11,14,CLE,92,15,9,26,23
2000-12-23,CHH,88,18,9,SAS,84,17,9,35,18
2000-12-23,ATL,91,8,18,IND,87,12,15,20,33
2000-12-23,DET,106,11,15,CHI,93,3,23,14,38
2000-12-23,MIL,104,13,12,BOS,99,11,15,24,27
2000-12-23,MIN,92,15,12,UTA,98,19,8,34,20
2000-12-23,HOU,87,13,12,GSW,95,7,19,20,31
2000-12-23,PHX,102,15,9,DEN,93,14,13,29,22
2000-12-23,LAC,92,9,18,VAN,90,8,18,17,36
2000-12-23,SAC,97,18,7,SEA,92,15,12,33,19
2000-12-23,POR,87,17,10,WAS,70,5,22,22,32
2000-12-25,IND,103,12,16,ORL,93,12,14,24,30
2000-12-25,LAL,104,20,9,POR,109,18,10,38,19
2000-12-26,NJN,76,9,18,ATL,81,9,18,18,36
2000-12-26,CHH,115,19,9,CLE,110,15,10,34,19
2000-12-26,DET,101,12,15,BOS,96,11,16,23,31
2000-12-26,MIL,89,14,12,ORL,77,12,15,26,27
2000-12-26,MIN,100,15,13,TOR,97,14,13,29,26
2000-12-26,DAL,114,18,11,SEA,93,15,13,33,24
2000-12-26,SAS,103,17,10,HOU,95,13,13,30,23
2000-12-26,DEN,109,14,14,LAC,108,10,18,24,32
2000-12-26,UTA,91,20,8,PHI,97,18,8,38,16
2000-12-26,VAN,95,8,19,PHX,97,16,9,24,28
2000-12-27,WAS,82,5,23,NYK,89,16,12,21,35
2000-12-27,MIA,91,15,14,IND,79,13,16,28,30
2000-12-27,HOU,92,13,14,SEA,107,15,14,28,28
2000-12-27,GSW,110,8,19,PHI,118,19,8,27,27
2000-12-28,NJN,111,9,19,BOS,112,11,17,20,36
2000-12-28,ORL,102,12,16,DET,96,13,15,25,31
2000-12-28,CLE,89,15,11,MIL,107,15,12,30,23
2000-12-28,CHI,105,3,24,SAS,104,18,10,21,34
2000-12-28,MIN,88,16,13,ATL,81,10,18,26,31
2000-12-28,DAL,105,19,11,LAC,96,10,19,29,30
2000-12-28,DEN,93,15,14,TOR,94,14,14,29,28
2000-12-28,UTA,102,20,9,POR,103,19,10,39,19
2000-12-28,PHX,78,17,9,LAL,115,20,10,37,19
2000-12-28,SAC,91,19,7,CHH,87,20,9,39,16
2000-12-29,NYK,95,17,12,CHI,68,4,24,21,36
2000-12-29,MIA,98,16,14,WAS,91,5,24,21,38
2000-12-29,ATL,85,10,19,CLE,97,15,12,25,31
2000-12-29,GSW,100,8,20,UTA,89,20,10,28,30
2000-12-29,POR,104,20,10,VAN,81,8,20,28,30
2000-12-30,BOS,90,12,17,ORL,95,13,16,25,33
2000-12-30,DET,102,13,16,MIA,110,17,14,30,30
2000-12-30,IND,77,13,17,SAS,89,18,11,31,28
2000-12-30,MIN,79,17,13,NYK,88,18,12,35,25
2000-12-30,DAL,99,20,11,HOU,114,13,15,33,26
2000-12-30,DEN,120,15,15,MIL,113,16,12,31,27
2000-12-30,PHX,109,17,10,TOR,103,15,14,32,24
2000-12-30,LAC,114,10,20,LAL,116,21,10,31,30
2000-12-30,SAC,104,20,7,PHI,107,20,8,40,15
2000-12-30,SEA,104,16,14,CHH,102,20,10,36,24
2000-12-30,VAN,101,8,21,GSW,102,9,20,17,41
2000-12-31,WAS,110,5,25,DET,96,13,17,18,42
2000-12-31,CHI,86,4,25,NJN,77,9,20,13,45
2001-01-01,MIN,106,17,14,HOU,96,14,15,31,29
2001-01-01,POR,89,21,10,CHH,67,20,11,41,21
2001-01-02,WAS,115,6,25,MIN,108,18,14,24,39
2001-01-02,ORL,110,14,16,NJN,120,9,21,23,37
2001-01-02,ATL,92,10,20,BOS,81,12,18,22,38
2001-01-02,CLE,95,16,12,HOU,100,14,16,30,28
2001-01-02,CHI,70,5,25,MIL,104,16,13,21,38
2001-01-02,SAS,80,19,11,MIA,72,18,14,37,25
2001-01-02,LAC,110,10,21,TOR,97,15,15,25,36
2001-01-02,SAC,121,20,8,PHX,117,18,10,38,18
2001-01-02,SEA,83,17,14,IND,91,13,18,30,32
2001-01-03,BOS,91,12,19,NYK,100,19,12,31,31
2001-01-03,PHI,98,21,8,ATL,80,11,20,32,28
2001-01-03,MIL,88,17,13,CLE,83,16,13,33,26
2001-01-03,DAL,104,20,12,DET,107,13,18,33,30
2001-01-03,PHX,90,18,11,LAC,85,11,21,29,32
2001-01-03,LAL,82,22,10,UTA,71,20,11,42,21
2001-01-03,GSW,100,10,20,DEN,111,16,15,26,35
2001-01-03,POR,102,22,10,IND,86,14,18,36,28
2001-01-03,VAN,99,8,22,CHH,89,20,12,28,34
2001-01-04,NYK,95,20,12,ORL,92,14,17,34,29
2001-01-04,MIA,81,18,15,NJN,78,10,21,28,36
2001-01-04,CHI,98,5,26,WAS,96,7,25,12,51
2001-01-04,MIN,105,18,15,SEA,92,17,15,35,30
2001-01-04,HOU,107,15,16,DET,97,14,18,29,34
2001-01-05,BOS,88,12,20,GSW,100,10,21,22,41
2001-01-05,PHI,121,22,8,SEA,89,17,16,39,24
2001-01-05,TOR,105,15,16,DAL,115,20,13,35,29
2001-01-05,DEN,100,17,15,UTA,87,20,12,37,27
2001-01-05,PHX,108,19,11,VAN,76,9,22,28,33
2001-01-05,LAC,73,11,22,CHH,86,20,13,31,35
2001-01-05,SAC,91,21,8,IND,93,14,19,35,27
2001-01-05,POR,119,23,10,MIL,115,18,13,41,23
2001-01-06,NJN,97,10,22,GSW,92,11,21,21,43
2001-01-06,WAS,85,7,26,DAL,103,21,13,28,39
2001-01-06,MIA,112,19,15,BOS,86,12,21,31,36
2001-01-06,ATL,83,11,21,ORL,82,14,18,25,39
2001-01-06,CLE,103,16,14,PHI,107,23,8,39,22
2001-01-06,HOU,97,16,16,UTA,99,20,13,36,29
2001-01-06,SAS,108,20,11,DET,101,14,19,34,30
2001-01-07,NYK,103,21,12,WAS,87,7,27,28,39
2001-01-07,TOR,94,15,17,SEA,92,17,17,32,34
2001-01-07,DEN,94,18,15,CHH,87,21,13,39,28
2001-01-07,PHX,88,20,11,MIN,108,19,15,39,26
2001-01-07,LAL,95,23,10,LAC,118,11,23,34,33
2001-01-07,VAN,120,9,23,MIL,117,18,14,27,37
2001-01-08,BOS,90,12,22,POR,98,24,10,36,32
2001-01-08,MIA,88,20,15,GSW,78,11,22,31,37
2001-01-08,CLE,92,16,15,NJN,90,11,22,27,37
2001-01-08,CHI,91,6,26,DAL,104,22,13,28,39
2001-01-08,LAC,82,12,23,IND,85,15,19,27,42
2001-01-08,SAC,100,21,9,MIN,97,20,15,41,24
2001-01-09,NJN,87,11,23,PHI,104,24,8,35,31
2001-01-09,ORL,95,14,19,SAS,112,21,11,35,30
2001-01-09,CHH,102,21,14,CHI,95,6,27,27,41
2001-01-09,ATL,86,12,21,SEA,95,17,18,29,39
2001-01-09,TOR,91,16,17,HOU,110,16,17,32,34
2001-01-09,MIL,99,18,15,WAS,95,7,28,25,43
2001-01-09,UTA,103,21,13,IND,99,16,19,37,32
2001-01-09,VAN,105,10,23,DEN,112,19,15,29,38
2001-01-10,BOS,88,12,23,MIA,76,21,15,33,38
2001-01-10,PHI,75,25,8,POR,93,25,10,50,18
2001-01-10,WAS,101,7,29,SEA,104,18,18,25,47
2001-01-10,DET,85,14,20,TOR,110,16,18,30,38
2001-01-10,MIN,86,20,16,DAL,106,23,13,43,29
2001-01-10,LAC,92,12,24,DEN,86,20,15,32,39
2001-01-10,SAC,108,22,9,CLE,103,17,15,39,24
2001-01-11,NYK,75,22,12,HOU,76,17,17,39,29
2001-01-11,NJN,87,11,24,ORL,101,14,20,25,44
2001-01-11,CHH,70,22,14,POR,83,26,10,48,24
2001-01-11,ATL,107,12,22,GSW,96,11,23,23,45
2001-01-11,MIL,102,19,15,DAL,94,24,13,43,28
2001-01-11,PHX,93,20,12,IND,85,16,20,36,32
2001-01-12,BOS,72,13,23,TOR,93,17,18,30,41
2001-01-12,WAS,82,7,30,PHI,86,25,9,32,39
2001-01-12,DET,90,14,21,SAS,111,22,11,36,32
2001-01-12,CHI,85,6,28,CHH,86,22,15,28,43
2001-01-12,MIN,95,20,17,LAC,89,13,24,33,41
2001-01-12,DEN,106,20,16,SAC,93,23,9,43,25
2001-01-12,LAL,101,23,11,CLE,98,17,16,40,27
2001-01-12,SEA,115,19,18,VAN,102,10,24,29,42
2001-01-13,NYK,91,22,13,POR,78,27,10,49,23
2001-01-13,PHI,100,26,9,SAS,83,23,11,49,20
2001-01-13,ORL,111,15,20,GSW,94,11,24,26,44
2001-01-13,ATL,108,13,22,LAC,88,13,25,26,47
2001-01-13,IND,87,16,21,MIA,71,21,16,37,37
2001-01-13,MIL,115,20,15,NJN,81,11,25,31,40
2001-01-13,DAL,86,24,14,PHX,103,21,12,45,26
2001-01-13,HOU,81,18,17,SAC,84,23,10,41,27
2001-01-13,UTA,111,22,13,LAL,103,24,11,46,24
2001-01-13,VAN,119,10,25,CLE,107,17,17,27,42
2001-01-14,MIA,90,21,17,CHI,81,6,29,27,46
2001-01-14,TOR,107,18,18,CHH,99,23,15,41,33
2001-01-14,DET,96,14,22,POR,103,27,11,41,33
2001-01-14,PHX,87,22,12,SEA,106,20,18,42,30
2001-01-15,NYK,104,23,13,SAS,82,23,12,46,25
2001-01-15,PHI,84,27,9,CHH,79,23,16,50,25
2001-01-15,WAS,95,7,31,MIL,101,21,15,28,46
2001-01-15,ORL,113,16,20,CHI,104,6,30,22,50
2001-01-15,ATL,78,14,22,NJN,84,11,26,25,48
2001-01-15,IND,89,17,21,LAC,74,13,26,30,47
2001-01-15,MIN,102,21,17,BOS,107,13,24,34,41
2001-01-15,DAL,105,24,15,SAC,116,24,10,48,25
2001-01-15,DEN,122,21,16,SEA,111,21,18,42,34
2001-01-15,UTA,116,23,13,HOU,104,18,18,41,31
2001-01-15,LAL,113,24,12,VAN,112,11,25,35,37
2001-01-15,GSW,101,11,25,CLE,107,17,18,28,43
2001-01-16,MIA,93,22,17,DET,85,14,23,36,40
2001-01-16,MIL,112,22,15,LAC,91,13,27,35,42
2001-01-16,HOU,114,18,19,TOR,99,19,18,37,37
2001-01-16,POR,103,28,11,CLE,83,18,18,46,29
2001-01-17,NJN,108,12,26,WAS,89,7,32,19,58
2001-01-17,PHI,99,28,9,CHI,88,6,31,34,40
2001-01-17,CHH,90,23,17,DAL,91,24,16,47,33
2001-01-17,SAS,91,23,13,TOR,98,19,19,42,32
2001-01-17,DEN,121,22,16,VAN,97,11,26,33,42
2001-01-17,UTA,81,24,13,MIN,89,21,18,45,31
2001-01-17,SAC,111,25,10,BOS,106,14,24,39,34
2001-01-17,SEA,80,21,19,PHX,89,22,13,43,32
2001-01-18,IND,84,18,21,ATL,76,14,23,32,44
2001-01-18,CHI,110,6,32,DET,116,14,24,20,56
2001-01-18,DAL,115,25,16,ORL,106,17,20,42,36
2001-01-18,LAC,79,13,28,BOS,82,14,25,27,53
2001-01-18,GSW,104,11,26,HOU,112,19,19,30,45
2001-01-18,POR,85,29,11,MIA,74,23,17,52,28
2001-01-19,PHI,97,29,9,NJN,86,13,26,42,35
2001-01-19,CHH,98,23,18,MIL,105,23,15,46,33
2001-01-19,TOR,101,20,19,WAS,79,7,33,27,52
2001-01-19,DET,91,15,24,NYK,97,24,13,39,37
2001-01-19,DEN,91,23,16,CLE,88,18,19,41,35
2001-01-19,PHX,95,23,13,GSW,103,11,27,34,40
2001-01-19,LAL,114,25,12,HOU,101,20,19,45,31
2001-01-19,SEA,93,21,20,MIN,98,22,18,43,38
2001-01-19,VAN,86,11,27,MIA,97,23,18,34,45
2001-01-20,NJN,123,13,27,CHI,103,6,33,19,60
2001-01-20,DAL,97,26,16,DEN,79,24,16,50,32
2001-01-20,SAS,109,23,14,ORL,112,17,21,40,35
2001-01-20,POR,101,30,11,SAC,111,26,10,56,21
2001-01-21,NYK,74,25,13,IND,87,19,21,44,34
2001-01-21,PHI,106,30,9,TOR,110,21,19,51,28
2001-01-21,WAS,94,7,34,ATL,90,14,24,21,58
2001-01-21,DET,98,15,25,MIL,102,24,15,39,40
2001-01-21,UTA,109,24,14,PHX,98,23,14,47,28
2001-01-21,LAL,92,26,12,MIA,103,24,18,50,30
2001-01-21,GSW,94,12,27,BOS,91,15,25,27,52
2001-01-21,SEA,109,21,21,SAC,107,27,10,48,31
2001-01-21,VAN,94,11,28,MIN,96,23,18,34,46
2001-01-22,CLE,84,18,20,POR,58,30,12,48,32
2001-01-23,BOS,83,15,26,ATL,82,14,25,29,51
2001-01-23,WAS,97,8,34,CHH,95,23,19,31,53
2001-01-23,ORL,116,18,21,TOR,111,22,19,40,40
2001-01-23,CHI,100,6,34,POR,104,30,13,36,47
2001-01-23,MIL,105,25,15,NYK,91,25,14,50,29
2001-01-23,MIN,82,24,18,PHX,73,23,15,47,33
2001-01-23,DAL,98,27,16,PHI,114,30,10,57,26
2001-01-23,SAS,110,23,15,VAN,77,11,29,34,44
2001-01-23,DEN,105,24,17,HOU,100,20,20,44,37
2001-01-23,UTA,100,25,14,GSW,78,13,27,38,41
2001-01-23,SAC,130,27,11,NJN,104,14,27,41,38
2001-01-23,SEA,91,22,21,LAL,80,26,13,48,34
2001-01-24,MIA,103,25,18,TOR,83,22,20,47,38
2001-01-24,CHH,81,23,20,NYK,67,25,15,48,35
2001-01-24,CLE,94,19,20,CHI,86,6,35,25,55
2001-01-24,DET,73,15,26,PHX,106,23,16,38,42
2001-01-24,HOU,84,20,21,PHI,85,31,10,51,31
2001-01-24,LAC,110,13,29,SEA,114,23,21,36,50
2001-01-24,GSW,109,13,28,NJN,87,14,28,27,56
2001-01-25,IND,82,20,21,POR,92,31,13,51,34
2001-01-25,MIN,109,25,18,ORL,100,19,21,44,39
2001-01-25,DAL,120,27,17,VAN,83,11,30,38,47
2001-01-25,UTA,98,26,14,DEN,96,25,17,51,31
2001-01-25,SAC,91,28,11,SAS,97,24,15,52,26
2001-01-26,BOS,99,16,26,PHX,83,24,16,40,42
2001-01-26,PHI,105,32,10,DET,89,15,27,47,37
2001-01-26,ATL,99,14,26,WAS,106,9,34,23,60
2001-01-26,HOU,106,20,22,VAN,89,11,31,31,53
2001-01-26,LAL,113,26,14,NJN,101,14,29,40,43
2001-01-26,GSW,105,14,28,SEA,107,24,21,38,49
2001-01-27,WAS,89,10,34,PHX,82,24,17,34,51
2001-01-27,ORL,59,19,22,MIA,81,26,18,45,40
2001-01-27,CHH,97,24,20,HOU,110,21,22,45,42
2001-01-27,CLE,90,20,20,ATL,101,14,27,34,47
2001-01-27,CHI,80,6,36,TOR,90,22,21,28,57
2001-01-27,MIL,103,26,15,DET,108,15,28,41,43
2001-01-27,MIN,93,26,18,POR,80,32,13,58,31
2001-01-27,DEN,102,25,18,DAL,100,28,17,53,35
2001-01-27,UTA,86,27,14,SAS,99,25,15,52,29
2001-01-27,LAC,89,13,30,SAC,101,28,12,41,42
2001-01-27,SEA,106,25,21,NJN,97,14,30,39,51
2001-01-28,NYK,91,25,16,LAL,81,27,14,52,30
2001-01-28,IND,81,20,22,PHI,86,33,10,53,32
2001-01-29,BOS,99,17,26,DET,87,16,28,33,54
2001-01-29,WAS,95,11,34,CLE,89,20,21,31,55
2001-01-29,ATL,82,15,27,PHX,95,24,18,39,45
2001-01-29,MIN,99,27,18,MIL,96,26,16,53,34
2001-01-29,DEN,91,26,18,UTA,97,27,15,53,33
2001-01-29,LAC,67,13,31,SAS,96,26,15,39,46
2001-01-29,GSW,85,14,29,CHH,93,24,21,38,50
2001-01-29,VAN,97,11,32,NJN,86,14,31,25,63
2001-01-30,ORL,93,19,23,IND,86,20,23,39,46
2001-01-30,TOR,96,23,21,PHI,89,34,10,57,31
2001-01-30,CLE,96,20,22,LAL,102,27,15,47,37
2001-01-30,HOU,85,22,22,MIA,103,27,18,49,40
2001-01-30,SAC,105,29,12,GSW,79,14,30,43,42
2001-01-30,POR,92,32,14,CHI,81,6,37,38,51
2001-01-30,SEA,88,26,21,UTA,102,28,15,54,36
2001-01-31,NJN,103,14,32,DET,112,16,29,30,61
2001-01-31,WAS,96,12,34,ORL,100,20,23,32,57
2001-01-31,ATL,102,15,28,TOR,97,24,21,39,49
2001-01-31,IND,96,20,24,BOS,102,18,26,38,50
2001-01-31,MIL,116,26,17,DEN,111,26,19,52,36
2001-01-31,MIN,96,28,18,LAL,83,28,15,56,33
2001-01-31,SAS,92,27,15,LAC,70,13,32,40,47
2001-01-31,PHX,101,25,18,VAN,92,12,32,37,50
2001-02-01,NYK,80,26,16,PHI,87,34,11,60,27
2001-02-01,CLE,81,20,23,MIN,90,29,18,49,41
2001-02-01,DAL,95,28,18,MIA,91,28,18,56,36
2001-02-01,HOU,84,22,23,LAC,101,13,33,35,56
2001-02-01,UTA,87,29,15,CHH,76,25,21,54,36
2001-02-01,POR,100,33,14,PHX,92,26,18,59,32
2001-02-01,SEA,97,26,22,CHI,91,6,38,32,60
2001-02-02,NJN,71,14,33,NYK,95,26,17,40,50
2001-02-02,PHI,117,35,11,ORL,123,21,23,56,34
2001-02-02,ATL,80,16,28,MIA,91,28,19,44,47
2001-02-02,DET,95,17,29,BOS,102,19,26,36,55
2001-02-02,IND,103,20,25,DEN,94,26,20,46,45
2001-02-02,LAL,93,28,16,CHH,87,25,22,53,38
2001-02-02,SAC,105,30,12,VAN,95,12,33,42,45
2001-02-03,WAS,100,12,35,DEN,105,26,21,38,56
2001-02-03,ORL,96,22,23,ATL,84,16,29,38,52
2001-02-03,TOR,105,24,22,MIN,108,30,18,54,40
2001-02-03,CLE,81,20,24,DET,88,17,30,37,54
2001-02-03,MIL,104,27,17,IND,85,21,25,48,42
2001-02-03,DAL,101,29,18,GSW,95,14,31,43,49
2001-02-03,SAS,90,28,15,HOU,88,22,24,50,39
2001-02-03,UTA,111,30,15,SEA,91,27,22,57,37
2001-02-03,LAC,90,14,33,POR,89,34,14,48,47
2001-02-03,VAN,91,12,34,CHI,84,6,39,18,73
2001-02-04,BOS,103,20,26,CLE,82,20,25,40,51
2001-02-04,NJN,96,14,34,PHI,89,35,12,49,46
2001-02-04,MIA,100,29,19,NYK,103,27,17,56,36
2001-02-04,PHX,85,26,19,CHH,82,25,23,51,42
2001-02-04,LAL,100,29,16,SAC,94,31,12,60,28
2001-02-05,PHI,99,35,13,DEN,80,27,21,62,34
2001-02-05,ATL,81,16,30,DAL,91,30,18,46,48
2001-02-05,TOR,110,24,23,BOS,98,21,26,45,49
2001-02-05,HOU,100,22,25,NYK,86,28,17,50,42
2001-02-05,SAS,109,29,15,GSW,85,14,32,43,47
2001-02-05,LAC,102,15,33,CHI,82,6,40,21,73
2001-02-05,SEA,95,27,23,VAN,82,13,34,40,57
2001-02-06,NJN,90,15,34,ATL,84,16,31,31,65
2001-02-06,MIA,102,29,20,IND,89,21,26,50,46
2001-02-06,CHH,83,25,24,ORL,109,23,23,48,47
2001-02-06,DET,94,18,30,DEN,83,27,22,45,52
2001-02-06,MIL,112,28,17,SAC,109,31,13,59,30
2001-02-06,PHX,97,27,19,CHI,80,6,41,33,60
2001-02-07,BOS,94,21,27,MIL,91,29,17,50,44
2001-02-07,NYK,96,28,18,DAL,93,31,18,59,36
2001-02-07,PHI,87,36,13,HOU,112,23,25,59,38
2001-02-07,ORL,107,24,23,WAS,98,12,36,36,59
2001-02-07,CLE,89,20,26,SAS,107,30,15,50,41
2001-02-07,MIN,117,31,18,SAC,88,31,14,62,32
2001-02-07,LAL,85,30,16,PHX,83,28,19,58,35
2001-02-07,GSW,89,14,33,LAC,88,16,33,30,66
2001-02-07,POR,97,34,15,SEA,80,28,23,62,38
2001-02-07,VAN,82,13,35,UTA,92,31,15,44,50
2001-02-08,NJN,99,16,34,SAS,97,31,15,47,49
2001-02-08,CHH,101,25,25,ATL,84,16,32,41,57
2001-02-08,TOR,99,25,23,DEN,92,27,23,52,46
2001-02-08,DET,90,19,30,HOU,103,24,25,43,55
2001-02-13,NJN,110,17,34,LAL,113,31,16,48,50
2001-02-13,MIA,101,30,20,LAC,99,16,34,46,54
2001-02-13,CLE,105,20,27,TOR,120,26,23,46,50
2001-02-13,IND,66,21,27,CHH,77,26,25,47,52
2001-02-13,CHI,96,6,42,ATL,92,16,33,22,75
2001-02-13,MIL,104,29,18,PHI,107,36,14,65,32
2001-02-13,HOU,99,25,25,WAS,89,12,37,37,62
2001-02-13,SAS,104,31,16,DAL,92,31,19,62,35
2001-02-13,DEN,96,27,24,NYK,77,29,18,56,42
2001-02-13,UTA,94,32,15,SAC,97,31,15,63,30
2001-02-13,GSW,83,15,33,PHX,93,28,20,43,53
2001-02-13,POR,109,35,15,MIN,88,32,18,67,33
2001-02-13,VAN,99,13,36,BOS,98,22,27,35,63
2001-02-14,PHI,112,37,14,LAL,97,32,16,69,30
2001-02-14,ORL,114,25,23,LAC,101,16,35,41,58
2001-02-14,ATL,98,16,34,MIL,102,29,19,45,53
2001-02-14,DET,105,19,31,NJN,86,17,35,36,66
2001-02-14,UTA,106,32,16,NYK,90,29,19,61,35
2001-02-14,PHX,104,29,20,MIN,96,32,19,61,39
2001-02-15,TOR,91,27,23,MIA,98,31,20,58,43
2001-02-15,IND,82,21,28,DET,73,20,31,41,59
2001-02-15,DAL,102,31,20,CLE,81,20,28,51,48
2001-02-15,SAS,102,32,16,WAS,78,12,38,44,54
2001-02-15,POR,105,36,15,SAC,81,32,15,68,30
2001-02-15,SEA,88,28,24,BOS,108,22,28,50,52
2001-02-15,VAN,99,14,36,GSW,89,15,34,29,70
2001-02-16,NYK,114,29,20,NJN,104,17,36,46,56
2001-02-16,PHI,108,38,14,LAC,93,16,36,54,50
2001-02-16,ORL,108,26,23,HOU,93,26,25,52,48
2001-02-16,CHH,94,27,25,LAL,99,32,17,59,42
2001-02-16,MIN,85,32,20,SAS,91,33,16,65,36
2001-02-16,GSW,79,15,35,VAN,92,15,36,30,71
2001-02-16,SAC,117,32,16,DEN,84,28,24,60,40
2001-02-17,CHI,89,7,42,MIA,82,32,20,39,62
2001-02-17,MIL,93,30,19,CHH,103,27,26,57,45
2001-02-17,DAL,112,32,20,WAS,105,12,39,44,59
2001-02-17,HOU,92,26,26,CLE,80,20,29,46,55
2001-02-17,POR,81,37,15,BOS,85,23,28,60,43
2001-02-17,SEA,94,28,25,ATL,101,16,35,44,60
2001-02-18,NJN,102,17,37,LAC,96,16,37,33,74
2001-02-18,PHI,104,39,14,PHX,98,30,20,69,34
2001-02-18,ORL,96,27,23,NYK,88,30,20,57,43
2001-02-18,TOR,74,27,24,SAS,92,34,16,61,40
2001-02-18,IND,110,22,28,LAL,109,33,17,55,45
2001-02-18,MIN,102,32,21,VAN,110,16,36,48,57
2001-02-18,DEN,98,28,25,WAS,101,12,40,40,65
2001-02-18,GSW,91,15,36,ATL,98,17,35,32,71
2001-02-18,SAC,90,33,16,UTA,94,33,16,66,32
2001-02-19,CLE,85,20,30,CHI,84,8,42,28,72
2001-02-19,DET,106,20,32,LAC,111,16,38,36,70
2001-02-19,MIL,102,30,20,SAS,98,35,16,65,36
2001-02-19,UTA,114,34,16,BOS,99,24,28,58,44
2001-02-20,NYK,76,30,21,MIA,74,32,21,62,42
2001-02-20,WAS,104,13,40,VAN,116,17,36,30,76
2001-02-20,ORL,104,28,23,PHX,110,30,21,58,44
2001-02-20,TOR,113,27,25,GSW,102,15,37,42,62
2001-02-20,CHI,92,8,43,MIL,101,31,20,39,63
2001-02-20,DAL,109,33,20,LAL,119,33,18,66,38
2001-02-20,HOU,101,27,26,BOS,84,24,29,51,55
2001-02-20,SAC,94,33,17,ATL,80,18,35,51,52
2001-02-20,POR,104,37,16,DEN,94,28,26,65,42
2001-02-21,NJN,113,18,37,TOR,111,28,25,46,62
2001-02-21,PHI,107,40,14,VAN,91,18,36,58,50
2001-02-21,MIA,85,32,22,PHX,100,31,21,63,43
2001-02-21,CLE,94,21,30,LAC,100,17,38,38,68
2001-02-21,DET,90,20,33,NYK,85,31,21,51,54
2001-02-21,MIN,83,32,22,HOU,89,28,26,60,48
2001-02-21,SAS,99,35,17,LAL,101,34,18,69,35
2001-02-21,SEA,127,28,26,DEN,98,28,27,56,53
2001-02-22,WAS,110,13,41,SAC,115,34,17,47,58
2001-02-22,CHH,93,28,26,GSW,91,15,38,43,64
2001-02-22,CHI,80,8,44,LAC,93,18,38,26,82
2001-02-22,DAL,98,33,21,BOS,91,24,30,57,51
2001-02-22,POR,84,38,16,UTA,90,35,16,73,32
2001-02-23,NYK,84,31,22,PHX,88,32,21,63,43
2001-02-23,TOR,118,28,26,SAC,119,35,17,63,43
2001-02-23,CLE,90,21,31,IND,92,23,28,44,59
2001-02-23,DET,78,21,33,PHI,99,41,14,62,47
2001-02-23,MIL,93,32,20,VAN,81,18,37,50,57
2001-02-23,MIN,122,32,23,GSW,83,15,39,47,62
2001-02-23,HOU,105,29,26,ORL,95,28,24,57,50
2001-02-23,SAS,100,35,18,BOS,82,24,31,59,49
2001-02-23,LAL,113,35,18,ATL,106,18,36,53,54
2001-02-23,SEA,84,29,26,UTA,96,36,16,65,42
2001-02-24,WAS,99,13,42,TOR,106,28,27,41,69
2001-02-24,MIA,75,32,23,NJN,70,19,37,51,60
2001-02-24,CHH,86,29,26,PHI,85,42,14,71,40
2001-02-24,CHI,90,8,45,VAN,75,18,38,26,83
2001-02-24,DAL,104,34,21,SAS,107,36,18,70,39
2001-02-24,DEN,85,28,28,ATL,82,18,37,46,65
2001-02-24,LAC,123,19,38,POR,120,38,17,57,55
2001-02-25,NYK,88,31,23,SAC,86,36,17,67,40
2001-02-25,NJN,101,19,38,WAS,91,13,43,32,81
2001-02-25,DET,94,21,34,CLE,101,21,32,42,66
2001-02-25,IND,110,24,28,MIN,100,33,23,57,51
2001-02-25,MIL,122,33,20,GSW,95,15,40,48,60
2001-02-25,PHX,90,33,21,UTA,80,37,16,70,37
2001-02-25,LAL,106,36,18,ORL,100,28,25,64,43
2001-02-26,BOS,85,24,32,SEA,82,29,27,53,59
2001-02-26,PHI,91,42,15,MIL,98,34,20,76,35
2001-02-26,CHH,82,30,26,IND,72,25,28,55,54
2001-02-26,CHI,78,9,45,GSW,84,15,41,24,86
2001-02-26,HOU,89,30,26,POR,95,38,18,68,44
2001-02-26,DEN,86,29,28,ORL,93,28,26,57,54
2001-02-26,UTA,99,37,17,ATL,82,18,38,55,55
2001-02-26,LAC,92,20,38,DAL,103,34,22,54,60
2001-02-27,NYK,101,32,23,SEA,92,29,28,61,51
2001-02-27,MIA,103,33,23,WAS,95,13,44,46,67
2001-02-27,TOR,101,29,27,CLE,89,22,32,51,59
2001-02-27,SAS,87,37,18,POR,95,39,18,76,36
2001-02-27,SAC,106,36,18,LAC,93,20,39,56,57
2001-02-27,VAN,112,18,39,DAL,116,35,22,53,61
2001-02-28,PHI,79,42,16,MIA,69,34,23,76,39
2001-02-28,CHH,91,31,26,NJN,88,20,38,51,64
2001-02-28,ATL,88,18,39,TOR,95,30,27,48,66
2001-02-28,IND,99,25,29,MIL,86,35,20,60,49
2001-02-28,CHI,78,9,46,HOU,95,30,27,39,73
2001-02-28,MIN,111,33,24,DET,100,21,35,54,59
2001-02-28,DEN,107,29,29,LAL,101,37,18,66,47
2001-02-28,UTA,101,38,17,VAN,83,18,40,56,57
2001-02-28,PHX,91,34,21,ORL,97,29,26,63,47
2001-02-28,GSW,101,16,41,SAC,122,37,18,53,59
2001-03-01,NYK,95,33,23,BOS,88,25,32,58,55
2001-03-01,CLE,99,22,33,SEA,101,29,29,51,62
2001-03-01,MIL,91,35,21,HOU,108,31,27,66,48
2001-03-01,SAS,91,37,19,PHX,71,34,22,71,41
2001-03-01,POR,94,40,18,LAC,81,20,40,60,58
2001-03-02,BOS,103,25,33,UTA,99,39,17,64,50
2001-03-02,PHI,107,43,16,WAS,102,13,45,56,61
2001-03-02,ORL,120,30,26,CLE,94,22,34,52,60
2001-03-02,ATL,99,18,40,CHH,105,32,26,50,66
2001-03-02,TOR,107,31,27,NJN,90,20,39,51,66
2001-03-02,DET,93,21,36,MIA,97,34,24,55,60
2001-03-02,IND,83,26,29,SEA,86,30,29,56,58
2001-03-02,CHI,81,9,47,NYK,72,34,23,43,70
2001-03-02,DEN,71,30,29,MIN,89,34,24,64,53
2001-03-02,LAC,88,20,41,SAC,81,38,18,58,59
2001-03-03,MIL,126,35,22,CHI,122,10,47,45,69
2001-03-03,DAL,100,36,22,HOU,95,32,27,68,49
2001-03-03,SAS,124,38,19,ATL,95,18,41,56,60
2001-03-03,PHX,97,34,23,DEN,82,30,30,64,53
2001-03-03,POR,122,41,18,GSW,91,16,42,57,60
2001-03-03,VAN,88,18,41,LAL,98,37,19,55,60
2001-03-04,BOS,97,26,33,CHH,116,33,26,59,59
2001-03-04,WAS,98,13,46,UTA,118,39,18,52,64
2001-03-04,TOR,98,32,27,NYK,88,34,24,66,51
2001-03-04,CLE,79,22,35,MIA,91,35,24,57,59
2001-03-04,DET,93,21,37,ORL,84,31,26,52,63
2001-03-04,IND,96,26,30,NJN,120,20,40,46,70
2001-03-04,MIN,119,35,24,SEA,111,31,29,66,53
2001-03-04,LAL,110,38,19,GSW,95,16,43,54,62
2001-03-05,NJN,100,21,40,MIL,107,36,22,57,62
2001-03-05,ORL,95,31,27,DAL,81,37,22,68,49
2001-03-05,MIA,87,36,24,DET,84,22,37,58,61
2001-03-05,ATL,102,18,42,UTA,109,40,18,58,60
2001-03-05,LAC,99,21,41,DEN,86,30,31,51,72
2001-03-05,VAN,77,18,42,SAS,91,39,19,57,61
2001-03-06,NYK,97,34,25,IND,83,26,31,60,56
2001-03-06,CHH,89,34,26,MIN,95,36,24,70,50
2001-03-06,CHI,87,10,48,CLE,74,22,36,32,84
2001-03-06,DEN,82,30,32,PHX,93,35,23,65,55
2001-03-06,GSW,85,16,44,LAL,97,39,19,55,63
2001-03-06,SAC,98,38,19,TOR,91,33,27,71,46
2001-03-06,POR,97,42,18,VAN,105,18,43,60,61
2001-03-06,SEA,73,31,30,SAS,101,40,19,71,49
2001-03-07,BOS,94,26,34,MIL,101,37,22,63,56
2001-03-07,PHI,102,44,16,NJN,94,21,41,65,57
2001-03-07,ORL,112,32,27,DET,102,22,38,54,65
2001-03-07,MIA,86,37,24,DAL,93,37,23,74,47
2001-03-07,ATL,98,18,43,HOU,104,32,28,50,71
2001-03-07,CLE,83,22,37,WAS,88,13,47,35,84
2001-03-07,IND,75,26,32,NYK,79,35,25,61,57
2001-03-07,UTA,86,41,18,SEA,82,31,31,72,49
2001-03-07,PHX,89,36,23,SAC,100,39,19,75,42
2001-03-07,LAL,97,40,19,TOR,85,33,28,73,47
2001-03-08,CHH,97,34,27,ORL,84,33,27,67,54
2001-03-08,HOU,99,33,28,LAC,87,22,41,55,69
2001-03-08,POR,79,42,19,SAS,93,41,19,83,38
2001-03-09,BOS,104,26,35,WAS,72,14,47,40,82
2001-03-09,NJN,96,21,42,NYK,83,36,25,57,67
2001-03-09,PHI,108,45,16,ATL,103,18,44,63,60
2001-03-09,MIA,86,37,25,MIN,79,37,24,74,49
2001-03-09,DET,108,22,39,CHI,75,11,48,33,87
2001-03-09,IND,99,26,33,CLE,84,22,38,48,71
2001-03-09,DAL,102,38,23,GSW,73,16,45,54,68
2001-03-09,UTA,107,42,18,PHX,95,36,24,78,42
2001-03-09,LAL,89,41,19,SAS,93,42,19,83,38
2001-03-09,SAC,110,40,19,DEN,104,30,33,70,52
2001-03-09,SEA,99,31,32,TOR,110,33,29,64,61
2001-03-09,VAN,95,19,43,POR,85,42,20,61,63
2001-03-10,WAS,107,14,48,NJN,101,22,42,36,90
2001-03-10,ORL,105,33,28,MIN,93,37,25,70,53
2001-03-10,CHH,100,35,27,MIL,90,38,22,73,49
2001-03-10,ATL,93,18,45,CHI,90,11,49,29,94
2001-03-10,HOU,86,34,28,GSW,81,16,46,50,74
2001-03-11,BOS,91,27,35,PHI,97,46,16,73,51
2001-03-11,NYK,86,36,26,MIA,83,38,25,74,51
2001-03-11,CLE,124,22,39,MIL,110,38,23,60,62
2001-03-11,DET,95,23,39,IND,78,27,33,50,72
2001-03-11,DAL,111,39,23,LAC,93,22,42,61,65
2001-03-11,PHX,94,36,25,HOU,92,35,28,71,53
2001-03-11,LAL,97,41,20,SEA,109,31,33,72,53
2001-03-11,SAC,105,41,19,UTA,90,43,18,84,37
2001-03-11,VAN,84,20,43,TOR,101,34,29,54,72
2001-03-12,CHH,102,36,27,CHI,94,11,50,47,77
2001-03-12,MIN,94,37,26,MIA,77,38,26,75,52
2001-03-12,SAS,99,43,19,LAC,81,22,43,65,62
2001-03-12,GSW,79,16,47,DEN,84,30,34,46,81
2001-03-13,NYK,98,37,26,CLE,79,23,39,60,65
2001-03-13,ORL,108,34,28,SAC,114,42,19,76,47
2001-03-13,ATL,109,19,45,VAN,99,20,44,39,89
2001-03-13,TOR,97,35,29,MIL,101,38,24,73,53
2001-03-13,DAL,122,40,23,NJN,98,22,43,62,66
2001-03-13,HOU,127,35,29,IND,118,27,34,62,63
2001-03-13,LAL,112,41,21,BOS,107,27,36,68,57
2001-03-13,SEA,99,32,33,POR,90,42,21,74,54
2001-03-14,WAS,103,15,48,DET,96,24,39,39,87
2001-03-14,MIA,114,38,27,SAC,104,43,19,81,46
2001-03-14,CHH,100,37,27,VAN,95,20,45,57,72
2001-03-14,CLE,87,23,40,ORL,97,34,29,57,69
2001-03-14,CHI,67,11,51,PHI,85,47,16,58,67
2001-03-14,SAS,106,44,19,MIN,100,38,26,82,45
2001-03-14,DEN,95,31,34,IND,83,27,35,58,69
2001-03-14,GSW,83,16,48,UTA,102,43,19,59,67
2001-03-14,POR,79,42,22,PHX,84,37,25,79,47
2001-03-15,NYK,88,38,26,TOR,72,35,30,73,56
2001-03-15,DET,119,24,40,LAL,125,42,21,66,61
2001-03-15,MIL,102,39,24,SEA,108,33,33,72,57
2001-03-15,DAL,103,41,23,MIN,83,38,27,79,50
2001-03-15,HOU,108,36,29,NJN,106,22,44,58,73
2001-03-15,PHX,101,38,25,BOS,105,27,37,65,62
2001-03-16,PHI,79,48,16,SAC,100,43,20,91,36
2001-03-16,WAS,89,16,48,LAL,101,43,21,59,69
2001-03-16,ORL,103,35,29,VAN,99,20,46,55,75
2001-03-16,CLE,114,23,41,CHH,109,38,27,61,68
2001-03-16,IND,103,27,36,ATL,97,20,45,47,81
2001-03-16,CHI,80,11,52,SEA,90,34,33,45,85
2001-03-16,SAS,95,45,19,NJN,86,22,45,67,64
2001-03-16,DEN,83,32,34,BOS,87,28,37,60,71
2001-03-16,LAC,94,22,44,GSW,76,16,49,38,93
2001-03-16,POR,90,42,23,UTA,87,44,19,86,42
2001-03-17,NYK,101,39,26,CHI,80,11,53,50,79
2001-03-17,MIA,95,39,27,VAN,81,20,47,59,74
2001-03-17,CHH,95,38,28,WAS,93,16,49,54,77
2001-03-17,ATL,90,20,46,DET,106,24,41,44,87
2001-03-17,MIL,87,39,25,PHI,78,48,17,87,42
2001-03-17,DAL,109,42,23,PHX,99,38,26,80,49
2001-03-17,HOU,103,37,29,SAS,99,46,19,83,48
2001-03-18,ORL,90,36,29,LAL,95,44,21,80,50
2001-03-18,DET,96,25,41,MIL,100,40,25,65,66
2001-03-18,IND,101,28,36,SAC,95,44,20,72,56
2001-03-18,MIN,91,38,28,CLE,76,24,41,62,69
2001-03-18,DEN,98,32,35,NJN,84,22,46,54,81
2001-03-18,LAC,96,23,44,UTA,111,44,20,67,64
2001-03-18,GSW,99,16,50,SEA,104,35,33,51,83
2001-03-19,ATL,108,20,47,LAL,106,45,21,65,68
2001-03-19,SAS,98,46,20,POR,85,43,23,89,43
2001-03-19,SEA,93,36,33,PHI,89,48,18,84,51
2001-03-20,NJN,104,22,47,VAN,90,20,48,42,95
2001-03-20,TOR,102,35,31,IND,81,29,36,64,67
2001-03-20,CLE,75,24,42,NYK,110,40,26,64,68
2001-03-20,CHI,95,11,54,ORL,103,36,30,47,84
2001-03-20,DAL,88,43,23,POR,96,43,24,86,47
2001-03-20,UTA,84,45,20,DET,79,25,42,70,62
2001-03-20,PHX,105,38,27,WAS,91,16,50,54,77
2001-03-20,LAC,88,23,45,PHI,77,48,19,71,64
2001-03-20,SAC,125,44,21,HOU,109,38,29,82,50
2001-03-21,BOS,77,29,37,SAS,97,47,20,76,57
2001-03-21,MIA,109,40,27,CHI,81,11,55,51,82
2001-03-21,CHH,111,39,28,TOR,95,36,31,75,59
2001-03-21,IND,96,29,37,ORL,95,37,30,66,67
2001-03-21,MIL,107,41,25,LAL,100,45,22,86,47
2001-03-21,MIN,109,39,28,DAL,97,43,24,82,52
2001-03-21,GSW,94,16,51,WAS,99,16,51,32,102
2001-03-22,NJN,98,23,47,BOS,113,29,38,52,85
2001-03-22,ATL,101,21,47,SAS,115,48,20,69,67
2001-03-22,CLE,109,24,43,VAN,95,20,49,44,92
2001-03-22,UTA,99,46,20,POR,101,44,24,90,44
2001-03-22,LAC,97,24,45,HOU,92,38,30,62,75
2001-03-22,SAC,103,45,21,DET,98,25,43,70,64
2001-03-22,SEA,88,37,33,PHX,91,39,27,76,60
2001-03-23,NYK,86,41,26,NJN,95,23,48,64,74
2001-03-23,TOR,112,36,32,ATL,86,21,48,57,80
2001-03-23,IND,95,30,37,VAN,75,20,50,50,87
2001-03-23,CHI,93,11,56,CHH,90,40,28,51,84
2001-03-23,MIL,115,42,25,ORL,103,37,31,79,56
2001-03-23,MIN,101,40,28,DEN,90,33,35,73,63
2001-03-23,PHX,84,40,27,PHI,71,48,20,88,47
2001-03-23,LAL,104,45,23,WAS,91,17,51,62,74
2001-03-24,CLE,117,25,43,DEN,105,33,36,58,79
2001-03-24,DAL,103,43,25,CHH,100,40,29,83,54
2001-03-24,UTA,119,46,21,WAS,93,17,52,63,73
2001-03-24,GSW,103,16,52,DET,95,25,44,41,96
2001-03-24,SEA,93,37,34,HOU,90,38,31,75,65
2001-03-25,BOS,102,30,38,CHI,98,12,56,42,94
2001-03-25,ORL,84,37,32,IND,82,31,37,68,69
2001-03-25,MIA,88,41,27,SAS,83,49,20,90,47
2001-03-25,TOR,102,37,32,VAN,92,20,51,57,83
2001-03-25,MIL,105,43,25,ATL,98,21,49,64,74
2001-03-25,MIN,105,41,28,NJN,91,24,48,65,76
2001-03-25,SAC,72,46,21,LAL,84,46,23,92,44
2001-03-26,PHI,90,48,21,MIL,78,44,25,92,46
2001-03-26,CHI,104,12,57,DEN,109,33,37,45,94
2001-03-26,UTA,90,47,21,DAL,98,44,25,91,46
2001-03-26,PHX,104,41,27,LAL,83,47,23,88,50
2001-03-26,GSW,87,17,52,NYK,89,41,27,58,79
2001-03-26,POR,104,45,24,LAC,96,25,45,70,69
2001-03-26,SEA,104,38,34,CLE,86,26,43,64,77
2001-03-27,WAS,102,17,53,IND,110,31,38,48,91
2001-03-27,MIA,92,42,27,TOR,101,38,32,80,59
2001-03-27,ATL,112,21,50,BOS,115,31,38,52,88
2001-03-27,HOU,109,38,32,UTA,86,47,22,85,54
2001-03-27,SAS,93,49,21,CHH,79,40,30,89,51
2001-03-27,LAC,101,25,46,DET,94,25,45,50,91
2001-03-27,SAC,124,46,22,NYK,117,42,27,88,49
2001-03-28,NJN,99,24,49,DEN,96,34,37,58,86
2001-03-28,PHI,95,49,21,ORL,96,38,32,87,53
2001-03-28,PHX,103,42,27,CLE,94,26,44,68,71
2001-03-28,LAL,84,47,24,SAC,108,47,22,94,46
2001-03-28,POR,84,46,24,DAL,94,45,25,91,49
2001-03-28,SEA,94,39,34,MIN,93,42,28,81,62
2001-03-29,WAS,116,17,54,GSW,100,17,53,34,107
2001-03-29,ATL,104,21,51,IND,93,32,38,53,89
2001-03-29,CHI,104,12,58,BOS,106,32,38,44,96
2001-03-29,MIL,104,44,26,MIA,96,42,28,86,54
2001-03-29,HOU,85,39,32,PHX,90,43,27,82,59
2001-03-29,SAS,106,50,21,UTA,88,47,23,97,44
2001-03-29,VAN,89,20,52,NYK,68,42,28,62,80
2001-03-30,BOS,87,33,38,IND,92,32,39,65,77
2001-03-30,PHI,102,49,22,GSW,89,17,54,66,76
2001-03-30,CHH,96,40,31,DEN,103,34,38,74,69
2001-03-30,TOR,110,39,32,NJN,99,25,49,64,81
2001-03-30,DET,100,25,46,ORL,97,39,32,64,78
2001-03-30,UTA,95,47,24,CLE,88,26,45,73,69
2001-03-30,LAL,98,47,25,DAL,89,46,25,93,50
2001-03-30,SAC,110,48,22,MIN,98,42,29,90,51
2001-03-30,POR,96,46,25,NYK,79,42,29,88,54
2001-03-30,SEA,94,40,34,LAC,84,26,46,66,80
2001-03-31,WAS,86,18,54,HOU,96,39,33,57,87
2001-03-31,ATL,99,22,51,DEN,88,35,38,57,89
2001-03-31,CHI,90,12,59,MIA,97,42,29,54,88
2001-03-31,SAS,77,51,21,MIL,86,45,26,96,47
2001-03-31,LAC,104,26,47,CLE,97,26,46,52,93
2001-04-01,NJN,101,25,50,HOU,98,40,33,65,83
2001-04-01,PHI,104,50,22,IND,93,33,39,83,61
2001-04-01,CHH,80,40,32,BOS,79,33,39,73,71
2001-04-01,TOR,101,40,32,ORL,104,39,33,79,65
2001-04-01,DET,104,26,46,GSW,87,17,55,43,101
2001-04-01,PHX,106,44,27,MIL,99,46,26,90,53
2001-04-01,LAL,78,48,25,NYK,79,42,30,90,55
2001-04-01,SAC,107,49,22,DAL,119,46,26,95,48
2001-04-01,POR,95,47,25,MIN,99,42,30,89,55
2001-04-01,VAN,73,21,52,UTA,92,48,24,69,76
2001-04-03,NYK,94,43,30,ORL,82,40,33,83,63
2001-04-03,NJN,88,26,50,CHH,103,41,32,67,82
2001-04-03,MIA,77,43,29,BOS,82,33,40,76,69
2001-04-03,TOR,100,40,33,PHI,85,51,22,91,55
2001-04-03,IND,85,33,40,PHX,81,45,27,78,67
2001-04-03,CHI,83,12,60,DET,110,27,46,39,106
2001-04-03,HOU,97,40,34,DAL,109,47,26,87,60
2001-04-03,SAS,107,51,22,SEA,89,41,34,92,56
2001-04-03,DEN,94,35,39,POR,92,47,26,82,65
2001-04-03,UTA,88,49,24,LAL,96,48,26,97,50
2001-04-03,SAC,101,49,23,MIL,107,46,27,95,50
2001-04-04,WAS,84,18,55,MIA,86,43,30,61,85
2001-04-04,ORL,108,40,34,BOS,101,34,40,74,74
2001-04-04,CHH,94,42,32,PHX,103,45,28,87,60
2001-04-04,CLE,94,26,47,TOR,97,41,33,67,80
2001-04-04,DET,84,28,46,PHI,90,51,23,79,69
2001-04-04,MIN,83,43,30,POR,79,47,27,90,57
2001-04-04,GSW,78,17,56,MIL,108,47,27,64,83
2001-04-04,VAN,86,21,53,LAC,78,27,47,48,100
2001-04-05,NYK,93,44,30,WAS,80,18,56,62,86
2001-04-05,CHI,88,12,61,LAL,100,49,26,61,87
2001-04-05,DAL,108,48,26,ATL,94,23,51,71,77
2001-04-05,HOU,91,40,35,SEA,88,41,35,81,70
2001-04-05,DEN,80,36,39,SAS,101,52,22,88,61
2001-04-05,UTA,86,49,25,SAC,92,49,24,98,49
2001-04-06,BOS,96,34,41,LAL,100,50,26,84,67
2001-04-06,PHI,96,52,23,CLE,88,26,48,78,71
2001-04-06,ORL,100,41,34,TOR,108,42,33,83,67
2001-04-06,MIA,81,44,30,CHH,76,42,33,86,63
2001-04-06,IND,100,34,40,CHI,93,12,62,46,102
2001-04-06,MIN,101,44,30,PHX,88,46,28,90,58
2001-04-06,LAC,113,27,48,MIL,110,48,27,75,75
2001-04-06,GSW,91,17,57,POR,122,47,28,64,85
2001-04-06,VAN,90,22,53,SAC,118,50,24,72,77
2001-04-07,WAS,100,18,57,BOS,102,34,42,52,99
2001-04-07,CHH,92,42,34,DET,97,28,47,70,81
2001-04-07,CLE,98,26,49,PHX,102,46,29,72,78
2001-04-07,DAL,103,49,26,UTA,116,49,26,98,52
2001-04-07,HOU,110,41,35,ATL,97,23,52,64,87
2001-04-07,DEN,98,36,40,VAN,97,22,54,58,94
2001-04-07,LAC,83,28,48,SAS,93,53,22,81,70
2001-04-08,NJN,83,26,51,IND,108,35,40,61,91
2001-04-08,MIA,81,45,30,NYK,76,45,30,90,60
2001-04-08,TOR,100,43,33,CHI,88,12,63,55,96
2001-04-08,MIN,99,45,30,LAL,104,51,26,96,56
2001-04-08,GSW,76,17,58,SAS,84,54,22,71,80
2001-04-08,SAC,98,51,24,POR,89,48,28,99,52
2001-04-08,SEA,101,41,36,MIL,88,48,28,89,64
2001-04-09,NYK,113,45,31,CHH,98,42,35,87,66
2001-04-09,PHI,108,53,23,BOS,95,35,42,88,65
2001-04-09,DET,81,29,47,ATL,69,23,53,52,100
2001-04-09,IND,100,36,40,WAS,78,18,58,54,98
2001-04-09,UTA,96,50,26,HOU,81,42,35,92,61
2001-04-10,MIA,83,46,30,PHI,81,54,23,100,53
2001-04-10,CLE,101,26,50,ORL,78,41,35,67,85
2001-04-10,MIL,105,48,29,CHI,84,12,64,60,93
2001-04-10,HOU,99,42,36,DEN,100,37,40,79,76
2001-04-10,SAS,91,55,22,DAL,79,49,27,104,49
2001-04-10,LAL,106,52,26,PHX,80,47,29,99,55
2001-04-10,SAC,116,52,24,LAC,109,28,49,80,73
2001-04-10,POR,116,48,29,GSW,88,17,59,65,88
2001-04-10,VAN,91,22,55,MIN,104,45,31,67,86
2001-04-11,BOS,97,35,43,MIA,102,47,30,82,73
2001-04-11,WAS,109,18,59,CHI,113,12,65,30,124
2001-04-11,ATL,107,23,54,CLE,102,27,50,50,104
2001-04-11,DET,99,30,47,TOR,87,44,33,74,80
2001-04-11,IND,100,37,40,NYK,93,46,31,83,71
2001-04-11,PHX,111,47,30,DAL,106,49,28,96,58
2001-04-11,SEA,107,42,36,GSW,101,17,60,59,96
2001-04-12,ORL,101,41,36,PHI,77,54,24,95,60
2001-04-12,CHH,88,42,36,NJN,78,26,52,68,88
2001-04-12,MIL,115,49,29,UTA,93,51,26,100,55
2001-04-12,SAS,105,56,22,SAC,107,53,24,109,46
2001-04-12,LAL,119,53,26,MIN,102,46,31,99,57
2001-04-12,VAN,87,22,56,POR,100,49,29,71,85
2001-04-13,NYK,101,46,32,ATL,65,24,54,70,86
2001-04-13,NJN,91,26,53,CLE,97,27,51,53,104
2001-04-13,WAS,113,18,60,ORL,110,42,36,60,96
2001-04-13,TOR,94,44,34,MIA,82,48,30,92,64
2001-04-13,IND,113,38,40,BOS,108,35,44,73,84
2001-04-13,CHI,83,13,65,UTA,94,51,27,64,92
2001-04-13,DAL,101,49,29,SAC,97,54,24,103,53
2001-04-13,DEN,108,38,40,GSW,92,17,61,55,101
2001-04-13,PHX,109,48,30,SEA,100,43,36,91,66
2001-04-13,LAC,111,28,50,MIN,105,46,32,74,82
2001-04-13,POR,103,50,29,HOU,109,42,37,92,66
2001-04-14,ATL,124,24,55,DET,129,31,47,55,102
2001-04-14,MIL,112,50,29,TOR,86,45,34,95,63
2001-04-14,SAS,111,56,23,DEN,95,39,40,95,63
2001-04-14,GSW,94,17,62,LAC,106,29,50,46,112
2001-04-14,VAN,95,22,57,HOU,100,43,37,65,94
2001-04-15,BOS,95,35,45,NJN,88,26,54,61,99
2001-04-15,PHI,89,54,25,NYK,82,47,32,101,57
2001-04-15,WAS,98,19,60,CLE,106,28,51,47,111
2001-04-15,MIA,73,48,31,ORL,90,42,37,90,68
2001-04-15,DET,90,32,47,CHH,99,43,36,75,83
2001-04-15,CHI,86,13,66,IND,93,39,40,52,106
2001-04-15,MIN,107,46,33,UTA,100,52,27,98,60
2001-04-15,PHX,88,49,30,SAC,86,54,25,103,55
2001-04-15,LAL,105,54,26,POR,100,50,30,104,56
2001-04-15,SEA,99,43,37,DAL,107,50,29,93,66
2001-04-16,ORL,89,43,37,MIL,101,51,29,94,66
2001-04-16,CHH,106,44,36,ATL,83,24,56,68,92
2001-04-16,CLE,80,29,51,NYK,78,47,33,76,84
2001-04-16,LAC,100,30,50,PHX,80,50,30,80,80
2001-04-16,GSW,101,17,63,DAL,110,51,29,68,92
2001-04-16,SAC,110,54,26,VAN,100,22,58,76,84
2001-04-17,NJN,94,26,55,CHI,100,13,67,39,122
2001-04-17,MIA,91,48,32,MIL,89,52,29,100,61
2001-04-17,ATL,122,24,57,WAS,119,19,61,43,118
2001-04-17,TOR,94,45,35,DET,92,32,48,77,83
2001-04-17,IND,105,40,40,PHI,111,55,25,95,65
2001-04-17,HOU,114,44,37,MIN,87,47,33,91,70
2001-04-17,UTA,97,52,28,LAC,92,31,50,83,78
2001-04-17,LAL,108,55,26,DEN,91,39,41,94,67
2001-04-17,POR,93,50,31,SAS,99,57,23,107,54
2001-04-18,BOS,92,36,45,CHH,97,45,36,81,81
2001-04-18,NYK,94,47,34,DET,88,32,49,79,83
2001-04-18,PHI,86,56,25,CHI,92,14,67,70,92
2001-04-18,WAS,92,19,62,TOR,98,46,35,65,97
2001-04-18,ORL,91,43,38,MIA,103,49,32,92,70
2001-04-18,CLE,101,30,51,IND,105,40,41,70,92
2001-04-18,DAL,120,52,29,MIN,100,47,34,99,63
2001-04-18,DEN,110,39,42,SAC,100,55,26,94,68
2001-04-18,PHX,98,50,31,UTA,93,53,28,103,59
2001-04-18,GSW,81,17,64,VAN,95,22,59,39,123
2001-04-18,SEA,105,43,38,SAS,67,58,23,101,61
2001-10-30,CLE,89,0,0,BOS,108,0,0,0,0
2001-10-30,NYK,93,0,0,WAS,91,0,0,0,0
2001-10-30,NJN,103,0,0,IND,97,0,0,0,0
2001-10-30,ORL,114,0,0,TOR,85,0,0,0,0
2001-10-30,MIN,83,0,0,PHI,74,0,0,0,0
2001-10-30,DAL,94,0,0,DET,87,0,0,0,0
2001-10-30,HOU,89,0,0,ATL,84,0,0,0,0
2001-10-30,SAS,109,0,0,LAC,98,0,0,0,0
2001-10-30,UTA,112,0,0,MIL,119,0,0,0,0
2001-10-30,PHX,96,0,0,DEN,99,0,0,0,0
2001-10-30,SAC,101,0,0,SEA,95,0,0,0,0
2001-10-30,LAL,98,0,0,POR,87,0,0,0,0
2001-10-31,BOS,92,1,0,NJN,95,1,0,2,0
2001-10-31,CHH,100,0,0,CLE,94,0,1,0,1
2001-10-31,MIA,97,0,0,TOR,92,0,1,0,1
2001-10-31,CHI,73,0,0,IND,98,0,1,0,1
2001-10-31,POR,92,0,1,GSW,87,0,0,0,1
2001-11-01,ATL,88,0,1,WAS,98,0,1,0,2
2001-11-01,PHI,92,0,1,DAL,99,1,0,1,1
2001-11-01,MEM,80,0,0,DET,90,0,1,0,1
2001-11-01,HOU,98,1,0,LAC,92,0,1,1,1
2001-11-01,DEN,101,1,0,MIL,102,1,0,2,0
2001-11-01,UTA,101,0,1,LAL,105,1,0,1,1
2001-11-01,SEA,114,0,1,SAS,108,1,0,1,1
2001-11-01,GSW,101,0,1,PHX,107,0,1,0,2
2001-11-02,TOR,109,0,2,DAL,92,2,0,2,2
2001-11-02,IND,117,1,1,ORL,107,1,0,2,1
2001-11-02,BOS,96,1,1,CHI,82,0,1,1,2
2001-11-02,MIA,83,1,0,CLE,90,0,2,1,2
2001-11-02,CHH,97,1,0,NYK,93,1,0,2,0
2001-11-02,DET,102,1,1,NJN,88,2,0,3,1
2001-11-02,MIN,111,1,0,MEM,102,0,1,1,1
2001-11-02,LAL,117,2,0,PHX,94,1,1,3,1
2001-11-03,WAS,90,1,1,PHI,76,0,2,1,3
2001-11-03,ATL,90,0,2,MIA,83,1,1,1,3
2001-11-03,CLE,69,1,2,ORL,99,1,1,2,3
2001-11-03,NJN,95,2,1,CHH,85,2,0,4,1
2001-11-03,SEA,74,1,1,UTA,91,0,2,1,3
2001-11-03,CHI,84,0,2,NYK,79,1,1,1,3
2001-11-03,MIL,105,2,0,BOS,99,2,1,4,1
2001-11-03,HOU,88,2,0,MIN,90,2,0,4,0
2001-11-03,DEN,94,1,1,SAC,106,1,0,2,1
2001-11-03,POR,90,1,1,SAS,106,1,1,2,2
2001-11-03,LAC,108,0,2,GSW,110,0,2,0,4
2001-11-04,MEM,85,0,2,DAL,94,2,1,2,3
2001-11-04,TOR,113,1,2,IND,100,2,1,3,3
2001-11-04,DET,100,2,1,WAS,78,2,1,4,2
2001-11-04,PHX,100,1,2,HOU,103,2,1,3,3
2001-11-04,GSW,96,1,2,POR,86,1,2,2,4
2001-11-04,SAC,103,2,0,SAS,83,2,1,4,1
2001-11-04,LAL,100,3,0,UTA,96,1,2,4,2
2001-11-05,ORL,119,2,1,SEA,123,1,2,3,3
2001-11-05,LAC,109,0,3,ATL,86,1,2,1,5
2001-11-06,PHI,77,0,3,IND,87,2,2,2,5
2001-11-06,CLE,99,1,3,SAC,115,3,0,4,3
2001-11-06,MIA,87,1,2,SEA,85,2,2,3,4
2001-11-06,MIN,104,3,0,NYK,94,1,2,4,2
2001-11-06,SAS,104,2,2,ORL,89,2,2,4,4
2001-11-06,DAL,110,3,1,CHH,92,2,1,5,2
2001-11-06,HOU,99,3,1,DEN,93,1,2,4,3
2001-11-06,PHX,113,1,3,MEM,101,0,3,1,6
2001-11-06,POR,101,1,3,UTA,83,1,3,2,6
2001-11-07,BOS,104,2,2,WAS,95,2,2,4,4
2001-11-07,TOR,109,2,2,GSW,92,2,2,4,4
2001-11-07,NYK,82,1,3,CLE,64,1,4,2,7
2001-11-07,IND,116,3,2,SAC,104,4,0,7,2
2001-11-07,CHI,73,1,2,DET,97,3,1,4,3
2001-11-07,UTA,96,1,4,ATL,89,1,3,2,7
2001-11-07,LAC,108,1,3,MEM,92,0,4,1,7
2001-11-08,CHH,95,2,2,SAS,105,3,2,5,4
2001-11-08,NJN,106,3,1,SEA,94,2,3,5,4
2001-11-08,MIL,86,3,0,MIA,82,2,2,5,2
2001-11-08,MIN,127,4,0,CHI,74,1,3,5,3
2001-11-08,DAL,105,4,1,DEN,91,1,3,5,4
2001-11-08,HOU,77,4,1,PHI,72,0,4,4,5
2001-11-08,PHX,108,2,3,ATL,80,1,4,3,7
2001-11-08,POR,119,2,3,LAC,101,2,3,4,6
2001-11-09,WAS,100,2,3,GSW,109,2,3,4,6
2001-11-09,IND,103,4,2,NYK,95,2,3,6,5
2001-11-09,BOS,104,3,2,SEA,94,2,4,5,6
2001-11-09,ORL,115,2,3,SAC,105,4,1,6,4
2001-11-09,DEN,108,1,4,HOU,81,5,1,6,5
2001-11-09,LAL,110,4,0,MEM,86,0,5,4,5
2001-11-10,NJN,87,4,1,CLE,84,1,5,5,6
2001-11-10,LAC,111,2,4,PHX,102,3,3,5,7
2001-11-10,NYK,71,2,4,GSW,90,3,3,5,7
2001-11-10,MIA,75,2,3,SAC,90,4,2,6,5
2001-11-10,IND,105,5,2,POR,96,3,3,8,5
2001-11-10,CHI,85,1,4,CHH,89,2,3,3,7
2001-11-10,MIL,82,4,0,MIN,98,5,0,9,0
2001-11-10,DAL,91,5,1,PHI,98,0,5,5,6
2001-11-10,SAS,110,4,2,ATL,88,1,5,5,7
2001-11-10,UTA,96,2,4,TOR,117,3,2,5,6
2001-11-11,WAS,84,2,4,SEA,99,2,5,4,9
2001-11-11,DET,98,4,1,POR,100,3,4,7,5
2001-11-11,DEN,96,2,4,TOR,85,4,2,6,6
2001-11-11,LAL,108,5,0,ORL,95,3,3,8,3
2001-11-12,MEM,79,0,6,GSW,86,4,3,4,9
2001-11-12,UTA,105,2,5,ORL,98,3,4,5,9
2001-11-13,IND,82,6,2,NJN,91,5,1,11,3
2001-11-13,NYK,89,2,5,POR,82,4,4,6,9
2001-11-13,MIA,76,2,4,PHI,82,1,5,3,9
2001-11-13,MIN,103,6,0,CLE,107,1,6,7,6
2001-11-13,SAC,95,5,2,TOR,86,4,3,9,5
2001-11-13,SAS,90,5,2,HOU,86,5,2,10,4
2001-11-13,DEN,101,3,4,CHI,93,1,5,4,9
2001-11-13,SEA,91,3,5,PHX,92,3,4,6,9
2001-11-14,BOS,101,4,2,IND,93,6,3,10,5
2001-11-14,PHI,100,2,5,CHH,86,3,3,5,8
2001-11-14,WAS,98,2,5,MIL,107,4,1,6,6
2001-11-14,CLE,94,2,6,DAL,107,5,2,7,8
2001-11-14,ATL,111,1,6,UTA,79,3,5,4,11
2001-11-14,PHX,92,4,4,ORL,93,3,5,7,9
2001-11-14,LAC,106,3,4,CHI,102,1,6,4,10
2001-11-14,GSW,82,5,3,TOR,89,4,4,9,7
2001-11-15,NYK,83,3,5,MIA,74,2,5,5,10
2001-11-15,DET,115,4,2,DAL,89,6,2,10,4
2001-11-15,MEM,85,0,7,POR,101,4,5,4,12
2001-11-15,HOU,97,5,3,LAL,98,6,0,11,3
2001-11-15,DEN,82,4,4,ORL,101,4,5,8,9
2001-11-16,PHI,98,3,5,ATL,78,2,6,5,11
2001-11-16,WAS,92,2,6,UTA,101,3,6,5,12
2001-11-16,IND,113,6,4,MIN,120,6,1,12,5
2001-11-16,NJN,109,6,1,NYK,83,4,5,10,6
2001-11-16,MIA,87,2,6,CHH,96,3,4,5,10
2001-11-16,SAS,105,6,2,CLE,91,2,7,8,9
2001-11-16,PHX,95,4,5,LAL,83,7,0,11,5
2001-11-16,SAC,105,6,2,CHI,71,1,7,7,9
2001-11-16,SEA,100,3,6,GSW,91,5,4,8,10
2001-11-16,LAC,85,4,4,TOR,94,5,4,9,8
2001-11-17,ATL,112,2,7,BOS,103,5,2,7,9
2001-11-17,CHH,87,4,4,POR,97,5,5,9,9
2001-11-17,DET,104,5,2,IND,98,6,5,11,7
2001-11-17,NJN,82,7,1,PHI,94,4,5,11,6
2001-11-17,MIN,103,7,1,ORL,95,5,5,12,6
2001-11-17,MEM,98,0,8,CLE,93,2,8,2,16
2001-11-17,MIL,104,5,1,UTA,93,4,6,9,7
2001-11-17,HOU,124,5,4,DAL,87,6,3,11,7
2001-11-17,GSW,93,5,5,CHI,88,1,8,6,13
2001-11-17,SEA,93,4,6,DEN,103,4,5,8,11
2001-11-18,LAC,99,4,5,NYK,86,4,6,8,11
2001-11-18,PHX,81,5,5,TOR,87,6,4,11,9
2001-11-18,LAL,93,7,1,SAC,85,7,2,14,3
2001-11-19,DEN,99,5,5,NJN,96,7,2,12,7
2001-11-19,SAC,113,7,3,HOU,77,6,4,13,7
2001-11-20,WAS,88,2,7,CHH,95,4,5,6,12
2001-11-20,TOR,84,7,4,DET,88,6,2,13,6
2001-11-20,IND,106,6,6,ATL,102,3,7,9,13
2001-11-20,MIA,73,2,7,MIN,80,8,1,10,8
2001-11-20,DAL,97,6,4,SEA,105,4,7,10,11
2001-11-20,POR,87,6,5,HOU,94,6,5,12,10
2001-11-20,LAC,93,5,5,LAL,98,8,1,13,6
2001-11-20,GSW,70,6,5,NYK,94,4,7,10,12
2001-11-21,BOS,85,5,3,ATL,92,3,8,8,11
2001-11-21,PHI,94,5,5,DET,89,7,2,12,7
2001-11-21,CHH,78,5,5,DAL,89,6,5,11,10
2001-11-21,CLE,101,2,9,MEM,94,1,8,3,17
2001-11-21,ORL,117,5,6,MIN,106,9,1,14,7
2001-11-21,MIL,96,6,1,CHI,92,1,9,7,10
2001-11-21,SAS,110,7,2,SEA,93,5,7,12,9
2001-11-21,DEN,68,6,5,LAL,89,9,1,15,6
2001-11-21,UTA,89,4,7,NJN,90,7,3,11,10
2001-11-21,PHX,96,5,6,NYK,72,5,7,10,13
2001-11-21,SAC,95,8,3,POR,83,6,6,14,9
2001-11-22,IND,110,7,6,WAS,103,2,8,9,14
2001-11-22,TOR,75,7,5,MIL,78,7,1,14,6
2001-11-22,LAC,90,5,6,NJN,95,8,3,13,9
2001-11-23,PHI,79,6,5,CLE,68,3,9,9,14
2001-11-23,BOS,89,5,4,TOR,91,7,6,12,10
2001-11-23,MIA,94,2,8,DAL,104,7,5,9,13
2001-11-23,CHH,99,5,6,ORL,109,6,6,11,12
2001-11-23,ATL,106,4,8,DET,99,7,3,11,11
2001-11-23,IND,79,8,6,SAS,97,8,2,16,8
2001-11-23,MEM,89,1,9,PHX,103,6,6,7,15
2001-11-23,UTA,106,4,8,LAC,101,5,7,9,15
2001-11-23,POR,97,6,7,DEN,90,6,6,12,13
2001-11-23,SEA,99,5,8,HOU,81,7,5,12,13
2001-11-23,LAL,106,10,1,GSW,90,6,6,16,7
2001-11-24,NYK,78,5,8,CHI,71,1,10,6,18
2001-11-24,WAS,88,2,9,BOS,84,5,5,7,14
2001-11-24,ORL,101,7,6,CHH,103,5,7,12,13
2001-11-24,CLE,100,3,10,MIA,96,2,9,5,19
2001-11-24,DET,91,7,4,MEM,84,1,10,8,14
2001-11-24,MIN,99,9,2,SAS,94,9,2,18,4
2001-11-24,DAL,119,8,5,PHX,104,7,6,15,11
2001-11-24,MIL,95,8,1,ATL,88,5,8,13,9
2001-11-24,SAC,98,9,3,NJN,97,9,3,18,6
2001-11-25,TOR,107,8,6,PHI,88,7,5,15,11
2001-11-25,LAC,90,5,8,HOU,83,7,6,12,14
2001-11-25,SEA,99,6,8,IND,88,8,7,14,15
2001-11-25,GSW,101,6,7,NJN,85,9,4,15,11
2001-11-25,LAL,105,11,1,DEN,98,6,7,17,8
2001-11-26,NYK,88,6,8,ATL,83,5,9,11,17
2001-11-26,ORL,100,7,7,DET,105,8,4,15,11
2001-11-26,MEM,98,1,11,SAC,94,10,3,11,14
2001-11-26,UTA,104,5,8,PHX,111,7,7,12,15
2001-11-27,CLE,94,4,10,WAS,75,3,9,7,19
2001-11-27,NJN,100,9,5,CHI,68,1,11,10,16
2001-11-27,MIA,83,2,10,BOS,84,5,6,7,16
2001-11-27,HOU,84,7,7,SAC,89,10,4,17,11
2001-11-27,DAL,116,9,5,GSW,106,7,7,16,12
2001-11-27,POR,96,7,7,IND,90,8,8,15,15
2001-11-27,SEA,112,7,8,MIN,102,10,2,17,10
2001-11-27,LAL,104,12,1,MIL,85,9,1,21,2
2001-11-28,ATL,100,5,10,NYK,105,7,8,12,18
2001-11-28,DET,96,9,4,CHH,104,6,7,15,11
2001-11-28,PHI,87,7,6,WAS,94,3,10,10,16
2001-11-28,SAS,94,9,3,GSW,83,7,8,16,11
2001-11-28,DEN,85,6,8,IND,99,8,9,14,17
2001-11-28,UTA,112,5,9,SEA,88,8,8,13,17
2001-11-28,PHX,104,8,7,MIL,84,9,2,17,9
2001-11-28,LAC,94,6,8,MIN,75,10,3,16,11
2001-11-29,TOR,91,9,6,MEM,88,2,11,11,17
2001-11-29,CLE,96,5,10,ATL,105,5,11,10,21
2001-11-29,ORL,89,7,8,BOS,99,6,6,13,14
2001-11-29,CHI,78,1,12,MIA,72,2,11,3,23
2001-11-29,DAL,98,10,5,SAC,110,11,4,21,9
2001-11-30,MIA,75,2,12,WAS,84,4,10,6,22
2001-11-30,CHH,105,7,7,DET,110,9,5,16,12
2001-11-30,MEM,102,2,12,HOU,85,7,8,9,20
2001-11-30,SAS,106,10,3,SAC,109,12,4,22,7
2001-11-30,DEN,96,6,9,LAC,93,7,8,13,17
2001-11-30,PHX,98,9,7,UTA,76,6,9,15,16
2001-11-30,POR,101,8,7,MIL,95,9,3,17,10
2001-11-30,SEA,92,8,9,LAL,107,13,1,21,10
2001-12-01,NJN,98,10,5,BOS,105,7,6,17,11
2001-12-01,ATL,103,6,11,TOR,104,10,6,16,17
2001-12-01,WAS,87,5,10,ORL,96,7,9,12,19
2001-12-01,NYK,97,8,8,DET,100,10,5,18,13
2001-12-01,CLE,93,5,11,CHH,81,7,8,12,19
2001-12-01,CHI,76,2,12,PHI,93,7,7,9,19
2001-12-01,HOU,75,7,9,SAS,85,10,4,17,13
2001-12-01,UTA,97,6,10,IND,100,9,9,15,19
2001-12-01,POR,83,9,7,PHX,97,10,7,19,14
2001-12-01,LAL,102,14,1,MIN,76,10,4,24,5
2001-12-01,GSW,82,7,9,DAL,111,10,6,17,15
2001-12-02,TOR,69,11,6,BOS,85,8,6,19,12
2001-12-02,PHI,87,8,7,MEM,93,3,12,11,19
2001-12-02,LAC,103,7,9,IND,72,10,9,17,18
2001-12-02,SAC,114,13,4,DAL,120,11,6,24,10
2001-12-02,SEA,97,8,10,MIL,83,9,4,17,14
2001-12-03,NYK,89,8,9,HOU,86,7,10,15,19
2001-12-03,ORL,113,8,9,MEM,71,4,12,12,21
2001-12-03,PHX,110,11,7,GSW,93,7,10,18,17
2001-12-04,CLE,100,6,11,DET,88,11,5,17,16
2001-12-04,IND,104,10,10,DEN,96,7,9,17,19
2001-12-04,MIL,71,9,5,NYK,85,9,9,18,14
2001-12-04,MIN,108,10,5,SEA,83,9,10,19,15
2001-12-04,SAC,94,13,5,PHI,84,8,8,21,13
2001-12-04,CHI,103,2,13,HOU,75,7,11,9,24
2001-12-04,SAS,103,11,4,WAS,88,5,11,16,15
2001-12-04,UTA,104,6,11,CHH,100,7,9,13,20
2001-12-04,LAC,87,8,9,MIA,83,2,13,10,22
2001-12-05,BOS,95,9,6,DEN,80,7,10,16,16
2001-12-05,ORL,102,9,9,CHI,74,3,13,12,22
2001-12-05,ATL,112,6,12,SAS,120,12,4,18,16
2001-12-05,DET,95,11,6,SEA,91,9,11,20,17
2001-12-05,NJN,106,10,6,PHX,87,12,7,22,13
2001-12-05,LAL,98,15,1,DAL,94,12,6,27,7
2001-12-05,GSW,93,7,11,PHI,87,8,9,15,20
2001-12-06,MEM,80,4,13,MIN,105,11,5,15,18
2001-12-06,HOU,82,7,12,WAS,85,5,12,12,24
2001-12-06,MIL,95,9,6,TOR,89,11,7,20,13
2001-12-06,POR,89,9,8,CHH,95,7,10,16,18
2001-12-07,TOR,98,11,8,DEN,96,7,11,18,19
2001-12-07,IND,98,11,10,CHI,83,3,14,14,24
2001-12-07,BOS,109,10,6,PHX,102,12,8,22,14
2001-12-07,NJN,96,11,6,CLE,84,7,11,18,17
2001-12-07,ORL,129,10,9,ATL,94,6,13,16,22
2001-12-07,SAS,86,13,4,PHI,76,8,10,21,14
2001-12-07,SAC,97,14,5,LAL,91,16,1,30,6
2001-12-07,SEA,94,9,12,MIA,98,2,14,11,26
2001-12-07,LAC,86,9,9,UTA,102,7,11,16,20
2001-12-07,GSW,89,8,11,CHH,106,8,10,16,21
2001-12-08,ATL,107,6,14,ORL,104,11,9,17,23
2001-12-08,NYK,101,10,9,IND,99,12,10,22,19
2001-12-08,CLE,109,7,12,DEN,99,7,12,14,24
2001-12-08,MIN,107,12,5,HOU,97,7,13,19,18
2001-12-08,MEM,92,4,14,PHI,83,8,11,12,25
2001-12-08,CHI,87,3,15,BOS,84,11,6,14,21
2001-12-08,MIL,95,10,6,NJN,79,12,6,22,12
2001-12-08,DAL,95,12,7,WAS,102,6,12,18,19
2001-12-08,UTA,111,8,11,GSW,101,8,12,16,23
2001-12-08,POR,113,9,9,SEA,92,9,13,18,22
2001-12-09,TOR,90,12,8,PHX,91,12,9,24,17
2001-12-09,DET,105,12,6,HOU,77,7,14,19,20
2001-12-09,LAC,89,9,10,CHH,78,9,10,18,20
2001-12-09,SAC,95,15,5,MIA,88,3,14,18,19
2001-12-10,UTA,107,9,11,DAL,98,12,8,21,19
2001-12-10,LAC,100,10,10,ORL,92,11,10,21,20
2001-12-11,NYK,93,11,9,BOS,102,11,7,22,16
2001-12-11,MIA,99,3,15,MIL,97,11,6,14,21
2001-12-11,ATL,89,7,14,PHI,87,8,12,15,26
2001-12-11,MIN,107,13,5,GSW,86,8,13,21,18
2001-12-11,MEM,81,5,14,WAS,91,7,12,12,26
2001-12-11,CHI,93,4,15,NJN,107,12,7,16,22
2001-12-11,DAL,105,12,9,POR,103,10,9,22,18
2001-12-11,HOU,102,7,15,CLE,107,8,12,15,27
2001-12-11,DEN,96,7,13,CHH,99,9,11,16,24
2001-12-11,SAC,112,16,5,ORL,100,11,11,27,16
2001-12-11,LAL,93,16,2,SEA,104,9,14,25,16
2001-12-12,WAS,82,8,12,MIA,80,4,15,12,27
2001-12-12,SAS,108,14,4,TOR,95,12,9,26,13
2001-12-12,UTA,87,10,11,MIN,98,14,5,24,16
2001-12-12,PHX,114,13,9,SAC,88,17,5,30,14
2001-12-12,LAC,114,11,10,SEA,94,10,14,21,24
2001-12-13,CHH,104,10,11,TOR,90,12,10,22,21
2001-12-13,IND,108,12,11,HOU,106,7,16,19,27
2001-12-13,DET,99,13,6,NYK,97,11,10,24,16
2001-12-13,DAL,102,13,9,CLE,82,9,12,22,21
2001-12-13,DEN,89,7,14,MEM,86,5,15,12,29
2001-12-13,GSW,100,8,14,ORL,105,11,12,19,26
2001-12-14,PHI,80,8,13,MIL,96,11,7,19,20
2001-12-14,WAS,96,9,12,NYK,80,11,11,20,23
2001-12-14,BOS,107,12,7,CHI,101,4,16,16,23
2001-12-14,MIA,86,4,16,NJN,95,13,7,17,23
2001-12-14,MIN,114,15,5,SAC,94,17,6,32,11
2001-12-14,UTA,93,10,12,POR,85,10,10,20,22
2001-12-14,PHX,93,14,9,SAS,105,15,4,29,13
2001-12-14,LAL,110,16,3,LAC,80,12,10,28,13
2001-12-15,CHH,97,11,11,BOS,106,13,7,24,18
2001-12-15,CLE,91,9,13,PHI,94,8,14,17,27
2001-12-15,CHI,79,4,17,ATL,80,8,14,12,31
2001-12-15,MIL,115,12,7,IND,95,13,11,25,18
2001-12-15,DAL,125,14,9,MIN,117,16,5,30,14
2001-12-15,HOU,73,7,17,MIA,76,4,17,11,34
2001-12-15,SAS,100,16,4,UTA,80,11,12,27,16
2001-12-15,DEN,106,8,14,PHX,98,14,10,22,24
2001-12-15,POR,117,10,11,ORL,106,12,12,22,23
2001-12-15,GSW,93,8,15,MEM,84,5,16,13,31
2001-12-16,TOR,88,12,11,WAS,93,10,12,22,23
2001-12-16,LAC,82,12,11,DET,77,14,6,26,17
2001-12-16,NYK,96,11,12,NJN,114,14,7,25,19
2001-12-16,SAC,104,17,7,MEM,87,5,17,22,24
2001-12-16,SEA,114,10,15,ORL,91,12,13,22,28
2001-12-16,LAL,101,17,3,GSW,85,9,15,26,18
2001-12-17,PHI,99,9,14,BOS,83,14,7,23,21
2001-12-18,CHH,95,11,12,NYK,100,11,13,22,25
2001-12-18,CLE,102,9,14,CHI,84,4,18,13,32
2001-12-18,MIA,56,5,17,UTA,95,11,13,16,30
2001-12-18,ATL,100,9,14,IND,103,13,12,22,26
2001-12-18,MIN,103,16,6,DAL,107,15,9,31,15
2001-12-18,MEM,105,5,18,MIL,114,13,7,18,25
2001-12-18,PHX,92,14,11,LAC,96,13,11,27,22
2001-12-18,HOU,92,7,18,POR,101,11,11,18,29
2001-12-18,DEN,93,9,14,SAS,102,17,4,26,18
2001-12-18,SAC,102,18,7,DET,98,14,7,32,14
2001-12-19,BOS,104,14,8,CLE,98,10,14,24,22
2001-12-19,PHI,85,10,14,CHH,94,11,13,21,27
2001-12-19,WAS,103,11,12,ATL,76,9,15,20,27
2001-12-19,NJN,117,15,7,MIN,112,16,7,31,14
2001-12-19,ORL,98,12,14,UTA,90,12,13,24,27
2001-12-19,IND,90,14,12,TOR,102,12,12,26,24
2001-12-19,SAS,97,18,4,POR,79,12,11,30,15
2001-12-19,SEA,104,11,15,SAC,92,19,7,30,22
2001-12-19,GSW,101,9,16,DET,88,14,8,23,24
2001-12-20,TOR,96,13,12,CHI,91,4,19,17,31
2001-12-20,NYK,88,12,13,MEM,90,5,19,17,32
2001-12-20,DAL,113,16,9,MIL,101,14,7,30,16
2001-12-20,HOU,101,7,19,LAL,107,18,3,25,22
2001-12-21,PHI,94,10,15,ATL,83,9,16,19,31
2001-12-21,IND,100,14,13,NJN,94,16,7,30,20
2001-12-21,BOS,98,15,8,UTA,92,12,14,27,22
2001-12-21,ORL,75,13,14,WAS,93,12,12,25,26
2001-12-21,MIA,81,5,18,CLE,86,10,15,15,33
2001-12-21,MIN,94,16,8,CHH,89,12,13,28,21
2001-12-21,MEM,114,6,19,LAL,108,19,3,25,22
2001-12-21,SAS,109,19,4,DEN,74,9,15,28,19
2001-12-21,POR,83,12,12,DET,81,14,9,26,21
2001-12-21,GSW,108,10,16,SEA,111,12,15,22,31
2001-12-22,ATL,101,9,17,CHH,88,12,14,21,31
2001-12-22,NYK,86,12,14,WAS,87,13,12,25,26
2001-12-22,CLE,103,11,15,IND,109,15,13,26,28
2001-12-22,NJN,90,16,8,UTA,104,12,15,28,23
2001-12-22,CHI,74,4,20,MIN,95,17,8,21,28
2001-12-22,DAL,102,17,9,ORL,80,13,15,30,24
2001-12-22,HOU,115,7,20,MIL,110,14,8,21,28
2001-12-22,DEN,101,9,16,GSW,105,10,17,19,33
2001-12-22,PHX,102,14,12,POR,90,13,12,27,24
2001-12-22,SEA,117,13,15,DET,89,14,10,27,25
2001-12-22,LAC,101,14,11,SAC,85,19,8,33,19
2001-12-23,TOR,83,14,12,MIA,76,5,19,19,31
2001-12-23,BOS,85,16,8,MEM,80,7,19,23,27
2001-12-23,SAS,91,20,4,MIL,101,14,9,34,13
2001-12-23,SAC,133,19,9,PHX,101,15,12,34,21
2001-12-25,NYK,102,12,15,TOR,94,15,12,27,27
2001-12-25,LAL,88,19,4,PHI,82,11,15,30,19
2001-12-26,CHH,99,12,15,WAS,93,14,12,26,27
2001-12-26,CLE,89,11,16,NJN,91,16,9,27,25
2001-12-26,ORL,82,13,16,IND,89,16,13,29,29
2001-12-26,MIL,107,15,9,ATL,97,10,17,25,26
2001-12-26,SAS,123,20,5,DAL,126,18,9,38,14
2001-12-26,MEM,107,7,20,CHI,85,4,21,11,41
2001-12-26,HOU,91,8,20,PHX,97,15,13,23,33
2001-12-26,DEN,91,9,17,MIN,94,18,8,27,25
2001-12-26,UTA,99,13,15,BOS,86,17,8,30,23
2001-12-26,SAC,89,20,9,POR,74,13,13,33,22
2001-12-26,LAC,86,15,11,PHI,100,11,16,26,27
2001-12-26,GSW,101,11,17,LAL,90,20,4,31,21
2001-12-27,IND,108,17,13,WAS,81,14,13,31,26
2001-12-27,ATL,100,10,18,MIA,96,5,20,15,38
2001-12-27,DET,75,14,11,NJN,88,17,9,31,20
2001-12-27,DAL,89,19,9,CHI,74,4,22,23,31
2001-12-27,PHX,84,16,13,BOS,82,17,9,33,22
2001-12-27,POR,87,13,14,UTA,99,14,15,27,29
2001-12-27,SEA,101,14,15,LAC,90,15,12,29,27
2001-12-28,ORL,87,13,17,DET,78,14,12,27,29
2001-12-28,MIA,86,5,21,MEM,91,8,20,13,41
2001-12-28,CHH,89,13,15,MIL,105,16,9,29,24
2001-12-28,CLE,98,11,17,NYK,88,13,15,24,32
2001-12-28,DEN,93,9,18,PHI,90,12,16,21,34
2001-12-28,SAC,125,21,9,MIN,111,19,8,40,17
2001-12-28,LAL,86,20,5,TOR,89,15,13,35,18
2001-12-28,GSW,93,12,17,HOU,100,8,21,20,38
2001-12-29,LAC,103,15,13,BOS,105,17,10,32,23
2001-12-29,WAS,107,14,14,CHH,90,13,16,27,30
2001-12-29,NJN,98,18,9,IND,93,18,13,36,22
2001-12-29,CHI,103,4,23,CLE,80,12,17,16,40
2001-12-29,MIL,102,17,9,SAS,99,20,6,37,15
2001-12-29,DAL,113,20,9,ATL,97,11,18,31,27
2001-12-29,UTA,89,15,15,PHI,81,12,17,27,32
2001-12-29,PHX,109,17,13,DEN,92,10,18,27,31
2001-12-29,SEA,101,15,15,TOR,75,16,13,31,28
2001-12-30,DET,86,14,13,MIA,80,5,22,19,35
2001-12-30,NYK,90,13,16,ORL,94,14,17,27,33
2001-12-30,MEM,79,9,20,SAS,83,20,7,29,27
2001-12-30,SAC,109,22,9,BOS,94,18,10,40,19
2001-12-30,LAL,114,20,6,HOU,90,9,21,29,27
2001-12-30,POR,93,13,15,MIN,95,19,9,32,24
2001-12-31,CHI,90,5,23,MIL,83,18,9,23,32
2001-12-31,IND,87,18,14,MIA,89,5,23,23,37
2001-12-31,WAS,98,15,14,NJN,76,19,9,34,23
2002-01-01,LAC,112,15,14,POR,97,13,16,28,30
2002-01-02,BOS,110,18,11,ORL,94,15,17,33,28
2002-01-02,CLE,113,12,18,GSW,98,12,18,24,36
2002-01-02,NJN,92,19,10,MEM,74,9,21,28,31
2002-01-02,MIN,95,20,9,MIL,77,18,10,38,19
2002-01-02,CHI,97,6,23,DAL,107,21,9,27,32
2002-01-02,SAS,97,21,7,DET,85,15,13,36,20
2002-01-02,DEN,86,10,19,LAL,87,21,6,31,25
2002-01-02,PHX,81,18,13,PHI,102,12,18,30,31
2002-01-02,SAC,105,23,9,LAC,91,16,14,39,23
2002-01-02,POR,84,13,17,TOR,95,16,14,29,31
2002-01-03,CHH,114,13,17,GSW,102,12,19,25,36
2002-01-03,NYK,108,13,17,DAL,101,22,9,35,26
2002-01-03,HOU,99,9,22,DET,97,15,14,24,36
2002-01-04,WAS,89,16,14,CHI,83,6,24,22,38
2002-01-04,TOR,101,17,14,CLE,91,13,18,30,32
2002-01-04,BOS,66,19,11,MIA,89,6,23,25,34
2002-01-04,NJN,96,20,10,ORL,109,15,18,35,28
2002-01-04,MIN,93,21,9,UTA,86,16,15,37,24
2002-01-04,MEM,109,9,22,ATL,113,11,19,20,41
2002-01-04,SAS,82,22,7,IND,92,18,15,40,22
2002-01-04,DEN,80,10,20,LAC,82,16,15,26,35
2002-01-04,SEA,77,16,15,PHI,87,13,18,29,33
2002-01-04,LAL,118,22,6,PHX,86,18,14,40,20
2002-01-05,ATL,96,12,19,MIN,112,22,9,34,28
2002-01-05,NYK,81,14,17,BOS,90,19,12,33,29
2002-01-05,ORL,118,16,18,GSW,109,12,20,28,38
2002-01-05,CHH,80,14,17,NJN,89,20,11,34,28
2002-01-05,DET,101,15,15,CLE,91,13,19,28,34
2002-01-05,CHI,111,6,25,UTA,113,16,16,22,41
2002-01-05,DAL,103,22,10,SAS,105,22,8,44,18
2002-01-05,HOU,79,10,22,IND,81,19,15,29,37
2002-01-05,PHX,112,18,15,SAC,118,24,9,42,24
2002-01-05,POR,96,13,18,PHI,88,14,18,27,36
2002-01-05,LAC,86,17,15,MIL,83,18,11,35,26
2002-01-06,TOR,89,18,14,LAL,109,23,6,41,20
2002-01-06,MEM,77,9,23,SEA,89,16,16,25,39
2002-01-06,MIA,92,7,23,GSW,84,12,21,19,44
2002-01-06,SAC,115,25,9,MIL,101,18,12,43,21
2002-01-07,PHI,116,14,19,LAC,92,18,15,32,34
2002-01-07,CHH,94,14,18,DEN,80,10,21,24,39
2002-01-07,CLE,72,13,20,POR,98,14,18,27,38
2002-01-07,ORL,98,17,18,BOS,87,20,12,37,30
2002-01-07,MIN,109,23,9,DET,93,16,15,39,24
2002-01-07,CHI,88,6,26,SEA,100,17,16,23,42
2002-01-07,SAS,90,23,8,NYK,79,14,18,37,26
2002-01-08,WAS,96,17,14,LAC,88,18,16,35,30
2002-01-08,NJN,104,21,11,MIA,95,8,23,29,34
2002-01-08,ATL,101,12,20,POR,92,15,18,27,38
2002-01-08,DET,92,16,16,LAL,121,24,6,40,22
2002-01-08,MEM,84,9,24,TOR,81,18,15,27,39
2002-01-08,DAL,95,22,11,DEN,94,10,22,32,33
2002-01-08,HOU,88,10,23,NYK,86,14,19,24,42
2002-01-08,UTA,98,17,16,PHX,84,18,16,35,32
2002-01-08,GSW,97,12,22,MIL,113,18,13,30,35
2002-01-09,BOS,90,20,13,SAS,93,24,8,44,21
2002-01-09,CHH,111,15,18,ATL,87,13,20,28,38
2002-01-09,IND,90,20,15,LAL,109,25,6,45,21
2002-01-09,PHI,91,15,19,ORL,102,18,18,33,37
2002-01-09,MIN,111,24,9,SEA,106,18,16,42,25
2002-01-09,CHI,73,6,27,TOR,85,18,16,24,43
2002-01-10,NJN,108,22,11,LAC,89,18,17,40,28
2002-01-10,MIA,85,8,24,POR,92,15,19,23,43
2002-01-10,DAL,111,23,11,NYK,89,14,20,37,31
2002-01-10,DEN,96,10,23,CLE,91,13,21,23,44
2002-01-10,UTA,83,18,16,HOU,79,11,23,29,39
2002-01-10,PHX,96,18,17,MEM,102,10,24,28,41
2002-01-11,PHI,101,15,20,SAS,84,25,8,40,28
2002-01-11,TOR,94,19,16,ATL,91,13,21,32,37
2002-01-11,IND,97,20,16,CHI,90,6,28,26,44
2002-01-11,BOS,104,20,14,DET,90,16,17,36,31
2002-01-11,ORL,84,19,18,POR,92,16,19,35,37
2002-01-11,CHH,92,16,18,LAC,91,18,18,34,36
2002-01-11,MIN,120,25,9,LAL,102,26,6,51,15
2002-01-11,MIL,105,19,13,WAS,86,18,14,37,27
2002-01-11,SEA,102,18,17,CLE,100,13,22,31,39
2002-01-12,WAS,100,18,15,MIN,108,26,9,44,24
2002-01-12,ATL,91,13,22,BOS,115,21,14,34,36
2002-01-12,NYK,97,14,21,MIL,102,20,13,34,34
2002-01-12,ORL,85,19,19,NJN,91,23,11,42,30
2002-01-12,DET,104,16,18,CHH,76,17,18,33,36
2002-01-12,CHI,106,6,29,LAL,104,26,7,32,36
2002-01-12,DAL,111,24,11,IND,102,21,16,45,27
2002-01-12,HOU,98,11,24,DEN,86,11,23,22,47
2002-01-12,UTA,95,19,16,MEM,97,11,24,30,40
2002-01-12,PHX,108,18,18,MIA,74,8,25,26,43
2002-01-13,TOR,72,20,16,LAC,79,18,19,38,35
2002-01-13,SAC,103,26,9,PHX,100,19,18,45,27
2002-01-13,POR,96,17,19,CLE,64,13,23,30,42
2002-01-14,NJN,99,24,11,SAS,97,25,9,49,20
2002-01-14,ORL,113,19,20,DAL,87,25,11,44,31
2002-01-14,UTA,106,19,17,DEN,97,11,24,30,41
2002-01-14,LAL,120,26,8,MEM,81,12,24,38,32
2002-01-14,GSW,79,12,23,MIA,85,8,26,20,49
2002-01-15,WAS,91,18,16,SAS,96,25,10,43,26
2002-01-15,IND,102,21,17,MIL,106,21,13,42,30
2002-01-15,ATL,107,13,23,DAL,116,25,12,38,35
2002-01-15,DET,90,17,18,TOR,92,20,17,37,35
2002-01-15,PHI,112,16,20,HOU,106,12,24,28,44
2002-01-15,MIN,97,27,9,LAC,83,19,19,46,28
2002-01-15,CHI,86,7,29,CHH,94,17,19,24,48
2002-01-15,SAC,109,27,9,CLE,102,13,24,40,33
2002-01-16,BOS,101,22,14,NYK,100,14,22,36,36
2002-01-16,TOR,109,21,17,HOU,103,12,25,33,42
2002-01-16,NJN,111,25,11,WAS,67,18,17,43,28
2002-01-16,MIL,105,22,13,IND,100,21,18,43,31
2002-01-16,DEN,107,11,25,SAC,112,28,9,39,34
2002-01-16,UTA,95,20,17,SEA,80,19,17,39,34
2002-01-16,PHX,99,19,19,POR,108,18,19,37,38
2002-01-16,LAL,96,27,8,MIA,102,9,26,36,34
2002-01-16,GSW,117,12,24,CLE,88,13,25,25,49
2002-01-17,CHH,88,18,19,PHI,93,17,20,35,39
2002-01-17,ATL,91,13,24,CHI,94,7,30,20,54
2002-01-17,MEM,97,12,25,DAL,108,26,12,38,37
2002-01-17,SAS,102,26,10,UTA,98,21,17,47,27
2002-01-17,POR,90,19,19,MIA,92,10,26,29,45
2002-01-18,TOR,89,22,17,NJN,77,26,11,48,28
2002-01-18,IND,93,21,19,DET,96,17,19,38,38
2002-01-18,BOS,101,23,14,HOU,104,12,26,35,40
2002-01-18,MIL,115,23,13,ORL,110,20,20,43,33
2002-01-18,DEN,96,11,26,SEA,90,19,18,30,44
2002-01-18,PHX,103,19,20,MIN,100,28,9,47,29
2002-01-18,SAC,121,29,9,GSW,97,13,24,42,33
2002-01-18,LAC,109,19,20,CLE,103,13,26,32,46
2002-01-19,PHI,97,18,20,NYK,89,14,23,32,43
2002-01-19,SAS,81,27,10,LAL,98,27,9,54,19
2002-01-19,ATL,107,13,25,MIL,116,24,13,37,38
2002-01-19,CHH,89,18,20,TOR,91,23,17,41,37
2002-01-19,DET,94,18,19,BOS,91,23,15,41,34
2002-01-19,NJN,99,26,12,HOU,90,13,26,39,38
2002-01-19,MIA,100,11,26,IND,88,21,20,32,46
2002-01-19,CHI,69,8,30,WAS,77,18,18,26,48
2002-01-19,DAL,106,27,12,UTA,103,21,18,48,30
2002-01-19,MEM,103,12,26,ORL,119,20,21,32,47
2002-01-19,POR,113,19,20,LAC,93,20,20,39,40
2002-01-19,SEA,104,19,19,DEN,77,12,26,31,45
2002-01-19,GSW,102,13,25,MIN,105,28,10,41,35
2002-01-21,NYK,68,14,24,CHH,111,18,21,32,45
2002-01-21,PHI,98,19,20,SEA,109,20,19,39,39
2002-01-21,ATL,95,13,26,HOU,91,13,27,26,53
2002-01-21,DET,79,19,19,MIL,97,25,13,44,32
2002-01-21,DAL,113,28,12,NJN,105,27,12,55,24
2002-01-21,CHI,81,8,31,IND,93,21,21,29,52
2002-01-21,GSW,99,13,26,UTA,101,21,19,34,45
2002-01-21,MIN,105,29,10,WAS,101,19,18,48,28
2002-01-21,CLE,93,13,27,MIA,95,12,26,25,53
2002-01-21,BOS,106,23,16,TOR,97,24,17,47,33
2002-01-21,SAC,112,30,9,MEM,98,12,27,42,36
2002-01-21,LAC,102,20,21,DEN,89,12,27,32,48
2002-01-22,WAS,84,19,19,PHI,91,19,21,38,40
2002-01-22,ORL,100,21,21,ATL,86,14,26,35,47
2002-01-22,MIA,92,13,26,CHI,79,8,32,21,58
2002-01-22,MIL,81,26,13,PHX,92,20,20,46,33
2002-01-22,HOU,107,13,28,DAL,113,29,12,42,40
2002-01-22,SAS,86,27,11,NJN,92,27,13,54,24
2002-01-22,LAL,91,28,9,DEN,107,12,28,40,37
2002-01-22,POR,116,20,20,SAC,110,31,9,51,29
2002-01-23,BOS,98,24,16,IND,94,22,21,46,37
2002-01-23,CHH,111,19,21,SEA,101,21,19,40,40
2002-01-23,DET,104,19,20,MIN,83,30,10,49,30
2002-01-23,TOR,92,24,18,NYK,96,14,25,38,43
2002-01-23,UTA,92,22,19,SAS,98,27,12,49,31
2002-01-23,LAC,95,21,21,LAL,90,28,10,49,31
2002-01-23,GSW,107,13,27,MEM,95,12,28,25,55
2002-01-24,WAS,94,19,20,CLE,85,13,28,32,48
2002-01-24,NYK,96,15,25,PHX,91,21,20,36,45
2002-01-24,ORL,92,22,21,MIA,87,14,26,36,47
2002-01-24,MIL,88,26,14,SEA,99,21,20,47,34
2002-01-24,HOU,98,13,29,NJN,103,28,13,41,42
2002-01-24,DEN,97,13,28,DAL,104,30,12,43,40
2002-01-24,SAC,113,31,10,UTA,80,22,20,53,30
2002-01-24,POR,120,21,20,MEM,82,12,29,33,49
2002-01-25,TOR,107,24,19,MIN,100,30,11,54,30
2002-01-25,IND,90,22,22,CHH,81,20,21,42,43
2002-01-25,BOS,90,25,16,PHI,106,20,21,45,37
2002-01-25,ATL,90,14,27,DET,107,20,20,34,47
2002-01-25,LAL,94,28,11,SAS,91,28,12,56,23
2002-01-26,MIA,90,14,27,NJN,77,29,13,43,40
2002-01-26,MIL,127,26,15,NYK,129,16,25,42,40
2002-01-26,UTA,90,22,21,SAC,114,32,10,54,31
2002-01-26,CHH,104,20,22,HOU,111,13,30,33,52
2002-01-26,WAS,112,20,20,PHX,102,21,21,41,41
2002-01-26,CLE,101,13,29,BOS,108,25,17,38,46
2002-01-26,IND,86,23,22,SEA,95,22,20,45,42
2002-01-26,MIN,103,30,12,ATL,80,14,28,44,40
2002-01-26,CHI,95,8,33,MEM,92,12,30,20,63
2002-01-26,LAC,112,22,21,DAL,133,31,12,53,33
2002-01-26,GSW,82,14,27,SAS,90,28,13,42,40
2002-01-27,TOR,106,25,19,ORL,97,23,21,48,40
2002-01-27,PHI,93,21,21,LAL,87,29,11,50,32
2002-01-28,MEM,119,12,31,LAC,115,22,22,34,53
2002-01-28,UTA,101,22,22,MIA,89,15,27,37,49
2002-01-29,WAS,86,21,20,DET,89,21,20,42,40
2002-01-29,CLE,114,13,30,MIN,81,31,12,44,42
2002-01-29,NYK,78,17,25,PHI,71,22,21,39,46
2002-01-29,ATL,93,14,29,LAL,127,29,12,43,41
2002-01-29,MIL,109,26,16,BOS,90,26,17,52,33
2002-01-29,DAL,100,32,12,LAC,117,22,23,54,35
2002-01-29,HOU,100,14,30,GSW,96,14,28,28,58
2002-01-29,SAS,73,29,13,CHH,78,20,23,49,36
2002-01-29,DEN,94,13,29,MIA,100,15,28,28,57
2002-01-29,PHX,91,21,22,CHI,90,9,33,30,55
2002-01-29,SEA,86,23,20,POR,92,22,20,45,40
2002-01-30,PHI,96,22,22,MIN,91,31,13,53,35
2002-01-30,IND,83,23,23,MEM,82,13,31,36,54
2002-01-30,DET,88,22,20,ATL,71,14,30,36,50
2002-01-30,ORL,93,23,22,LAL,111,30,12,53,34
2002-01-30,UTA,90,23,22,CHI,78,9,34,32,56
2002-01-31,TOR,97,26,19,BOS,92,26,18,52,37
2002-01-31,CLE,92,14,30,WAS,93,21,21,35,51
2002-01-31,NJN,125,29,14,MIL,100,27,16,56,30
2002-01-31,SAS,87,29,14,LAC,91,23,23,52,37
2002-01-31,DAL,95,32,13,HOU,91,15,30,47,43
2002-01-31,POR,105,23,20,PHX,97,22,22,45,42
2002-01-31,SEA,95,23,21,SAC,99,33,10,56,31
2002-02-01,WAS,97,22,21,ATL,90,14,31,36,52
2002-02-01,IND,92,24,23,NYK,87,18,25,42,48
2002-02-01,BOS,95,26,19,MIN,98,31,14,57,33
2002-02-01,MIA,88,16,28,SAS,83,29,15,45,43
2002-02-01,DET,83,23,20,ORL,85,23,23,46,43
2002-02-01,MEM,85,13,32,LAL,100,31,12,44,44
2002-02-01,HOU,72,15,31,CHH,73,21,23,36,54
2002-02-01,PHX,104,22,23,GSW,98,14,29,36,52
2002-02-01,SAC,132,34,10,DEN,96,13,30,47,40
2002-02-02,NJN,98,30,14,TOR,91,27,19,57,33
2002-02-02,UTA,97,24,22,POR,96,24,20,48,42
2002-02-02,MIL,81,27,17,PHI,86,23,22,50,39
2002-02-02,ATL,101,14,32,LAC,94,24,23,38,55
2002-02-02,CLE,107,14,31,DET,115,23,21,37,52
2002-02-02,SEA,91,23,22,CHI,97,9,35,32,57
2002-02-03,NYK,83,18,26,MIA,94,17,28,35,54
2002-02-03,WAS,109,23,21,IND,89,25,23,48,44
2002-02-03,ORL,98,24,23,SAS,105,29,16,53,39
2002-02-03,MIN,107,32,14,SAC,112,35,10,67,24
2002-02-03,MEM,79,13,33,CHH,97,22,23,35,56
2002-02-03,DAL,94,33,13,LAL,101,32,12,65,25
2002-02-03,BOS,104,26,20,LAC,91,24,24,50,44
2002-02-03,GSW,97,14,30,PHX,98,23,23,37,53
2002-02-03,POR,101,24,21,CHI,96,10,35,34,56
2002-02-04,PHI,93,24,22,TOR,100,27,20,51,42
2002-02-04,NJN,117,31,14,SAC,83,36,10,67,24
2002-02-04,HOU,104,15,32,UTA,97,25,22,40,54
2002-02-04,SAS,113,30,16,MIN,83,32,15,62,31
2002-02-05,WAS,99,24,21,TOR,94,28,20,52,41
2002-02-05,CHH,79,23,23,BOS,82,27,20,50,43
2002-02-05,NYK,110,18,27,LAC,112,24,25,42,52
2002-02-05,ORL,106,24,24,CLE,98,14,32,38,56
2002-02-05,MIA,73,18,28,ATL,76,15,32,33,60
2002-02-05,DET,86,24,21,PHI,82,24,23,48,44
2002-02-05,IND,140,25,24,DAL,141,33,14,58,38
2002-02-05,MEM,86,13,34,UTA,79,25,23,38,57
2002-02-05,DEN,97,13,31,POR,96,25,21,38,52
2002-02-05,GSW,87,14,31,SEA,113,23,23,37,54
2002-02-06,BOS,85,28,20,SAC,102,36,11,64,31
2002-02-06,CLE,111,14,33,HOU,109,16,32,30,65
2002-02-06,NJN,100,32,14,DAL,112,34,14,66,28
2002-02-06,MIN,113,32,16,POR,103,25,22,57,38
2002-02-06,SEA,90,24,23,PHX,79,24,23,48,46
2002-02-06,LAL,89,33,12,CHI,97,10,36,43,48
2002-02-07,WAS,108,25,21,SAC,101,37,11,62,32
2002-02-07,CHH,93,23,24,PHI,100,24,24,47,48
2002-02-07,NYK,92,18,28,ATL,89,16,32,34,60
2002-02-07,DET,105,25,21,LAC,92,25,25,50,46
2002-02-07,TOR,80,28,21,SAS,74,31,16,59,37
2002-02-07,MIL,107,27,18,MEM,103,14,34,41,52
2002-02-12,CLE,99,15,33,TOR,81,29,21,44,54
2002-02-12,IND,82,25,25,UTA,98,25,24,50,49
2002-02-12,ATL,105,16,33,NJN,103,32,15,48,48
2002-02-12,DET,71,26,21,PHX,99,24,24,50,45
2002-02-12,ORL,122,25,24,NYK,114,19,28,44,52
2002-02-12,CHI,96,11,36,MIL,92,28,18,39,54
2002-02-12,HOU,85,16,33,MEM,78,14,35,30,68
2002-02-12,DEN,93,14,31,BOS,110,28,21,42,52
2002-02-12,SEA,106,25,23,DAL,112,35,14,60,37
2002-02-12,LAL,103,33,13,WAS,94,26,21,59,34
2002-02-12,SAC,99,37,12,SAS,86,31,17,68,29
2002-02-13,CHH,113,23,25,CHI,91,12,36,35,61
2002-02-13,NYK,89,19,29,TOR,82,29,22,48,51
2002-02-13,MIA,112,18,29,ORL,95,26,24,44,53
2002-02-13,MIL,107,28,19,CLE,115,16,33,44,52
2002-02-13,MIN,107,33,16,PHX,92,25,24,58,40
2002-02-13,POR,114,25,23,DAL,103,36,14,61,37
2002-02-13,GSW,92,14,32,BOS,75,29,21,43,53
2002-02-14,NJN,80,32,16,DET,85,26,22,58,38
2002-02-14,PHI,91,25,24,UTA,98,26,24,51,48
2002-02-14,MEM,85,14,36,DEN,100,14,32,28,68
2002-02-14,SAC,109,38,12,WAS,93,26,22,64,34
2002-02-14,SEA,87,25,24,LAL,92,34,13,59,37
2002-02-14,LAC,76,25,26,SAS,89,31,18,56,44
2002-02-15,TOR,85,29,23,UTA,94,27,24,56,47
2002-02-15,NYK,90,20,29,DET,101,27,22,47,51
2002-02-15,CHH,116,24,25,IND,106,25,26,49,51
2002-02-15,MIN,98,34,16,DEN,99,15,32,49,48
2002-02-15,CHI,81,12,37,NJN,106,32,17,44,54
2002-02-15,MIL,88,28,20,MIA,90,19,29,47,49
2002-02-15,PHX,96,25,25,WAS,97,26,23,51,48
2002-02-15,POR,104,26,23,BOS,107,29,22,55,45
2002-02-15,LAL,90,35,13,ATL,93,17,33,52,46
2002-02-15,GSW,99,15,32,SAS,108,32,18,47,50
2002-02-16,CHI,101,12,38,CLE,114,17,33,29,71
2002-02-16,HOU,100,17,33,ORL,109,26,25,43,58
2002-02-16,SEA,99,25,25,BOS,79,30,22,55,47
2002-02-16,LAC,119,25,27,DAL,110,36,15,61,42
2002-02-17,NJN,98,33,17,DEN,77,16,32,49,49
2002-02-17,CHH,78,25,25,MEM,92,14,37,39,62
2002-02-17,TOR,86,29,24,MIL,91,28,21,57,45
2002-02-17,IND,86,25,27,PHI,76,25,25,50,52
2002-02-17,MIN,93,34,17,MIA,80,20,29,54,46
2002-02-17,POR,111,26,24,LAL,105,35,14,61,38
2002-02-17,NYK,89,20,30,UTA,92,28,24,48,54
2002-02-17,PHX,92,25,26,DAL,105,36,16,61,42
2002-02-17,GSW,94,15,33,ATL,100,18,33,33,66
2002-02-17,SAC,116,39,12,SEA,126,26,25,65,37
2002-02-18,WAS,89,27,23,HOU,102,17,34,44,57
2002-02-18,PHI,110,25,26,DEN,83,16,33,41,59
2002-02-18,CLE,92,18,33,UTA,103,29,24,47,57
2002-02-18,MIA,102,20,30,CHI,80,12,39,32,69
2002-02-18,DET,89,28,22,TOR,76,29,25,57,47
2002-02-18,MIL,92,29,21,CHH,101,25,26,54,47
2002-02-18,LAC,79,26,27,POR,80,27,24,53,51
2002-02-19,NJN,123,34,17,GSW,115,15,34,49,51
2002-02-19,DAL,100,37,16,MIN,117,35,17,72,33
2002-02-19,SAS,99,33,18,MEM,93,15,37,48,55
2002-02-19,PHX,91,25,27,SEA,103,27,25,52,52
2002-02-19,SAC,99,39,13,ATL,79,19,33,58,46
2002-02-19,LAL,108,35,15,BOS,109,30,23,65,38
2002-02-20,PHI,114,26,26,GSW,107,15,35,41,61
2002-02-20,MIA,71,21,30,LAC,81,26,28,47,58
2002-02-20,DET,97,29,22,WAS,90,27,24,56,46
2002-02-20,TOR,77,29,26,CHH,78,26,26,55,52
2002-02-20,MIL,115,29,22,HOU,76,18,34,47,56
2002-02-20,CHI,113,12,40,NYK,109,20,31,32,71
2002-02-20,DEN,99,16,34,UTA,110,30,24,46,58
2002-02-20,SEA,84,28,25,POR,90,28,24,56,49
2002-02-21,WAS,82,27,25,NJN,93,35,17,62,42
2002-02-21,CLE,97,18,34,LAL,104,35,16,53,50
2002-02-21,ORL,119,27,25,LAC,102,27,28,54,53
2002-02-21,MEM,72,15,38,PHX,78,25,28,40,66
2002-02-21,DAL,98,37,17,BOS,92,31,23,68,40
2002-02-21,HOU,89,18,35,MIN,83,36,17,54,52
2002-02-21,SAS,115,34,18,SAC,92,40,13,74,31
2002-02-21,POR,94,29,24,ATL,79,19,34,48,58
2002-02-22,TOR,72,29,27,DET,80,30,22,59,49
2002-02-22,IND,93,26,27,CLE,103,18,35,44,62
2002-02-22,NJN,115,36,17,NYK,93,20,32,56,49
2002-02-22,CHH,94,27,26,LAL,96,36,16,63,42
2002-02-22,CHI,91,13,40,PHX,83,26,28,39,68
2002-02-22,MIL,116,30,22,GSW,112,15,36,45,58
2002-02-22,SEA,99,28,26,ATL,96,19,35,47,61
2002-02-23,ORL,105,28,25,PHI,87,27,26,55,51
2002-02-23,DAL,111,38,17,SAC,97,40,14,78,31
2002-02-23,WAS,95,27,26,MIA,97,21,31,48,57
2002-02-23,IND,106,26,28,LAC,88,27,29,53,57
2002-02-23,CHI,105,14,40,GSW,91,15,37,29,77
2002-02-23,HOU,99,19,35,BOS,89,31,24,50,59
2002-02-23,SAS,88,35,18,MIN,112,36,18,71,36
2002-02-23,POR,101,30,24,DEN,90,16,35,46,59
2002-02-24,NYK,91,20,33,LAL,107,37,16,57,49
2002-02-24,NJN,95,37,17,CHH,93,27,27,64,44
2002-02-24,MIL,89,31,22,DET,82,31,22,62,44
2002-02-24,TOR,92,29,28,SEA,101,29,26,58,54
2002-02-24,CLE,111,19,35,ORL,96,29,25,48,60
2002-02-24,MIA,92,22,31,WAS,80,27,27,49,58
2002-02-24,PHX,92,26,29,SAS,83,35,19,61,48
2002-02-24,DEN,84,16,36,ATL,89,19,36,35,72
2002-02-25,PHI,83,27,27,POR,88,31,24,58,51
2002-02-25,CHH,92,27,28,MIN,97,37,18,64,46
2002-02-25,MEM,77,15,39,LAC,90,27,30,42,69
2002-02-25,GSW,97,15,38,IND,102,27,28,42,66
2002-02-26,CLE,89,20,35,SEA,109,30,26,50,61
2002-02-26,MIL,89,32,22,LAL,99,38,16,70,38
2002-02-26,CHI,97,15,40,ORL,112,29,26,44,66
2002-02-26,DAL,104,39,17,MEM,91,15,40,54,57
2002-02-26,HOU,84,20,35,LAC,94,28,30,48,65
2002-02-26,SAS,99,35,20,PHX,91,27,29,62,49
2002-02-26,SAC,107,40,15,UTA,81,31,24,71,39
2002-02-27,BOS,92,31,25,MIL,95,32,23,63,48
2002-02-27,PHI,82,27,28,MIA,72,23,31,50,59
2002-02-27,WAS,101,27,28,POR,105,32,24,59,52
2002-02-27,CHH,104,27,29,NJN,85,38,17,65,46
2002-02-27,ATL,81,20,36,SEA,98,31,26,51,62
2002-02-27,DET,101,31,23,CHI,89,15,41,46,64
2002-02-27,TOR,85,29,29,ORL,90,30,26,59,55
2002-02-27,MIN,112,38,18,LAL,101,39,16,77,34
2002-02-27,GSW,110,15,39,DEN,93,16,37,31,76
2002-02-28,CLE,114,20,36,SAS,107,36,20,56,56
2002-02-28,MIA,100,23,32,NYK,86,20,34,43,66
2002-02-28,UTA,114,31,25,MEM,70,15,41,46,66
2002-02-28,PHX,107,27,30,IND,100,28,28,55,58
2002-03-01,PHI,110,28,28,NJN,102,38,18,66,46
2002-03-01,TOR,81,29,30,POR,91,33,24,62,54
2002-03-01,BOS,87,31,26,CHH,100,28,29,59,55
2002-03-01,NYK,89,20,35,SEA,87,32,26,52,61
2002-03-01,DET,110,32,23,ORL,102,31,26,63,49
2002-03-01,MIN,77,39,18,SAS,85,36,21,75,39
2002-03-01,CHI,90,15,42,WAS,81,27,29,42,71
2002-03-01,DEN,96,16,38,MEM,83,15,42,31,80
2002-03-01,LAL,96,39,17,IND,84,28,29,67,46
2002-03-01,GSW,108,16,39,SAC,116,41,15,57,54
2002-03-02,ATL,84,20,37,CLE,81,21,36,41,73
2002-03-02,MIL,103,33,23,POR,104,34,24,67,47
2002-03-02,DAL,95,40,17,MIA,109,24,32,64,49
2002-03-02,UTA,105,32,25,MIN,116,39,19,71,44
2002-03-02,PHX,97,28,30,HOU,104,20,36,48,66
2002-03-02,LAC,109,29,30,GSW,95,16,40,45,70
2002-03-03,NYK,83,21,35,SAS,99,37,21,58,56
2002-03-03,NJN,92,38,19,CHI,84,16,42,54,61
2002-03-03,WAS,107,27,30,ORL,102,31,27,58,57
2002-03-03,CHH,81,29,29,DET,83,33,23,62,52
2002-03-03,MEM,71,15,43,SEA,96,32,27,47,70
2002-03-03,TOR,84,29,31,PHI,96,29,28,58,59
2002-03-03,SAC,86,42,15,IND,97,28,30,70,45
2002-03-03,CLE,91,21,37,MIL,101,33,24,54,61
2002-03-03,DEN,110,17,38,DAL,116,40,18,57,56
2002-03-03,LAL,95,40,17,HOU,79,21,36,61,53
2002-03-04,PHI,94,30,28,BOS,100,31,27,61,55
2002-03-04,ATL,95,21,37,MEM,76,15,44,36,81
2002-03-04,UTA,100,32,26,DEN,82,17,39,49,65
2002-03-04,POR,107,35,24,SAC,95,42,16,77,40
2002-03-05,WAS,115,28,30,CHI,90,16,43,44,73
2002-03-05,CLE,103,21,38,ATL,96,22,37,43,75
2002-03-05,NYK,102,21,36,MIL,89,34,24,55,60
2002-03-05,DET,91,34,23,MIA,93,25,32,59,55
2002-03-05,IND,111,29,30,ORL,98,31,28,60,58
2002-03-05,DAL,81,41,18,PHX,77,28,31,69,49
2002-03-05,HOU,112,21,37,TOR,109,29,32,50,69
2002-03-05,SAS,109,38,21,GSW,88,16,41,54,62
2002-03-05,SEA,97,33,27,MIN,83,40,19,73,46
2002-03-05,LAL,101,41,17,NJN,92,39,19,80,36
2002-03-06,BOS,130,32,27,ORL,110,31,29,63,56
2002-03-06,PHI,85,30,29,CLE,76,22,38,52,67
2002-03-06,MIL,92,34,25,LAC,86,30,30,64,55
2002-03-06,UTA,92,33,26,LAL,84,42,17,75,43
2002-03-06,CHI,87,16,44,MIA,92,26,32,42,76
2002-03-06,PHX,89,28,32,NJN,87,39,20,67,52
2002-03-06,POR,85,36,24,MIN,78,40,20,76,44
2002-03-07,WAS,92,29,30,DET,95,34,24,63,54
2002-03-07,MEM,122,15,45,IND,111,30,30,45,75
2002-03-07,SAS,99,39,21,HOU,97,22,37,61,58
2002-03-07,DAL,122,42,18,TOR,103,29,33,71,51
2002-03-07,DEN,104,17,40,NYK,93,22,36,39,76
2002-03-07,SEA,92,34,27,CHH,89,29,30,63,57
2002-03-08,PHI,109,31,29,IND,100,30,31,61,60
2002-03-08,BOS,117,33,27,DET,92,35,24,68,51
2002-03-08,ORL,99,31,30,WAS,96,29,31,60,61
2002-03-08,MIA,74,27,32,TOR,83,29,34,56,66
2002-03-08,CHI,90,16,45,LAC,94,30,31,46,76
2002-03-08,MIL,109,35,25,CLE,115,22,39,57,64
2002-03-08,HOU,95,22,38,GSW,108,16,42,38,80
2002-03-08,UTA,79,34,26,NYK,85,22,37,56,63
2002-03-08,PHX,81,29,32,MIN,76,40,21,69,53
2002-03-08,SAC,99,42,17,CHH,87,29,31,71,48
2002-03-08,POR,82,37,24,NJN,73,39,21,76,45
2002-03-09,ATL,91,22,38,PHI,112,32,29,54,67
2002-03-09,MEM,88,16,45,MIA,93,27,33,43,78
2002-03-09,CHI,73,16,46,SAS,100,40,21,56,67
2002-03-09,DAL,107,43,18,GSW,105,17,42,60,60
2002-03-09,DEN,109,18,40,POR,106,38,24,56,64
2002-03-09,SEA,96,35,27,NJN,90,39,22,74,49
2002-03-10,ORL,92,32,30,TOR,79,30,34,62,64
2002-03-10,BOS,98,34,27,WAS,91,29,32,63,59
2002-03-10,CLE,78,23,39,LAC,95,31,31,54,70
2002-03-10,DET,84,35,25,IND,89,30,32,65,57
2002-03-10,MIL,73,35,26,SAC,98,43,17,78,43
2002-03-10,HOU,95,22,39,UTA,92,34,27,56,66
2002-03-10,LAL,117,42,18,NYK,103,23,37,65,55
2002-03-10,PHX,82,30,32,CHH,88,29,32,59,64
2002-03-11,WAS,99,29,33,BOS,104,35,27,64,60
2002-03-11,ATL,121,22,39,GSW,96,17,43,39,82
2002-03-11,MIN,99,40,22,LAC,108,32,31,72,53
2002-03-11,MEM,79,16,46,UTA,78,34,28,50,74
2002-03-11,CHI,103,16,47,SAC,107,44,17,60,64
2002-03-11,DAL,119,44,18,SEA,108,36,27,80,45
2002-03-11,DEN,78,19,40,SAS,93,41,21,60,61
2002-03-12,IND,115,31,32,GSW,101,17,44,48,76
2002-03-12,NYK,96,23,38,PHI,104,33,29,56,67
2002-03-12,NJN,86,39,23,TOR,84,30,35,69,58
2002-03-12,MIA,90,28,33,PHX,78,30,33,58,66
2002-03-12,MIL,110,35,27,CHI,81,16,48,51,75
2002-03-12,HOU,101,23,39,SEA,98,36,28,59,67
2002-03-12,SAS,98,42,21,MEM,84,17,46,59,67
2002-03-12,LAL,107,43,18,CHH,66,30,32,73,50
2002-03-13,BOS,97,36,27,NJN,89,40,23,76,50
2002-03-13,ORL,119,33,30,PHX,114,30,34,63,64
2002-03-13,ATL,105,23,39,DEN,102,19,41,42,80
2002-03-13,DET,85,35,26,CLE,84,23,40,58,66
2002-03-13,PHI,88,34,29,SAC,92,45,17,79,46
2002-03-13,MIN,95,40,23,HOU,96,24,39,64,62
2002-03-13,LAC,96,33,31,WAS,75,29,34,62,65
2002-03-14,CHH,100,30,33,UTA,82,34,29,64,62
2002-03-14,NYK,113,23,39,SAC,96,46,17,69,56
2002-03-14,SAS,91,43,21,CHI,86,16,49,59,70
2002-03-14,POR,132,38,25,DAL,106,45,18,83,43
2002-03-14,GSW,102,17,45,LAL,110,44,18,61,63
2002-03-15,NJN,97,40,24,MIA,78,29,33,69,57
2002-03-15,ORL,124,34,30,DEN,102,19,42,53,72
2002-03-15,ATL,104,24,39,PHX,89,30,35,54,74
2002-03-15,DET,97,36,26,UTA,100,34,30,70,56
2002-03-15,MIN,85,40,24,IND,98,32,32,72,56
2002-03-15,MEM,97,17,47,BOS,103,37,27,54,74
2002-03-15,SEA,98,36,29,WAS,103,29,35,65,64
2002-03-15,LAL,98,45,18,LAC,92,34,31,79,49
2002-03-16,NYK,105,24,39,CLE,95,23,41,47,80
2002-03-16,MIA,101,29,34,DEN,76,19,43,48,77
2002-03-16,CHH,87,31,33,PHX,76,30,36,61,69
2002-03-16,MIL,94,36,27,DET,102,36,27,72,54
2002-03-16,HOU,112,25,39,CHI,114,16,50,41,89
2002-03-16,SAS,111,44,21,BOS,104,38,27,82,48
2002-03-16,POR,95,39,25,WAS,80,30,35,69,60
2002-03-16,LAC,87,34,32,SEA,95,36,30,70,62
2002-03-16,GSW,100,17,46,DAL,117,45,19,62,65
2002-03-17,PHI,103,34,30,ORL,105,35,30,69,60
2002-03-17,IND,85,33,32,ATL,68,25,39,58,71
2002-03-17,MEM,76,17,48,NJN,87,41,24,58,72
2002-03-17,MIN,89,40,25,UTA,96,35,30,75,55
2002-03-17,TOR,113,30,36,SAC,116,46,18,76,54
2002-03-17,CLE,104,23,42,NYK,99,25,39,48,81
2002-03-17,LAL,105,46,18,DAL,103,46,19,92,37
2002-03-18,BOS,91,38,28,POR,100,40,25,78,53
2002-03-18,CHH,113,32,33,MIL,110,36,28,68,61
2002-03-18,DEN,91,19,44,DET,98,37,27,56,71
2002-03-18,LAC,93,34,33,HOU,86,25,40,59,73
2002-03-18,GSW,96,17,47,WAS,99,30,36,47,83
2002-03-19,CLE,100,24,42,NJN,97,42,24,66,66
2002-03-19,MIA,79,30,34,PHI,91,34,31,64,65
2002-03-19,ORL,101,36,30,MIL,91,36,29,72,59
2002-03-19,MIN,112,40,26,TOR,80,30,37,70,63
2002-03-19,MEM,92,17,49,NYK,101,25,40,42,89
2002-03-19,CHI,96,17,50,ATL,102,25,40,42,90
2002-03-19,DAL,114,46,20,LAL,98,47,18,93,38
2002-03-19,UTA,87,36,30,DET,94,38,27,74,57
2002-03-19,SEA,110,37,30,GSW,93,17,48,54,78
2002-03-19,SAC,110,47,18,HOU,87,25,41,72,59
2002-03-20,BOS,96,38,29,CLE,70,25,42,63,71
2002-03-20,PHI,77,35,31,MIA,82,30,35,65,66
2002-03-20,CHH,94,33,33,IND,88,34,32,67,65
2002-03-20,NJN,97,42,25,POR,82,41,25,83,50
2002-03-20,SAS,108,45,21,LAL,90,47,19,92,40
2002-03-20,DEN,75,19,45,WAS,107,31,36,50,81
2002-03-21,ATL,118,26,40,NYK,89,26,40,52,80
2002-03-21,MEM,93,17,50,MIN,95,41,26,58,76
2002-03-21,DAL,102,47,20,SAS,105,46,21,93,41
2002-03-21,UTA,94,36,31,WAS,79,32,36,68,67
2002-03-21,PHX,82,30,37,DET,95,39,27,69,64
2002-03-21,SAC,118,48,18,DEN,82,19,46,67,64
2002-03-21,GSW,96,17,49,LAC,116,35,33,52,82
2002-03-22,BOS,91,39,29,PHI,96,35,32,74,61
2002-03-22,NJN,108,43,25,MIL,84,36,30,79,55
2002-03-22,ORL,92,37,30,CHH,106,34,33,71,63
2002-03-22,MIA,94,31,35,IND,104,34,33,65,68
2002-03-22,CLE,80,25,43,TOR,94,30,38,55,81
2002-03-22,CHI,93,17,51,POR,109,41,26,58,77
2002-03-22,SEA,112,38,30,HOU,82,25,42,63,72
2002-03-22,LAL,94,47,20,DET,82,40,27,87,47
2002-03-23,ATL,112,27,40,CHI,96,17,52,44,92
2002-03-23,MIN,99,42,26,POR,108,42,26,84,52
2002-03-23,DAL,111,47,21,MEM,100,17,51,64,72
2002-03-23,SAS,89,47,21,MIA,79,31,36,78,57
2002-03-23,UTA,112,37,31,GSW,103,17,50,54,81
2002-03-23,DEN,88,19,47,SEA,85,39,30,58,77
2002-03-23,LAC,94,36,33,PHX,97,30,38,66,71
2002-03-24,PHI,90,36,32,NYK,82,26,41,62,73
2002-03-24,IND,84,35,33,CHH,99,35,33,70,66
2002-03-24,MIL,110,36,31,ORL,85,37,31,73,62
2002-03-24,DET,109,40,28,BOS,101,39,30,79,58
2002-03-24,TOR,92,31,38,WAS,91,32,37,63,75
2002-03-24,NJN,116,44,25,ATL,102,28,40,72,65
2002-03-24,SAC,96,49,18,LAL,97,48,20,97,38
2002-03-24,GSW,104,17,51,HOU,116,25,43,42,94
2002-03-25,NYK,83,26,42,DEN,84,20,47,46,89
2002-03-25,MIA,82,31,37,BOS,87,39,31,70,68
2002-03-25,PHX,102,31,38,CLE,96,25,44,56,82
2002-03-25,POR,100,43,26,MEM,103,17,52,60,78
2002-03-25,SEA,106,39,31,UTA,92,38,31,77,62
2002-03-25,LAC,85,36,34,SAS,91,48,21,84,55
2002-03-26,WAS,103,32,38,DEN,87,21,47,53,85
2002-03-26,IND,77,35,34,DET,96,41,28,76,62
2002-03-26,ORL,96,37,32,CHI,82,17,53,54,85
2002-03-26,ATL,103,28,41,NJN,77,45,25,73,66
2002-03-26,MIL,106,37,31,DAL,112,48,21,85,52
2002-03-26,MIN,106,42,27,GSW,115,17,52,59,79
2002-03-26,UTA,109,38,32,HOU,105,26,43,64,75
2002-03-26,SAC,107,49,19,LAC,90,36,35,85,54
2002-03-26,LAL,121,49,20,CLE,116,25,45,74,65
2002-03-27,BOS,102,40,31,GSW,99,18,52,58,83
2002-03-27,PHI,80,37,32,NJN,88,45,26,82,58
2002-03-27,CHH,111,36,33,ORL,104,38,32,74,65
2002-03-27,DET,82,42,28,NYK,89,26,43,68,71
2002-03-27,TOR,81,32,38,MIA,80,31,38,63,76
2002-03-27,PHX,118,32,38,LAL,106,50,20,82,58
2002-03-27,SEA,96,40,31,MEM,82,18,52,58,83
2002-03-27,POR,98,43,27,SAS,93,49,21,92,48
2002-03-28,ATL,83,29,41,TOR,85,33,38,62,79
2002-03-28,MIL,95,37,32,DEN,88,21,48,58,80
2002-03-28,MIN,113,42,28,DAL,111,49,21,91,49
2002-03-28,CHI,79,17,54,PHI,99,37,33,54,87
2002-03-28,HOU,74,26,44,SAC,101,50,19,76,63
2002-03-28,UTA,112,39,32,CLE,91,25,46,64,78
2002-03-29,WAS,107,33,38,MIL,98,38,32,71,70
2002-03-29,BOS,82,41,31,DAL,108,49,22,90,53
2002-03-29,NYK,77,27,43,MIN,98,43,28,70,71
2002-03-29,ORL,114,38,33,IND,106,35,35,73,68
2002-03-29,MIA,92,31,39,ATL,80,29,42,60,81
2002-03-29,CHH,87,37,33,SAC,92,51,19,88,52
2002-03-29,DET,110,42,29,GSW,103,18,53,60,82
2002-03-29,PHX,94,33,38,LAC,96,36,36,69,74
2002-03-29,SEA,79,41,31,SAS,76,49,22,90,53
2002-03-29,LAL,91,50,21,POR,79,44,27,94,48
2002-03-30,NJN,102,46,26,PHI,92,38,33,84,59
2002-03-30,CLE,85,25,47,CHH,93,37,34,62,81
2002-03-30,MEM,105,18,53,GSW,99,18,54,36,107
2002-03-30,CHI,84,17,55,DEN,100,21,49,38,104
2002-03-30,HOU,88,26,45,PHX,90,33,39,59,84
2002-03-30,POR,87,44,28,SEA,92,42,31,86,59
2002-03-30,LAC,92,37,36,UTA,105,40,32,77,68
2002-03-31,PHI,70,38,34,TOR,72,34,38,72,72
2002-03-31,ATL,91,29,43,SAC,92,52,19,81,62
2002-03-31,BOS,110,41,32,MIL,80,38,33,79,65
2002-03-31,WAS,103,34,38,DAL,110,50,22,84,60
2002-03-31,ORL,97,39,33,NYK,90,27,44,66,77
2002-03-31,IND,100,35,36,MIA,81,32,39,67,75
2002-03-31,MIN,86,44,28,NJN,85,47,26,91,54
2002-03-31,LAL,96,51,21,SAS,95,49,23,100,44
2002-03-31,DET,86,43,29,DEN,82,22,49,65,78
2002-04-02,WAS,93,34,39,LAL,113,52,21,86,60
2002-04-02,CLE,101,25,48,PHX,96,34,39,59,87
2002-04-02,IND,94,36,36,BOS,105,42,32,78,68
2002-04-02,MIA,87,32,40,DET,90,44,29,76,69
2002-04-02,ATL,100,29,44,MIL,92,38,34,67,78
2002-04-02,NYK,91,27,45,CHH,85,38,34,65,79
2002-04-02,MEM,83,19,53,SAC,107,53,19,72,72
2002-04-02,HOU,100,26,46,SEA,98,43,31,69,77
2002-04-02,DEN,98,22,50,UTA,90,41,32,63,82
2002-04-02,GSW,107,18,55,POR,91,44,29,62,84
2002-04-03,CHH,97,38,35,MIA,90,32,41,70,76
2002-04-03,TOR,117,35,38,CHI,104,17,56,52,94
2002-04-03,NJN,94,47,27,LAL,92,53,21,100,48
2002-04-03,DET,86,45,29,SAC,107,54,19,99,48
2002-04-03,PHI,89,38,35,PHX,83,34,40,72,75
2002-04-03,MIL,105,38,35,WAS,90,34,40,72,75
2002-04-03,MIN,92,45,28,MEM,81,19,54,64,82
2002-04-03,SAS,90,49,24,SEA,88,43,32,92,56
2002-04-03,UTA,99,41,33,LAC,87,37,37,78,70
2002-04-04,ORL,105,40,33,CLE,101,26,48,66,81
2002-04-04,ATL,95,30,44,IND,94,36,37,66,81
2002-04-04,DAL,115,51,22,LAC,90,37,38,88,60
2002-04-04,HOU,78,27,46,SAS,102,50,24,77,70
2002-04-04,DEN,88,23,50,MIN,87,46,28,69,78
2002-04-04,POR,88,44,30,NYK,80,28,45,72,75
2002-04-05,PHI,88,39,35,DET,92,45,30,84,65
2002-04-05,IND,97,36,38,PHX,87,34,41,70,79
2002-04-05,BOS,99,43,32,LAL,81,53,22,96,54
2002-04-05,NJN,110,48,27,ORL,85,41,33,89,60
2002-04-05,MIA,102,32,42,MIL,97,39,35,71,77
2002-04-05,CHH,97,39,35,WAS,91,34,41,73,76
2002-04-05,MEM,99,19,55,HOU,81,27,47,46,102
2002-04-05,CHI,96,17,57,TOR,98,36,38,53,95
2002-04-05,UTA,109,42,33,SAC,117,55,19,97,52
2002-04-05,SEA,83,43,33,NYK,86,28,46,71,79
2002-04-05,GSW,108,19,55,DEN,104,24,50,43,105
2002-04-06,SAS,89,51,24,DAL,87,52,22,103,46
2002-04-06,WAS,88,34,42,MEM,85,20,55,54,97
2002-04-06,ATL,86,31,44,CHH,93,40,35,71,79
2002-04-06,CLE,120,26,49,CHI,101,17,58,43,107
2002-04-06,MIN,108,46,29,PHX,104,34,42,80,71
2002-04-06,POR,113,45,30,GSW,86,20,55,65,85
2002-04-07,PHI,89,39,36,MIL,87,39,36,78,72
2002-04-07,MIA,88,33,42,LAL,96,53,23,86,65
2002-04-07,TOR,94,37,38,IND,84,37,38,74,76
2002-04-07,SAC,116,56,19,NYK,82,29,46,85,65
2002-04-07,NJN,90,49,27,BOS,102,44,32,93,59
2002-04-07,LAC,97,37,39,DEN,75,24,51,61,90
2002-04-08,ORL,83,41,34,HOU,74,27,48,68,82
2002-04-08,DET,105,46,30,ATL,99,31,45,77,75
2002-04-08,IND,99,37,39,CLE,111,27,49,64,88
2002-04-08,CHI,105,17,59,BOS,100,45,32,62,91
2002-04-08,SAS,99,52,24,POR,87,46,30,98,54
2002-04-08,UTA,96,42,34,DAL,105,52,23,94,57
2002-04-08,SEA,102,43,34,LAC,100,38,39,81,73
2002-04-08,GSW,93,20,56,MIN,100,47,29,67,85
2002-04-09,TOR,84,38,38,CHH,80,41,35,79,73
2002-04-09,NYK,97,29,47,ORL,108,42,34,71,81
2002-04-09,NJN,101,49,28,WAS,88,35,42,84,70
2002-04-09,MIA,120,33,43,HOU,117,27,49,60,92
2002-04-09,MIL,90,39,37,PHI,92,40,36,79,73
2002-04-09,MEM,97,20,56,DEN,86,24,52,44,108
2002-04-09,DAL,108,53,23,POR,96,46,31,99,54
2002-04-09,PHX,99,34,43,SEA,92,44,34,78,77
2002-04-09,LAL,112,54,23,UTA,82,42,35,96,58
2002-04-09,SAC,122,57,19,MIN,103,48,29,105,48
2002-04-10,BOS,70,45,33,MIA,65,34,43,79,76
2002-04-10,WAS,90,35,43,PHI,77,41,36,76,79
2002-04-10,CHH,95,41,36,ATL,101,31,46,72,82
2002-04-10,CLE,106,28,49,MIL,81,39,38,67,87
2002-04-10,DET,101,47,30,CHI,102,18,59,65,89
2002-04-10,IND,98,37,40,TOR,82,39,38,76,78
2002-04-10,SAS,87,53,24,DEN,79,24,53,77,77
2002-04-10,GSW,116,20,57,SAC,118,58,19,78,76
2002-04-11,NYK,101,29,48,CHI,104,19,59,48,107
2002-04-11,ORL,99,43,34,NJN,101,50,28,93,62
2002-04-11,DAL,95,54,23,HOU,98,27,50,81,73
2002-04-11,MEM,102,21,56,POR,99,46,32,67,88
2002-04-11,PHX,96,35,43,UTA,97,42,36,77,79
2002-04-11,LAL,96,55,23,MIN,83,48,30,103,53
2002-04-12,PHI,100,41,37,WAS,91,36,43,77,80
2002-04-12,TOR,112,39,39,ATL,73,32,46,71,85
2002-04-12,BOS,107,46,33,NYK,92,29,49,75,82
2002-04-12,MIA,99,34,44,ORL,94,43,35,77,79
2002-04-12,CHH,112,41,37,CLE,100,29,49,70,86
2002-04-12,DET,86,47,31,SAS,96,54,24,101,55
2002-04-12,IND,112,38,40,MIL,107,39,39,77,79
2002-04-12,HOU,79,28,50,POR,80,46,33,74,83
2002-04-12,DEN,97,24,54,GSW,89,20,58,44,112
2002-04-12,LAC,106,38,40,SAC,125,59,19,97,59
2002-04-13,ATL,128,32,47,CLE,123,29,50,61,97
2002-04-13,MEM,92,22,56,SAS,113,55,24,77,80
2002-04-13,SEA,99,44,35,DAL,116,54,24,98,59
2002-04-13,CHI,106,20,59,DET,124,47,32,67,91
2002-04-13,DEN,98,25,54,PHX,94,35,44,60,98
2002-04-13,LAC,98,38,41,MIN,101,48,31,86,72
2002-04-13,GSW,101,20,59,UTA,109,43,36,63,95
2002-04-14,ORL,89,43,36,PHI,95,42,37,85,73
2002-04-14,WAS,80,36,44,IND,86,39,40,75,84
2002-04-14,MIA,67,35,44,NYK,94,29,50,64,94
2002-04-14,MIL,98,39,40,CHH,91,42,37,81,77
2002-04-14,TOR,101,40,39,NJN,82,51,28,91,67
2002-04-14,POR,128,47,33,LAL,120,56,23,103,56
2002-04-14,HOU,95,28,51,MEM,98,22,57,50,108
2002-04-14,SAC,100,60,19,DAL,113,55,24,115,43
2002-04-15,PHI,96,43,37,CHI,98,20,60,63,97
2002-04-15,MIN,90,49,31,BOS,93,47,33,96,64
2002-04-15,LAL,111,56,24,SEA,104,44,36,100,60
2002-04-16,WAS,116,36,45,NYK,112,30,50,66,95
2002-04-16,CLE,95,29,51,IND,99,40,40,69,91
2002-04-16,NJN,98,51,29,DET,103,48,32,99,61
2002-04-16,MIA,81,35,45,CHH,88,42,38,77,83
2002-04-16,ATL,95,33,47,ORL,102,43,37,76,84
2002-04-16,MIL,105,40,40,TOR,89,41,39,81,79
2002-04-16,DAL,96,56,24,UTA,87,44,36,100,60
2002-04-16,SAS,95,56,24,PHX,71,35,45,91,69
2002-04-16,DEN,101,26,54,HOU,70,28,52,54,106
2002-04-16,SAC,120,60,20,GSW,106,20,60,80,80
2002-04-16,LAC,92,38,42,MEM,84,23,57,61,99
2002-04-17,BOS,89,48,33,ATL,81,33,48,81,81
2002-04-17,CHH,112,43,38,CHI,106,21,60,64,98
2002-04-17,TOR,103,41,40,CLE,85,29,52,70,92
2002-04-17,NYK,94,30,51,NJN,99,51,30,81,81
2002-04-17,ORL,89,44,37,MIA,103,35,46,79,83
2002-04-17,DET,123,49,32,MIL,89,41,40,90,72
2002-04-17,IND,103,41,40,PHI,80,43,38,84,78
2002-04-17,MIN,104,49,32,DEN,90,27,54,76,86
2002-04-17,UTA,84,44,37,SAS,86,57,24,101,61
2002-04-17,PHX,89,35,46,DAL,76,57,24,92,70
2002-04-17,POR,92,48,33,HOU,79,28,53,76,86
2002-04-17,SEA,109,44,37,MEM,94,23,58,67,95
2002-04-17,LAL,109,57,24,SAC,95,61,20,118,44
2002-04-17,GSW,107,20,61,LAC,103,39,42,59,103
2002-10-29,ORL,95,0,0,PHI,88,0,0,0,0
2002-10-29,SAC,94,0,0,CLE,67,0,0,0,0
2002-10-29,LAL,82,0,0,SAS,87,0,0,0,0
2002-10-30,BOS,96,0,0,CHI,99,0,0,0,0
2002-10-30,PHI,95,0,1,MIL,93,0,0,0,1
2002-10-30,TOR,74,0,0,WAS,68,0,0,0,0
2002-10-30,IND,91,0,0,HOU,82,0,0,0,0
2002-10-30,NJN,105,0,0,ATL,94,0,0,0,0
2002-10-30,MIA,86,0,0,ORL,100,1,0,1,0
2002-10-30,DET,86,0,0,NYK,77,0,0,0,0
2002-10-30,MIN,83,0,0,DEN,77,0,0,0,0
2002-10-30,MEM,108,0,0,DAL,119,0,0,0,0
2002-10-30,NOH,100,0,0,UTA,75,0,0,0,0
2002-10-30,POR,102,0,0,LAL,90,0,1,0,1
2002-10-30,SEA,86,0,0,PHX,73,0,0,0,0
2002-10-30,LAC,96,0,0,CLE,98,0,1,0,1
2002-10-30,GSW,106,0,0,SAS,98,1,0,1,0
2002-10-31,WAS,114,0,1,BOS,69,0,1,0,2
2002-10-31,ATL,105,0,1,UTA,98,0,1,0,2
2002-10-31,SAC,100,1,0,POR,72,1,0,2,0
2002-11-01,NJN,102,1,0,IND,91,1,0,2,0
2002-11-01,PHI,98,1,1,NYK,86,0,1,1,2
2002-11-01,DET,109,1,0,MEM,86,0,1,1,1
2002-11-01,MIN,111,1,0,ORL,105,2,0,3,0
2002-11-01,CHI,84,1,0,NOH,79,1,0,2,0
2002-11-01,SAS,91,1,1,TOR,72,1,0,2,1
2002-11-01,DEN,74,0,1,HOU,83,0,1,0,2
2002-11-01,PHX,78,0,1,CLE,74,1,1,1,2
2002-11-01,LAC,93,0,1,LAL,108,0,2,0,3
2002-11-01,GSW,93,1,0,SEA,106,1,0,2,0
2002-11-02,WAS,79,1,1,NJN,87,2,0,3,1
2002-11-02,ATL,98,1,1,CHI,92,2,0,3,1
2002-11-02,IND,87,1,1,MIN,80,2,0,3,1
2002-11-02,NYK,107,0,2,BOS,117,0,2,0,4
2002-11-02,MEM,99,0,2,SAC,116,2,0,2,2
2002-11-02,NOH,100,1,1,MIA,95,0,1,1,2
2002-11-02,MIL,90,0,1,ORL,100,2,1,2,2
2002-11-02,DAL,97,1,0,PHX,83,1,1,2,1
2002-11-02,HOU,88,1,1,TOR,76,1,1,2,2
2002-11-02,UTA,101,0,2,GSW,92,1,1,1,3
2002-11-02,POR,79,1,1,DEN,96,0,2,1,3
2002-11-03,LAC,74,0,2,DET,72,2,0,2,2
2002-11-03,MIA,88,0,2,SAC,78,3,0,3,2
2002-11-03,SEA,91,2,0,UTA,77,1,2,3,2
2002-11-03,LAL,98,1,2,POR,95,1,2,2,4
2002-11-04,TOR,109,1,2,CHI,105,2,1,3,3
2002-11-04,NYK,88,0,3,MIL,97,0,2,0,5
2002-11-04,NJN,106,3,0,MIN,82,2,1,5,1
2002-11-04,MEM,101,0,3,SAS,103,2,1,2,4
2002-11-04,DAL,107,2,0,GSW,100,1,2,3,2
2002-11-04,PHX,82,1,2,DET,84,2,1,3,3
2002-11-05,ORL,125,3,1,SAC,121,3,1,6,2
2002-11-05,CLE,89,1,2,LAL,70,2,2,3,4
2002-11-05,MIA,79,1,2,IND,83,2,1,3,3
2002-11-05,MIN,90,2,2,WAS,86,1,2,3,4
2002-11-05,HOU,97,2,1,SEA,104,3,0,5,1
2002-11-05,SAS,93,3,1,GSW,73,1,3,4,4
2002-11-05,DEN,87,1,2,ATL,103,2,1,3,3
2002-11-06,NYK,95,0,4,SAC,88,3,2,3,6
2002-11-06,PHI,101,2,1,LAC,99,1,2,3,3
2002-11-06,WAS,107,1,3,CLE,100,2,2,3,5
2002-11-06,TOR,92,2,2,DAL,106,3,0,5,2
2002-11-06,NOH,86,2,1,SEA,84,4,0,6,1
2002-11-06,CHI,69,2,2,BOS,91,1,2,3,4
2002-11-06,UTA,78,1,3,DET,80,3,1,4,4
2002-11-06,PHX,93,1,3,ATL,88,3,1,4,4
2002-11-06,MIL,99,1,2,NJN,93,4,0,5,2
2002-11-06,POR,94,1,3,MEM,88,0,4,1,7
2002-11-07,BOS,98,2,2,LAL,95,2,3,4,5
2002-11-07,MIN,114,3,2,MIL,110,2,2,5,4
2002-11-07,DEN,63,1,3,DET,89,4,1,5,4
2002-11-08,PHI,108,3,1,CLE,84,2,3,5,4
2002-11-08,ORL,105,4,1,SEA,98,4,1,8,2
2002-11-08,IND,107,3,1,NYK,94,1,4,4,5
2002-11-08,NJN,106,4,1,LAC,92,1,3,5,4
2002-11-08,WAS,100,2,3,LAL,99,2,4,4,7
2002-11-08,NOH,110,3,1,GSW,104,1,4,4,5
2002-11-08,CHI,87,2,3,DAL,114,4,0,6,3
2002-11-08,UTA,110,1,4,ATL,97,3,2,4,6
2002-11-08,PHX,86,2,3,POR,75,2,3,4,6
2002-11-08,SAC,99,3,3,MEM,91,0,5,3,8
2002-11-09,IND,108,4,1,TOR,84,2,3,6,4
2002-11-09,CLE,79,2,4,WAS,93,3,3,5,7
2002-11-09,MIA,82,1,3,SEA,84,4,2,5,5
2002-11-09,MIN,99,4,2,BOS,105,3,2,7,4
2002-11-09,CHI,100,2,4,NJN,93,5,1,7,5
2002-11-09,MIL,110,2,3,PHI,105,4,1,6,4
2002-11-09,DAL,114,5,0,DET,75,5,1,10,1
2002-11-09,HOU,111,2,2,GSW,104,1,5,3,7
2002-11-09,SAS,76,4,1,POR,95,2,4,6,5
2002-11-09,DEN,84,1,4,MEM,73,0,6,1,10
2002-11-10,NYK,91,1,5,NOH,97,4,1,5,6
2002-11-10,ORL,117,5,1,LAC,120,1,4,6,5
2002-11-10,SAC,105,4,3,ATL,97,3,3,7,6
2002-11-11,BOS,112,4,2,UTA,95,2,4,6,6
2002-11-11,MEM,101,0,7,GSW,108,1,6,1,13
2002-11-11,DAL,82,6,0,POR,73,3,4,9,4
2002-11-11,SAS,91,4,2,MIN,75,4,3,8,5
2002-11-12,WAS,95,4,3,SEA,101,5,2,9,5
2002-11-12,ORL,109,5,2,TOR,115,2,4,7,6
2002-11-12,IND,95,5,1,CLE,75,2,5,7,6
2002-11-12,NYK,87,1,6,UTA,108,2,5,3,11
2002-11-12,MIA,82,1,4,LAC,101,2,4,3,8
2002-11-12,DET,93,5,2,NOH,87,5,1,10,3
2002-11-12,HOU,86,3,2,POR,83,3,5,6,7
2002-11-12,LAL,83,2,5,ATL,95,3,4,5,9
2002-11-13,BOS,91,5,2,PHI,81,4,2,9,4
2002-11-13,NJN,91,5,2,SAS,82,5,2,10,4
2002-11-13,CLE,99,2,6,DAL,103,7,0,9,6
2002-11-13,MIL,108,3,3,CHI,101,3,4,6,7
2002-11-13,NOH,102,5,2,MIN,98,4,4,9,6
2002-11-13,DEN,72,2,4,PHX,75,3,3,5,7
2002-11-13,GSW,93,2,6,SAC,104,5,3,7,9
2002-11-14,WAS,105,4,4,UTA,102,3,5,7,9
2002-11-14,PHI,99,4,3,SAS,94,5,3,9,6
2002-11-14,LAC,80,3,4,ORL,101,5,3,8,7
2002-11-15,TOR,84,3,4,DEN,79,2,5,5,9
2002-11-15,IND,103,6,1,MIL,100,4,3,10,4
2002-11-15,BOS,86,6,2,DAL,97,8,0,14,2
2002-11-15,MIA,84,1,5,NJN,93,6,2,7,7
2002-11-15,DET,86,6,2,UTA,75,3,6,9,8
2002-11-15,MEM,95,0,8,MIN,99,4,5,4,13
2002-11-15,NOH,105,6,2,CHI,87,3,5,9,7
2002-11-15,POR,112,3,6,LAC,88,3,5,6,11
2002-11-15,SEA,111,6,2,SAC,97,6,3,12,5
2002-11-15,PHX,88,4,3,HOU,87,4,2,8,5
2002-11-15,LAL,96,2,6,GSW,89,2,7,4,13
2002-11-16,NYK,92,1,7,PHI,93,5,3,6,10
2002-11-16,WAS,95,5,4,MIA,65,1,6,6,10
2002-11-16,ATL,89,4,4,NOH,82,7,2,11,6
2002-11-16,NJN,88,7,2,DAL,96,9,0,16,2
2002-11-16,CLE,77,2,7,SAS,90,5,4,7,11
2002-11-16,DET,74,7,2,DEN,53,2,6,9,8
2002-11-16,MIN,101,5,5,IND,107,7,1,12,6
2002-11-16,CHI,111,3,6,MEM,93,0,9,3,15
2002-11-16,MIL,104,4,4,BOS,85,6,3,10,7
2002-11-16,GSW,135,2,8,ORL,92,6,3,8,11
2002-11-17,TOR,78,4,4,UTA,82,3,7,7,11
2002-11-17,LAC,78,3,6,SEA,84,7,2,10,8
2002-11-17,PHI,100,6,3,WAS,84,6,4,12,7
2002-11-17,SAC,101,6,4,ORL,99,6,4,12,8
2002-11-17,LAL,89,3,6,HOU,93,4,3,7,9
2002-11-18,NYK,94,1,8,DET,91,8,2,9,10
2002-11-18,NJN,99,7,3,DEN,79,2,7,9,10
2002-11-18,ATL,117,5,4,TOR,92,4,5,9,9
2002-11-18,SAS,104,6,4,CLE,78,2,8,8,12
2002-11-18,GSW,89,3,8,LAC,99,3,7,6,15
2002-11-19,MIL,93,5,4,MIA,97,1,7,6,11
2002-11-19,MIN,110,5,6,MEM,106,0,10,5,16
2002-11-19,NOH,99,7,3,PHI,98,7,3,14,6
2002-11-19,DAL,98,10,0,LAL,72,3,7,13,7
2002-11-19,HOU,97,5,3,CLE,80,2,9,7,12
2002-11-19,UTA,99,4,7,PHX,76,5,3,9,10
2002-11-19,SAC,111,7,4,CHI,98,4,6,11,10
2002-11-19,SEA,84,8,2,ORL,101,6,5,14,7
2002-11-20,BOS,96,6,4,NJN,79,8,3,14,7
2002-11-20,TOR,95,4,6,IND,97,8,1,12,7
2002-11-20,ATL,93,6,4,MIN,103,6,6,12,10
2002-11-20,DET,79,8,3,MIA,68,2,7,10,10
2002-11-20,SAS,95,7,4,LAL,88,3,8,10,12
2002-11-20,MEM,88,0,11,PHI,95,7,4,7,15
2002-11-20,DEN,79,2,8,UTA,96,5,7,7,15
2002-11-20,POR,98,4,6,ORL,84,7,5,11,11
2002-11-20,LAC,89,4,7,SAC,93,8,4,12,11
2002-11-20,GSW,100,3,9,CHI,94,4,7,7,16
2002-11-21,DAL,103,11,0,HOU,90,6,3,17,3
2002-11-21,SEA,85,8,3,POR,89,5,6,13,9
2002-11-22,IND,106,9,1,ORL,70,7,6,16,7
2002-11-22,BOS,105,7,4,ATL,98,6,5,13,9
2002-11-22,NJN,120,8,4,CLE,79,2,10,10,14
2002-11-22,PHI,90,8,4,TOR,80,4,7,12,11
2002-11-22,MIA,72,2,8,DET,75,9,3,11,11
2002-11-22,NOH,105,8,3,NYK,97,2,8,10,11
2002-11-22,HOU,93,6,4,WAS,86,6,5,12,9
2002-11-22,SAS,95,8,4,MEM,86,0,12,8,16
2002-11-22,SAC,118,9,4,PHX,101,5,4,14,8
2002-11-22,DEN,72,2,9,LAC,70,4,8,6,17
2002-11-22,LAL,86,3,9,CHI,73,4,8,7,17
2002-11-22,GSW,91,4,9,MIL,95,5,5,9,14
2002-11-23,ATL,99,6,6,BOS,109,8,4,14,10
2002-11-23,IND,91,10,1,DET,106,10,3,20,4
2002-11-23,CLE,84,2,11,NOH,97,9,3,11,14
2002-11-23,MIN,82,7,6,NJN,96,9,4,16,10
2002-11-23,MEM,85,0,13,WAS,74,6,6,6,19
2002-11-23,DAL,115,12,0,SEA,105,8,4,20,4
2002-11-23,UTA,110,6,7,CHI,90,4,9,10,16
2002-11-23,PHX,79,5,5,DEN,80,3,9,8,14
2002-11-23,POR,94,6,6,SAC,95,10,4,16,10
2002-11-24,TOR,84,4,8,PHI,94,9,4,13,12
2002-11-24,LAC,90,4,9,HOU,89,7,4,11,13
2002-11-24,ORL,77,7,7,MIA,75,2,9,9,16
2002-11-24,NYK,88,2,9,MIN,106,7,7,9,16
2002-11-24,SAS,90,9,4,SEA,91,8,5,17,9
2002-11-24,LAL,111,4,9,MIL,99,6,5,10,14
2002-11-25,PHI,108,10,4,NOH,87,10,3,20,7
2002-11-25,PHX,86,5,6,MIL,81,6,6,11,12
2002-11-26,WAS,84,6,7,IND,88,10,2,16,9
2002-11-26,CLE,85,2,12,SAC,91,11,4,13,16
2002-11-26,MIA,97,2,10,LAL,85,5,9,7,19
2002-11-26,ATL,119,6,7,SEA,116,9,5,15,12
2002-11-26,DEN,85,4,9,SAS,81,9,5,13,14
2002-11-26,POR,77,6,7,HOU,71,7,5,13,12
2002-11-26,LAC,94,5,9,UTA,99,7,7,12,16
2002-11-27,BOS,92,9,4,CHI,82,4,10,13,14
2002-11-27,PHI,83,11,4,MIA,74,3,10,14,14
2002-11-27,ORL,112,8,7,LAL,102,5,10,13,17
2002-11-27,TOR,81,4,9,NYK,87,2,10,6,19
2002-11-27,DET,82,11,3,DAL,102,13,0,24,3
2002-11-27,MIL,112,6,7,CLE,80,2,13,8,20
2002-11-27,MIN,90,8,7,SAC,74,12,4,20,11
2002-11-27,MEM,117,1,13,SEA,99,9,6,10,19
2002-11-27,NOH,106,10,4,ATL,94,7,7,17,11
2002-11-27,SAS,99,9,6,DEN,68,5,9,14,15
2002-11-27,PHX,82,6,6,NJN,75,10,4,16,10
2002-11-27,GSW,84,4,10,HOU,91,7,6,11,16
2002-11-28,IND,110,11,2,DAL,98,14,0,25,2
2002-11-28,LAC,126,5,10,NJN,118,10,5,15,15
2002-11-29,ATL,100,7,8,MIA,94,3,11,10,19
2002-11-29,CLE,99,2,14,PHI,106,12,4,14,18
2002-11-29,BOS,95,10,4,TOR,98,4,10,14,14
2002-11-29,DET,96,11,4,MIL,91,7,7,18,11
2002-11-29,IND,100,12,2,WAS,84,6,8,18,10
2002-11-29,MEM,106,2,13,LAL,112,5,11,7,24
2002-11-29,DEN,82,5,10,GSW,92,4,11,9,21
2002-11-29,UTA,95,8,7,MIN,77,9,7,17,14
2002-11-29,PHX,94,7,6,SAS,87,10,6,17,12
2002-11-29,SAC,107,12,5,LAC,94,6,10,18,15
2002-11-29,SEA,72,9,7,HOU,83,8,6,17,13
2002-11-30,NYK,92,3,10,NOH,86,11,4,14,14
2002-11-30,WAS,94,6,9,PHI,95,13,4,19,13
2002-11-30,ORL,117,9,7,ATL,92,8,8,17,15
2002-11-30,MIA,85,3,12,CLE,79,2,15,5,27
2002-11-30,DAL,103,14,1,CHI,90,4,11,18,12
2002-11-30,SAS,107,10,7,UTA,85,9,7,19,14
2002-11-30,MIL,109,7,8,DET,86,12,4,19,12
2002-11-30,POR,86,7,7,NJN,93,10,6,17,13
2002-11-30,GSW,100,5,11,PHX,90,8,6,13,17
2002-12-01,LAC,87,6,11,IND,92,13,2,19,13
2002-12-01,MEM,87,2,14,TOR,92,5,10,7,24
2002-12-01,BOS,95,10,5,NOH,86,11,5,21,10
2002-12-01,SAC,103,13,5,HOU,84,9,6,22,11
2002-12-01,SEA,96,9,8,NJN,95,11,6,20,14
2002-12-01,LAL,107,6,11,MIN,110,9,8,15,19
2002-12-02,ORL,97,10,7,BOS,102,11,5,21,12
2002-12-02,NYK,125,4,10,CLE,93,2,16,6,26
2002-12-02,DAL,113,15,1,TOR,102,6,10,21,11
2002-12-02,UTA,102,9,8,IND,91,14,2,23,10
2002-12-02,PHX,90,8,7,MIA,100,4,12,12,19
2002-12-03,WAS,103,6,10,MIL,78,8,8,14,18
2002-12-03,NJN,87,11,7,ATL,72,8,9,19,16
2002-12-03,CHI,90,4,12,NOH,115,11,6,15,18
2002-12-03,HOU,89,9,7,SAS,75,11,7,20,14
2002-12-03,SAC,98,14,5,MIN,86,10,8,24,13
2002-12-03,LAL,101,6,12,MEM,91,2,15,8,27
2002-12-03,GSW,110,6,11,DEN,89,5,11,11,22
2002-12-04,PHI,99,14,4,BOS,93,12,5,26,9
2002-12-04,CLE,111,2,17,CHI,101,4,13,6,30
2002-12-04,NYK,85,5,10,ORL,87,10,8,15,18
2002-12-04,DET,83,12,5,WAS,88,7,10,19,15
2002-12-04,NOH,89,12,6,TOR,74,6,11,18,17
2002-12-04,DEN,90,5,12,SAC,92,15,5,20,17
2002-12-04,UTA,93,10,8,LAL,85,7,12,17,20
2002-12-04,PHX,98,8,8,MEM,85,2,16,10,24
2002-12-04,POR,88,7,8,DAL,103,16,1,23,9
2002-12-04,SEA,111,10,8,IND,114,14,3,24,11
2002-12-04,LAC,89,6,12,MIA,80,5,12,11,24
2002-12-05,ATL,98,8,10,MIL,80,8,9,16,19
2002-12-05,GSW,98,7,11,MIN,114,10,9,17,20
2002-12-06,ORL,88,11,8,WAS,78,8,10,19,18
2002-12-06,BOS,91,12,6,NYK,80,5,11,17,17
2002-12-06,TOR,103,6,12,CHI,89,4,14,10,26
2002-12-06,NOH,98,13,6,HOU,96,10,7,23,13
2002-12-06,SAS,98,11,8,PHI,93,15,4,26,12
2002-12-06,UTA,104,11,8,MEM,71,2,17,13,25
2002-12-06,PHX,102,9,8,IND,96,15,3,24,11
2002-12-06,SAC,98,16,5,DEN,77,5,13,21,18
2002-12-06,POR,88,7,9,MIA,69,5,13,12,22
2002-12-06,LAL,105,7,13,DAL,103,17,1,24,14
2002-12-07,ATL,94,9,10,DET,92,12,6,21,16
2002-12-07,LAC,104,7,12,MIN,88,11,9,18,21
2002-12-07,WAS,100,8,11,NYK,97,5,12,13,23
2002-12-07,NJN,121,12,7,ORL,88,12,8,24,15
2002-12-07,CHI,112,4,15,CLE,104,3,17,7,32
2002-12-07,MIL,88,8,10,NOH,94,14,6,22,16
2002-12-07,HOU,97,10,8,PHI,72,15,5,25,13
2002-12-07,DEN,92,5,14,IND,81,15,4,20,18
2002-12-07,SEA,100,10,9,MIA,71,5,14,15,23
2002-12-07,GSW,116,7,12,DAL,121,17,2,24,14
2002-12-08,TOR,91,7,12,POR,104,8,9,15,21
2002-12-08,MEM,102,2,18,PHX,94,10,8,12,26
2002-12-08,SAS,80,12,8,SAC,104,17,5,29,13
2002-12-08,LAL,110,8,13,UTA,101,12,8,20,21
2002-12-09,BOS,114,13,6,ORL,109,12,9,25,15
2002-12-09,CLE,133,3,18,MIL,140,8,11,11,29
2002-12-09,NJN,106,13,7,PHX,93,10,9,23,16
2002-12-09,NOH,90,15,6,LAC,94,8,12,23,18
2002-12-09,DEN,84,6,14,MIN,92,11,10,17,24
2002-12-10,WAS,79,9,11,POR,98,9,9,18,20
2002-12-10,NYK,97,5,13,SEA,80,11,9,16,22
2002-12-10,MIA,96,5,15,MEM,107,3,18,8,33
2002-12-10,CHI,107,5,15,ORL,87,12,10,17,25
2002-12-10,DAL,122,18,2,LAC,95,9,12,27,14
2002-12-10,HOU,103,11,8,SAC,96,18,5,29,13
2002-12-10,GSW,106,7,13,LAL,102,9,13,16,26
2002-12-11,BOS,94,14,6,PHX,103,10,10,24,16
2002-12-11,NJN,105,14,7,POR,104,10,9,24,16
2002-12-11,PHI,88,15,6,SEA,92,11,10,26,16
2002-12-11,CLE,96,3,19,TOR,83,7,13,10,32
2002-12-11,DET,91,12,7,ATL,80,10,11,22,18
2002-12-11,MIL,119,9,11,IND,126,16,5,25,16
2002-12-11,MEM,96,4,18,DEN,93,6,15,10,33
2002-12-11,SAS,111,12,9,DAL,104,19,2,31,11
2002-12-12,CHI,76,6,15,DET,86,13,7,19,22
2002-12-12,UTA,88,12,9,NOH,93,15,7,27,16
2002-12-12,MIN,113,16,14,ATL,95,12,18,28,32
2002-12-13,PHI,91,15,7,PHX,99,11,10,26,17
2002-12-13,ORL,111,12,11,GSW,85,8,13,20,24
2002-12-13,TOR,79,7,14,SEA,91,12,10,19,24
2002-12-13,IND,94,17,5,DEN,72,6,16,23,21
2002-12-13,BOS,115,14,7,CLE,100,4,19,18,26
2002-12-13,NJN,79,15,7,WAS,65,9,12,24,19
2002-12-13,MIA,92,5,16,NYK,97,6,13,11,29
2002-12-13,MEM,114,5,18,HOU,109,12,8,17,26
2002-12-13,MIL,101,9,12,POR,79,10,10,19,22
2002-12-13,SAS,97,13,9,LAC,84,9,13,22,22
2002-12-13,LAL,82,9,14,NOH,98,16,7,25,21
2002-12-14,ATL,88,10,12,PHX,102,12,10,22,22
2002-12-14,NYK,90,7,13,BOS,113,15,7,22,20
2002-12-14,CLE,111,4,20,DEN,104,6,17,10,37
2002-12-14,DET,91,14,7,SEA,78,13,10,27,17
2002-12-14,MIA,101,5,17,GSW,92,8,14,13,31
2002-12-14,MIN,92,12,10,POR,98,10,11,22,21
2002-12-14,CHI,97,6,16,MIL,95,10,12,16,28
2002-12-14,DAL,104,19,3,MEM,87,6,18,25,21
2002-12-14,HOU,83,12,9,LAC,94,9,14,21,23
2002-12-14,UTA,96,12,10,SAC,98,18,6,30,16
2002-12-15,TOR,82,7,15,WAS,95,9,13,16,28
2002-12-15,IND,107,18,5,PHI,97,15,8,33,13
2002-12-15,DET,101,15,7,NJN,91,16,7,31,14
2002-12-15,SAC,107,19,6,NOH,92,17,7,36,13
2002-12-15,LAL,107,9,15,ORL,84,13,11,22,26
2002-12-16,PHI,93,15,9,DEN,71,6,18,21,27
2002-12-16,CLE,98,5,20,SEA,111,13,11,18,31
2002-12-16,MIA,100,6,17,HOU,105,12,10,18,27
2002-12-16,MEM,104,6,19,GSW,91,8,15,14,34
2002-12-16,CHI,94,7,16,BOS,83,16,7,23,23
2002-12-16,PHX,87,13,10,ORL,84,13,12,26,22
2002-12-16,LAC,91,10,14,SAS,79,14,9,24,23
2002-12-17,NYK,101,7,14,NJN,99,16,8,23,22
2002-12-17,ATL,99,10,13,WAS,109,10,13,20,26
2002-12-17,MIL,117,10,13,TOR,122,7,16,17,29
2002-12-17,MIN,96,12,11,LAL,80,10,15,22,26
2002-12-17,DAL,118,20,3,IND,97,19,5,39,8
2002-12-17,SAC,95,20,6,PHX,86,14,10,34,16
2002-12-17,POR,102,11,11,NOH,93,17,8,28,19
2002-12-18,BOS,81,16,8,MIA,91,6,18,22,26
2002-12-18,PHI,99,16,9,MIN,94,13,11,29,20
2002-12-18,WAS,118,11,13,MEM,100,7,19,18,32
2002-12-18,CLE,106,5,21,DET,111,16,7,21,28
2002-12-18,CHI,96,8,16,TOR,83,8,16,16,32
2002-12-18,HOU,95,13,10,IND,83,19,6,32,16
2002-12-18,DEN,75,6,19,DAL,80,21,3,27,22
2002-12-18,UTA,90,12,11,ORL,97,13,13,25,24
2002-12-18,SEA,88,14,11,SAS,91,14,10,28,21
2002-12-18,LAC,93,11,14,POR,97,12,11,23,25
2002-12-18,GSW,111,8,16,NOH,106,17,9,25,25
2002-12-19,NJN,98,16,9,LAL,71,10,16,26,25
2002-12-19,SAC,81,21,6,SAS,83,15,10,36,16
2002-12-20,TOR,77,8,17,MIA,97,7,18,15,35
2002-12-20,IND,101,19,7,CHI,86,9,16,28,23
2002-12-20,BOS,108,16,9,MIN,99,13,12,29,21
2002-12-20,PHI,107,17,9,LAL,104,10,17,27,26
2002-12-20,DET,109,17,7,CLE,107,5,22,22,29
2002-12-20,MEM,95,7,20,MIL,84,10,14,17,34
2002-12-20,DAL,81,22,3,UTA,93,12,12,34,15
2002-12-20,HOU,101,14,10,ATL,82,10,14,24,24
2002-12-20,DEN,80,6,20,ORL,89,14,13,20,33
2002-12-20,SEA,86,14,12,NOH,88,17,10,31,22
2002-12-20,LAC,76,11,15,PHX,87,14,11,25,26
2002-12-20,GSW,111,9,16,POR,113,13,11,22,27
2002-12-21,ATL,79,10,15,PHI,77,18,9,28,24
2002-12-21,CLE,82,5,23,BOS,89,17,9,22,32
2002-12-21,NJN,100,17,9,DET,92,18,7,35,16
2002-12-21,MIN,98,13,13,HOU,86,15,10,28,23
2002-12-21,CHI,110,9,17,IND,103,20,7,29,24
2002-12-21,MIL,94,10,15,NYK,90,8,14,18,29
2002-12-21,SAS,92,16,10,WAS,81,12,13,28,23
2002-12-21,PHX,110,15,11,SAC,101,21,7,36,18
2002-12-21,POR,81,14,11,SEA,80,14,13,28,24
2002-12-21,LAC,92,11,16,DEN,89,6,21,17,37
2002-12-22,MEM,74,8,20,UTA,103,13,12,21,32
2002-12-22,TOR,107,8,18,LAL,109,10,18,18,36
2002-12-22,NYK,84,8,15,MIA,92,8,18,16,33
2002-12-22,SAC,103,21,8,GSW,88,9,17,30,25
2002-12-23,IND,112,15,5,ATL,97,10,10,25,15
2002-12-23,ORL,103,15,13,MIL,108,11,15,26,28
2002-12-23,CLE,74,5,24,MIA,72,9,18,14,42
2002-12-23,NJN,99,18,9,CHI,83,10,17,28,26
2002-12-23,DAL,92,22,4,WAS,86,12,14,34,18
2002-12-23,HOU,91,15,11,UTA,96,14,12,29,23
2002-12-23,SAS,99,17,10,NOH,94,18,10,35,20
2002-12-23,PHX,89,16,11,SEA,88,14,14,30,25
2002-12-25,ORL,104,15,14,DET,99,18,8,33,22
2002-12-25,NJN,117,19,9,BOS,81,18,9,37,18
2002-12-25,LAL,99,11,18,SAC,105,22,8,33,26
2002-12-26,WAS,82,12,15,DET,87,18,9,30,24
2002-12-26,NOH,81,18,11,DAL,83,23,4,41,15
2002-12-26,SEA,97,14,15,TOR,88,8,19,22,34
2002-12-27,NJN,110,20,9,MIL,90,12,15,32,24
2002-12-27,ATL,81,11,15,SAS,79,18,10,29,25
2002-12-27,CLE,89,6,24,IND,113,20,8,26,32
2002-12-27,MIA,90,9,19,BOS,70,18,10,27,29
2002-12-27,MEM,99,8,21,ORL,86,16,14,24,35
2002-12-27,CHI,100,10,18,MIN,113,14,13,24,31
2002-12-27,HOU,83,15,12,NYK,99,8,16,23,28
2002-12-27,PHX,108,17,11,LAC,95,12,16,29,27
2002-12-27,GSW,101,9,18,TOR,96,8,20,17,38
2002-12-27,POR,103,15,11,UTA,98,15,12,30,23
2002-12-28,WAS,84,12,16,ATL,76,12,15,24,31
2002-12-28,ORL,101,16,15,BOS,95,18,11,34,26
2002-12-28,IND,91,21,8,NOH,84,18,12,39,20
2002-12-28,DET,106,19,9,MIN,82,15,13,34,22
2002-12-28,CHI,95,10,19,SAS,109,18,11,28,30
2002-12-28,MIL,96,12,16,NJN,104,21,9,33,25
2002-12-28,DAL,107,24,4,NYK,82,9,16,33,20
2002-12-28,DEN,93,6,22,LAL,112,11,19,17,41
2002-12-28,UTA,98,15,13,PHI,69,18,10,33,23
2002-12-28,SAC,113,23,8,POR,119,16,11,39,19
2002-12-28,LAC,92,12,17,GSW,99,10,18,22,35
2002-12-29,CLE,84,6,25,PHX,103,18,11,24,36
2002-12-29,HOU,97,15,13,NOH,85,18,13,33,26
2002-12-29,LAL,104,12,19,TOR,88,8,21,20,40
2002-12-30,ORL,112,17,15,WAS,95,13,16,30,31
2002-12-30,NYK,96,9,17,SAS,95,19,11,28,28
2002-12-30,NJN,102,22,9,CLE,88,6,26,28,35
2002-12-30,MIA,93,10,19,ATL,84,12,16,22,35
2002-12-30,DET,74,20,9,POR,85,17,11,37,20
2002-12-30,MIN,104,15,14,PHX,98,19,11,34,25
2002-12-30,DAL,107,25,4,MIL,110,12,17,37,21
2002-12-30,DEN,77,6,23,SEA,79,15,15,21,38
2002-12-30,UTA,107,16,13,TOR,85,8,22,24,35
2002-12-30,GSW,104,11,18,PHI,98,18,11,29,29
2002-12-31,BOS,96,18,12,MEM,89,9,21,27,33
2002-12-31,CHI,102,10,20,POR,87,18,11,28,31
2002-12-31,WAS,105,13,17,SAS,103,19,12,32,29
2002-12-31,NOH,86,18,14,IND,89,22,8,40,22
2002-12-31,LAC,75,12,18,PHI,83,18,12,30,30
2002-12-31,HOU,103,16,13,MIL,80,13,17,29,30
2003-01-01,ATL,73,12,17,MIA,107,11,19,23,36
2003-01-01,NYK,95,10,17,TOR,75,8,23,18,40
2003-01-02,CHI,82,11,20,WAS,107,14,17,25,37
2003-01-02,DAL,102,25,5,LAC,92,12,19,37,24
2003-01-02,PHX,96,19,12,PHI,78,19,12,38,24
2003-01-03,TOR,80,8,24,CLE,81,6,27,14,51
2003-01-03,BOS,103,19,12,POR,108,18,12,37,24
2003-01-03,NYK,98,11,17,IND,96,23,8,34,25
2003-01-03,MIA,80,12,19,NJN,100,23,9,35,28
2003-01-03,MEM,116,9,22,LAC,111,12,20,21,42
2003-01-03,NOH,100,18,15,ORL,89,18,15,36,30
2003-01-03,MIL,115,13,18,UTA,118,17,13,30,31
2003-01-03,SAS,98,19,13,GSW,95,12,18,31,31
2003-01-03,SEA,82,16,15,DEN,94,6,24,22,39
2003-01-04,DAL,102,26,5,PHI,83,19,13,45,18
2003-01-04,WAS,107,15,17,IND,104,23,9,38,26
2003-01-04,ORL,83,18,16,NJN,88,24,9,42,25
2003-01-04,ATL,86,12,19,DET,90,20,10,32,29
2003-01-04,MIN,97,17,14,UTA,105,18,13,35,27
2003-01-04,CHI,85,11,21,CLE,79,7,27,18,48
2003-01-04,HOU,84,17,13,GSW,86,12,19,29,32
2003-01-04,DEN,76,7,24,SAC,87,23,9,30,33
2003-01-04,PHX,107,20,12,LAL,93,13,19,33,31
2003-01-05,TOR,84,8,25,NOH,99,19,15,27,40
2003-01-05,LAC,86,12,21,SAS,94,20,13,32,34
2003-01-05,NYK,89,12,17,POR,92,19,12,31,29
2003-01-05,SAC,96,24,9,MIA,70,12,20,36,29
2003-01-05,LAL,109,13,20,PHX,97,21,12,34,32
2003-01-06,BOS,95,19,13,WAS,100,16,17,35,30
2003-01-06,PHI,104,19,14,IND,105,23,10,42,24
2003-01-06,ORL,103,18,17,NYK,100,12,18,30,35
2003-01-06,CLE,94,7,28,MIL,106,13,19,20,47
2003-01-06,ATL,94,12,20,NJN,101,25,9,37,29
2003-01-06,DET,82,21,10,TOR,74,8,26,29,36
2003-01-06,MEM,106,10,22,NOH,102,20,15,30,37
2003-01-06,CHI,113,12,21,UTA,98,19,13,31,34
2003-01-06,DAL,86,27,5,DEN,71,7,25,34,30
2003-01-06,GSW,99,13,19,MIA,85,12,21,25,40
2003-01-07,MIL,76,14,19,SAC,101,25,9,39,28
2003-01-07,HOU,94,17,14,MIN,86,17,15,34,29
2003-01-07,POR,81,20,12,PHX,88,21,13,41,25
2003-01-07,LAL,119,14,20,SEA,98,16,16,30,36
2003-01-08,PHI,94,19,15,DET,103,22,10,41,25
2003-01-08,WAS,101,17,17,CHI,98,13,21,30,38
2003-01-08,ORL,81,19,17,HOU,91,18,14,37,31
2003-01-08,IND,89,24,10,NYK,87,12,19,36,29
2003-01-08,ATL,99,12,21,DAL,117,28,5,40,26
2003-01-08,MIN,102,17,16,GSW,95,14,19,31,35
2003-01-08,NOH,83,20,16,BOS,93,19,14,39,30
2003-01-08,DEN,86,7,26,MIA,76,12,22,19,48
2003-01-08,UTA,99,19,14,PHX,93,22,13,41,27
2003-01-08,SEA,95,16,17,SAS,106,21,13,37,30
2003-01-08,LAC,103,12,22,MEM,95,11,22,23,44
2003-01-09,NJN,82,26,9,SAC,118,26,9,52,18
2003-01-09,POR,90,20,13,SAS,87,22,13,42,26
2003-01-10,PHI,112,19,16,NYK,114,12,20,31,36
2003-01-10,WAS,99,18,17,GSW,104,14,20,32,37
2003-01-10,ORL,97,19,18,IND,101,25,10,44,28
2003-01-10,TOR,79,8,27,NJN,94,26,10,34,37
2003-01-10,ATL,84,12,22,HOU,75,19,14,31,36
2003-01-10,MIN,115,18,16,SAC,109,27,9,45,25
2003-01-10,DAL,103,29,5,BOS,78,20,14,49,19
2003-01-10,NOH,99,20,17,DET,101,23,10,43,27
2003-01-10,MIL,93,14,20,CHI,85,13,22,27,42
2003-01-10,DEN,82,8,26,POR,81,21,13,29,39
2003-01-10,UTA,92,20,14,MIA,76,12,23,32,37
2003-01-10,PHX,96,22,14,MEM,90,11,23,33,37
2003-01-10,LAL,115,15,20,CLE,99,7,29,22,49
2003-01-10,SEA,88,16,18,LAC,90,13,22,29,40
2003-01-11,ATL,87,13,22,NOH,80,20,18,33,40
2003-01-11,IND,116,26,10,GSW,104,15,20,41,30
2003-01-11,NYK,84,13,20,WAS,89,18,18,31,38
2003-01-11,DET,87,24,10,MIL,89,15,20,39,30
2003-01-11,HOU,87,19,15,DEN,85,9,26,28,41
2003-01-12,TOR,105,8,28,MIN,91,19,16,27,44
2003-01-12,LAC,90,14,22,DAL,96,30,5,44,27
2003-01-12,PHI,105,19,17,ORL,107,19,19,38,36
2003-01-12,SAS,81,22,14,BOS,80,20,15,42,29
2003-01-12,PHX,107,23,14,UTA,99,21,14,44,28
2003-01-12,SAC,106,27,10,MEM,98,11,24,38,34
2003-01-12,SEA,79,16,19,CLE,87,7,30,23,49
2003-01-12,LAL,106,16,20,MIA,81,12,24,28,44
2003-01-13,ORL,86,20,19,DET,101,24,11,44,30
2003-01-13,MIN,89,19,17,DEN,75,9,27,28,44
2003-01-13,CHI,101,13,23,NYK,94,13,21,26,44
2003-01-13,HOU,101,20,15,BOS,92,20,16,40,31
2003-01-13,POR,118,21,14,CLE,94,8,30,29,44
2003-01-13,GSW,108,15,21,MEM,110,11,25,26,46
2003-01-14,WAS,75,19,18,TOR,84,9,28,28,46
2003-01-14,NYK,98,13,22,CHI,86,14,23,27,45
2003-01-14,MIA,88,12,25,DET,85,25,11,37,36
2003-01-14,MIL,97,16,20,ATL,88,14,22,30,42
2003-01-14,SAS,108,23,14,PHX,100,24,14,47,28
2003-01-15,BOS,86,20,17,ATL,66,14,23,34,40
2003-01-15,PHI,108,19,18,NJN,107,27,10,46,28
2003-01-15,TOR,87,10,28,MIL,99,17,20,27,48
2003-01-15,IND,104,27,10,MIA,81,13,25,40,35
2003-01-15,NOH,82,20,19,LAL,90,17,20,37,39
2003-01-15,HOU,102,21,15,PHX,96,24,15,45,30
2003-01-15,DEN,81,9,28,UTA,92,21,15,30,43
2003-01-15,SAC,123,28,10,DAL,94,31,5,59,15
2003-01-15,POR,100,22,14,MEM,92,12,25,34,39
2003-01-15,LAC,64,14,23,MIN,95,20,17,34,40
2003-01-15,GSW,108,15,22,CLE,80,8,31,23,53
2003-01-16,WAS,108,19,19,ORL,93,20,20,39,39
2003-01-16,UTA,92,22,15,SEA,85,16,20,38,35
2003-01-17,PHI,95,20,18,MIL,99,18,20,38,38
2003-01-17,BOS,98,21,17,IND,93,28,10,49,27
2003-01-17,NJN,88,27,11,TOR,77,10,29,37,40
2003-01-17,DET,99,25,12,NYK,82,14,22,39,34
2003-01-17,NOH,90,20,20,CHI,83,14,24,34,44
2003-01-17,SAS,106,24,14,ATL,93,14,24,38,38
2003-01-17,DEN,97,9,29,CLE,80,8,32,17,61
2003-01-17,PHX,111,24,16,DAL,106,31,6,55,22
2003-01-17,HOU,108,22,15,LAL,104,18,20,40,35
2003-01-17,SEA,103,16,21,MEM,97,12,26,28,47
2003-01-17,GSW,107,16,22,MIN,98,21,17,37,39
2003-01-18,WAS,80,20,19,PHI,88,20,19,40,38
2003-01-18,ATL,92,14,25,NYK,95,14,23,28,48
2003-01-18,IND,88,28,11,DET,86,26,12,54,23
2003-01-18,MIA,102,13,26,CHI,101,14,25,27,51
2003-01-18,MIL,95,19,20,BOS,97,22,17,41,37
2003-01-18,UTA,95,23,15,CLE,78,8,33,31,48
2003-01-18,POR,98,23,14,MIN,104,21,18,44,32
2003-01-18,LAC,112,14,24,SAC,107,29,10,43,34
2003-01-19,TOR,93,10,30,ORL,101,20,21,30,51
2003-01-19,SEA,85,17,21,DAL,81,31,7,48,28
2003-01-20,NYK,72,15,23,MIA,65,14,26,29,49
2003-01-20,WAS,89,20,20,DEN,74,10,29,30,49
2003-01-20,ATL,102,14,26,CHI,115,14,26,28,52
2003-01-20,DET,88,26,13,IND,78,29,11,55,24
2003-01-20,NOH,114,21,20,PHX,102,25,16,46,36
2003-01-20,SAS,87,25,14,HOU,82,23,15,48,29
2003-01-20,GSW,80,17,22,SAC,102,29,11,46,33
2003-01-20,MIN,89,22,18,TOR,81,10,31,32,49
2003-01-20,MEM,87,12,27,POR,99,23,15,35,42
2003-01-20,PHI,99,21,19,BOS,100,23,17,44,36
2003-01-20,UTA,106,24,15,NJN,103,28,11,52,26
2003-01-20,LAL,96,18,21,LAC,92,15,24,33,45
2003-01-21,CLE,94,8,34,ORL,103,21,21,29,55
2003-01-21,DAL,107,31,8,HOU,86,23,16,54,24
2003-01-21,SAC,109,30,11,NJN,102,28,12,58,23
2003-01-22,BOS,97,24,17,MIL,106,19,21,43,38
2003-01-22,ORL,94,22,21,CHI,91,15,26,37,47
2003-01-22,IND,101,29,12,TOR,98,10,32,39,44
2003-01-22,NYK,97,16,23,DEN,88,10,30,26,53
2003-01-22,MIA,92,14,27,PHX,85,25,17,39,44
2003-01-22,ATL,110,14,27,POR,112,24,15,38,42
2003-01-22,DET,83,27,13,PHI,92,21,20,48,33
2003-01-22,MIN,96,23,18,SEA,91,18,21,41,39
2003-01-22,SAS,93,26,14,MEM,98,12,28,38,42
2003-01-22,NOH,103,22,20,WAS,94,21,20,43,40
2003-01-22,UTA,89,25,15,LAC,96,15,25,40,40
2003-01-22,LAL,110,19,21,GSW,114,17,23,36,44
2003-01-23,PHI,94,22,20,DAL,107,32,8,54,28
2003-01-23,MEM,98,13,28,SAC,104,31,11,44,39
2003-01-23,GSW,105,18,23,NJN,97,28,13,46,36
2003-01-24,NYK,90,17,23,DAL,101,33,8,50,31
2003-01-24,ORL,107,23,21,PHX,110,25,18,48,39
2003-01-24,IND,93,30,12,SEA,80,18,22,48,34
2003-01-24,BOS,77,24,18,DEN,58,10,31,34,49
2003-01-24,ATL,115,14,28,SAC,104,32,11,46,39
2003-01-24,MIN,88,24,18,LAC,85,16,25,40,43
2003-01-24,NOH,96,23,20,POR,97,25,15,48,35
2003-01-24,CHI,104,15,27,WAS,97,21,21,36,48
2003-01-24,HOU,74,23,17,DET,98,27,14,50,31
2003-01-24,UTA,90,25,16,SAS,91,26,15,51,31
2003-01-24,LAL,83,19,22,NJN,89,28,14,47,36
2003-01-25,MIA,91,15,27,PHI,97,22,21,37,48
2003-01-25,WAS,89,21,22,MIN,97,25,18,46,40
2003-01-25,CLE,101,8,35,ATL,102,15,28,23,63
2003-01-25,MEM,83,13,29,SEA,95,18,23,31,52
2003-01-25,MIL,88,20,21,DEN,75,10,32,30,53
2003-01-25,SAS,108,27,15,DET,76,28,14,55,29
2003-01-25,GSW,108,19,23,UTA,95,25,17,44,40
2003-01-26,BOS,91,25,18,ORL,83,23,22,48,40
2003-01-26,NYK,106,17,24,PHX,98,26,18,43,42
2003-01-26,IND,108,31,12,LAC,101,16,26,47,38
2003-01-26,CHI,100,16,27,HOU,98,23,18,39,45
2003-01-26,TOR,101,10,33,SAC,97,32,12,42,45
2003-01-26,DAL,93,34,8,POR,100,26,15,60,23
2003-01-27,WAS,98,21,23,PHX,93,26,19,47,42
2003-01-27,CLE,104,8,36,LAC,100,16,27,24,63
2003-01-27,MIA,95,15,28,IND,102,32,12,47,40
2003-01-27,MIN,106,26,18,SAS,95,28,15,54,33
2003-01-27,MEM,95,13,30,HOU,100,23,19,36,49
2003-01-27,NOH,93,23,21,MIL,108,21,21,44,42
2003-01-27,DEN,66,10,33,NJN,92,29,14,39,47
2003-01-28,NYK,103,18,24,ATL,98,16,28,34,52
2003-01-28,DET,86,28,15,BOS,83,26,18,54,33
2003-01-28,MIL,81,22,21,PHI,108,23,21,45,42
2003-01-28,SAC,92,32,13,UTA,102,25,18,57,31
2003-01-28,POR,98,27,15,DEN,92,10,34,37,49
2003-01-28,SEA,91,19,23,GSW,88,20,23,39,46
2003-01-29,PHI,83,24,21,ATL,97,16,29,40,50
2003-01-29,ORL,113,23,23,CLE,108,9,36,32,59
2003-01-29,IND,97,33,12,SAS,106,28,16,61,28
2003-01-29,NJN,86,30,14,WAS,78,22,23,52,37
2003-01-29,MIA,82,15,29,NYK,80,19,24,34,53
2003-01-29,NOH,104,23,22,TOR,83,11,33,34,55
2003-01-29,HOU,81,24,19,DAL,104,34,9,58,28
2003-01-29,UTA,95,26,18,POR,71,28,15,54,33
2003-01-29,PHX,90,26,20,LAL,99,19,23,45,43
2003-01-29,LAC,77,16,28,CHI,75,17,27,33,55
2003-01-30,DAL,112,35,9,MIN,109,27,18,62,27
2003-01-30,MIL,97,22,22,WAS,90,22,24,44,46
2003-01-30,SEA,77,20,23,SAC,95,32,14,52,37
2003-01-31,PHI,104,24,22,MIA,99,16,29,40,51
2003-01-31,TOR,102,11,34,IND,90,33,13,44,47
2003-01-31,BOS,66,26,19,DET,118,29,15,55,34
2003-01-31,NJN,89,31,14,NOH,72,24,22,55,36
2003-01-31,ATL,96,17,29,CLE,91,9,37,26,66
2003-01-31,ORL,108,24,23,SAS,109,29,16,53,39
2003-01-31,MEM,102,13,31,NYK,108,19,25,32,56
2003-01-31,HOU,121,24,20,MIN,101,27,19,51,39
2003-01-31,UTA,102,27,18,GSW,94,20,24,47,42
2003-01-31,POR,107,28,16,CHI,94,17,28,45,44
2003-01-31,LAC,92,17,28,PHX,98,26,21,43,49
2003-01-31,SAC,113,33,14,LAL,124,20,23,53,37
2003-02-01,WAS,109,22,25,NOH,104,24,23,46,48
2003-02-01,IND,109,33,14,BOS,100,26,20,59,34
2003-02-01,DET,106,30,15,NJN,84,32,14,62,29
2003-02-01,MIA,65,16,30,SAS,67,30,16,46,46
2003-02-01,MIL,107,23,22,NYK,100,20,25,43,47
2003-02-01,DAL,122,36,9,DEN,100,10,35,46,44
2003-02-01,PHX,116,27,21,GSW,107,20,25,47,46
2003-02-01,SEA,90,20,24,CHI,77,17,29,37,53
2003-02-01,LAL,99,21,23,UTA,87,28,18,49,41
2003-02-02,CLE,95,9,38,POR,114,29,16,38,54
2003-02-02,TOR,100,12,34,LAC,86,17,29,29,63
2003-02-02,ATL,97,18,29,ORL,89,24,24,42,53
2003-02-02,MIN,99,27,20,PHI,91,25,22,52,42
2003-02-02,HOU,105,25,20,SAC,89,33,15,58,35
2003-02-02,DEN,93,10,36,MEM,78,13,32,23,68
2003-02-03,NJN,109,32,15,SEA,108,21,24,53,39
2003-02-03,MIA,99,16,31,ATL,79,19,29,35,60
2003-02-03,NOH,103,24,24,BOS,96,26,21,50,45
2003-02-03,UTA,90,28,19,DAL,92,37,9,65,28
2003-02-03,PHX,115,28,21,CHI,111,17,30,45,51
2003-02-03,GSW,101,20,26,MEM,91,13,33,33,59
2003-02-04,WAS,93,23,25,CLE,84,9,39,32,64
2003-02-04,ORL,89,24,25,POR,96,30,16,54,41
2003-02-04,IND,94,34,14,LAL,97,22,23,56,37
2003-02-04,NYK,105,20,26,LAC,92,17,30,37,56
2003-02-04,MIL,95,24,22,TOR,98,13,34,37,56
2003-02-04,MIN,103,28,20,HOU,89,26,20,54,40
2003-02-04,DAL,109,38,9,SAC,110,33,16,71,25
2003-02-04,DEN,102,11,36,CHI,100,17,31,28,67
2003-02-05,BOS,114,26,22,SEA,74,21,25,47,47
2003-02-05,CLE,105,9,40,HOU,102,26,21,35,61
2003-02-05,PHI,85,25,23,NJN,111,33,15,58,38
2003-02-05,MIA,87,17,31,POR,101,31,16,48,47
2003-02-05,DET,89,31,15,LAC,80,17,31,48,46
2003-02-05,NOH,108,25,24,SAC,84,34,16,59,40
2003-02-05,UTA,105,28,20,MEM,84,13,34,41,54
2003-02-05,GSW,99,21,26,SAS,103,31,16,52,42
2003-02-06,NYK,109,21,26,LAL,114,23,23,44,49
2003-02-06,MIL,97,24,23,SEA,91,21,26,45,49
2003-02-06,DEN,74,12,36,SAS,83,32,16,44,52
2003-02-11,ORL,92,24,26,NJN,83,34,15,58,41
2003-02-11,IND,107,34,15,CLE,96,10,40,44,55
2003-02-11,MIA,69,17,32,NOH,78,26,24,43,56
2003-02-11,ATL,113,19,30,GSW,116,21,27,40,57
2003-02-11,MIN,100,29,20,DAL,98,38,10,67,30
2003-02-11,CHI,79,17,32,DET,89,32,15,49,47
2003-02-11,HOU,101,26,22,UTA,103,29,20,55,42
2003-02-11,PHX,106,29,21,LAC,107,17,32,46,53
2003-02-11,SAC,99,34,17,WAS,80,24,25,58,42
2003-02-11,POR,111,32,16,SAS,116,33,16,65,32
2003-02-11,SEA,76,21,27,BOS,82,27,22,48,49
2003-02-11,LAL,121,24,23,DEN,93,12,37,36,60
2003-02-12,PHI,119,25,24,CHI,111,17,33,42,57
2003-02-12,TOR,97,14,34,ATL,96,19,31,33,65
2003-02-12,CLE,91,10,41,MIN,102,30,20,40,61
2003-02-12,NYK,107,21,27,GSW,113,22,27,43,54
2003-02-12,MEM,97,13,35,NJN,90,34,16,47,51
2003-02-12,NOH,72,27,24,IND,83,35,15,62,39
2003-02-12,MIL,120,25,23,DAL,114,38,11,63,34
2003-02-12,DEN,102,12,38,LAL,113,25,23,37,61
2003-02-12,UTA,76,30,20,HOU,106,26,23,56,43
2003-02-12,LAC,104,18,32,WAS,108,24,26,42,58
2003-02-13,DET,98,33,15,ORL,88,25,26,58,41
2003-02-13,POR,92,32,17,BOS,100,28,22,60,39
2003-02-14,TOR,114,15,34,GSW,118,23,27,38,61
2003-02-14,IND,98,36,15,ATL,97,19,32,55,47
2003-02-14,NJN,90,34,17,CHI,72,17,34,51,51
2003-02-14,PHI,99,26,24,ORL,98,25,27,51,51
2003-02-14,MIN,114,31,20,NOH,93,27,25,58,45
2003-02-14,MEM,103,14,35,DAL,110,38,12,52,47
2003-02-14,MIL,96,26,23,DET,86,34,15,60,38
2003-02-14,HOU,82,27,23,MIA,94,17,33,44,56
2003-02-14,UTA,109,30,21,WAS,77,25,26,55,47
2003-02-14,PHX,115,29,22,NYK,116,21,28,50,50
2003-02-14,SAC,110,35,17,SEA,81,21,28,56,45
2003-02-14,LAL,95,26,23,SAS,103,34,16,60,39
2003-02-15,CHI,88,17,35,DEN,69,12,39,29,74
2003-02-15,DAL,98,39,12,MIA,92,18,33,57,45
2003-02-15,POR,101,32,18,SEA,96,21,29,53,47
2003-02-15,LAC,84,18,33,BOS,92,29,22,47,55
2003-02-16,NJN,83,35,17,PHI,90,27,24,62,41
2003-02-16,TOR,99,15,35,ORL,97,25,28,40,63
2003-02-16,MIL,95,27,23,MEM,101,14,36,41,59
2003-02-16,MIN,109,32,20,GSW,102,24,27,56,47
2003-02-16,SAC,101,36,17,SAS,104,35,16,71,33
2003-02-16,ATL,99,19,33,IND,86,37,15,56,48
2003-02-16,NOH,100,27,26,DEN,92,12,40,39,66
2003-02-16,CLE,75,10,42,DET,90,34,16,44,58
2003-02-16,PHX,102,29,23,BOS,92,30,22,59,45
2003-02-16,LAL,110,26,24,NYK,117,22,28,48,52
2003-02-17,DET,93,35,16,MIA,62,18,34,53,50
2003-02-17,UTA,109,31,21,MIN,97,33,20,64,41
2003-02-17,POR,99,33,18,NYK,91,23,28,56,46
2003-02-18,ORL,99,25,29,NOH,94,28,26,53,55
2003-02-18,CLE,101,10,43,CHI,107,18,35,28,78
2003-02-18,NJN,84,35,18,MIA,79,18,35,53,53
2003-02-18,MEM,108,15,36,IND,103,37,16,52,52
2003-02-18,DAL,105,40,12,ATL,79,20,33,60,45
2003-02-18,SAS,101,36,16,DEN,76,12,41,48,57
2003-02-18,SAC,102,36,18,MIL,93,27,24,63,42
2003-02-18,LAL,106,26,25,HOU,99,27,24,53,49
2003-02-18,GSW,117,24,28,BOS,125,30,23,54,51
2003-02-19,TOR,84,17,35,DET,89,36,16,53,51
2003-02-19,NOH,87,28,27,WAS,75,25,28,53,55
2003-02-19,DEN,77,12,42,MIN,85,33,21,45,63
2003-02-19,UTA,87,32,21,LAL,93,27,25,59,46
2003-02-19,PHX,89,30,23,HOU,107,27,25,57,48
2003-02-19,CHI,82,19,35,PHI,110,28,24,47,59
2003-02-19,POR,125,34,18,GSW,98,24,29,58,47
2003-02-19,SEA,103,21,30,NYK,94,23,29,44,59
2003-02-19,LAC,110,18,34,MIL,104,27,25,45,59
2003-02-20,NJN,98,36,18,IND,91,37,17,73,35
2003-02-20,DAL,95,41,12,SAS,87,37,16,78,28
2003-02-20,SAC,105,37,18,BOS,83,31,23,68,41
2003-02-21,WAS,89,25,29,NJN,86,37,18,62,47
2003-02-21,ORL,110,26,29,CHI,96,19,36,45,65
2003-02-21,TOR,92,17,36,PHX,89,30,24,47,60
2003-02-21,CLE,99,10,44,PHI,119,29,24,39,68
2003-02-21,MIN,103,34,21,DET,96,37,16,71,37
2003-02-21,NOH,125,29,27,MEM,123,16,36,45,63
2003-02-21,HOU,85,28,25,DAL,100,42,12,70,37
2003-02-21,LAL,92,28,25,POR,84,35,18,63,43
2003-02-21,GSW,111,24,30,NYK,107,23,30,47,60
2003-02-21,SEA,88,22,30,MIL,58,27,26,49,56
2003-02-22,DET,91,37,17,NOH,93,30,27,67,44
2003-02-22,MIA,100,18,36,CHI,90,19,37,37,73
2003-02-22,HOU,93,28,26,MEM,82,16,37,44,63
2003-02-22,SAS,105,37,17,IND,96,37,18,74,35
2003-02-22,UTA,99,32,22,DEN,89,12,43,44,65
2003-02-22,POR,90,35,19,MIL,93,27,27,62,46
2003-02-22,LAC,87,19,34,ATL,89,20,34,39,68
2003-02-23,WAS,101,26,29,DAL,106,43,12,69,41
2003-02-23,NJN,105,37,19,ORL,113,27,29,64,48
2003-02-23,MIN,99,35,21,PHX,97,30,25,65,46
2003-02-23,PHI,116,30,24,CLE,103,10,45,40,69
2003-02-23,GSW,115,25,30,ATL,93,21,34,46,64
2003-02-23,SAC,99,38,18,NYK,92,23,31,61,49
2003-02-23,LAL,106,29,25,SEA,101,23,30,52,55
2003-02-24,BOS,95,31,24,HOU,101,29,26,60,50
2003-02-24,MIL,114,28,27,MIN,117,36,21,64,48
2003-02-24,MEM,103,16,38,UTA,92,33,22,49,60
2003-02-24,CHI,90,19,38,PHX,87,30,26,49,64
2003-02-24,DEN,89,12,44,GSW,94,26,30,38,74
2003-02-24,SEA,86,23,31,DET,79,37,18,60,49
2003-02-25,ORL,98,28,29,DAL,93,44,12,72,41
2003-02-25,CLE,93,10,46,NJN,90,37,20,47,66
2003-02-25,IND,78,37,19,WAS,83,26,30,63,49
2003-02-25,NYK,102,23,32,HOU,95,30,26,53,58
2003-02-25,SAS,84,38,17,MIA,69,19,36,57,53
2003-02-25,SAC,81,39,18,DET,75,37,19,76,37
2003-02-25,POR,89,35,20,ATL,86,21,35,56,55
2003-02-25,LAL,109,30,25,LAC,98,19,35,49,60
2003-02-26,BOS,71,31,25,IND,69,37,20,68,45
2003-02-26,PHI,111,31,24,MEM,107,17,38,48,62
2003-02-26,NJN,105,37,21,NYK,76,24,32,61,53
2003-02-26,MIL,112,28,28,PHX,118,30,27,58,55
2003-02-26,MIN,92,37,21,UTA,85,33,23,70,44
2003-02-26,NOH,91,31,27,MIA,82,19,37,50,64
2003-02-26,CHI,103,20,38,TOR,95,18,36,38,74
2003-02-26,DEN,84,12,45,POR,94,36,20,48,65
2003-02-26,SEA,93,24,31,ATL,76,21,36,45,67
2003-02-26,LAC,94,19,36,GSW,108,27,30,46,66
2003-02-27,WAS,100,27,30,HOU,98,30,27,57,57
2003-02-27,DAL,124,44,13,SAC,126,40,18,84,31
2003-02-27,LAL,95,31,25,DET,85,37,20,68,45
2003-02-28,PHI,104,32,24,UTA,83,33,24,65,48
2003-02-28,IND,107,37,21,MIL,98,28,29,65,50
2003-02-28,NYK,118,24,33,ORL,110,29,29,53,62
2003-02-28,BOS,90,32,25,TOR,85,18,37,50,62
2003-02-28,MIN,118,38,21,CLE,95,11,46,49,67
2003-02-28,MEM,126,17,39,MIA,116,19,38,36,77
2003-02-28,CHI,88,21,38,ATL,110,21,37,42,75
2003-02-28,DEN,88,12,46,NOH,94,32,27,44,73
2003-02-28,SEA,107,25,31,LAL,90,32,25,57,56
2003-02-28,POR,109,37,20,LAC,103,19,37,56,57
2003-03-01,SAS,108,39,17,SAC,100,41,18,80,35
2003-03-01,WAS,101,28,30,CHI,93,21,39,49,69
2003-03-01,DAL,114,44,14,MEM,87,18,39,62,53
2003-03-01,PHX,92,31,27,NOH,97,33,27,64,54
2003-03-01,LAC,101,19,38,SEA,109,26,31,45,69
2003-03-01,GSW,92,28,30,DET,90,37,21,65,51
2003-03-02,NJN,90,38,21,UTA,91,33,25,71,46
2003-03-02,CLE,76,11,47,ORL,102,29,30,40,77
2003-03-02,TOR,104,18,38,BOS,92,33,25,51,63
2003-03-02,MIL,120,28,30,ATL,93,22,37,50,67
2003-03-02,MIN,99,39,21,NYK,90,25,33,64,54
2003-03-02,HOU,88,30,28,SAS,97,40,17,70,45
2003-03-02,MIA,93,19,39,WAS,83,29,30,48,69
2003-03-02,DEN,94,12,47,PHI,100,33,24,45,71
2003-03-02,POR,103,38,20,DET,86,37,22,75,42
2003-03-03,MEM,110,18,40,BOS,111,33,26,51,66
2003-03-03,CHI,89,21,40,ORL,104,30,30,51,70
2003-03-03,SAC,107,41,19,PHI,99,34,24,75,43
2003-03-03,LAC,108,19,39,NOH,111,34,27,53,66
2003-03-04,WAS,86,25,27,TOR,89,16,35,41,62
2003-03-04,NYK,89,25,34,CLE,80,11,48,36,82
2003-03-04,MIA,91,20,39,MIL,100,29,30,49,69
2003-03-04,ATL,92,22,38,DEN,86,12,48,34,86
2003-03-04,DET,96,37,23,HOU,83,30,29,67,52
2003-03-04,DAL,88,45,14,NJN,79,38,22,83,36
2003-03-04,SAS,97,41,17,PHX,104,31,28,72,45
2003-03-04,SEA,92,27,31,MIN,83,40,21,67,52
2003-03-04,GSW,107,29,30,IND,100,38,21,67,51
2003-03-05,BOS,97,34,26,NYK,95,26,34,60,60
2003-03-05,WAS,99,29,31,LAC,80,19,40,48,71
2003-03-05,ORL,111,31,30,MIL,99,30,30,61,60
2003-03-05,TOR,95,19,38,HOU,97,30,30,49,68
2003-03-05,CLE,105,11,49,ATL,111,23,38,34,87
2003-03-05,MEM,96,18,41,DEN,86,12,49,30,90
2003-03-05,UTA,94,34,25,SEA,83,28,31,62,56
2003-03-05,PHX,98,32,28,POR,92,39,20,71,48
2003-03-05,SAC,96,42,19,MIN,95,40,22,82,41
2003-03-05,LAL,97,32,26,IND,95,38,22,70,48
2003-03-06,SAS,92,41,18,NJN,78,38,23,79,41
2003-03-06,CHI,119,21,41,GSW,105,30,30,51,71
2003-03-06,POR,60,39,21,PHI,88,34,25,73,46
2003-03-07,WAS,82,30,31,MIL,85,30,31,60,62
2003-03-07,ORL,102,32,30,NYK,111,26,35,58,65
2003-03-07,BOS,83,35,26,LAC,72,19,41,54,67
2003-03-07,MIA,89,20,40,DAL,91,46,14,66,54
2003-03-07,NOH,102,35,27,CLE,76,11,50,46,77
2003-03-07,UTA,105,35,25,SAC,108,43,19,78,44
2003-03-07,LAL,106,33,26,MIN,96,40,23,73,49
2003-03-07,SEA,99,28,32,PHI,108,35,25,63,57
2003-03-08,ATL,98,24,38,TOR,107,19,39,43,77
2003-03-08,CLE,89,11,51,MEM,115,19,41,30,92
2003-03-08,MIA,92,20,41,DEN,98,12,50,32,91
2003-03-08,CHI,97,22,41,LAC,103,19,42,41,83
2003-03-08,MIL,138,31,31,GSW,133,30,31,61,62
2003-03-08,DAL,101,47,14,UTA,77,35,26,82,40
2003-03-08,HOU,83,31,30,NJN,71,38,24,69,54
2003-03-08,POR,94,39,22,IND,80,38,23,77,45
2003-03-09,NYK,97,27,35,WAS,96,30,32,57,67
2003-03-09,LAL,106,34,26,PHI,92,36,25,70,51
2003-03-09,BOS,78,36,26,SAS,94,42,18,78,44
2003-03-09,ORL,111,32,31,DEN,98,13,50,45,81
2003-03-09,TOR,106,20,39,MEM,119,20,41,40,80
2003-03-09,DET,107,38,23,GSW,105,30,32,68,55
2003-03-09,NOH,92,36,27,NJN,102,38,25,74,52
2003-03-09,PHX,98,33,28,MIN,105,40,24,73,52
2003-03-09,SAC,107,44,19,IND,88,38,24,82,43
2003-03-10,MIA,73,20,42,UTA,83,35,27,55,69
2003-03-10,ATL,95,24,39,LAC,86,20,42,44,81
2003-03-10,DAL,83,48,14,MIN,92,41,24,89,38
2003-03-11,WAS,106,30,33,ORL,105,33,31,63,64
2003-03-11,CLE,75,11,52,MIA,77,20,43,31,95
2003-03-11,IND,71,38,25,NOH,81,36,28,74,53
2003-03-11,NYK,85,28,35,MEM,87,21,41,49,76
2003-03-11,MIL,102,32,31,SAS,105,43,18,75,49
2003-03-11,CHI,116,22,42,LAL,99,35,26,57,68
2003-03-11,DEN,95,13,51,TOR,87,20,40,33,91
2003-03-11,SEA,77,28,33,POR,92,40,22,68,55
2003-03-11,GSW,113,30,33,PHX,98,33,29,63,62
2003-03-12,BOS,93,36,27,NOH,65,37,28,73,55
2003-03-12,PHI,96,36,26,IND,93,38,26,74,52
2003-03-12,ORL,108,33,32,UTA,111,36,27,69,59
2003-03-12,ATL,111,25,39,MIL,92,32,32,57,71
2003-03-12,DET,111,39,23,LAL,88,35,27,74,50
2003-03-12,MIN,99,42,24,SAS,111,44,18,86,42
2003-03-12,MEM,124,22,41,CHI,95,23,42,45,83
2003-03-12,HOU,118,32,30,LAC,114,20,43,52,73
2003-03-12,POR,125,41,22,TOR,103,20,41,61,63
2003-03-13,NJN,90,39,25,BOS,75,37,27,76,52
2003-03-13,PHX,109,33,30,SAC,84,45,19,78,49
2003-03-13,SEA,107,28,34,DAL,100,48,15,76,49
2003-03-14,PHI,90,37,26,POR,79,42,22,79,48
2003-03-14,IND,101,38,27,UTA,81,37,27,75,54
2003-03-14,ATL,107,26,39,NYK,104,28,36,54,75
2003-03-14,MIA,83,21,43,NOH,87,37,29,58,72
2003-03-14,DET,90,40,23,WAS,80,31,33,71,56
2003-03-14,MIN,99,42,25,LAL,106,35,28,77,53
2003-03-14,HOU,121,33,30,CHI,91,23,43,56,73
2003-03-14,SAS,107,45,18,LAC,96,20,44,65,62
2003-03-14,SAC,119,45,20,TOR,84,20,42,65,62
2003-03-14,GSW,114,31,33,DAL,116,48,16,79,49
2003-03-15,WAS,89,31,34,MIA,82,21,44,52,78
2003-03-15,ORL,96,33,33,NOH,86,38,29,71,62
2003-03-15,DET,71,41,23,BOS,81,37,28,78,51
2003-03-15,MIL,94,32,33,LAL,98,36,28,68,61
2003-03-15,SEA,88,29,34,GSW,94,31,34,60,68
2003-03-16,NJN,87,40,25,PHI,92,38,26,78,51
2003-03-16,CLE,122,11,53,UTA,95,37,28,48,81
2003-03-16,MIN,111,42,26,POR,95,42,23,84,49
2003-03-16,SAC,123,46,20,DAL,129,49,16,95,36
2003-03-16,MEM,124,23,41,ATL,92,27,39,50,80
2003-03-16,NYK,120,28,37,MIL,111,32,34,60,71
2003-03-16,SAS,108,46,18,CHI,97,23,44,69,62
2003-03-16,HOU,85,34,30,PHX,75,34,30,68,60
2003-03-16,DEN,84,14,51,SEA,92,29,35,43,86
2003-03-16,LAC,111,20,45,TOR,110,20,43,40,88
2003-03-17,IND,88,39,27,POR,95,42,24,81,51
2003-03-17,PHX,95,34,31,TOR,91,20,44,54,75
2003-03-17,LAC,85,21,45,LAL,102,37,28,58,73
2003-03-18,BOS,74,38,28,NJN,87,40,26,78,54
2003-03-18,WAS,90,32,34,DET,94,41,24,73,58
2003-03-18,MIA,83,21,45,PHI,103,39,26,60,71
2003-03-18,MIN,96,43,26,MEM,80,24,41,67,67
2003-03-18,CHI,103,23,45,ATL,78,27,40,50,85
2003-03-18,DAL,114,50,16,CLE,93,12,53,62,69
2003-03-18,SAS,97,47,18,NYK,105,29,37,76,55
2003-03-18,UTA,99,37,29,DEN,81,14,52,51,81
2003-03-18,SAC,117,46,21,GSW,91,32,34,78,55
2003-03-18,SEA,100,30,35,HOU,94,35,30,65,65
2003-03-19,ORL,109,34,33,MIA,93,21,46,55,79
2003-03-19,TOR,87,20,45,ATL,86,27,41,47,86
2003-03-19,IND,102,39,28,BOS,72,38,29,77,57
2003-03-19,NJN,85,41,26,MIL,104,32,35,73,61
2003-03-19,MEM,128,24,42,CLE,101,12,54,36,96
2003-03-19,NOH,101,38,30,NYK,96,30,37,68,67
2003-03-19,PHX,86,35,31,UTA,99,38,29,73,60
2003-03-19,POR,94,43,24,HOU,83,35,31,78,55
2003-03-19,LAC,91,21,46,DEN,78,14,53,35,99
2003-03-19,GSW,105,32,35,SEA,99,31,35,63,70
2003-03-20,DET,113,42,24,PHI,85,40,26,82,50
2003-03-20,DAL,110,51,16,SAS,112,47,19,98,35
2003-03-20,SAC,107,47,21,LAL,99,38,28,85,49
2003-03-21,PHI,105,40,27,ATL,114,27,42,67,69
2003-03-21,ORL,109,35,33,CLE,85,12,55,47,88
2003-03-21,IND,101,40,28,MEM,92,25,42,65,70
2003-03-21,NYK,97,30,38,DET,93,43,24,73,62
2003-03-21,MIA,107,21,47,TOR,98,21,45,42,92
2003-03-21,NOH,113,39,30,MIL,98,33,35,72,65
2003-03-21,SAS,94,48,19,MIN,101,44,26,92,45
2003-03-21,PHX,109,35,32,WAS,83,32,35,67,67
2003-03-21,SEA,101,31,36,DEN,99,14,54,45,90
2003-03-21,LAL,104,38,29,BOS,96,38,30,76,59
2003-03-21,GSW,107,33,35,HOU,117,35,32,68,67
2003-03-22,ATL,92,28,42,IND,89,41,28,69,70
2003-03-22,NJN,107,41,27,MEM,99,25,43,66,70
2003-03-22,CHI,100,24,45,NYK,98,31,38,55,83
2003-03-22,MIL,93,33,36,NOH,85,40,30,73,66
2003-03-22,DAL,102,51,17,PHX,95,36,32,87,49
2003-03-22,UTA,88,39,29,LAC,73,22,46,61,75
2003-03-22,DEN,90,14,55,BOS,80,38,31,52,86
2003-03-22,POR,104,44,24,SAC,113,48,21,92,45
2003-03-23,SAS,98,48,20,LAL,89,39,29,87,49
2003-03-23,TOR,95,21,46,PHI,112,40,28,61,74
2003-03-23,MIA,74,22,47,ORL,96,36,33,58,80
2003-03-23,DET,105,43,25,CHI,82,25,45,68,70
2003-03-23,CLE,93,12,56,NJN,88,42,27,54,83
2003-03-23,GSW,113,33,36,WAS,107,32,36,65,72
2003-03-23,SAC,109,49,21,HOU,108,36,32,85,53
2003-03-24,ORL,104,37,33,MEM,110,25,44,62,77
2003-03-24,NYK,100,31,39,TOR,90,21,47,52,86
2003-03-24,DEN,96,15,55,DAL,108,52,17,67,72
2003-03-24,UTA,96,40,29,BOS,91,38,32,78,61
2003-03-24,PHX,73,36,33,SEA,82,32,36,68,69
2003-03-24,LAC,90,22,47,HOU,108,36,33,58,80
2003-03-25,CLE,124,13,56,GSW,103,34,36,47,92
2003-03-25,ATL,91,29,42,LAL,108,39,30,68,72
2003-03-25,MIN,108,45,26,MIA,91,22,48,67,74
2003-03-25,SAS,107,49,20,MIL,94,34,36,83,56
2003-03-25,POR,91,44,25,WAS,95,32,37,76,62
2003-03-26,BOS,95,38,33,GSW,107,34,37,72,70
2003-03-26,TOR,89,21,48,CLE,83,14,56,35,104
2003-03-26,IND,85,41,29,PHI,91,41,28,82,57
2003-03-26,NJN,101,42,28,NYK,95,32,39,74,67
2003-03-26,DET,102,44,25,ATL,99,29,43,73,68
2003-03-26,MEM,99,26,44,PHX,101,36,34,62,78
2003-03-26,CHI,82,25,46,MIA,74,22,49,47,95
2003-03-26,HOU,93,37,33,LAL,96,40,30,77,63
2003-03-26,NOH,95,40,31,ORL,97,37,34,77,65
2003-03-26,DEN,108,15,56,MIL,103,34,37,49,93
2003-03-26,UTA,94,41,29,POR,85,44,26,85,55
2003-03-26,SEA,74,33,36,WAS,80,33,37,66,73
2003-03-26,LAC,107,22,48,DAL,114,53,17,75,65
2003-03-27,ORL,110,38,34,MIN,107,46,26,84,60
2003-03-27,SAS,98,50,20,HOU,85,37,34,87,54
2003-03-27,SAC,93,50,21,LAC,83,22,49,72,70
2003-03-28,PHI,98,42,28,GSW,102,35,37,77,65
2003-03-28,TOR,92,22,48,NOH,101,40,32,62,80
2003-03-28,IND,140,41,30,CHI,89,26,46,67,76
2003-03-28,BOS,104,38,34,CLE,95,14,57,52,91
2003-03-28,NYK,101,32,40,NJN,122,43,28,75,68
2003-03-28,MIA,111,22,50,MIN,84,46,27,68,77
2003-03-28,DET,91,45,25,PHX,94,37,34,82,59
2003-03-28,UTA,103,42,29,MIL,90,34,38,76,67
2003-03-28,SEA,95,33,37,MEM,71,26,45,59,82
2003-03-28,LAL,108,41,30,WAS,94,34,37,75,67
2003-03-28,POR,112,44,27,DAL,95,54,17,98,44
2003-03-29,ATL,89,29,44,PHI,110,42,29,71,73
2003-03-29,NJN,109,44,28,GSW,97,36,37,80,65
2003-03-29,CLE,106,14,58,BOS,110,39,34,53,92
2003-03-29,CHI,92,26,47,SAC,107,51,21,77,68
2003-03-29,HOU,102,37,35,DEN,89,16,56,53,91
2003-03-29,SAS,101,51,20,UTA,81,43,29,94,49
2003-03-30,MIN,95,46,28,DAL,119,54,18,100,46
2003-03-30,IND,92,42,30,PHX,81,38,34,80,64
2003-03-30,MIL,109,34,39,MIA,87,23,50,57,89
2003-03-30,TOR,95,22,49,NYK,86,32,41,54,90
2003-03-30,DET,99,45,26,SAC,88,52,21,97,47
2003-03-30,NOH,90,41,32,SAS,92,52,20,93,52
2003-03-30,DEN,88,16,57,WAS,72,34,38,50,95
2003-03-30,LAC,102,22,50,MEM,100,26,46,48,96
2003-03-30,SEA,119,34,37,LAL,98,42,30,76,67
2003-03-31,ORL,113,39,34,PHI,118,43,29,82,63
2003-03-31,NJN,110,45,28,HOU,86,38,35,83,63
2003-03-31,MIA,86,23,51,MIL,91,35,39,58,90
2003-03-31,LAL,110,42,31,MEM,94,26,47,68,78
2003-04-01,TOR,85,23,49,DET,92,46,26,69,75
2003-04-01,IND,98,43,30,SAC,103,52,22,95,52
2003-04-01,CHI,94,26,48,SEA,101,35,37,61,85
2003-04-01,DAL,95,55,18,NOH,86,41,33,96,51
2003-04-01,SAS,118,53,20,ORL,105,39,35,92,55
2003-04-01,PHX,95,38,35,DEN,65,17,57,55,92
2003-04-01,POR,100,45,27,GSW,86,36,38,81,65
2003-04-01,LAC,89,23,50,UTA,94,43,30,66,80
2003-04-02,BOS,90,40,34,MIA,62,23,52,63,86
2003-04-02,PHI,108,44,29,CHI,101,26,49,70,78
2003-04-02,CLE,82,14,59,IND,103,43,31,57,90
2003-04-02,DET,78,47,26,TOR,89,23,50,70,76
2003-04-02,WAS,99,34,39,SAC,105,53,22,87,61
2003-04-02,MIL,106,36,39,HOU,99,38,36,74,75
2003-04-02,MIN,91,46,29,SEA,86,36,37,82,66
2003-04-02,MEM,87,26,48,SAS,105,54,20,80,68
2003-04-02,NOH,106,41,34,NJN,97,46,28,87,62
2003-04-02,DEN,75,17,58,NYK,83,32,42,49,100
2003-04-03,ATL,91,29,45,WAS,89,34,40,63,85
2003-04-03,DAL,89,56,18,LAL,100,43,31,99,49
2003-04-03,POR,88,46,27,UTA,93,44,30,90,57
2003-04-04,PHI,79,45,29,HOU,88,38,37,83,66
2003-04-04,TOR,98,24,50,SAS,124,55,20,79,70
2003-04-04,NJN,99,46,29,MIA,83,23,53,69,82
2003-04-04,BOS,92,41,34,SAC,93,54,22,95,56
2003-04-04,DET,92,47,27,IND,98,44,31,91,58
2003-04-04,MEM,101,26,49,LAL,102,44,31,70,80
2003-04-04,MIL,95,37,39,CLE,93,14,60,51,99
2003-04-04,UTA,92,45,30,NYK,94,33,42,78,72
2003-04-04,GSW,100,36,39,POR,122,46,28,82,67
2003-04-04,SEA,101,36,38,LAC,93,23,51,59,89
2003-04-05,ATL,97,30,45,MEM,91,26,50,56,95
2003-04-05,CLE,79,14,61,NOH,76,42,34,56,95
2003-04-05,CHI,117,26,50,MIL,115,38,39,64,89
2003-04-05,DAL,108,56,19,ORL,90,39,36,95,55
2003-04-05,PHX,111,39,35,MIN,94,47,29,86,64
2003-04-05,LAC,109,23,52,NYK,98,34,42,57,94
2003-04-06,BOS,98,41,35,WAS,99,34,41,75,76
2003-04-06,PHI,81,45,30,SAC,97,55,22,100,52
2003-04-06,TOR,87,24,51,NJN,96,47,29,71,80
2003-04-06,DET,83,47,28,SAS,89,56,20,103,48
2003-04-06,IND,90,45,31,MIA,69,23,54,68,85
2003-04-06,GSW,106,36,40,DEN,99,17,59,53,99
2003-04-06,HOU,114,39,37,ORL,93,39,37,78,74
2003-04-06,POR,78,47,28,MIN,97,47,30,94,58
2003-04-06,SEA,82,37,38,UTA,80,45,31,82,69
2003-04-06,LAL,115,45,31,PHX,113,40,35,85,66
2003-04-08,PHI,91,45,31,DET,74,47,29,92,60
2003-04-08,CLE,91,15,61,WAS,100,35,41,50,102
2003-04-08,NYK,99,34,43,ATL,95,31,45,65,88
2003-04-08,MIA,89,23,55,TOR,83,24,52,47,107
2003-04-08,MEM,111,26,51,LAC,108,24,52,50,103
2003-04-08,CHI,115,27,50,IND,103,46,31,73,81
2003-04-08,HOU,66,40,37,POR,81,47,29,87,66
2003-04-08,DEN,78,17,60,PHX,98,40,36,57,96
2003-04-08,SAC,107,56,22,SEA,85,38,38,94,60
2003-04-08,LAL,108,46,31,DAL,99,57,19,103,50
2003-04-08,GSW,128,37,40,UTA,102,45,32,82,72
2003-04-09,WAS,83,36,41,BOS,87,41,36,77,77
2003-04-09,ORL,88,39,38,TOR,82,24,53,63,91
2003-04-09,ATL,97,31,46,NJN,92,48,29,79,75
2003-04-09,DET,111,47,30,CHI,102,28,50,75,80
2003-04-09,MIL,112,38,40,LAC,92,24,53,62,93
2003-04-09,NOH,100,42,35,CLE,81,15,62,57,97
2003-04-09,SAS,84,57,20,POR,79,48,29,105,49
2003-04-09,UTA,94,45,33,HOU,73,40,38,85,71
2003-04-09,PHX,112,41,36,DAL,89,57,20,98,56
2003-04-09,SEA,100,38,39,MIN,92,48,30,86,69
2003-04-10,BOS,78,42,36,PHI,99,46,31,88,67
2003-04-10,LAL,117,47,31,SAC,104,57,22,104,53
2003-04-11,TOR,103,24,54,MIL,105,39,40,63,94
2003-04-11,ATL,109,32,46,CLE,89,15,63,47,109
2003-04-11,NYK,108,35,43,PHI,103,47,31,82,74
2003-04-11,MIA,87,24,55,WAS,91,36,42,60,97
2003-04-11,IND,86,46,32,ORL,98,40,38,86,70
2003-04-11,MIN,106,48,31,LAC,90,24,54,72,85
2003-04-11,MEM,96,27,51,POR,93,48,30,75,81
2003-04-11,NOH,93,43,35,DET,89,48,30,91,65
2003-04-11,CHI,95,28,51,NJN,86,48,30,76,81
2003-04-11,SAS,94,58,20,SEA,86,39,39,97,59
2003-04-11,UTA,95,46,33,DAL,92,57,21,103,54
2003-04-11,PHX,117,42,36,GSW,101,38,40,80,76
2003-04-11,SAC,105,57,23,DEN,103,17,61,74,84
2003-04-12,WAS,100,37,42,ATL,101,33,46,70,88
2003-04-12,ORL,89,41,38,BOS,86,42,37,83,75
2003-04-12,NJN,94,48,31,TOR,86,24,55,72,86
2003-04-12,CLE,104,15,64,NYK,99,36,43,51,107
2003-04-12,DAL,117,57,22,GSW,108,38,41,95,63
2003-04-12,HOU,101,40,39,SEA,86,39,40,79,79
2003-04-12,DEN,79,17,62,LAC,101,24,55,41,117
2003-04-13,MIL,107,40,40,IND,98,46,33,86,73
2003-04-13,MIN,119,49,31,CHI,95,29,51,78,82
2003-04-13,POR,101,48,31,LAL,99,48,31,96,62
2003-04-13,MEM,107,28,51,DET,110,48,31,76,82
2003-04-13,PHI,89,47,32,NOH,94,44,35,91,67
2003-04-13,MIA,86,24,56,BOS,94,42,38,66,94
2003-04-13,PHX,92,43,36,SAS,85,59,20,102,56
2003-04-14,WAS,79,37,43,NYK,93,36,44,73,87
2003-04-14,NJN,74,49,31,NOH,87,45,35,94,66
2003-04-14,ATL,100,34,46,ORL,84,42,38,76,84
2003-04-14,DET,89,49,31,CLE,88,16,64,65,95
2003-04-14,DAL,109,58,22,SEA,106,39,41,97,63
2003-04-14,UTA,83,47,33,SAS,91,59,21,106,54
2003-04-14,GSW,113,38,42,LAC,122,25,55,63,97
2003-04-15,TOR,99,24,56,MIA,103,24,57,48,113
2003-04-15,NYK,93,37,44,IND,109,46,34,83,78
2003-04-15,CHI,115,29,52,PHI,106,47,33,76,85
2003-04-15,HOU,97,41,39,MEM,86,28,52,69,91
2003-04-15,POR,120,49,31,PHX,102,44,36,93,67
2003-04-15,LAL,126,48,32,DEN,104,17,63,65,95
2003-04-16,BOS,99,43,38,DET,92,50,31,93,69
2003-04-16,PHI,107,47,34,WAS,87,37,44,84,78
2003-04-16,CLE,96,16,65,TOR,86,24,57,40,122
2003-04-16,IND,90,47,34,NJN,83,49,32,96,66
2003-04-16,MIL,93,41,40,ORL,87,42,39,83,79
2003-04-16,MEM,87,28,53,MIN,95,50,31,78,84
2003-04-16,NOH,92,46,35,ATL,77,35,46,81,81
2003-04-16,SAS,72,60,21,DAL,93,59,22,119,43
2003-04-16,DEN,84,17,64,HOU,89,42,39,59,103
2003-04-16,SAC,95,58,23,UTA,84,47,34,105,57
2003-04-16,SEA,84,39,42,PHX,70,44,37,83,79
2003-04-16,LAC,107,26,55,POR,93,50,31,76,86
2003-04-16,GSW,111,38,43,LAL,117,49,32,87,75
2003-10-28,PHI,89,0,0,MIA,74,0,0,0,0
2003-10-28,SAS,83,0,0,PHX,82,0,0,0,0
2003-10-28,LAL,109,0,0,DAL,93,0,0,0,0
2003-10-29,BOS,98,0,0,MIA,75,0,1,0,1
2003-10-29,NYK,83,0,0,ORL,85,0,0,0,0
2003-10-29,NOH,88,0,0,ATL,83,0,0,0,0
2003-10-29,TOR,90,0,0,NJN,87,0,0,0,0
2003-10-29,DET,87,0,0,IND,89,0,0,0,0
2003-10-29,MIN,95,0,0,MIL,89,0,0,0,0
2003-10-29,CHI,74,0,0,WAS,99,0,0,0,0
2003-10-29,DEN,80,0,0,SAS,72,1,0,1,0
2003-10-29,UTA,99,0,0,POR,92,0,0,0,0
2003-10-29,GSW,87,0,0,DAL,95,0,1,0,1
2003-10-29,SAC,106,0,0,CLE,92,0,0,0,0
2003-10-30,SEA,109,0,0,LAC,100,0,0,0,0
2003-10-30,ORL,98,1,0,NOH,100,1,0,2,0
2003-10-30,HOU,102,0,0,DEN,85,1,0,1,0
2003-10-30,PHX,95,0,1,CLE,86,0,1,0,2
2003-10-31,TOR,82,1,0,WAS,79,1,0,2,0
2003-10-31,MIA,81,0,2,DET,93,0,1,0,3
2003-10-31,IND,79,1,0,MIL,93,0,1,1,1
2003-10-31,NJN,84,0,1,MIN,61,1,0,1,1
2003-10-31,MEM,91,0,0,BOS,93,1,0,1,0
2003-10-31,CHI,100,0,1,ATL,94,0,1,0,2
2003-10-31,LAC,105,0,1,SEA,124,1,0,1,1
2003-10-31,SAC,100,1,0,PHI,89,1,0,2,0
2003-11-01,WAS,85,1,1,NJN,98,1,1,2,2
2003-11-01,ORL,85,1,1,DET,96,1,1,2,2
2003-11-01,ATL,99,0,2,IND,103,1,1,1,3
2003-11-01,NOH,97,2,0,BOS,90,2,0,4,0
2003-11-01,MIN,73,1,1,TOR,56,2,0,3,1
2003-11-01,MIL,98,1,1,CHI,68,1,1,2,2
2003-11-01,DAL,127,1,1,UTA,102,1,0,2,1
2003-11-01,HOU,71,1,0,MEM,79,0,1,1,1
2003-11-01,SAS,86,1,1,NYK,74,0,1,1,2
2003-11-01,DEN,109,1,1,SAC,88,2,0,3,1
2003-11-01,PHX,99,1,1,LAL,103,1,0,2,1
2003-11-01,POR,104,0,1,CLE,85,0,2,0,3
2003-11-01,GSW,104,0,1,PHI,90,1,1,1,2
2003-11-02,LAL,87,2,0,GSW,72,1,1,3,1
2003-11-03,ORL,68,1,2,NYK,75,0,2,1,4
2003-11-03,ATL,90,0,3,NOH,80,3,0,3,3
2003-11-03,MEM,88,1,1,SAS,80,2,1,3,2
2003-11-03,CHI,66,1,2,HOU,98,1,1,2,3
2003-11-03,DAL,103,2,1,MIA,93,0,3,2,4
2003-11-03,UTA,93,1,1,MIN,88,2,1,3,2
2003-11-03,POR,83,1,1,PHI,94,1,2,2,3
2003-11-04,IND,71,2,1,DEN,60,2,1,4,2
2003-11-04,NJN,75,2,1,HOU,86,2,1,4,2
2003-11-04,MIL,107,2,1,LAL,113,3,0,5,1
2003-11-04,SAS,80,2,2,MIA,73,0,4,2,6
2003-11-05,PHI,99,2,2,NOH,106,3,1,5,3
2003-11-05,WAS,100,1,2,DAL,90,3,1,4,3
2003-11-05,ORL,100,1,3,CHI,106,1,3,2,6
2003-11-05,NYK,90,1,2,MIL,106,2,2,3,4
2003-11-05,DET,96,2,1,BOS,88,2,1,4,2
2003-11-05,CLE,89,0,3,DEN,93,2,2,2,5
2003-11-05,MIN,121,2,2,SAC,125,2,1,4,3
2003-11-05,UTA,91,2,1,PHX,80,1,2,3,3
2003-11-05,GSW,99,1,2,ATL,72,1,3,2,5
2003-11-05,POR,93,1,2,MEM,87,2,1,3,3
2003-11-06,NJN,81,2,2,IND,87,3,1,5,3
2003-11-06,TOR,77,2,1,DAL,71,3,2,5,3
2003-11-06,SAS,117,3,2,LAL,120,4,0,7,2
2003-11-07,WAS,86,2,2,TOR,60,3,1,5,3
2003-11-07,BOS,87,2,2,NJN,94,2,3,4,5
2003-11-07,NYK,114,1,3,SAC,111,3,1,4,4
2003-11-07,IND,91,4,1,CLE,90,0,4,4,5
2003-11-07,ORL,71,1,4,MIN,100,2,3,3,7
2003-11-07,NOH,114,4,1,LAL,95,5,0,9,1
2003-11-07,DET,105,3,1,MIL,99,3,2,6,3
2003-11-07,CHI,85,2,3,PHI,106,2,3,4,6
2003-11-07,DEN,102,3,2,LAC,104,0,2,3,4
2003-11-07,PHX,96,1,3,MEM,88,2,2,3,5
2003-11-07,GSW,95,2,2,UTA,89,3,1,5,3
2003-11-07,SEA,100,2,0,POR,82,2,2,4,2
2003-11-08,MIA,79,0,5,MIN,88,3,3,3,8
2003-11-08,CLE,111,0,5,WAS,98,3,2,3,7
2003-11-08,NOH,106,5,1,CHI,109,2,4,7,5
2003-11-08,MIL,90,3,3,NYK,87,2,3,5,6
2003-11-08,HOU,96,3,1,ORL,86,1,5,4,6
2003-11-08,SAS,78,3,3,DAL,81,3,3,6,6
2003-11-08,UTA,96,3,2,MEM,89,2,3,5,5
2003-11-08,POR,90,2,3,ATL,83,1,4,3,7
2003-11-09,TOR,89,3,2,DEN,76,3,3,6,5
2003-11-09,BOS,91,2,3,SAC,82,3,2,5,5
2003-11-09,PHI,74,3,3,IND,85,5,1,8,4
2003-11-09,DET,98,4,1,NJN,84,3,3,7,4
2003-11-09,SEA,81,3,0,ATL,91,1,5,4,5
2003-11-10,CLE,94,1,5,NYK,80,2,4,3,9
2003-11-10,MEM,105,2,4,LAL,95,5,1,7,5
2003-11-10,CHI,97,3,4,DEN,105,3,4,6,8
2003-11-10,SAS,87,3,4,UTA,78,4,2,7,6
2003-11-10,GSW,96,3,2,PHX,99,2,3,5,5
2003-11-11,WAS,105,3,3,PHI,112,3,4,6,7
2003-11-11,IND,76,6,1,BOS,78,3,3,9,4
2003-11-11,MIN,87,4,3,SEA,89,3,1,7,4
2003-11-11,DAL,125,4,3,NOH,97,5,2,9,5
2003-11-11,HOU,90,4,1,MIA,70,0,6,4,7
2003-11-11,SAC,97,3,3,DET,91,5,1,8,4
2003-11-11,POR,83,3,3,TOR,80,4,2,7,5
2003-11-11,LAC,115,1,2,ATL,103,2,5,3,7
2003-11-12,BOS,82,4,3,CHI,89,3,5,7,8
2003-11-12,NJN,71,3,4,SAS,85,4,4,7,8
2003-11-12,ORL,97,1,6,MEM,107,3,4,4,10
2003-11-12,MIA,88,0,7,CLE,83,2,5,2,12
2003-11-12,NOH,96,5,3,UTA,89,4,3,9,6
2003-11-12,MIL,99,4,3,SEA,104,4,1,8,4
2003-11-12,PHX,94,3,3,ATL,99,2,6,5,9
2003-11-12,GSW,87,3,3,DET,85,5,2,8,5
2003-11-12,LAL,94,5,2,TOR,79,4,3,9,5
2003-11-13,DAL,97,5,3,HOU,86,5,1,10,4
2003-11-13,CHI,89,4,5,MIN,92,4,4,8,9
2003-11-13,POR,112,4,3,SAC,110,4,3,8,6
2003-11-14,BOS,91,4,4,CLE,82,2,6,6,10
2003-11-14,NJN,85,3,5,NYK,80,2,5,5,10
2003-11-14,MIA,105,1,7,WAS,101,3,4,4,11
2003-11-14,IND,101,6,2,SEA,78,5,1,11,3
2003-11-14,PHI,100,4,4,SAS,96,5,4,9,8
2003-11-14,MIN,77,5,4,UTA,85,4,4,9,8
2003-11-14,HOU,90,5,2,PHX,85,3,4,8,6
2003-11-14,SAC,94,4,4,TOR,64,4,4,8,8
2003-11-14,DEN,106,4,4,ORL,101,1,7,5,11
2003-11-14,LAL,94,6,2,DET,89,5,3,11,5
2003-11-14,GSW,98,4,3,LAC,104,2,2,6,5
2003-11-15,NOH,101,6,3,POR,79,5,3,11,6
2003-11-15,WAS,71,3,5,SAS,95,5,5,8,10
2003-11-15,ATL,85,3,6,NJN,100,4,5,7,11
2003-11-15,NYK,94,2,6,IND,95,7,2,9,8
2003-11-15,CLE,91,2,7,PHI,88,5,4,7,11
2003-11-15,MEM,108,4,4,DAL,101,6,3,10,7
2003-11-15,CHI,90,4,6,SEA,98,5,2,9,8
2003-11-15,MIL,100,4,4,UTA,95,5,4,9,8
2003-11-15,PHX,91,3,5,DET,100,5,4,8,9
2003-11-15,LAC,95,3,2,ORL,92,1,8,4,10
2003-11-16,TOR,101,4,5,HOU,97,6,2,10,7
2003-11-16,SAC,106,5,4,GSW,104,4,4,9,8
2003-11-16,LAL,99,7,2,MIA,77,2,7,9,9
2003-11-17,PHI,66,5,5,HOU,74,6,3,11,8
2003-11-17,NYK,89,2,7,BOS,86,5,4,7,11
2003-11-17,ATL,97,3,7,WAS,106,3,6,6,13
2003-11-17,DAL,105,6,4,POR,98,5,4,11,8
2003-11-17,UTA,90,5,5,ORL,88,1,9,6,14
2003-11-18,CLE,103,3,7,LAC,95,4,2,7,9
2003-11-18,NJN,85,5,5,NOH,88,7,3,12,8
2003-11-18,DET,106,6,4,LAL,96,8,2,14,6
2003-11-18,MIL,93,5,4,ATL,101,3,8,8,12
2003-11-18,MIN,89,5,5,DEN,76,5,4,10,9
2003-11-18,SAS,94,6,5,GSW,81,4,5,10,10
2003-11-18,PHX,95,3,6,CHI,82,4,7,7,13
2003-11-18,SEA,98,6,2,MIA,105,2,8,8,10
2003-11-19,BOS,73,5,5,NOH,81,8,3,13,8
2003-11-19,WAS,106,4,6,CLE,95,4,7,8,13
2003-11-19,TOR,75,5,5,PHI,81,5,6,10,11
2003-11-19,IND,91,8,2,LAC,78,4,3,12,5
2003-11-19,NYK,83,3,7,LAL,104,8,3,11,10
2003-11-19,HOU,85,7,3,GSW,83,4,6,11,9
2003-11-19,MEM,92,5,4,DET,99,7,4,12,8
2003-11-19,DEN,94,5,5,MIL,86,5,5,10,10
2003-11-19,UTA,110,6,5,SAC,118,6,4,12,9
2003-11-19,POR,94,5,5,MIA,93,3,8,8,13
2003-11-20,DAL,95,7,4,SAS,92,7,5,14,9
2003-11-20,PHX,96,4,6,ORL,89,1,10,5,16
2003-11-21,PHI,87,6,6,BOS,85,5,6,11,12
2003-11-21,NOH,75,9,3,IND,76,9,2,18,5
2003-11-21,CLE,83,4,8,MIN,97,6,5,10,13
2003-11-21,DET,94,8,4,NYK,85,3,8,11,12
2003-11-21,SAS,114,7,6,ATL,75,4,8,11,14
2003-11-21,DEN,108,6,5,WAS,87,5,6,11,11
2003-11-21,UTA,99,6,6,MIL,90,5,6,11,12
2003-11-21,SAC,122,7,4,ORL,92,1,11,8,15
2003-11-21,LAL,101,9,3,CHI,94,4,8,13,11
2003-11-21,GSW,101,4,7,MIA,91,3,9,7,16
2003-11-21,POR,85,6,5,HOU,78,8,3,14,8
2003-11-21,SEA,97,6,3,MEM,98,5,5,11,8
2003-11-22,NJN,80,5,6,TOR,81,5,6,10,12
2003-11-22,ATL,92,4,9,CLE,83,4,9,8,18
2003-11-22,NYK,99,3,9,PHI,88,7,6,10,15
2003-11-22,MIN,103,7,5,LAC,91,4,4,11,9
2003-11-22,DAL,115,8,4,DEN,101,7,5,15,9
2003-11-22,PHX,100,5,6,MIA,98,3,10,8,16
2003-11-23,TOR,62,6,6,MIL,82,5,7,11,13
2003-11-23,DET,80,9,4,NOH,81,9,4,18,8
2003-11-23,GSW,78,5,7,POR,72,7,5,12,12
2003-11-23,SAC,110,8,4,CHI,99,4,9,12,13
2003-11-23,SEA,88,6,4,WAS,85,5,7,11,11
2003-11-23,LAL,121,10,3,MEM,89,6,5,16,8
2003-11-24,BOS,88,5,7,NYK,94,4,9,9,16
2003-11-24,ORL,78,1,12,IND,89,10,2,11,14
2003-11-24,ATL,89,5,9,DET,94,9,5,14,14
2003-11-24,LAC,90,4,5,HOU,105,8,4,12,9
2003-11-25,IND,98,11,2,MIN,75,8,5,19,7
2003-11-25,MIA,91,3,11,NOH,87,10,4,13,15
2003-11-25,MIL,95,6,7,PHI,91,7,7,13,14
2003-11-25,DAL,124,9,4,CHI,98,4,10,13,14
2003-11-25,DEN,110,7,6,PHX,80,6,6,13,12
2003-11-25,SAC,109,9,4,MEM,89,6,6,15,10
2003-11-25,POR,80,7,6,WAS,81,5,8,12,14
2003-11-25,SEA,70,7,4,NJN,93,5,7,12,11
2003-11-26,PHI,90,7,8,DET,86,10,5,17,13
2003-11-26,ORL,92,1,13,BOS,94,5,8,6,21
2003-11-26,ATL,97,5,10,TOR,99,6,7,11,17
2003-11-26,NOH,82,10,5,CLE,72,4,10,14,15
2003-11-26,MIN,92,8,6,NYK,97,5,9,13,15
2003-11-26,SAS,109,8,6,CHI,98,4,11,12,17
2003-11-26,UTA,83,7,6,HOU,76,9,4,16,10
2003-11-26,PHX,121,6,7,DAL,90,10,4,16,11
2003-11-26,LAL,120,11,3,WAS,99,6,8,17,11
2003-11-27,IND,93,12,2,NYK,70,6,9,18,11
2003-11-27,LAC,96,4,6,NJN,102,6,7,10,13
2003-11-28,BOS,106,6,8,MIL,96,7,7,13,15
2003-11-28,ATL,95,5,11,MIA,83,4,11,9,22
2003-11-28,ORL,86,1,14,TOR,87,7,7,8,21
2003-11-28,DET,92,10,6,CLE,88,4,11,14,17
2003-11-28,IND,90,13,2,PHI,77,8,8,21,10
2003-11-28,MEM,98,6,7,MIN,102,8,7,14,14
2003-11-28,DEN,113,8,6,DAL,103,10,5,18,11
2003-11-28,UTA,98,8,6,SEA,81,7,5,15,11
2003-11-28,PHX,83,7,7,GSW,92,6,7,13,14
2003-11-28,SAC,103,10,4,HOU,74,9,5,19,9
2003-11-28,POR,97,7,7,NJN,93,7,7,14,14
2003-11-28,LAL,103,12,3,SAS,87,9,6,21,9
2003-11-29,NYK,79,6,10,NOH,74,11,5,17,15
2003-11-29,PHI,98,8,9,ATL,86,6,11,14,20
2003-11-29,WAS,69,6,9,DET,80,11,6,17,15
2003-11-29,MIA,78,4,12,TOR,66,8,7,12,19
2003-11-29,CLE,115,4,12,MEM,122,6,8,10,20
2003-11-29,DAL,92,10,6,MIN,88,9,7,19,13
2003-11-29,MIL,100,7,8,BOS,94,7,8,14,16
2003-11-29,SEA,95,7,6,HOU,88,9,6,16,12
2003-11-29,LAC,86,4,7,DEN,98,9,6,13,13
2003-11-29,GSW,91,7,7,SAS,89,9,7,16,14
2003-11-30,SAC,105,11,4,NJN,92,7,8,18,12
2003-11-30,LAL,99,13,3,IND,77,14,2,27,5
2003-12-01,BOS,89,7,9,MEM,96,7,8,14,17
2003-12-01,NYK,78,7,10,DET,79,12,6,19,16
2003-12-01,CHI,97,4,12,MIL,87,8,8,12,20
2003-12-01,UTA,91,9,6,NJN,84,7,9,16,15
2003-12-01,PHX,82,7,8,IND,89,14,3,21,11
2003-12-01,LAC,91,4,8,SAS,83,9,8,13,16
2003-12-02,PHI,88,9,9,TOR,95,8,8,17,17
2003-12-02,ORL,91,1,15,NOH,100,11,6,12,21
2003-12-02,ATL,94,6,12,MIL,106,8,9,14,21
2003-12-02,DAL,97,11,6,WAS,72,6,10,17,16
2003-12-02,DEN,115,10,6,CLE,103,4,13,14,19
2003-12-03,TOR,105,9,8,BOS,95,7,10,16,18
2003-12-03,NJN,93,7,10,MEM,96,8,8,15,18
2003-12-03,DET,87,13,6,MIA,73,5,12,18,18
2003-12-03,NOH,106,12,6,ORL,91,1,16,13,22
2003-12-03,HOU,107,9,7,UTA,101,10,6,19,13
2003-12-03,SAS,86,9,9,LAL,90,14,3,23,12
2003-12-03,PHX,79,7,9,MIN,92,9,8,16,17
2003-12-03,POR,97,8,7,IND,95,15,3,23,10
2003-12-03,SEA,95,8,6,NYK,87,7,11,15,17
2003-12-03,LAC,90,5,8,CLE,80,4,14,9,22
2003-12-03,GSW,109,8,7,DEN,117,11,6,19,13
2003-12-04,PHI,83,9,10,CHI,82,5,12,14,22
2003-12-04,DAL,103,12,6,LAL,114,15,3,27,9
2003-12-05,TOR,92,10,8,ATL,87,6,13,16,21
2003-12-05,BOS,106,7,11,PHX,110,7,10,14,21
2003-12-05,NJN,93,7,11,MIL,86,9,9,16,20
2003-12-05,MIA,90,5,13,PHI,93,10,10,15,23
2003-12-05,ORL,94,1,17,SAS,105,9,10,10,27
2003-12-05,NOH,74,13,6,HOU,83,10,7,23,13
2003-12-05,MEM,92,9,8,WAS,77,6,11,15,19
2003-12-05,DEN,98,12,6,GSW,91,8,8,20,14
2003-12-05,UTA,86,10,7,LAC,67,6,8,16,15
2003-12-05,POR,88,9,7,NYK,81,7,12,16,19
2003-12-05,SAC,109,12,4,MIN,112,10,8,22,12
2003-12-05,SEA,94,9,6,IND,101,15,4,24,10
2003-12-06,NJN,99,8,11,PHX,88,8,10,16,21
2003-12-06,MIA,70,5,14,SAS,86,10,10,15,24
2003-12-06,CLE,95,4,15,ATL,85,6,14,10,29
2003-12-06,CHI,91,5,13,NOH,97,13,7,18,20
2003-12-06,MIL,109,9,10,WAS,114,6,12,15,22
2003-12-06,DAL,110,12,7,ORL,97,1,18,13,25
2003-12-06,HOU,86,11,7,DET,80,14,6,25,13
2003-12-06,GSW,104,8,9,NYK,92,7,13,15,22
2003-12-07,LAC,94,6,9,MIN,96,11,8,17,17
2003-12-07,TOR,108,11,8,SEA,98,9,7,20,15
2003-12-07,MEM,93,10,8,POR,79,10,7,20,15
2003-12-07,DEN,111,13,6,BOS,116,7,12,20,18
2003-12-07,SAC,91,12,5,IND,88,16,4,28,9
2003-12-07,LAL,94,16,3,UTA,92,11,7,27,10
2003-12-08,ORL,105,1,19,PHX,98,8,11,9,30
2003-12-08,NOH,91,14,7,MIL,85,9,11,23,18
2003-12-08,CHI,82,5,14,SAS,96,11,10,16,24
2003-12-08,UTA,80,11,8,BOS,102,8,12,19,20
2003-12-09,CLE,93,5,15,TOR,100,12,8,17,23
2003-12-09,IND,93,16,5,WAS,79,7,12,23,17
2003-12-09,NJN,101,9,11,SEA,88,9,8,18,19
2003-12-09,MIA,92,5,15,PHX,72,8,12,13,27
2003-12-09,ATL,112,6,15,DEN,98,13,7,19,22
2003-12-09,DET,76,14,7,PHI,78,11,10,25,17
2003-12-09,MIN,95,12,8,GSW,98,9,9,21,17
2003-12-09,HOU,93,12,7,POR,91,10,8,22,15
2003-12-09,SAC,105,13,5,LAC,95,6,10,19,15
2003-12-09,LAL,98,17,3,NYK,90,7,14,24,17
2003-12-10,BOS,126,9,12,SEA,112,9,9,18,21
2003-12-10,WAS,91,7,13,ORL,95,2,19,9,32
2003-12-10,MIL,94,9,12,GSW,89,10,9,19,21
2003-12-10,MEM,103,11,8,ATL,90,7,15,18,23
2003-12-10,SAS,102,12,10,POR,77,10,9,22,19
2003-12-10,UTA,95,11,9,NYK,73,7,15,18,24
2003-12-10,LAC,100,6,11,DAL,99,13,7,19,18
2003-12-11,CLE,95,5,16,DET,86,14,8,19,24
2003-12-11,HOU,67,13,7,SAS,71,13,10,26,17
2003-12-11,PHX,101,8,13,NOH,111,15,7,23,20
2003-12-12,PHI,77,12,10,DEN,86,13,8,25,18
2003-12-12,WAS,91,7,14,MIN,110,12,9,19,23
2003-12-12,BOS,114,10,12,TOR,111,13,8,23,20
2003-12-12,MIA,91,6,15,MEM,88,12,8,18,23
2003-12-12,IND,103,17,5,ATL,92,7,16,24,21
2003-12-12,ORL,95,3,19,NJN,99,10,11,13,30
2003-12-12,DET,72,14,9,SEA,93,9,10,23,19
2003-12-12,MIL,109,10,12,CHI,95,5,15,15,27
2003-12-12,UTA,93,12,9,SAC,100,14,5,26,14
2003-12-12,LAL,93,18,3,DAL,110,13,8,31,11
2003-12-12,GSW,85,10,10,NOH,96,16,7,26,17
2003-12-13,NYK,95,7,16,DEN,88,14,8,21,24
2003-12-13,ATL,102,7,17,ORL,105,3,20,10,37
2003-12-13,CLE,98,6,16,BOS,105,11,12,17,28
2003-12-13,MEM,110,12,9,NJN,63,11,11,23,20
2003-12-13,CHI,86,5,16,IND,75,18,5,23,21
2003-12-13,SAS,86,14,10,HOU,73,13,8,27,18
2003-12-13,POR,112,10,10,LAL,108,18,4,28,14
2003-12-13,LAC,106,7,11,PHX,91,8,14,15,25
2003-12-14,TOR,89,13,9,MIA,90,7,15,20,24
2003-12-14,SEA,108,10,10,MIL,102,11,12,21,22
2003-12-14,PHI,86,12,11,UTA,94,12,10,24,21
2003-12-14,NYK,89,8,16,WAS,87,7,15,15,31
2003-12-14,SAC,107,15,5,PHX,102,8,15,23,20
2003-12-15,BOS,95,12,12,MIN,116,13,9,25,21
2003-12-15,IND,95,18,6,CLE,85,6,17,24,23
2003-12-15,DAL,111,14,8,TOR,94,13,10,27,18
2003-12-15,SAS,78,15,10,MEM,67,13,9,28,19
2003-12-15,LAC,109,8,11,NOH,80,17,7,25,18
2003-12-16,WAS,91,7,16,UTA,87,13,10,20,26
2003-12-16,NYK,86,9,16,GSW,104,10,11,19,27
2003-12-16,MIA,97,8,15,ATL,79,7,18,15,33
2003-12-16,MIN,92,14,9,HOU,75,13,9,27,18
2003-12-16,MEM,105,13,10,SAC,100,16,5,29,15
2003-12-16,CHI,102,6,16,ORL,88,4,20,10,36
2003-12-16,DEN,116,14,9,NOH,94,17,8,31,17
2003-12-16,PHX,92,8,16,SEA,91,11,10,19,26
2003-12-16,POR,99,11,10,MIL,106,11,13,22,23
2003-12-17,PHI,87,12,12,MIA,76,9,15,21,27
2003-12-17,CLE,85,6,18,HOU,89,13,10,19,28
2003-12-17,IND,90,19,6,ORL,94,4,21,23,27
2003-12-17,NJN,87,11,12,UTA,74,13,11,24,23
2003-12-17,ATL,85,7,19,GSW,98,11,11,18,30
2003-12-17,DET,77,14,10,CHI,73,7,16,21,26
2003-12-17,BOS,105,12,13,DAL,103,15,8,27,21
2003-12-17,SAS,73,16,10,TOR,70,13,11,29,21
2003-12-17,SEA,98,11,11,DEN,99,15,9,26,20
2003-12-17,LAC,93,9,11,MIL,83,12,13,21,24
2003-12-18,MIN,114,15,9,DAL,109,15,9,30,18
2003-12-18,NOH,90,17,9,SAC,101,16,6,33,15
2003-12-18,POR,101,11,11,PHX,94,9,16,20,27
2003-12-19,PHI,81,13,12,CLE,88,6,19,19,31
2003-12-19,ORL,119,5,21,GSW,93,12,11,17,32
2003-12-19,TOR,105,13,12,NYK,99,9,17,22,29
2003-12-19,BOS,96,13,13,UTA,99,13,12,26,25
2003-12-19,NJN,97,12,12,WAS,87,8,16,20,28
2003-12-19,ATL,86,7,20,SAC,98,17,6,24,26
2003-12-19,IND,80,19,7,DET,75,15,10,34,17
2003-12-19,MEM,97,14,10,MIA,83,9,16,23,26
2003-12-19,HOU,99,14,10,LAC,85,10,11,24,21
2003-12-19,LAL,101,18,5,DEN,99,16,9,34,14
2003-12-19,SEA,73,11,12,SAS,87,17,10,28,22
2003-12-20,NYK,103,9,18,ATL,92,7,21,16,39
2003-12-20,NOH,94,17,10,MEM,89,15,10,32,20
2003-12-20,MIN,102,16,9,IND,80,20,7,36,16
2003-12-20,CHI,87,7,17,CLE,95,7,19,14,36
2003-12-20,MIL,92,12,14,NJN,87,13,12,25,26
2003-12-20,DAL,105,15,10,LAC,115,10,12,25,22
2003-12-20,DEN,106,16,10,SEA,115,11,13,27,23
2003-12-20,PHX,102,9,17,HOU,87,15,10,24,27
2003-12-20,POR,91,12,11,SAS,101,18,10,30,21
2003-12-21,TOR,93,14,12,ORL,104,6,21,20,33
2003-12-21,BOS,87,13,14,PHI,84,13,13,26,27
2003-12-21,MIA,104,9,17,GSW,93,12,12,21,29
2003-12-21,DET,96,15,11,UTA,75,14,12,29,23
2003-12-21,SAC,117,18,6,POR,98,12,12,30,18
2003-12-21,LAL,107,19,5,PHX,101,10,17,29,22
2003-12-22,PHI,95,13,14,ORL,73,7,21,20,35
2003-12-22,CHI,80,7,18,UTA,92,14,13,21,31
2003-12-22,DEN,106,16,11,MEM,99,15,11,31,22
2003-12-23,CLE,97,8,19,NOH,86,18,10,26,29
2003-12-23,NYK,92,10,18,MIN,98,17,9,27,27
2003-12-23,NJN,95,13,13,CHI,78,7,19,20,32
2003-12-23,MIA,79,10,17,WAS,72,8,17,18,34
2003-12-23,ATL,93,7,22,BOS,88,14,14,21,36
2003-12-23,MIL,83,13,14,DET,78,16,11,29,25
2003-12-23,HOU,71,15,11,IND,79,20,8,35,19
2003-12-23,SAS,111,19,10,LAC,90,11,12,30,22
2003-12-23,SAC,114,19,6,MEM,97,15,12,34,18
2003-12-23,POR,97,12,13,DAL,88,15,11,27,24
2003-12-23,SEA,116,12,13,PHX,90,10,18,22,31
2003-12-23,GSW,107,12,13,LAL,98,20,5,32,18
2003-12-25,ORL,113,7,22,CLE,101,9,19,16,41
2003-12-25,SAC,103,20,6,DAL,111,15,12,35,18
2003-12-25,LAL,87,20,6,HOU,99,15,12,35,18
2003-12-26,WAS,84,8,18,MIA,92,11,17,19,35
2003-12-26,CLE,80,9,20,CHI,87,7,20,16,40
2003-12-26,NOH,109,18,11,ATL,79,8,22,26,33
2003-12-26,DET,79,16,12,NJN,82,14,13,30,25
2003-12-26,MEM,94,15,13,NYK,98,10,19,25,32
2003-12-26,MIL,101,14,14,IND,96,21,8,35,22
2003-12-26,SAS,98,20,10,ORL,83,8,22,28,32
2003-12-26,DEN,95,17,11,HOU,94,16,12,33,23
2003-12-26,UTA,97,15,13,TOR,94,14,13,29,26
2003-12-26,PHX,102,10,19,BOS,104,14,15,24,34
2003-12-26,LAC,101,11,13,PHI,98,14,14,25,27
2003-12-26,GSW,98,13,13,SAC,91,20,7,33,20
2003-12-26,POR,101,13,13,MIN,92,18,9,31,22
2003-12-27,ATL,84,8,23,DET,87,16,13,24,36
2003-12-27,MIA,80,12,17,NYK,100,11,19,23,36
2003-12-27,IND,75,21,9,NJN,82,15,13,36,22
2003-12-27,CHI,100,8,20,WAS,86,8,19,16,39
2003-12-27,DAL,104,16,12,MEM,98,15,14,31,26
2003-12-27,SEA,86,13,13,MIN,104,18,10,31,23
2003-12-28,LAC,88,12,13,TOR,94,14,14,26,27
2003-12-28,CLE,86,9,21,POR,74,14,13,23,34
2003-12-28,SAS,89,21,10,MIL,74,15,14,36,24
2003-12-28,PHX,100,10,20,PHI,92,14,15,24,35
2003-12-28,DEN,103,18,11,GSW,79,14,13,32,24
2003-12-28,SAC,98,20,8,UTA,89,16,13,36,21
2003-12-28,LAL,105,20,7,BOS,82,15,15,35,22
2003-12-29,ORL,86,8,23,NYK,114,12,19,20,42
2003-12-29,IND,94,21,10,MEM,86,15,15,36,25
2003-12-29,NJN,87,16,13,POR,91,14,14,30,27
2003-12-29,DET,108,17,13,NOH,99,19,11,36,24
2003-12-29,CHI,83,9,20,MIA,90,12,18,21,38
2003-12-29,HOU,86,16,13,SEA,87,13,14,29,27
2003-12-29,UTA,106,16,14,PHI,97,14,16,30,30
2003-12-29,LAC,105,12,14,PHX,113,11,20,23,34
2003-12-29,GSW,91,14,14,BOS,100,15,16,29,30
2003-12-30,WAS,73,8,20,ATL,83,8,24,16,44
2003-12-30,CLE,89,10,21,IND,92,22,10,32,31
2003-12-30,NYK,102,13,19,MIA,73,13,18,26,37
2003-12-30,MIN,98,19,10,CHI,93,9,21,28,31
2003-12-30,MEM,99,15,16,SEA,105,14,14,29,30
2003-12-30,DAL,101,17,12,MIL,92,15,15,32,27
2003-12-30,DEN,74,19,11,TOR,81,15,14,34,25
2003-12-31,BOS,94,16,16,NOH,96,19,12,35,28
2003-12-31,DET,78,18,13,POR,71,15,14,33,27
2003-12-31,NJN,88,16,14,GSW,70,14,15,30,29
2003-12-31,LAC,120,12,15,DEN,104,19,12,31,27
2003-12-31,HOU,80,16,14,PHI,72,14,17,30,31
2004-01-02,WAS,97,8,21,GSW,79,14,16,22,37
2004-01-02,TOR,74,16,14,NOH,86,20,12,36,26
2004-01-02,BOS,90,16,17,IND,103,23,10,39,27
2004-01-02,NYK,99,14,19,CHI,104,9,22,23,41
2004-01-02,NJN,97,17,14,CLE,82,10,22,27,36
2004-01-02,MIA,112,13,19,ORL,101,8,24,21,43
2004-01-02,DET,93,19,13,PHX,81,12,20,31,33
2004-01-02,MIN,93,20,10,ATL,75,9,24,29,34
2004-01-02,MEM,100,15,17,UTA,88,17,14,32,31
2004-01-02,MIL,109,15,16,DAL,101,18,12,33,28
2004-01-02,POR,96,15,15,DEN,106,19,13,34,28
2004-01-02,SEA,111,15,14,LAL,109,21,7,36,21
2004-01-03,SAS,77,22,10,PHI,83,14,18,36,28
2004-01-03,LAC,109,13,15,SAC,116,21,8,34,23
2004-01-03,DET,99,20,13,GSW,93,14,17,34,30
2004-01-03,IND,91,24,10,NOH,84,21,12,45,22
2004-01-03,MEM,112,16,17,ORL,103,8,25,24,42
2004-01-03,CHI,77,10,22,BOS,88,16,18,26,40
2004-01-03,DAL,119,18,13,MIN,112,21,10,39,23
2004-01-03,HOU,84,17,14,UTA,63,17,15,34,29
2004-01-03,DEN,76,20,13,ATL,84,9,25,29,38
2004-01-04,TOR,83,16,15,PHX,73,12,21,28,36
2004-01-04,WAS,94,9,21,MIL,100,16,16,25,37
2004-01-04,NYK,85,14,20,NJN,95,18,14,32,34
2004-01-04,SAC,130,22,8,SEA,99,16,14,38,22
2004-01-04,LAC,101,13,16,LAL,98,21,8,34,24
2004-01-05,BOS,68,17,18,DET,78,21,13,38,31
2004-01-05,PHI,76,15,18,MIL,88,17,16,32,34
2004-01-05,MIA,65,14,19,IND,87,25,10,39,29
2004-01-05,CHI,87,10,23,PHX,82,12,22,22,45
2004-01-05,HOU,83,18,14,GSW,65,14,18,32,32
2004-01-05,DEN,74,20,14,SAS,98,22,11,42,25
2004-01-05,UTA,108,17,16,DAL,94,19,13,36,29
2004-01-05,SEA,119,16,15,POR,108,15,16,31,31
2004-01-06,CLE,107,10,23,NYK,96,14,21,24,44
2004-01-06,IND,114,26,10,ORL,107,8,26,34,36
2004-01-06,NJN,92,19,14,LAC,75,14,16,33,30
2004-01-06,MIN,106,21,11,LAL,90,21,9,42,20
2004-01-06,SAS,94,23,11,WAS,72,9,22,32,33
2004-01-06,SAC,105,23,8,ATL,89,10,25,33,33
2004-01-07,BOS,101,17,19,ORL,93,8,27,25,46
2004-01-07,PHI,100,15,19,LAC,80,14,17,29,36
2004-01-07,TOR,75,17,15,CLE,69,11,23,28,38
2004-01-07,MIA,102,14,20,CHI,95,11,23,25,43
2004-01-07,DET,85,22,13,HOU,66,19,14,41,27
2004-01-07,NOH,97,21,13,WAS,87,9,23,30,36
2004-01-07,MIL,95,18,16,PHX,87,12,23,30,39
2004-01-07,DAL,105,19,14,GSW,99,14,19,33,33
2004-01-07,DEN,113,20,15,LAL,91,21,10,41,25
2004-01-07,SEA,104,17,15,SAC,93,24,8,41,23
2004-01-08,NYK,79,14,22,HOU,111,19,15,33,37
2004-01-08,MIN,96,22,11,POR,75,15,18,37,29
2004-01-09,PHI,97,16,19,NJN,81,20,14,36,33
2004-01-09,ORL,103,8,28,WAS,92,9,24,17,52
2004-01-09,TOR,68,18,15,LAC,78,14,18,32,33
2004-01-09,BOS,107,18,19,CLE,82,11,24,29,43
2004-01-09,NOH,84,22,13,SAS,94,24,11,46,24
2004-01-09,DAL,80,20,14,IND,92,27,10,47,24
2004-01-09,CHI,78,11,24,POR,87,15,19,26,43
2004-01-09,MIL,103,19,16,MIA,94,15,20,34,36
2004-01-09,DEN,106,21,15,UTA,96,19,16,40,31
2004-01-09,PHX,93,12,24,SAC,113,24,9,36,33
2004-01-09,LAL,113,21,11,ATL,67,10,26,31,37
2004-01-09,SEA,122,18,15,MEM,116,18,18,36,33
2004-01-10,WAS,94,9,25,PHI,87,17,19,26,44
2004-01-10,NYK,94,14,23,MIL,88,20,16,34,39
2004-01-10,MIN,83,23,11,MIA,77,15,21,38,32
2004-01-10,CHI,89,11,25,NOH,84,22,14,33,39
2004-01-10,SAS,89,25,11,IND,88,28,10,53,21
2004-01-10,UTA,92,19,17,ATL,71,10,27,29,44
2004-01-10,GSW,113,14,20,SEA,110,19,15,33,35
2004-01-11,TOR,83,18,16,POR,72,16,19,34,35
2004-01-11,DET,115,23,13,DAL,102,20,15,43,28
2004-01-11,HOU,93,20,15,BOS,97,19,19,39,34
2004-01-11,SAC,117,25,9,DEN,106,22,15,47,24
2004-01-11,LAC,107,15,18,MEM,108,18,19,33,37
2004-01-12,NYK,121,15,23,DAL,127,20,16,35,39
2004-01-12,ORL,82,9,28,PHI,87,17,20,26,48
2004-01-12,LAL,89,22,11,CLE,79,11,25,33,36
2004-01-12,GSW,113,15,20,MEM,115,19,19,34,39
2004-01-13,WAS,80,10,25,HOU,93,20,16,30,41
2004-01-13,ATL,86,10,28,SAS,77,26,11,36,39
2004-01-13,NOH,89,22,15,MIN,94,24,11,46,26
2004-01-13,MIL,111,20,17,BOS,103,20,19,40,36
2004-01-13,CHI,89,12,25,DET,105,24,13,36,38
2004-01-13,UTA,97,20,17,GSW,80,15,21,35,38
2004-01-13,PHX,92,12,25,DEN,105,22,16,34,41
2004-01-13,SAC,90,26,9,MIA,86,15,22,41,31
2004-01-13,SEA,96,19,16,CLE,104,11,26,30,42
2004-01-13,LAC,103,15,19,POR,96,16,20,31,39
2004-01-14,BOS,80,20,20,HOU,95,21,16,41,36
2004-01-14,IND,85,28,11,ATL,78,11,28,39,39
2004-01-14,NYK,120,15,24,ORL,110,9,29,24,53
2004-01-14,NJN,115,20,15,WAS,103,10,26,30,41
2004-01-14,DET,95,25,13,TOR,91,19,16,44,29
2004-01-14,SAS,93,26,12,MIN,100,25,11,51,23
2004-01-14,DAL,125,21,16,PHI,122,18,20,39,36
2004-01-14,LAL,97,23,11,DEN,71,23,16,46,27
2004-01-15,NOH,74,22,16,TOR,78,19,17,41,33
2004-01-15,MIL,86,21,17,NJN,83,21,15,42,32
2004-01-15,MEM,108,20,19,CHI,93,12,26,32,45
2004-01-15,UTA,97,21,17,MIA,85,15,23,36,40
2004-01-15,POR,96,16,21,PHX,105,12,26,28,47
2004-01-15,GSW,119,15,22,CLE,102,12,26,27,48
2004-01-16,ORL,124,9,30,BOS,118,20,21,29,51
2004-01-16,IND,89,29,11,SAS,79,26,13,55,24
2004-01-16,NYK,108,16,24,SEA,88,19,17,35,41
2004-01-16,DET,98,26,13,WAS,77,10,27,36,40
2004-01-16,DEN,88,23,17,DAL,91,22,16,45,33
2004-01-16,PHX,104,13,26,GSW,93,16,22,29,48
2004-01-16,LAC,85,16,19,MIA,87,15,24,31,43
2004-01-16,SAC,103,27,9,LAL,83,24,11,51,20
2004-01-17,PHI,87,18,21,MEM,91,21,19,39,40
2004-01-17,HOU,95,22,16,MIN,76,26,11,48,27
2004-01-17,WAS,99,10,28,SEA,84,19,18,29,46
2004-01-17,ATL,75,11,29,TOR,70,20,17,31,46
2004-01-17,NJN,84,21,16,IND,90,30,11,51,27
2004-01-17,NOH,91,22,17,ORL,90,10,30,32,47
2004-01-17,CHI,96,12,27,NYK,101,17,24,29,51
2004-01-17,MIL,94,22,17,DET,99,27,13,49,30
2004-01-17,UTA,96,22,17,CLE,102,12,27,34,44
2004-01-17,POR,104,16,22,DAL,108,23,16,39,38
2004-01-17,LAL,91,24,12,LAC,89,16,20,40,32
2004-01-18,BOS,92,20,22,SAS,109,26,14,46,36
2004-01-18,PHX,96,14,26,POR,92,16,23,30,49
2004-01-18,DEN,88,23,18,MIA,80,16,24,39,42
2004-01-19,NYK,90,18,24,TOR,79,20,18,38,42
2004-01-19,WAS,93,11,28,CHI,83,12,28,23,56
2004-01-19,PHI,81,18,22,SEA,90,19,19,37,41
2004-01-19,ATL,97,12,29,IND,100,31,11,43,40
2004-01-19,ORL,106,10,31,MIL,99,22,18,32,49
2004-01-19,DET,85,28,13,SAS,77,27,14,55,27
2004-01-19,LAC,100,16,21,SAC,125,28,9,44,30
2004-01-19,MIN,97,26,12,NOH,90,23,17,49,29
2004-01-19,MEM,88,22,19,HOU,83,23,16,45,35
2004-01-19,GSW,101,16,23,UTA,85,22,18,38,41
2004-01-19,LAL,85,25,12,PHX,88,15,26,40,38
2004-01-20,CLE,99,13,27,SEA,94,20,19,33,46
2004-01-20,IND,81,32,11,DET,69,29,13,61,24
2004-01-20,MIA,84,16,25,BOS,86,20,23,36,48
2004-01-20,DAL,106,24,16,NJN,93,21,17,45,33
2004-01-20,UTA,75,22,19,DEN,96,24,18,46,37
2004-01-20,SAC,104,29,9,POR,109,16,24,45,33
2004-01-21,TOR,97,20,19,MIN,108,27,12,47,31
2004-01-21,ATL,97,12,30,CHI,87,12,29,24,59
2004-01-21,NOH,86,23,18,PHI,92,18,23,41,41
2004-01-21,MIL,113,22,19,ORL,102,11,31,33,50
2004-01-21,MEM,88,23,19,LAL,82,25,13,48,32
2004-01-21,SAS,99,27,15,NJN,76,21,18,48,33
2004-01-21,HOU,86,23,17,NYK,71,19,24,42,41
2004-01-21,DEN,97,25,18,PHX,92,16,26,41,44
2004-01-21,LAC,106,16,22,GSW,102,17,23,33,45
2004-01-22,CLE,89,14,27,SAC,95,29,10,43,37
2004-01-22,DAL,106,25,16,LAL,87,25,14,50,30
2004-01-22,SEA,103,20,20,GSW,87,17,24,37,44
2004-01-23,PHI,93,19,23,ORL,98,11,32,30,55
2004-01-23,BOS,100,21,23,WAS,89,12,28,33,51
2004-01-23,MIA,85,16,26,NJN,64,21,19,37,45
2004-01-23,ATL,94,13,30,NYK,96,19,25,32,55
2004-01-23,NOH,97,23,19,DEN,91,26,18,49,37
2004-01-23,IND,74,33,11,HOU,78,24,17,57,28
2004-01-23,MIN,80,28,12,DET,79,29,14,57,26
2004-01-23,MEM,109,24,19,SAC,95,30,10,54,29
2004-01-23,CHI,93,12,30,DAL,106,26,16,38,46
2004-01-23,MIL,98,23,19,TOR,86,20,20,43,39
2004-01-23,PHX,84,16,27,SAS,86,28,15,44,42
2004-01-23,LAC,93,17,22,UTA,82,22,20,39,42
2004-01-24,POR,87,17,24,GSW,105,17,25,34,49
2004-01-24,WAS,107,12,29,IND,96,33,12,45,41
2004-01-24,NYK,77,20,25,MIA,85,17,26,37,51
2004-01-24,CLE,95,14,28,PHI,87,19,24,33,52
2004-01-24,SAS,96,29,15,NOH,98,24,19,53,34
2004-01-24,UTA,86,22,21,LAL,93,25,15,47,36
2004-01-24,SEA,102,21,20,LAC,97,18,22,39,42
2004-01-25,NJN,110,21,20,BOS,91,22,23,43,43
2004-01-25,DAL,108,27,16,SAC,99,30,11,57,27
2004-01-25,CHI,96,12,31,TOR,89,20,21,32,52
2004-01-25,MIN,99,29,12,PHX,95,16,28,45,40
2004-01-25,ORL,87,12,32,HOU,99,25,17,37,49
2004-01-25,DET,82,29,15,ATL,91,13,31,42,46
2004-01-25,MEM,106,25,19,DEN,88,26,19,51,38
2004-01-26,WAS,83,13,29,POR,94,17,25,30,54
2004-01-26,CLE,99,15,28,ORL,98,12,33,27,61
2004-01-26,MIA,95,18,26,HOU,81,26,17,44,43
2004-01-26,MIL,93,24,19,SAS,92,29,16,53,35
2004-01-26,DEN,95,26,20,MIN,97,30,12,56,32
2004-01-26,UTA,98,22,22,LAC,93,18,23,40,45
2004-01-27,PHI,76,19,25,NJN,94,22,20,41,45
2004-01-27,NYK,67,20,26,SAS,77,29,17,49,43
2004-01-27,ATL,85,14,31,PHX,89,16,29,30,60
2004-01-27,SEA,116,22,20,DAL,118,28,16,50,36
2004-01-27,LAC,102,18,24,CHI,92,13,31,31,55
2004-01-28,BOS,103,22,24,DET,106,29,16,51,40
2004-01-28,WAS,100,13,30,ORL,104,12,34,25,64
2004-01-28,CLE,94,16,28,MIA,93,19,26,35,54
2004-01-28,IND,101,33,13,PHX,79,17,29,50,42
2004-01-28,TOR,94,20,22,PHI,84,19,26,39,48
2004-01-28,NOH,101,25,19,MIL,100,25,19,50,38
2004-01-28,MEM,76,26,19,POR,88,18,25,44,44
2004-01-28,HOU,94,26,18,SAC,99,30,12,56,30
2004-01-28,DEN,115,26,21,CHI,99,13,32,39,53
2004-01-28,UTA,91,23,22,DAL,88,29,16,52,38
2004-01-28,LAL,96,26,15,SEA,82,22,21,48,36
2004-01-28,GSW,97,18,25,MIN,90,31,12,49,37
2004-01-29,ORL,79,13,34,NJN,89,23,20,36,54
2004-01-29,ATL,85,14,32,POR,93,19,25,33,57
2004-01-29,SAS,91,30,17,SAC,96,31,12,61,29
2004-01-30,PHI,85,19,27,NOH,82,26,19,45,46
2004-01-30,WAS,105,13,31,PHX,100,17,30,30,61
2004-01-30,TOR,89,21,22,DET,90,30,16,51,38
2004-01-30,BOS,74,22,25,NYK,92,20,27,42,52
2004-01-30,MIA,97,19,27,LAC,88,19,24,38,51
2004-01-30,MEM,79,26,20,UTA,85,24,22,50,42
2004-01-30,MIL,101,25,20,CLE,95,17,28,42,48
2004-01-30,LAL,84,27,15,MIN,97,31,13,58,28
2004-01-30,GSW,101,19,25,CHI,81,13,33,32,58
2004-01-31,DAL,102,29,17,DEN,107,27,21,56,38
2004-01-31,HOU,77,26,19,NJN,88,24,20,50,39
2004-01-31,ORL,106,13,35,LAC,115,19,25,32,60
2004-01-31,ATL,93,14,33,MIL,83,26,20,40,53
2004-01-31,NYK,110,21,27,PHX,105,17,31,38,58
2004-01-31,DET,80,31,16,MEM,78,26,21,57,37
2004-01-31,NOH,70,26,20,MIA,94,20,27,46,47
2004-01-31,IND,99,34,13,BOS,98,22,26,56,39
2004-01-31,SAS,85,30,18,UTA,81,25,22,55,40
2004-01-31,POR,102,20,25,CHI,95,13,34,33,59
2004-01-31,SEA,103,22,22,SAC,110,32,12,54,34
2004-02-01,WAS,100,14,31,CLE,104,17,29,31,60
2004-02-01,TOR,83,21,23,LAL,84,27,16,48,39
2004-02-01,MIN,106,32,13,PHI,101,20,27,52,40
2004-02-02,IND,85,35,13,LAL,72,28,16,63,29
2004-02-02,MIA,100,21,27,DET,102,32,16,53,43
2004-02-02,ATL,95,15,33,LAC,101,20,25,35,58
2004-02-02,NOH,70,26,21,NJN,91,25,20,51,41
2004-02-02,MEM,106,26,22,GSW,101,20,25,46,47
2004-02-02,DEN,116,28,21,POR,97,21,25,49,46
2004-02-02,UTA,65,25,23,SAS,83,31,18,56,41
2004-02-02,PHX,99,17,32,HOU,79,26,20,43,52
2004-02-02,SEA,109,22,23,CHI,97,13,35,35,58
2004-02-03,PHI,80,20,28,TOR,93,21,24,41,52
2004-02-03,NYK,97,22,27,IND,90,36,13,58,40
2004-02-03,DET,82,33,16,CLE,85,18,29,51,45
2004-02-03,MIN,113,33,13,ORL,100,13,36,46,49
2004-02-03,DAL,107,29,18,GSW,93,20,26,49,44
2004-02-03,SAC,117,33,12,SEA,101,23,23,56,35
2004-02-04,BOS,86,22,27,LAC,95,21,25,43,52
2004-02-04,WAS,101,14,32,MEM,103,27,22,41,54
2004-02-04,TOR,110,22,24,ORL,90,13,37,35,61
2004-02-04,NJN,99,26,20,MIA,88,21,28,47,48
2004-02-04,ATL,97,15,34,MIN,89,34,13,49,47
2004-02-04,CLE,106,19,29,LAL,111,28,17,47,46
2004-02-04,NOH,104,26,22,DAL,113,30,18,56,40
2004-02-04,HOU,103,26,21,MIL,89,26,21,52,42
2004-02-04,UTA,79,25,24,CHI,95,13,36,38,60
2004-02-04,PHX,97,18,32,POR,101,21,26,39,58
2004-02-05,PHI,96,20,29,LAL,73,29,17,49,46
2004-02-05,SEA,90,23,24,SAS,96,32,18,55,42
2004-02-06,WAS,112,14,33,LAC,100,22,25,36,58
2004-02-06,BOS,96,22,28,ATL,100,16,34,38,62
2004-02-06,TOR,77,23,24,IND,83,36,14,59,38
2004-02-06,NJN,120,27,20,ORL,99,13,38,40,58
2004-02-06,NOH,92,26,23,DET,81,33,17,59,40
2004-02-06,MIN,103,34,14,CLE,92,19,30,53,44
2004-02-06,MEM,105,28,22,MIL,85,26,22,54,44
2004-02-06,HOU,82,27,21,CHI,80,14,36,41,57
2004-02-06,UTA,73,25,25,POR,87,22,26,47,51
2004-02-06,PHX,105,18,33,SEA,107,23,25,41,58
2004-02-06,GSW,96,20,27,DEN,87,29,21,49,48
2004-02-06,SAC,94,34,12,SAS,102,33,18,67,30
2004-02-07,MIA,64,21,29,NYK,76,23,27,44,56
2004-02-07,PHI,80,21,29,BOS,110,22,29,43,58
2004-02-07,ATL,77,17,34,HOU,86,28,21,45,55
2004-02-07,CLE,88,19,31,WAS,106,15,33,34,64
2004-02-07,MIL,107,26,23,NOH,97,27,23,53,46
2004-02-07,DAL,111,31,18,DET,108,33,18,64,36
2004-02-07,PHX,92,18,34,UTA,96,25,26,43,60
2004-02-08,ORL,96,13,39,LAL,98,29,18,42,57
2004-02-08,IND,97,37,14,MIA,91,21,30,58,44
2004-02-08,MIN,98,35,14,MEM,99,29,22,64,36
2004-02-08,NYK,110,24,27,LAC,104,22,26,46,53
2004-02-08,NJN,99,28,20,PHI,87,21,30,49,50
2004-02-08,POR,95,23,26,SEA,85,24,25,47,51
2004-02-08,GSW,81,21,27,TOR,84,23,25,44,52
2004-02-08,SAC,115,34,13,DEN,92,29,22,63,35
2004-02-09,CLE,97,19,32,BOS,89,23,29,42,61
2004-02-09,ATL,102,17,35,DAL,96,32,18,49,53
2004-02-09,DEN,86,29,23,MEM,83,30,22,59,45
2004-02-09,HOU,82,29,21,SAS,85,34,18,63,39
2004-02-10,NJN,89,29,20,DET,78,33,19,62,39
2004-02-10,MIA,83,21,31,LAL,98,30,18,51,49
2004-02-10,MIL,117,27,23,SAC,124,35,13,62,36
2004-02-10,MIN,96,35,15,LAC,84,22,27,57,42
2004-02-10,CHI,84,14,37,IND,103,38,14,52,51
2004-02-10,DAL,105,32,19,NYK,90,25,27,57,46
2004-02-10,PHX,94,18,35,TOR,101,24,25,42,60
2004-02-10,POR,81,24,26,UTA,86,26,26,50,52
2004-02-10,SEA,97,24,26,GSW,106,21,28,45,54
2004-02-11,PHI,113,21,31,WAS,88,16,33,37,64
2004-02-11,ORL,98,13,40,MIA,111,21,32,34,72
2004-02-11,CLE,85,20,32,NJN,105,30,20,50,52
2004-02-11,DET,94,33,20,SAC,96,36,13,69,33
2004-02-11,NOH,106,27,24,NYK,98,25,28,52,52
2004-02-11,MEM,110,30,23,LAC,102,22,28,52,51
2004-02-11,HOU,102,29,22,LAL,87,31,18,60,40
2004-02-11,UTA,66,27,26,MIN,77,36,15,63,41
2004-02-11,GSW,110,22,28,PHX,99,18,36,40,64
2004-02-12,CHI,107,14,38,BOS,87,23,30,37,68
2004-02-12,POR,98,24,27,DEN,107,30,23,54,50
2004-02-12,SEA,94,24,27,TOR,74,25,25,49,52
2004-02-17,IND,75,39,14,NOH,89,28,24,67,38
2004-02-17,NYK,92,25,29,DET,88,33,21,58,50
2004-02-17,MIA,97,22,32,UTA,85,27,27,49,59
2004-02-17,MIL,127,27,24,ORL,104,13,41,40,65
2004-02-17,MIN,110,37,15,PHX,95,18,37,55,52
2004-02-17,MEM,109,31,23,DAL,92,33,19,64,42
2004-02-17,CHI,75,15,38,TOR,73,25,26,40,64
2004-02-17,HOU,107,30,22,WAS,81,16,34,46,56
2004-02-17,DEN,106,31,23,PHI,85,22,31,53,54
2004-02-17,SAC,127,37,13,BOS,111,23,31,60,44
2004-02-17,LAL,89,31,19,POR,86,24,28,55,47
2004-02-18,ORL,90,13,42,UTA,77,27,28,40,70
2004-02-18,TOR,82,25,27,SAS,86,35,18,60,45
2004-02-18,CLE,98,20,33,DAL,114,33,20,53,53
2004-02-18,NJN,98,31,20,ATL,92,18,35,49,55
2004-02-18,DET,102,33,22,MIL,98,28,24,61,46
2004-02-18,NOH,120,29,24,WAS,98,16,35,45,59
2004-02-18,POR,101,24,29,LAC,86,22,29,46,58
2004-02-18,GSW,99,23,28,LAL,100,32,19,55,47
2004-02-19,MIN,92,38,15,SAC,75,38,13,76,28
2004-02-19,SEA,101,25,27,PHI,112,22,32,47,59
2004-02-19,LAC,102,22,30,BOS,100,23,32,45,62
2004-02-20,WAS,87,16,36,IND,96,39,15,55,51
2004-02-20,ORL,102,14,42,DEN,98,32,23,46,65
2004-02-20,NYK,78,26,29,UTA,92,27,29,53,58
2004-02-20,MIA,125,23,32,ATL,92,18,36,41,68
2004-02-20,TOR,72,25,28,NJN,91,32,20,57,48
2004-02-20,CLE,89,20,34,SAS,87,36,18,56,52
2004-02-20,DET,87,34,22,MIN,88,39,15,73,37
2004-02-20,MEM,97,32,23,PHX,92,18,38,50,61
2004-02-20,CHI,83,16,38,SAC,91,38,14,54,52
2004-02-20,LAL,116,33,19,PHI,88,23,32,56,51
2004-02-20,GSW,93,23,29,POR,94,25,29,48,58
2004-02-21,NJN,97,33,20,NOH,84,30,24,63,44
2004-02-21,MIA,97,24,32,DEN,81,32,24,56,56
2004-02-21,CHI,98,16,39,MEM,105,33,23,49,62
2004-02-21,MIL,103,28,25,LAC,105,23,30,51,55
2004-02-21,DAL,97,34,20,HOU,88,31,22,65,42
2004-02-21,POR,105,26,29,BOS,84,23,33,49,62
2004-02-21,GSW,94,23,30,SEA,92,25,28,48,58
2004-02-22,NYK,86,26,30,CLE,92,21,34,47,64
2004-02-22,TOR,81,25,29,SAC,96,39,14,64,43
2004-02-22,IND,94,40,15,UTA,80,28,29,68,44
2004-02-22,MIN,92,40,15,SAS,94,36,19,76,34
2004-02-22,WAS,85,16,37,MIL,113,28,26,44,63
2004-02-22,DET,86,34,23,ORL,87,15,42,49,65
2004-02-22,PHX,92,18,39,LAL,104,34,19,52,58
2004-02-22,HOU,123,31,23,ATL,121,18,37,49,60
2004-02-22,SEA,108,25,29,BOS,87,23,34,48,63
2004-02-23,PHI,66,23,33,DET,76,34,24,57,57
2004-02-23,CLE,104,22,34,NOH,100,30,25,52,59
2004-02-23,MIA,81,25,32,POR,89,27,29,52,61
2004-02-23,MEM,109,34,23,DEN,106,32,25,66,48
2004-02-24,ORL,91,16,42,POR,94,28,29,44,71
2004-02-24,IND,107,41,15,GSW,96,24,30,65,45
2004-02-24,NJN,86,34,20,TOR,74,25,30,59,50
2004-02-24,ATL,86,18,38,PHI,75,23,34,41,72
2004-02-24,MIL,102,29,26,MIN,108,40,16,69,42
2004-02-24,DAL,116,35,20,LAC,91,24,30,59,50
2004-02-24,SAS,86,37,19,HOU,77,32,23,69,42
2004-02-24,UTA,99,28,30,SEA,86,26,29,54,59
2004-02-24,SAC,107,40,14,NYK,99,26,31,66,45
2004-02-25,BOS,104,23,35,MIL,106,29,27,52,62
2004-02-25,TOR,74,25,31,WAS,76,16,38,41,69
2004-02-25,NOH,99,30,26,LAC,93,24,31,54,57
2004-02-25,MIN,81,41,16,NJN,68,35,20,76,36
2004-02-25,MEM,92,35,23,GSW,99,24,31,59,54
2004-02-25,CHI,88,16,40,DET,107,35,24,51,64
2004-02-25,HOU,90,32,24,CLE,84,23,34,55,58
2004-02-25,DEN,111,32,26,LAL,112,35,19,67,45
2004-02-25,PHX,113,18,40,NYK,95,26,32,44,72
2004-02-25,SEA,92,26,30,UTA,93,29,30,55,60
2004-02-26,WAS,95,17,38,CHI,87,16,41,33,79
2004-02-26,DAL,115,36,20,SAS,91,38,19,74,39
2004-02-26,LAL,101,36,19,SAC,103,41,14,77,33
2004-02-27,BOS,88,23,36,TOR,75,25,32,48,68
2004-02-27,ORL,107,16,43,CLE,112,23,35,39,78
2004-02-27,NOH,89,31,26,IND,77,42,15,73,41
2004-02-27,DET,105,36,24,ATL,83,19,38,55,62
2004-02-27,MIN,91,42,16,GSW,81,25,31,67,47
2004-02-27,MIL,106,30,27,MEM,104,35,24,65,51
2004-02-27,HOU,89,33,24,POR,85,29,29,62,53
2004-02-27,SEA,99,26,31,PHX,104,19,40,45,71
2004-02-27,SAC,97,42,14,UTA,102,30,30,72,44
2004-02-27,LAC,96,24,32,NYK,94,26,33,50,65
2004-02-28,NJN,92,35,21,MIA,86,25,33,60,54
2004-02-28,WAS,110,18,38,LAL,122,36,20,54,58
2004-02-28,ATL,99,19,39,ORL,104,16,44,35,83
2004-02-28,IND,81,42,16,PHI,74,23,35,65,51
2004-02-28,MEM,97,35,25,NOH,92,32,26,67,51
2004-02-28,CHI,87,16,42,GSW,81,25,32,41,74
2004-02-28,DAL,111,37,20,POR,91,29,30,66,50
2004-02-28,SAS,117,38,20,DEN,92,32,27,70,47
2004-02-29,TOR,82,25,33,BOS,91,24,36,49,69
2004-02-29,MIL,108,31,27,MIA,104,25,34,56,61
2004-02-29,HOU,80,34,24,SEA,97,26,32,60,56
2004-02-29,NJN,83,36,21,LAL,100,37,20,73,41
2004-02-29,PHI,81,23,36,MIN,74,43,16,66,52
2004-02-29,DEN,107,32,28,NYK,96,26,34,58,62
2004-02-29,SAC,108,42,15,PHX,94,20,40,62,55
2004-02-29,LAC,88,25,32,DET,100,37,24,62,56
2004-03-01,BOS,117,25,36,ORL,96,17,44,42,80
2004-03-01,WAS,111,18,39,NOH,106,32,27,50,66
2004-03-01,CHI,92,17,42,CLE,81,24,35,41,77
2004-03-01,SAS,80,39,20,MEM,81,36,25,75,45
2004-03-01,UTA,94,31,30,DET,86,38,24,69,54
2004-03-02,MIA,86,25,35,TOR,89,25,34,50,69
2004-03-02,ATL,94,19,40,LAL,93,38,20,57,60
2004-03-02,DAL,107,38,20,SEA,96,27,32,65,52
2004-03-02,DEN,91,33,28,NJN,95,36,22,69,50
2004-03-02,SAC,113,43,15,LAC,106,25,33,68,48
2004-03-02,GSW,88,25,33,IND,96,43,16,68,49
2004-03-03,POR,88,15,17,MEM,97,17,17,32,34
2004-03-03,WAS,84,19,39,TOR,70,26,34,45,73
2004-03-03,ORL,97,17,45,MIL,105,32,27,49,72
2004-03-03,CLE,112,24,36,ATL,80,20,40,44,76
2004-03-03,NYK,88,26,35,PHI,77,24,36,50,71
2004-03-03,NOH,100,32,28,CHI,97,18,42,50,70
2004-03-03,MIN,121,43,17,DAL,97,39,20,82,37
2004-03-03,SAS,88,39,21,SEA,84,27,33,66,54
2004-03-03,HOU,93,34,25,LAL,96,38,21,72,46
2004-03-03,PHX,87,20,41,NJN,74,37,22,57,63
2004-03-03,LAC,94,25,34,IND,101,44,16,69,50
2004-03-04,PHI,105,24,37,SAC,114,44,15,68,52
2004-03-04,MIA,104,25,36,MIL,98,33,27,58,63
2004-03-04,POR,68,29,31,DET,83,38,25,67,56
2004-03-05,ORL,101,17,46,ATL,96,20,41,37,87
2004-03-05,TOR,103,26,35,NYK,109,27,35,53,70
2004-03-05,BOS,94,26,36,WAS,90,20,39,46,75
2004-03-05,NOH,85,33,28,CLE,88,25,36,58,64
2004-03-05,MIN,109,44,17,HOU,112,34,26,78,43
2004-03-05,SAS,113,40,21,DAL,100,39,21,79,42
2004-03-05,UTA,88,32,30,IND,96,45,16,77,46
2004-03-05,LAL,99,39,21,SEA,91,27,34,66,55
2004-03-05,GSW,74,25,34,NJN,78,37,23,62,57
2004-03-06,MIA,102,26,36,SAC,96,45,15,71,51
2004-03-06,LAC,92,25,35,MEM,98,37,25,62,60
2004-03-06,PHI,97,24,38,CHI,88,18,43,42,81
2004-03-06,CLE,106,26,36,MIL,97,33,28,59,64
2004-03-06,DEN,66,33,29,DET,97,39,25,72,54
2004-03-06,PHX,86,21,41,SAS,107,41,21,62,62
2004-03-06,POR,91,29,32,UTA,70,32,31,61,63
2004-03-07,TOR,84,26,36,NOH,76,33,29,59,65
2004-03-07,HOU,101,35,26,DAL,98,39,22,74,48
2004-03-07,WAS,86,20,40,NYK,99,28,35,48,75
2004-03-07,LAL,94,40,21,NJN,88,38,23,78,44
2004-03-07,ORL,90,18,46,SAC,107,45,16,63,62
2004-03-07,MIN,77,44,18,BOS,80,27,36,71,54
2004-03-07,GSW,85,25,35,MEM,95,38,25,63,60
2004-03-07,SEA,65,27,35,DET,86,40,25,67,60
2004-03-07,LAC,91,25,36,POR,71,30,32,55,68
2004-03-07,DEN,94,33,30,IND,103,46,16,79,46
2004-03-08,PHI,97,25,38,MIL,92,33,29,58,67
2004-03-08,ATL,102,20,42,CLE,108,27,36,47,78
2004-03-08,DAL,103,39,23,PHX,90,21,42,60,65
2004-03-08,UTA,88,32,32,LAL,83,41,21,73,53
2004-03-09,WAS,87,20,41,DEN,117,33,31,53,72
2004-03-09,IND,94,47,16,TOR,84,27,36,74,52
2004-03-09,NYK,84,29,35,BOS,87,28,36,57,71
2004-03-09,MIA,100,27,36,ORL,89,18,47,45,83
2004-03-09,MEM,94,39,25,SAS,88,42,21,81,46
2004-03-09,CHI,81,18,44,PHI,89,26,38,44,82
2004-03-09,HOU,90,36,26,LAC,85,26,36,62,62
2004-03-09,SAC,96,46,16,GSW,92,25,36,71,52
2004-03-09,SEA,92,27,36,MIN,105,44,19,71,55
2004-03-10,BOS,109,29,36,LAL,117,41,22,70,58
2004-03-10,ORL,108,18,48,WAS,99,20,42,38,90
2004-03-10,TOR,92,27,37,CLE,106,28,36,55,73
2004-03-10,NJN,98,38,24,DEN,97,34,31,72,55
2004-03-10,DET,98,41,25,CHI,65,18,45,59,70
2004-03-10,NOH,95,33,30,MIA,84,28,36,61,66
2004-03-10,MIL,94,33,30,ATL,80,20,43,53,73
2004-03-10,SAS,108,42,22,LAC,90,26,37,68,59
2004-03-10,UTA,91,33,32,GSW,77,25,37,58,69
2004-03-10,POR,92,30,33,MIN,79,45,19,75,52
2004-03-11,HOU,97,37,26,NOH,86,34,30,71,56
2004-03-11,SAC,120,47,16,DAL,102,40,23,87,39
2004-03-12,PHI,99,27,38,NYK,94,29,36,56,74
2004-03-12,BOS,81,29,37,IND,99,48,16,77,53
2004-03-12,NJN,88,39,24,CHI,76,18,46,57,70
2004-03-12,MIA,82,28,37,SEA,74,27,37,55,74
2004-03-12,ATL,138,20,44,WAS,124,20,43,40,87
2004-03-12,MIN,96,45,20,LAL,86,42,22,87,42
2004-03-12,MEM,98,40,25,LAC,89,26,38,66,63
2004-03-12,MIL,111,34,30,DEN,117,34,32,68,62
2004-03-12,SAS,99,43,22,GSW,74,25,38,68,60
2004-03-12,PHX,90,21,43,UTA,99,34,32,55,75
2004-03-12,POR,83,31,33,SAC,81,48,16,79,49
2004-03-13,WAS,102,20,44,BOS,111,29,38,49,82
2004-03-13,ORL,101,19,48,SEA,115,27,38,46,86
2004-03-13,NOH,102,34,31,GSW,84,25,39,59,70
2004-03-13,CHI,81,18,47,LAL,88,42,23,60,70
2004-03-13,HOU,88,38,26,MEM,80,41,25,79,51
2004-03-13,PHX,90,21,44,DAL,113,40,24,61,68
2004-03-14,TOR,101,27,38,ATL,84,21,44,48,82
2004-03-14,DET,85,42,25,PHI,69,28,38,70,63
2004-03-14,CLE,107,29,36,IND,104,49,16,78,52
2004-03-14,MIL,100,34,31,NYK,103,29,37,63,68
2004-03-14,MIN,83,46,20,POR,92,32,33,78,53
2004-03-14,SAC,101,48,17,SAS,87,44,22,92,39
2004-03-14,MIA,104,29,37,NJN,95,40,24,69,61
2004-03-14,DEN,102,35,32,UTA,75,35,32,70,64
2004-03-14,LAC,88,26,39,DAL,101,41,24,67,63
2004-03-15,HOU,97,39,26,PHX,99,21,45,60,71
2004-03-15,GSW,97,25,40,SAS,80,44,23,69,63
2004-03-15,LAL,113,43,23,ORL,110,19,49,62,72
2004-03-16,CLE,111,30,36,CHI,87,18,48,48,84
2004-03-16,NYK,114,30,37,WAS,110,20,45,50,82
2004-03-16,NJN,94,40,25,SAC,77,49,17,89,42
2004-03-16,MIA,96,30,37,NOH,83,35,31,65,68
2004-03-16,ATL,110,21,45,SEA,118,28,38,49,83
2004-03-16,MIL,99,34,32,POR,100,33,33,67,65
2004-03-16,MEM,82,41,26,PHI,79,28,39,69,65
2004-03-16,PHX,98,22,45,LAC,110,26,40,48,85
2004-03-17,BOS,104,30,38,DEN,100,36,32,66,70
2004-03-17,WAS,114,20,46,SAC,108,49,18,69,64
2004-03-17,IND,80,49,17,POR,71,34,33,83,50
2004-03-17,TOR,85,28,38,UTA,81,35,33,63,71
2004-03-17,NOH,104,35,32,PHI,80,28,40,63,72
2004-03-17,DAL,110,42,24,ATL,111,21,46,63,70
2004-03-17,LAC,103,27,40,LAL,106,44,23,71,63
2004-03-17,GSW,110,26,40,ORL,85,19,50,45,90
2004-03-18,NJN,71,41,25,DET,89,43,25,84,50
2004-03-18,MEM,94,42,26,SEA,97,29,38,71,64
2004-03-18,SAS,106,44,24,MIN,86,46,21,90,45
2004-03-19,WAS,94,21,46,ATL,84,22,46,43,92
2004-03-19,TOR,91,29,38,CHI,96,18,49,47,87
2004-03-19,NYK,79,31,37,NJN,65,41,26,72,63
2004-03-19,CLE,88,31,36,UTA,97,35,34,66,70
2004-03-19,IND,92,50,17,SAC,94,49,19,99,36
2004-03-19,NOH,80,36,32,SEA,91,30,38,66,70
2004-03-19,DET,94,44,25,DEN,75,36,33,80,58
2004-03-19,DAL,120,42,25,BOS,104,31,38,73,63
2004-03-19,PHX,80,22,46,MIN,93,46,22,68,68
2004-03-19,LAL,106,45,23,LAC,100,27,41,72,64
2004-03-19,GSW,90,27,40,HOU,84,39,27,66,67
2004-03-20,MIA,101,31,37,PHI,69,28,41,59,78
2004-03-20,ATL,81,22,47,UTA,87,36,34,58,81
2004-03-20,MEM,99,42,27,IND,95,50,18,92,45
2004-03-20,CHI,87,19,49,NYK,81,32,37,51,86
2004-03-20,SAS,103,45,24,BOS,87,31,39,76,63
2004-03-20,PHX,123,22,47,MIL,111,34,33,56,80
2004-03-20,POR,92,34,34,ORL,73,19,51,53,85
2004-03-21,NJN,98,41,27,DAL,101,43,25,84,52
2004-03-21,MIN,98,47,22,DEN,77,36,34,83,56
2004-03-21,LAC,85,27,42,GSW,96,28,40,55,82
2004-03-21,WAS,81,22,46,MIA,101,32,37,54,83
2004-03-21,CLE,76,31,37,DET,96,45,25,76,62
2004-03-21,NOH,120,36,33,TOR,121,29,39,65,72
2004-03-21,SAC,100,50,19,HOU,95,39,28,89,47
2004-03-21,SEA,84,31,38,ORL,67,19,52,50,90
2004-03-21,LAL,104,46,23,MIL,103,34,34,80,57
2004-03-22,PHI,107,28,42,DAL,98,44,25,72,67
2004-03-22,IND,101,50,19,CHI,77,20,49,70,68
2004-03-22,NYK,96,32,38,ATL,84,22,48,54,86
2004-03-22,DEN,102,36,35,LAC,80,27,43,63,78
2004-03-22,POR,85,35,34,HOU,93,39,29,74,63
2004-03-23,CLE,86,31,38,PHX,103,23,47,54,85
2004-03-23,NOH,82,36,34,DET,81,46,25,82,59
2004-03-23,MIN,86,48,22,SAS,81,46,24,94,46
2004-03-23,MEM,95,43,27,TOR,86,30,39,73,66
2004-03-23,CHI,81,20,50,NJN,84,41,28,61,78
2004-03-23,UTA,85,37,34,WAS,77,22,47,59,81
2004-03-23,SAC,101,51,19,MIL,112,34,35,85,54
2004-03-24,PHI,99,29,42,PHX,94,24,47,53,89
2004-03-24,ORL,90,19,53,MIA,105,33,37,52,90
2004-03-24,NYK,97,33,38,MEM,111,44,27,77,65
2004-03-24,IND,103,51,19,DAL,99,44,26,95,45
2004-03-24,HOU,90,40,29,TOR,89,30,40,70,69
2004-03-24,DEN,101,37,35,MIN,92,49,22,86,57
2004-03-24,POR,91,35,35,LAC,85,27,44,62,79
2004-03-24,SEA,84,32,38,UTA,77,38,34,70,72
2004-03-24,LAL,115,47,23,SAC,91,51,20,98,43
2004-03-24,GSW,98,29,40,MIL,89,35,35,64,75
2004-03-25,ATL,84,22,49,NOH,76,37,34,59,83
2004-03-25,SAS,84,46,25,DET,75,46,26,92,51
2004-03-25,LAC,94,27,45,WAS,103,22,48,49,93
2004-03-26,PHI,86,30,42,CLE,71,31,39,61,81
2004-03-26,ORL,92,19,54,IND,107,52,19,71,73
2004-03-26,NYK,108,33,39,TOR,101,30,41,63,80
2004-03-26,MIA,119,34,37,DAL,118,44,27,78,64
2004-03-26,BOS,102,31,40,NJN,93,42,28,73,68
2004-03-26,NOH,94,37,35,PHX,99,24,48,61,83
2004-03-26,MEM,109,45,27,HOU,86,41,29,86,56
2004-03-26,CHI,105,20,51,MIL,115,35,36,55,87
2004-03-26,LAL,90,48,23,MIN,73,49,23,97,46
2004-03-26,GSW,99,30,40,WAS,78,23,48,53,88
2004-03-26,SEA,102,33,38,DEN,86,38,35,71,73
2004-03-27,ATL,97,23,49,CHI,88,20,52,43,101
2004-03-27,CLE,107,31,40,NJN,104,42,29,73,69
2004-03-27,DET,100,46,27,NYK,85,34,39,80,66
2004-03-27,SAS,105,47,25,PHX,76,25,48,72,73
2004-03-27,UTA,85,38,35,DEN,83,38,36,76,71
2004-03-27,POR,115,36,35,SEA,108,34,38,70,73
2004-03-27,LAC,82,27,46,MIN,98,49,24,76,70
2004-03-28,TOR,88,30,42,MEM,94,46,27,76,69
2004-03-28,ORL,88,19,55,DAL,118,44,28,63,83
2004-03-28,MIL,107,36,36,HOU,111,41,30,77,66
2004-03-28,IND,87,53,19,MIA,80,35,37,88,56
2004-03-28,BOS,89,32,40,PHI,65,31,42,63,82
2004-03-28,GSW,105,31,40,LAC,77,27,47,58,87
2004-03-28,SAC,100,51,21,WAS,92,23,49,74,70
2004-03-28,LAL,91,49,23,UTA,84,39,35,88,58
2004-03-29,NYK,92,34,40,POR,91,37,35,71,75
2004-03-29,NJN,80,42,30,BOS,84,33,40,75,70
2004-03-29,MIA,105,35,38,CHI,96,20,53,55,91
2004-03-29,ATL,133,24,49,MEM,136,47,27,71,76
2004-03-29,HOU,88,42,30,MIN,94,50,24,92,54
2004-03-29,SAS,101,48,25,CLE,93,32,40,80,65
2004-03-29,PHX,101,25,49,WAS,95,23,50,48,99
2004-03-30,PHI,95,31,43,GSW,71,32,40,63,83
2004-03-30,MIL,95,36,37,IND,86,54,19,90,56
2004-03-30,DAL,126,45,28,CLE,109,32,41,77,69
2004-03-30,DEN,124,38,37,SEA,119,34,39,72,76
2004-03-30,LAL,107,50,23,NOH,88,37,36,87,59
2004-03-31,BOS,98,34,40,POR,105,37,36,71,76
2004-03-31,WAS,99,23,51,NJN,103,42,31,65,82
2004-03-31,ORL,91,19,56,CHI,109,20,54,39,110
2004-03-31,IND,111,54,20,MIL,78,37,37,91,57
2004-03-31,ATL,97,24,50,MIA,100,36,38,60,88
2004-03-31,TOR,78,30,43,GSW,85,32,41,62,84
2004-03-31,DET,108,47,27,LAC,99,27,48,74,75
2004-03-31,MIN,90,51,24,SEA,83,34,40,85,64
2004-03-31,SAS,107,49,25,SAC,89,52,21,101,46
2004-03-31,UTA,89,39,36,NOH,76,37,37,76,73
2004-04-01,PHI,82,32,43,POR,88,38,36,70,79
2004-04-01,DAL,127,46,28,SAC,117,52,22,98,50
2004-04-01,LAL,93,51,23,HOU,85,42,31,93,54
2004-04-02,ORL,87,19,57,ATL,95,24,51,43,108
2004-04-02,BOS,111,34,41,GSW,106,33,41,67,82
2004-04-02,IND,84,55,20,TOR,64,30,44,85,64
2004-04-02,NJN,108,43,31,NYK,83,35,40,78,71
2004-04-02,DET,92,48,27,MIA,84,37,38,85,65
2004-04-02,MIN,91,52,24,WAS,73,23,52,75,76
2004-04-02,MEM,109,48,27,PHX,99,26,49,74,76
2004-04-02,CHI,114,21,54,LAC,110,27,49,48,103
2004-04-02,MIL,107,37,38,CLE,89,32,42,69,80
2004-04-02,DEN,110,39,37,HOU,100,42,32,81,69
2004-04-02,UTA,81,40,36,SAS,94,50,25,90,61
2004-04-02,SEA,86,34,41,LAL,97,52,23,86,64
2004-04-03,PHI,75,32,44,NYK,86,35,41,67,85
2004-04-03,CLE,100,32,43,GSW,103,33,42,65,85
2004-04-03,CHI,83,22,54,MIA,97,37,39,59,93
2004-04-03,DAL,124,47,28,PHX,103,26,50,73,78
2004-04-03,POR,81,39,36,NOH,94,37,38,76,74
2004-04-04,TOR,83,30,45,MIL,90,38,38,68,83
2004-04-04,HOU,94,42,33,SAC,99,52,23,94,56
2004-04-04,WAS,112,23,53,BOS,102,35,41,58,94
2004-04-04,MIN,90,53,24,MEM,82,49,27,102,51
2004-04-04,LAL,89,53,23,SAS,95,51,25,104,48
2004-04-04,DET,79,49,27,IND,61,56,20,105,47
2004-04-04,NJN,106,44,31,ATL,89,25,51,69,82
2004-04-04,SEA,96,34,42,NOH,88,38,38,72,80
2004-04-04,LAC,92,27,50,UTA,97,40,37,67,87
2004-04-05,UTA,92,18,16,MEM,81,18,17,36,33
2004-04-06,CLE,86,32,44,TOR,87,30,46,62,90
2004-04-06,NJN,98,45,31,MIL,103,39,38,84,69
2004-04-06,ATL,100,25,52,PHI,103,32,45,57,97
2004-04-06,DET,102,50,27,ORL,86,19,58,69,85
2004-04-06,IND,107,56,21,NYK,86,36,41,92,62
2004-04-06,DAL,118,48,28,SEA,108,35,42,83,70
2004-04-06,LAL,80,53,24,POR,91,39,37,92,61
2004-04-06,SAC,105,53,23,NOH,91,38,39,91,62
2004-04-06,GSW,97,34,42,HOU,90,42,34,76,76
2004-04-07,NYK,96,36,42,CHI,82,22,55,58,97
2004-04-07,MIA,104,38,39,BOS,101,35,42,73,81
2004-04-07,TOR,90,31,46,IND,94,57,21,88,67
2004-04-07,MIL,116,40,38,WAS,107,24,53,64,91
2004-04-07,MEM,92,49,28,CLE,74,32,45,81,73
2004-04-07,SAS,96,52,25,SEA,75,35,43,87,68
2004-04-07,PHX,96,26,51,DEN,111,40,37,66,88
2004-04-07,POR,87,40,37,GSW,81,35,42,75,79
2004-04-07,LAC,79,27,51,HOU,102,42,35,69,86
2004-04-08,NJN,101,45,32,ORL,81,19,59,64,91
2004-04-08,DAL,117,49,28,UTA,94,41,37,90,65
2004-04-08,SAC,86,54,23,MIN,94,54,24,108,47
2004-04-09,PHI,80,33,45,WAS,83,24,54,57,99
2004-04-09,MIA,106,39,39,CLE,91,32,46,71,85
2004-04-09,NOH,89,38,40,BOS,80,35,43,73,83
2004-04-09,DET,74,51,27,TOR,66,31,47,82,74
2004-04-09,SAS,84,53,25,POR,74,41,37,94,62
2004-04-09,IND,90,58,21,NJN,80,46,32,104,53
2004-04-09,CHI,101,22,56,ATL,116,25,53,47,109
2004-04-09,HOU,106,43,35,DEN,103,41,37,84,72
2004-04-09,PHX,101,26,52,SAC,96,54,24,80,76
2004-04-09,LAL,103,53,25,MEM,95,50,28,103,53
2004-04-09,GSW,74,35,43,MIN,92,55,24,90,67
2004-04-10,SEA,119,35,44,DAL,99,50,28,85,72
2004-04-10,WAS,98,25,54,NYK,102,37,42,62,96
2004-04-10,ORL,89,19,60,DET,101,52,27,71,87
2004-04-10,ATL,110,26,53,BOS,99,35,44,61,97
2004-04-10,CLE,91,32,47,MIA,80,40,39,72,86
2004-04-10,MIL,87,41,38,NOH,92,39,40,80,78
2004-04-10,DEN,110,41,38,POR,100,41,38,82,76
2004-04-10,UTA,82,41,38,HOU,69,44,35,85,73
2004-04-11,NJN,89,46,33,PHI,75,33,46,79,79
2004-04-11,TOR,108,31,48,CHI,114,22,57,53,105
2004-04-11,SAC,102,54,25,LAL,85,54,25,108,50
2004-04-11,PHX,89,27,52,MEM,83,50,29,77,81
2004-04-11,GSW,108,35,44,DAL,107,50,29,85,73
2004-04-11,LAC,79,27,52,SAS,88,54,25,81,77
2004-04-12,BOS,77,35,45,MIA,84,40,40,75,85
2004-04-12,CLE,93,33,47,MIL,89,41,39,74,86
2004-04-12,PHI,93,33,47,IND,107,59,21,92,68
2004-04-12,ATL,129,27,53,NJN,107,47,33,74,86
2004-04-12,DET,101,53,27,WAS,79,25,55,78,82
2004-04-12,NOH,97,40,40,NYK,101,38,42,78,82
2004-04-12,MIN,104,56,24,UTA,90,42,38,98,62
2004-04-12,CHI,84,23,57,ORL,93,19,61,42,118
2004-04-12,DEN,97,42,38,SAC,89,55,25,97,63
2004-04-12,POR,66,41,39,SAS,78,55,25,96,64
2004-04-12,SEA,107,36,44,HOU,111,44,36,80,80
2004-04-13,TOR,87,31,49,DET,78,54,27,85,76
2004-04-13,DAL,110,50,30,MEM,103,50,30,100,60
2004-04-13,PHX,96,28,52,LAC,98,27,53,55,105
2004-04-13,LAL,109,54,26,GSW,104,36,44,90,70
2004-04-14,BOS,137,35,46,ATL,132,28,53,63,99
2004-04-14,WAS,78,25,56,NOH,94,40,41,65,97
2004-04-14,ORL,95,20,61,PHI,89,33,48,53,109
2004-04-14,NYK,90,39,42,CLE,100,34,47,73,89
2004-04-14,MIA,96,41,40,NJN,84,47,34,88,74
2004-04-14,IND,101,60,21,CHI,96,23,58,83,79
2004-04-14,MIL,87,41,40,TOR,89,32,49,73,89
2004-04-14,MEM,90,50,31,MIN,107,57,24,107,55
2004-04-14,SAS,93,56,25,DEN,67,43,38,99,63
2004-04-14,UTA,84,42,39,PHX,89,28,53,70,92
2004-04-14,HOU,89,45,36,DAL,92,51,30,96,66
2004-04-14,POR,104,41,40,LAL,105,55,26,96,66
2004-04-14,LAC,87,28,53,SEA,118,36,45,64,98
2004-04-14,GSW,97,36,45,SAC,91,55,26,91,71
2004-11-02,DET,87,0,0,HOU,79,0,0,0,0
2004-11-02,DAL,107,0,0,SAC,98,0,0,0,0
2004-11-02,LAL,89,0,0,DEN,78,0,0,0,0
2004-11-03,TOR,95,0,0,HOU,88,0,1,0,1
2004-11-03,ORL,93,0,0,MIL,92,0,0,0,0
2004-11-03,CLE,104,0,0,IND,109,0,0,0,0
2004-11-03,BOS,95,0,0,PHL,98,0,0,0,0
2004-11-03,NJN,77,0,0,MIA,100,0,0,0,0
2004-11-03,MEM,91,0,0,WAS,103,0,0,0,0
2004-11-03,NOK,91,0,0,DAL,106,1,0,1,0
2004-11-03,MIN,99,0,0,NYK,93,0,0,0,0
2004-11-03,SAN,101,0,0,SAC,85,0,1,0,1
2004-11-03,PHX,112,0,0,ATL,82,0,0,0,0
2004-11-03,UTH,104,0,0,LAL,78,1,0,1,0
2004-11-03,LAC,114,0,0,SEA,84,0,0,0,0
2004-11-03,GOS,75,0,0,POR,78,0,0,0,0
2004-11-04,CHA,96,0,0,WAS,103,1,0,1,0
2004-11-04,MIA,92,1,0,CLE,86,0,1,1,1
2004-11-04,DEN,94,0,1,MIN,92,1,0,1,1
2004-11-05,TOR,101,1,0,DET,89,1,0,2,0
2004-11-05,PHL,98,1,0,PHX,108,1,0,2,0
2004-11-05,BOS,94,0,1,IND,100,1,0,1,1
2004-11-05,MEM,81,0,1,HOU,89,0,2,0,3
2004-11-05,NOH,89,0,0,ORL,90,1,0,1,0
2004-11-05,CHI,106,0,0,NJN,111,0,1,0,1
2004-11-05,POR,94,1,0,LAC,81,1,0,2,0
2004-11-05,LAL,96,1,1,SAN,105,1,0,2,1
2004-11-05,GOS,80,0,1,UTH,102,1,0,1,1
2004-11-05,SEA,106,0,1,ATL,85,0,1,0,2
2004-11-06,WAS,106,2,0,MIA,118,2,0,4,0
2004-11-06,CHA,111,0,1,ORL,100,2,0,2,1
2004-11-06,NYK,73,0,1,BOS,107,0,2,0,3
2004-11-06,DET,99,1,1,PHL,91,1,1,2,2
2004-11-06,NJN,80,1,1,PHX,112,2,0,3,1
2004-11-06,IND,100,2,0,CHI,90,0,1,2,1
2004-11-06,MIN,99,1,1,NOK,92,0,1,1,2
2004-11-06,MIL,102,0,1,CLE,88,0,2,0,3
2004-11-06,HOU,104,1,2,SAC,101,0,2,1,4
2004-11-06,DAL,112,2,0,MEM,88,0,2,2,2
2004-11-06,DEN,82,1,1,UTH,106,2,0,3,1
2004-11-06,GOS,86,0,2,LAC,94,1,1,1,3
2004-11-07,TOR,101,2,0,POR,97,2,0,4,0
2004-11-07,SEA,113,1,1,SAN,94,2,0,3,1
2004-11-07,LAL,106,1,2,ATL,90,0,2,1,4
2004-11-08,DAL,101,3,0,GSW,98,0,0,3,0
2004-11-08,UTH,102,3,0,DEN,91,1,2,4,2
2004-11-08,LAC,96,2,1,DET,99,2,1,4,2
2004-11-09,ORL,94,2,1,DAL,84,4,0,6,1
2004-11-09,NJN,64,1,2,POR,60,2,1,3,3
2004-11-09,NYK,96,0,2,PHL,88,1,2,1,4
2004-11-09,ATL,79,0,3,CLE,93,0,3,0,6
2004-11-09,MIA,103,3,0,WAS,93,2,1,5,1
2004-11-09,NOK,98,0,2,LAL,106,2,2,2,4
2004-11-09,MIN,101,2,1,IND,102,3,0,5,1
2004-11-09,CHI,74,0,2,PHX,94,3,0,3,2
2004-11-09,HOU,90,2,2,MEM,87,0,3,2,5
2004-11-09,DEN,88,1,3,SEA,108,2,1,3,4
2004-11-09,SAC,108,0,3,TOR,92,3,0,3,3
2004-11-10,BOS,90,1,2,POR,88,2,2,3,4
2004-11-10,PHL,108,1,3,NJN,100,2,2,3,5
2004-11-10,WAS,106,2,2,ORL,96,3,1,5,3
2004-11-10,IND,68,4,0,LAC,102,2,2,6,2
2004-11-10,CLE,114,1,3,PHX,109,4,0,5,3
2004-11-10,MIL,102,1,1,CHA,100,1,1,2,2
2004-11-10,MEM,110,0,4,LAL,87,3,2,3,6
2004-11-10,SAN,91,2,1,GOS,71,0,3,2,4
2004-11-10,UTH,95,4,0,TOR,104,3,1,7,1
2004-11-10,SEA,108,3,1,SAC,78,1,3,4,4
2004-11-11,MIA,93,4,0,DAL,113,4,1,8,1
2004-11-11,HOU,91,3,2,MIN,96,2,2,5,4
2004-11-11,DEN,117,1,4,DET,109,3,1,4,5
2004-11-12,PHL,106,2,3,IND,104,4,1,6,4
2004-11-12,ORL,122,3,2,LAL,113,3,3,6,5
2004-11-12,BOS,91,2,2,CHA,74,1,2,3,4
2004-11-12,NYK,110,1,2,LAC,96,3,2,4,4
2004-11-12,MEM,96,1,4,GSW,67,0,1,1,5
2004-11-12,NOK,95,0,3,ATL,96,0,4,0,7
2004-11-12,SAN,93,3,1,MIA,84,4,1,7,2
2004-11-12,SEA,88,4,1,TOR,87,4,1,8,2
2004-11-13,NJN,78,2,3,DAL,94,5,1,7,4
2004-11-13,CLE,105,2,3,WAS,74,3,2,5,5
2004-11-13,CHA,87,1,3,GOS,103,0,4,1,7
2004-11-13,ATL,88,1,4,SAN,103,4,1,5,5
2004-11-13,IND,103,4,2,NYK,97,2,2,6,4
2004-11-13,CHI,96,0,3,LAC,97,3,3,3,6
2004-11-13,MIL,94,2,1,NOK,91,0,4,2,5
2004-11-13,HOU,79,3,3,LAL,84,3,4,6,7
2004-11-13,UTH,108,4,1,DET,93,3,2,7,3
2004-11-13,PHX,111,4,1,SAC,113,1,4,5,5
2004-11-13,POR,105,2,3,TOR,102,4,2,6,5
2004-11-14,WAS,113,3,3,DAL,122,6,1,9,4
2004-11-14,PHL,96,3,3,ORL,87,4,2,7,5
2004-11-14,MIA,112,4,2,MIL,110,3,1,7,3
2004-11-14,SEA,118,5,1,MEM,113,2,4,7,5
2004-11-14,SAC,101,2,4,DEN,89,2,4,4,8
2004-11-15,CLE,99,3,3,GOS,88,1,4,4,7
2004-11-15,NJN,69,2,4,HOU,80,3,4,5,8
2004-11-16,PHL,95,4,3,SEA,103,6,1,10,4
2004-11-16,CHA,105,1,4,UTH,107,5,1,6,5
2004-11-16,ATL,88,1,5,HOU,84,4,4,5,9
2004-11-16,MIN,108,3,2,MIA,97,5,2,8,4
2004-11-16,DAL,101,7,1,PHX,107,4,2,11,3
2004-11-16,SAN,99,5,1,NYK,81,2,3,7,4
2004-11-16,SAC,113,3,4,CHI,106,0,4,3,8
2004-11-16,LAC,101,4,3,TOR,89,4,3,8,6
2004-11-17,WAS,110,3,4,BOS,105,3,2,6,6
2004-11-17,ORL,107,4,3,UTA,92,0,0,4,3
2004-11-17,IND,93,5,2,ATL,86,2,5,7,7
2004-11-17,NJN,68,2,5,SEA,79,7,1,9,6
2004-11-17,DET,93,3,3,MIN,85,4,2,7,5
2004-11-17,NOK,84,0,5,PHO,95,0,0,0,5
2004-11-17,MIL,106,3,2,MIA,113,5,3,8,5
2004-11-17,DEN,112,2,5,TOR,106,4,4,6,9
2004-11-17,POR,82,3,3,MEM,101,2,5,5,8
2004-11-17,LAL,103,4,4,LAC,89,5,3,9,7
2004-11-17,GSW,98,0,2,CHI,85,0,5,0,7
2004-11-18,PHI,80,0,0,SAS,88,0,0,0,0
2004-11-18,CHA,89,1,5,CLE,106,4,3,5,8
2004-11-18,HOU,92,4,5,NYK,93,2,4,6,9
2004-11-19,TOR,94,4,5,SEA,101,8,1,12,6
2004-11-19,BOS,84,3,3,SAS,92,1,0,4,3
2004-11-19,MIA,107,6,3,UTA,105,0,1,6,4
2004-11-19,DET,82,4,3,IND,97,6,2,10,5
2004-11-19,DAL,103,7,2,NYK,101,3,4,10,6
2004-11-19,DEN,99,3,5,CHI,81,0,6,3,11
2004-11-19,PHO,107,1,0,LAL,102,5,4,6,4
2004-11-19,POR,110,3,4,MIL,98,3,3,6,7
2004-11-19,SAC,107,4,4,MEM,105,3,5,7,9
2004-11-20,LAC,86,5,4,HOU,91,4,6,9,10
2004-11-20,ATL,79,2,6,UTA,92,0,2,2,8
2004-11-20,CLE,100,5,3,CHA,84,1,6,6,9
2004-11-20,NJN,86,2,6,WAS,97,4,4,6,10
2004-11-20,IND,83,7,2,ORL,86,5,3,12,5
2004-11-20,NOK,94,0,6,MIN,99,4,3,4,9
2004-11-20,GSW,87,1,2,MEM,100,3,6,4,8
2004-11-21,TOR,96,4,6,SAS,91,2,0,6,6
2004-11-21,LAC,111,5,5,PHO,122,2,0,7,5
2004-11-21,BOS,102,3,4,SEA,83,9,1,12,5
2004-11-21,MIA,93,7,3,PHI,83,0,1,7,4
2004-11-21,DET,117,4,4,CHA,116,1,7,5,11
2004-11-21,NYK,98,3,5,CLE,88,6,3,9,8
2004-11-21,POR,93,4,4,HOU,97,5,6,9,10
2004-11-21,DEN,110,4,5,DAL,82,8,2,12,7
2004-11-21,SAC,88,5,4,MIL,79,3,4,8,8
2004-11-21,LAL,102,5,5,CHI,93,0,7,5,12
2004-11-22,MEM,93,4,6,SAS,90,2,1,6,7
2004-11-22,DAL,82,8,3,MIN,83,5,3,13,6
2004-11-22,UTA,75,1,2,NOK,76,0,7,1,9
2004-11-22,PHX,100,5,2,CHI,82,0,8,5,10
2004-11-23,WAS,102,5,4,TOR,86,5,6,10,10
2004-11-23,CHA,91,1,8,DET,89,5,4,6,12
2004-11-23,IND,106,7,3,BOS,96,4,4,11,7
2004-11-23,NYK,104,4,5,ATL,88,2,7,6,12
2004-11-23,MIA,87,8,3,POR,99,4,5,12,8
2004-11-23,MIN,92,6,3,SEA,103,9,2,15,5
2004-11-23,DEN,90,5,5,NJN,88,2,7,7,12
2004-11-23,SAC,102,6,4,HOU,96,6,6,12,10
2004-11-23,LAL,100,6,5,MIL,96,3,5,9,10
2004-11-23,GSW,115,1,3,NOK,109,1,7,2,10
2004-11-24,TOR,114,5,7,NYK,91,5,5,10,12
2004-11-24,PHI,110,0,2,BOS,97,4,5,4,7
2004-11-24,ORL,83,6,3,POR,89,5,5,11,8
2004-11-24,CLE,92,6,4,DET,76,5,5,11,9
2004-11-24,ATL,93,2,8,MIA,99,8,4,10,12
2004-11-24,MEM,84,5,6,SEA,93,10,2,15,8
2004-11-24,SAS,94,2,2,DAL,80,8,4,10,6
2004-11-24,UTA,99,1,3,CHI,101,0,9,1,12
2004-11-24,PHO,111,3,0,MIL,104,3,6,6,6
2004-11-25,IND,106,8,3,MIN,102,6,4,14,7
2004-11-25,LAC,101,5,6,NJN,88,2,8,7,14
2004-11-26,DAL,92,8,5,POR,83,6,5,14,10
2004-11-26,BOS,96,4,6,CLE,98,7,4,11,10
2004-11-26,PHI,116,1,2,WAS,114,6,4,7,6
2004-11-26,ATL,99,2,9,ORL,117,6,4,8,13
2004-11-26,DET,78,5,6,MIA,77,9,4,14,10
2004-11-26,IND,82,9,3,CHA,77,2,8,11,11
2004-11-26,MIN,115,6,5,MEM,90,5,7,11,12
2004-11-26,DEN,75,6,5,SAS,89,3,2,9,7
2004-11-26,UTA,90,1,4,HOU,80,6,7,7,11
2004-11-26,PHO,95,4,0,NOK,86,1,8,5,8
2004-11-26,LAL,106,7,5,SAC,109,7,4,14,9
2004-11-26,GSW,87,2,3,LAC,98,6,6,8,9
2004-11-26,SEA,92,11,2,NJN,79,2,9,13,11
2004-11-27,NYK,108,5,6,TOR,102,6,7,11,13
2004-11-27,CHA,107,2,9,ATL,92,2,10,4,19
2004-11-27,ORL,105,7,4,PHI,99,2,2,9,6
2004-11-27,CLE,96,8,4,CHI,74,1,9,9,13
2004-11-27,MEM,85,5,8,DAL,98,9,5,14,13
2004-11-27,HOU,76,6,8,DEN,82,6,6,12,14
2004-11-27,SAS,109,4,2,UTA,76,2,4,6,6
2004-11-27,MIL,96,3,7,DET,90,6,6,9,13
2004-11-28,TOR,109,6,8,WAS,114,6,5,12,13
2004-11-28,LAC,103,7,6,GSW,91,2,4,9,10
2004-11-28,MIA,106,9,5,BOS,104,4,7,13,12
2004-11-28,POR,83,6,6,NJN,71,2,10,8,16
2004-11-28,SAC,110,8,4,MIN,121,7,5,15,9
2004-11-28,SEA,103,12,2,IND,95,10,3,22,5
2004-11-28,LAL,89,7,6,NOK,76,1,9,8,15
2004-11-29,ORL,101,8,4,BOS,117,4,8,12,12
2004-11-29,DEN,76,7,6,NOK,67,1,10,8,16
2004-11-29,LAC,94,8,6,CLE,82,9,4,17,10
2004-11-30,NJN,99,2,11,CHA,86,3,9,5,20
2004-11-30,ATL,109,2,11,NYK,110,6,6,8,17
2004-11-30,MIA,92,10,5,TOR,94,6,9,16,14
2004-11-30,MIL,90,4,7,LAL,95,8,6,12,13
2004-11-30,MEM,93,5,9,SAC,98,8,5,13,14
2004-11-30,HOU,72,6,9,DET,93,6,7,12,16
2004-11-30,DAL,89,10,5,SAS,107,5,2,15,7
2004-11-30,UTA,102,2,5,PHO,115,5,0,7,5
2004-11-30,POR,100,7,6,SEA,94,13,2,20,8
2004-12-01,BOS,101,5,8,MIL,100,4,8,9,16
2004-12-01,WAS,95,7,5,NJN,68,3,11,10,16
2004-12-01,ORL,129,8,5,TOR,108,7,9,15,14
2004-12-01,NYK,90,7,6,MEM,82,5,10,12,16
2004-12-01,NOK,81,1,11,SAC,94,9,5,10,16
2004-12-01,CHI,92,1,10,LAL,84,9,6,10,16
2004-12-01,SAS,105,6,2,PHI,72,2,3,8,5
2004-12-01,PHO,120,6,0,CLE,101,9,5,15,5
2004-12-01,SEA,129,13,3,UTA,119,2,6,15,9
2004-12-01,LAC,88,9,6,IND,76,10,4,19,10
2004-12-01,GSW,99,2,5,MIN,107,8,5,10,10
2004-12-02,DAL,113,10,6,HOU,106,6,10,16,16
2004-12-02,DEN,73,8,6,CLE,92,9,6,17,12
2004-12-03,BOS,91,6,8,TOR,89,7,10,13,18
2004-12-03,NYK,98,8,6,ORL,104,9,5,17,11
2004-12-03,ATL,90,2,12,WAS,114,8,5,10,17
2004-12-03,MEM,94,5,11,PHI,86,2,4,7,15
2004-12-03,SAS,80,7,2,DET,77,7,7,14,9
2004-12-03,CHI,81,2,10,MIA,105,10,6,12,16
2004-12-03,PHO,93,7,0,MIN,97,9,5,16,5
2004-12-03,LAL,97,9,7,GSW,88,2,6,11,13
2004-12-03,SAC,113,10,5,IND,87,10,5,20,10
2004-12-04,CHA,107,3,10,NYK,101,8,7,11,17
2004-12-04,ORL,96,10,5,MEM,91,6,11,16,16
2004-12-04,NJN,109,3,12,ATL,88,2,13,5,25
2004-12-04,CLE,105,10,6,TOR,97,7,11,17,17
2004-12-04,WAS,95,9,5,CHI,88,2,11,11,16
2004-12-04,NOK,69,1,12,DET,92,7,8,8,20
2004-12-04,MIL,83,4,9,SAS,104,8,2,12,11
2004-12-04,HOU,77,6,11,PHI,76,2,5,8,16
2004-12-04,DAL,109,11,6,UTA,86,2,7,13,13
2004-12-04,DEN,104,8,7,MIA,95,11,6,19,13
2004-12-04,LAC,100,10,6,MIN,107,10,5,20,11
2004-12-04,GSW,104,2,7,IND,96,10,6,12,13
2004-12-04,SEA,99,14,3,POR,89,8,6,22,9
2004-12-05,SAC,119,11,5,BOS,105,7,8,18,13
2004-12-05,POR,99,8,7,PHO,121,7,1,15,8
2004-12-06,NJN,88,4,12,TOR,86,7,12,11,24
2004-12-06,ATL,96,2,14,PHI,92,2,6,4,20
2004-12-06,CHI,75,2,12,SAS,91,9,2,11,14
2004-12-06,DAL,85,12,6,DET,101,8,8,20,14
2004-12-06,DEN,115,9,7,ORL,102,11,5,20,12
2004-12-06,UTA,80,2,8,MIA,100,11,7,13,15
2004-12-06,LAC,99,10,7,CHA,93,4,10,14,17
2004-12-06,GSW,110,3,7,BOS,106,7,9,10,16
2004-12-07,CLE,103,11,6,NJN,97,5,12,16,18
2004-12-07,IND,86,10,7,MIL,89,4,10,14,17
2004-12-07,MEM,96,6,12,NYK,88,8,8,14,20
2004-12-07,MIN,87,11,5,DAL,97,12,7,23,12
2004-12-07,HOU,89,7,11,NOK,81,1,13,8,24
2004-12-07,PHO,118,8,1,GSW,104,4,7,12,8
2004-12-07,SAC,109,12,5,CHA,92,4,11,16,16
2004-12-08,PHI,84,2,7,MIN,119,11,6,13,13
2004-12-08,WAS,105,10,5,DEN,111,10,7,20,12
2004-12-08,ATL,89,3,14,MEM,97,7,12,10,26
2004-12-08,DET,90,9,8,TOR,86,7,13,16,21
2004-12-08,MIL,96,5,10,MIA,101,12,7,17,17
2004-12-08,NOK,79,1,14,NYK,86,8,9,9,23
2004-12-08,CHI,113,2,13,CLE,85,12,6,14,19
2004-12-08,SAS,96,10,2,SEA,102,15,3,25,5
2004-12-08,UTA,100,2,9,ORL,106,11,6,13,15
2004-12-08,LAL,110,10,7,PHO,113,9,1,19,8
2004-12-09,HOU,81,8,11,SAS,80,10,3,18,14
2004-12-09,DAL,102,13,7,SEA,107,16,3,29,10
2004-12-09,POR,89,8,8,BOS,87,7,10,15,18
2004-12-10,TOR,87,7,14,DEN,101,11,7,18,21
2004-12-10,WAS,106,10,6,NYK,104,9,9,19,15
2004-12-10,NJN,94,5,13,NOK,91,1,15,6,28
2004-12-10,MIA,92,13,7,MEM,84,8,12,21,19
2004-12-10,DET,72,10,8,ATL,88,3,15,13,23
2004-12-10,CHI,88,3,13,PHI,93,2,8,5,21
2004-12-10,MIN,113,12,6,SAC,105,13,5,25,11
2004-12-10,MIL,95,5,11,IND,86,10,8,15,19
2004-12-10,PHO,115,10,1,CHA,106,4,12,14,13
2004-12-10,UTA,92,2,10,POR,87,9,8,11,18
2004-12-10,GSW,109,4,8,ORL,113,12,6,16,14
2004-12-11,ATL,90,4,15,NJN,95,6,13,10,28
2004-12-11,IND,92,10,9,SAC,97,13,6,23,15
2004-12-11,MEM,72,8,13,DET,68,10,9,18,22
2004-12-11,CHI,99,3,14,MIN,88,13,6,16,20
2004-12-11,HOU,78,9,11,DAL,102,13,8,22,19
2004-12-11,SAS,116,10,4,CLE,97,12,7,22,11
2004-12-11,SEA,84,17,3,BOS,98,7,11,24,14
2004-12-11,LAC,87,11,7,LAL,89,10,8,21,15
2004-12-12,NYK,107,9,10,DEN,96,12,7,21,17
2004-12-12,TOR,98,7,15,MIA,106,14,7,21,22
2004-12-12,WAS,88,11,6,NOK,69,1,16,12,22
2004-12-12,PHI,107,3,8,MIL,101,6,11,9,19
2004-12-12,POR,98,9,9,UTA,88,3,10,12,19
2004-12-12,GSW,99,4,9,CHA,87,4,13,8,22
2004-12-12,LAL,105,11,8,ORL,98,13,6,24,14
2004-12-13,MIA,106,15,7,WAS,83,12,6,27,13
2004-12-13,MEM,86,9,13,CLE,92,12,8,21,21
2004-12-13,CHI,93,4,14,DAL,94,14,8,18,22
2004-12-13,PHO,121,11,1,ORL,100,13,7,24,8
2004-12-13,LAC,127,11,8,BOS,134,8,11,19,19
2004-12-14,PHI,110,4,8,DEN,102,12,8,16,16
2004-12-14,CHA,94,4,14,NOK,93,1,17,5,31
2004-12-14,NJN,79,7,13,NYK,87,10,10,17,23
2004-12-14,ATL,97,4,16,IND,108,10,10,14,26
2004-12-14,MIL,86,6,12,SAC,89,14,6,20,18
2004-12-14,MIN,100,13,7,POR,89,10,9,23,16
2004-12-14,DAL,107,15,8,GSW,111,5,9,20,17
2004-12-14,UTA,93,3,11,LAC,91,11,9,14,20
2004-12-14,SEA,108,17,4,LAL,93,12,8,29,12
2004-12-15,BOS,99,9,11,DEN,100,12,9,21,20
2004-12-15,TOR,96,7,16,MIN,90,14,7,21,23
2004-12-15,WAS,93,12,7,MIA,98,16,7,28,14
2004-12-15,CLE,112,13,8,POR,88,10,10,23,18
2004-12-15,NYK,93,11,10,DET,94,10,10,21,20
2004-12-15,MEM,88,9,14,CHI,96,4,15,13,29
2004-12-15,NOK,98,1,18,GSW,89,6,9,7,27
2004-12-15,HOU,92,9,12,ATL,69,4,17,13,29
2004-12-15,SAS,94,11,4,ORL,91,13,8,24,12
2004-12-15,PHO,108,12,1,UTA,86,4,11,16,12
2004-12-16,DET,81,11,10,CLE,69,14,8,25,18
2004-12-16,CHI,85,5,15,MIL,77,6,13,11,28
2004-12-16,SAC,99,15,6,LAL,115,12,9,27,15
2004-12-17,PHI,107,5,8,NYK,113,11,11,16,19
2004-12-17,IND,89,11,10,TOR,86,8,16,19,26
2004-12-17,BOS,114,9,12,UTA,106,4,12,13,24
2004-12-17,ATL,84,4,18,POR,100,10,11,14,29
2004-12-17,MIA,107,17,7,DEN,100,13,9,30,16
2004-12-17,MEM,89,9,15,NJN,84,7,14,16,29
2004-12-17,NOK,67,2,18,SAS,83,12,4,14,22
2004-12-17,MIN,113,14,8,LAC,86,11,10,25,18
2004-12-17,HOU,100,10,12,GSW,83,6,10,16,22
2004-12-17,LAL,116,13,9,WAS,120,12,8,25,17
2004-12-17,SEA,110,18,4,PHO,112,13,1,31,5
2004-12-18,CHA,101,5,14,HOU,100,11,12,16,26
2004-12-18,ORL,117,13,9,DEN,95,13,10,26,19
2004-12-18,DET,74,12,10,POR,75,11,11,23,21
2004-12-18,CLE,107,14,9,BOS,114,10,12,24,21
2004-12-18,CHI,85,6,15,IND,71,12,10,18,25
2004-12-18,MIL,97,6,14,PHI,116,5,9,11,23
2004-12-18,DAL,90,15,9,ATL,68,4,19,19,28
2004-12-18,SAS,104,13,4,GSW,85,6,11,19,15
2004-12-18,PHO,110,14,1,WAS,96,13,8,27,9
2004-12-19,TOR,110,8,17,NJN,99,7,15,15,32
2004-12-19,NYK,94,12,11,UTA,93,4,13,16,24
2004-12-19,MIA,117,18,7,ORL,107,14,9,32,16
2004-12-19,SAC,107,15,7,NOK,71,2,19,17,26
2004-12-19,LAC,82,11,11,MEM,92,10,15,21,26
2004-12-20,PHI,101,6,9,UTA,103,4,14,10,23
2004-12-20,CHI,92,7,15,POR,87,12,11,19,26
2004-12-20,HOU,114,11,13,TOR,102,9,17,20,30
2004-12-20,DEN,105,13,11,PHO,107,15,1,28,12
2004-12-20,LAL,72,13,10,MEM,82,11,15,24,25
2004-12-20,GSW,101,6,12,WAS,103,13,9,19,21
2004-12-21,CHA,91,6,14,NJN,94,7,16,13,30
2004-12-21,CLE,107,14,10,MIN,97,15,8,29,18
2004-12-21,NYK,94,13,11,DAL,123,16,9,29,20
2004-12-21,MIA,108,19,7,BOS,100,11,12,30,19
2004-12-21,SAC,104,16,7,WAS,93,14,9,30,16
2004-12-21,LAC,100,11,12,NOK,91,2,20,13,32
2004-12-22,BOS,114,11,13,NYK,109,13,12,24,25
2004-12-22,TOR,98,9,18,UTA,86,5,14,14,32
2004-12-22,ORL,93,14,10,SAS,87,14,4,28,14
2004-12-22,IND,90,12,11,PHI,102,6,10,18,21
2004-12-22,NJN,92,8,16,CLE,90,15,10,23,26
2004-12-22,ATL,113,4,20,DAL,100,17,9,21,29
2004-12-22,DET,82,12,11,CHI,89,8,15,20,26
2004-12-22,MIL,95,6,15,POR,104,12,12,18,27
2004-12-22,HOU,87,12,13,CHA,90,6,15,18,28
2004-12-22,GSW,109,6,13,MEM,99,12,15,18,28
2004-12-22,SEA,98,18,5,DEN,83,13,12,31,17
2004-12-22,LAL,101,13,11,NOK,89,2,21,15,32
2004-12-23,SAS,96,14,5,MIN,82,15,9,29,14
2004-12-23,PHO,109,16,1,MEM,102,12,16,28,17
2004-12-23,SAC,107,17,7,MIA,109,20,7,37,14
2004-12-25,IND,93,12,12,DET,98,12,12,24,24
2004-12-25,LAL,102,14,11,MIA,104,21,7,35,18
2004-12-26,NYK,91,13,13,CHA,82,7,15,20,28
2004-12-26,CLE,100,15,11,NOK,91,2,22,17,33
2004-12-26,MIL,99,6,16,CHI,92,9,15,15,31
2004-12-26,SAS,107,15,5,BOS,90,12,13,27,18
2004-12-26,MIN,109,15,10,WAS,74,14,10,29,20
2004-12-26,PHO,106,17,1,TOR,94,10,18,27,19
2004-12-26,HOU,96,12,14,LAC,79,12,12,24,26
2004-12-26,DEN,88,13,13,DAL,102,17,10,30,23
2004-12-26,SAC,94,17,8,GSW,98,7,13,24,21
2004-12-27,WAS,106,14,11,CHA,87,7,16,21,27
2004-12-27,ORL,111,15,10,NYK,119,14,13,29,23
2004-12-27,IND,100,12,13,NOK,82,2,23,14,36
2004-12-27,MIA,116,22,7,ATL,102,5,20,27,27
2004-12-27,DET,100,13,12,NJN,90,9,16,22,28
2004-12-27,MEM,96,12,17,LAC,76,12,13,24,30
2004-12-27,UTA,88,5,15,SEA,98,19,5,24,20
2004-12-27,POR,104,13,12,PHI,111,7,10,20,22
2004-12-27,GSW,104,8,13,DEN,101,13,14,21,27
2004-12-28,ATL,102,5,21,CLE,111,16,11,21,32
2004-12-28,MIL,115,7,16,HOU,87,13,14,20,30
2004-12-28,CHI,80,9,16,NJN,84,9,17,18,33
2004-12-28,DAL,113,18,10,BOS,94,12,14,30,24
2004-12-28,SAS,115,16,5,PHO,94,18,1,34,6
2004-12-28,SEA,107,20,5,PHI,114,8,10,28,15
2004-12-28,LAL,117,14,12,TOR,99,10,19,24,31
2004-12-29,WAS,105,15,11,DET,107,14,12,29,23
2004-12-29,CHA,71,7,17,IND,74,13,13,20,30
2004-12-29,ORL,105,15,11,MIL,111,8,16,23,27
2004-12-29,CLE,87,17,11,HOU,98,13,15,30,26
2004-12-29,NYK,100,15,13,MIN,87,16,10,31,23
2004-12-29,MEM,117,13,17,BOS,109,12,15,25,32
2004-12-29,NOK,96,2,24,PHO,107,18,2,20,26
2004-12-29,LAC,101,12,14,UTA,90,5,16,17,30
2004-12-29,GSW,111,9,13,TOR,105,10,20,19,33
2004-12-30,ATL,79,5,22,SEA,94,20,6,25,28
2004-12-30,NJN,83,10,17,IND,96,14,13,24,30
2004-12-30,DET,78,15,12,MIA,89,23,7,38,19
2004-12-30,POR,80,13,13,SAS,114,17,5,30,18
2004-12-31,BOS,108,12,16,WAS,103,15,12,27,28
2004-12-31,CHA,97,7,18,SEA,103,21,6,28,24
2004-12-31,DEN,97,13,15,PHI,92,9,10,22,25
2004-12-31,UTA,102,5,17,SAC,109,17,9,22,26
2004-12-31,LAC,79,13,14,SAS,98,18,5,31,19
2004-12-31,HOU,105,14,15,MIL,90,9,16,23,31
2005-01-01,NYK,87,16,13,NJN,93,10,18,26,31
2005-01-01,MIA,113,24,7,CHA,90,7,19,31,26
2005-01-01,MIN,95,16,11,MEM,104,14,17,30,28
2005-01-01,CHI,105,9,17,ORL,90,15,12,24,29
2005-01-01,POR,97,13,14,GSW,88,10,13,23,27
2005-01-02,WAS,104,15,13,ATL,101,5,23,20,36
2005-01-02,LAC,89,13,15,PHI,83,9,11,22,26
2005-01-02,DET,100,15,13,BOS,88,13,16,28,29
2005-01-02,PHO,117,19,2,POR,98,14,14,33,16
2005-01-02,HOU,99,15,15,UTA,80,5,18,20,33
2005-01-02,DAL,123,19,10,MIL,104,9,17,28,27
2005-01-02,SAC,86,18,9,SAS,81,19,5,37,14
2005-01-02,LAL,99,15,12,DEN,91,14,15,29,27
2005-01-03,BOS,108,13,17,NOK,90,2,25,15,42
2005-01-03,TOR,105,10,21,ORL,94,15,13,25,34
2005-01-03,CHA,83,7,20,CLE,94,17,12,24,32
2005-01-03,MIA,96,25,7,SEA,98,22,6,47,13
2005-01-03,MEM,92,15,17,UTA,82,5,19,20,36
2005-01-03,CHI,80,10,17,DET,87,16,13,26,30
2005-01-03,DEN,98,14,16,LAC,102,14,15,28,31
2005-01-03,GSW,104,10,14,PHI,112,9,12,19,26
2005-01-04,WAS,112,16,13,NJN,88,11,18,27,31
2005-01-04,IND,116,15,13,MIL,99,9,18,24,31
2005-01-04,NYK,98,16,14,SAC,105,19,9,35,23
2005-01-04,MIN,115,16,12,PHO,122,20,2,36,14
2005-01-04,SAS,100,19,6,LAL,83,16,12,35,18
2005-01-05,BOS,84,14,17,GSW,83,10,15,24,32
2005-01-05,TOR,96,11,21,SAC,93,20,9,31,30
2005-01-05,CHA,102,7,21,MIN,84,16,13,23,34
2005-01-05,ORL,105,15,14,SEA,87,23,6,38,20
2005-01-05,CLE,101,18,12,ATL,85,5,24,23,36
2005-01-05,MIA,102,25,8,NYK,94,16,15,41,23
2005-01-05,MIL,97,9,19,NJN,74,11,19,20,38
2005-01-05,NOK,89,2,26,CHI,95,10,18,12,44
2005-01-05,DAL,118,20,10,LAL,104,16,13,36,23
2005-01-05,HOU,98,16,15,PHO,108,21,2,37,17
2005-01-05,UTA,99,5,20,PHI,106,10,12,15,32
2005-01-05,LAC,102,15,15,POR,98,14,15,29,30
2005-01-06,WAS,107,17,13,SEA,96,23,7,40,20
2005-01-06,DET,79,17,13,MEM,101,16,17,33,30
2005-01-06,SAS,111,20,6,IND,98,16,13,36,19
2005-01-07,TOR,105,12,21,MIL,107,10,19,22,40
2005-01-07,ORL,111,16,14,CHA,91,8,21,24,35
2005-01-07,BOS,104,15,17,DET,110,17,14,32,31
2005-01-07,NJN,82,11,20,GSW,72,10,16,21,36
2005-01-07,ATL,97,5,25,SAC,100,20,10,25,35
2005-01-07,MEM,84,17,17,NOK,76,2,27,19,44
2005-01-07,MIN,89,16,14,PHI,84,11,12,27,26
2005-01-07,CHI,84,11,18,UTA,78,5,21,16,39
2005-01-07,POR,92,14,16,MIA,103,26,8,40,24
2005-01-07,LAL,111,16,14,HOU,104,16,16,32,30
2005-01-08,CLE,104,19,12,NYK,79,16,16,35,28
2005-01-08,SAS,99,21,6,DEN,90,14,17,35,23
2005-01-08,LAC,91,16,15,PHO,108,22,2,38,17
2005-01-08,WAS,117,18,13,MIN,114,17,14,35,27
2005-01-08,ORL,104,17,14,NJN,101,12,20,29,34
2005-01-08,NOK,121,2,28,SAC,117,21,10,23,38
2005-01-08,CHI,102,12,18,BOS,91,15,18,27,36
2005-01-08,MIL,89,11,19,UTA,86,5,22,16,41
2005-01-08,DAL,121,21,10,IND,101,16,14,37,24
2005-01-09,TOR,109,12,22,GSW,87,10,17,22,39
2005-01-09,NYK,113,16,17,POR,105,14,17,30,34
2005-01-09,PHO,124,23,2,IND,89,16,15,39,17
2005-01-09,SEA,108,23,8,MIA,98,27,8,50,16
2005-01-09,DEN,98,14,18,HOU,116,16,17,30,35
2005-01-10,BOS,119,15,19,ORL,101,18,14,33,33
2005-01-10,PHI,100,11,13,POR,109,14,18,25,31
2005-01-10,MIN,96,17,15,LAL,105,17,14,34,29
2005-01-10,CHI,94,13,18,GSW,85,10,18,23,36
2005-01-10,UTA,97,5,23,SAS,96,22,6,27,29
2005-01-11,CLE,100,20,12,CHA,98,8,22,28,34
2005-01-11,NJN,80,12,21,DET,89,18,14,30,35
2005-01-11,NYK,82,17,17,NOK,88,3,28,20,45
2005-01-11,ATL,103,5,26,MIL,80,12,19,17,45
2005-01-11,MEM,85,18,17,IND,86,16,16,34,33
2005-01-11,PHO,122,24,2,MIA,107,27,9,51,11
2005-01-11,SAC,109,21,11,DEN,100,14,19,35,30
2005-01-11,SEA,104,24,8,LAC,99,16,16,40,24
2005-01-12,TOR,104,13,22,BOS,93,16,19,29,41
2005-01-12,WAS,104,19,13,POR,100,15,18,34,31
2005-01-12,DET,90,19,14,NOK,76,4,28,23,42
2005-01-12,MIN,80,17,16,ORL,87,18,15,35,31
2005-01-12,CHI,110,14,18,PHI,78,11,14,25,32
2005-01-12,SAS,94,22,7,MIL,79,12,20,34,27
2005-01-12,DAL,114,22,10,HOU,124,17,17,39,27
2005-01-12,DEN,95,14,20,LAL,83,18,14,32,34
2005-01-12,UTA,115,6,23,PHO,108,25,2,31,25
2005-01-12,LAC,103,16,17,SEA,92,25,8,41,25
2005-01-12,GSW,91,10,19,MIA,98,27,10,37,29
2005-01-13,HOU,94,18,17,NJN,85,12,22,30,39
2005-01-13,SAC,107,22,11,UTA,93,7,23,29,34
2005-01-13,LAL,98,18,15,CLE,94,21,12,39,27
2005-01-14,PHI,106,11,15,TOR,96,14,22,25,37
2005-01-14,CHA,89,8,23,MEM,109,18,18,26,41
2005-01-14,IND,101,17,16,PHO,83,25,3,42,19
2005-01-14,BOS,106,16,20,ATL,94,6,26,22,46
2005-01-14,DET,101,20,14,ORL,94,19,15,39,29
2005-01-14,NOK,112,4,29,POR,106,15,19,19,48
2005-01-14,SAS,98,23,7,DAL,95,22,11,45,18
2005-01-14,MIL,103,12,21,WAS,105,20,13,32,34
2005-01-14,DEN,83,15,20,MIN,93,17,17,32,37
2005-01-14,LAC,114,17,17,MIA,112,28,10,45,27
2005-01-14,SEA,103,25,9,GSW,84,10,20,35,29
2005-01-15,CHI,86,15,18,NYK,84,17,18,32,36
2005-01-15,WAS,108,21,13,PHO,103,25,4,46,17
2005-01-15,ATL,103,6,27,CHA,95,8,24,14,51
2005-01-15,DET,99,21,14,PHI,95,12,15,33,29
2005-01-15,IND,84,18,16,ORL,85,19,16,37,32
2005-01-15,MEM,101,19,18,MIL,82,12,22,31,40
2005-01-15,MIN,92,18,17,POR,84,15,20,33,37
2005-01-15,HOU,73,19,17,SAS,67,24,7,43,24
2005-01-15,DAL,98,22,12,NJN,93,12,23,34,35
2005-01-15,UTA,71,7,24,CLE,84,21,13,28,37
2005-01-15,SAC,99,23,11,LAC,95,18,17,41,28
2005-01-15,GSW,102,10,21,LAL,104,19,15,29,36
2005-01-16,TOR,102,14,23,NOK,99,5,29,19,52
2005-01-16,SEA,105,26,9,CLE,97,22,13,48,22
2005-01-17,NYK,86,17,19,CHI,88,16,18,33,37
2005-01-17,CHA,92,8,25,MIL,99,12,23,20,48
2005-01-17,PHI,95,12,16,NOK,91,5,30,17,46
2005-01-17,ATL,84,7,27,NJN,85,12,24,19,51
2005-01-17,DET,94,22,14,PHO,80,25,5,47,19
2005-01-17,LAC,83,18,18,SAC,89,24,11,42,29
2005-01-17,SAS,101,24,8,WAS,73,22,13,46,21
2005-01-17,MIN,91,19,17,TOR,100,15,23,34,40
2005-01-17,MEM,99,20,18,HOU,80,20,17,40,35
2005-01-17,LAL,94,20,15,UTA,102,7,25,27,40
2005-01-17,GSW,107,10,22,DEN,97,15,21,25,43
2005-01-18,ORL,103,20,16,DET,101,23,14,43,30
2005-01-18,HOU,74,20,18,IND,87,18,17,38,35
2005-01-18,DAL,137,23,12,WAS,120,22,14,45,26
2005-01-18,SAC,113,25,11,POR,107,15,21,40,32
2005-01-18,SEA,110,27,9,DEN,116,15,22,42,31
2005-01-19,BOS,92,17,20,CHI,83,17,18,34,38
2005-01-19,TOR,98,16,23,NYK,81,17,20,33,43
2005-01-19,CHA,105,8,26,PHI,107,13,16,21,42
2005-01-19,NJN,96,13,24,MIL,90,13,23,26,47
2005-01-19,MIA,111,28,11,ATL,92,7,28,35,39
2005-01-19,NOK,90,5,31,IND,87,19,17,24,48
2005-01-19,SAS,80,25,8,LAC,79,18,19,43,27
2005-01-19,PHO,79,25,6,MEM,88,21,18,46,24
2005-01-19,POR,101,15,22,CLE,107,22,14,37,36
2005-01-19,LAL,93,20,16,MIN,90,19,18,39,34
2005-01-20,DAL,99,24,12,LAC,77,18,20,42,32
2005-01-20,ORL,99,21,16,HOU,108,20,19,41,35
2005-01-20,SAC,123,26,11,CLE,96,23,14,49,25
2005-01-21,WAS,118,22,15,TOR,109,17,23,39,38
2005-01-21,CHA,99,8,27,DAL,105,25,12,33,39
2005-01-21,NJN,104,14,24,BOS,98,18,20,32,44
2005-01-21,NYK,91,17,21,HOU,92,21,19,38,40
2005-01-21,MIA,100,29,11,IND,106,19,18,48,29
2005-01-21,CHI,95,17,19,ATL,85,7,29,24,48
2005-01-21,MIL,89,13,24,DET,86,23,15,36,39
2005-01-21,PHO,123,25,7,SAS,128,26,8,51,15
2005-01-21,DEN,92,16,22,MEM,82,22,18,38,40
2005-01-21,LAL,105,21,16,GSW,101,11,22,32,38
2005-01-21,SEA,107,27,10,MIN,112,19,19,46,29
2005-01-22,ATL,100,7,30,BOS,96,18,21,25,51
2005-01-22,ORL,115,21,17,PHI,111,14,16,35,33
2005-01-22,DET,89,23,16,CHI,100,18,19,41,35
2005-01-22,IND,93,20,18,WAS,95,23,15,43,33
2005-01-22,NOK,88,6,31,LAC,85,18,21,24,52
2005-01-22,UTA,94,8,25,MEM,110,22,19,30,44
2005-01-22,POR,83,15,23,MIN,92,20,19,35,42
2005-01-22,GSW,87,11,23,CLE,105,23,15,34,38
2005-01-23,TOR,103,17,24,CHA,92,8,28,25,52
2005-01-23,DAL,95,26,12,DEN,93,17,22,43,34
2005-01-23,NYK,96,17,22,MIL,101,14,24,31,46
2005-01-23,PHO,113,25,8,NJN,105,15,24,40,32
2005-01-23,SAC,73,27,11,SAS,103,27,8,54,19
2005-01-23,SEA,122,27,11,UTA,105,8,26,35,37
2005-01-23,MIA,97,29,13,NOK,68,7,31,36,44
2005-01-24,PHI,106,14,17,MIA,98,29,12,43,29
2005-01-24,CLE,97,24,15,WAS,106,24,15,48,30
2005-01-24,ATL,82,8,30,CHI,107,19,19,27,49
2005-01-24,MIN,86,21,19,DET,83,23,17,44,36
2005-01-24,HOU,89,22,19,ORL,78,22,17,44,36
2005-01-24,POR,107,15,24,SAS,99,28,8,43,32
2005-01-24,LAC,97,18,22,DAL,87,27,12,45,34
2005-01-25,CHA,92,8,29,BOS,97,18,22,26,51
2005-01-25,NYK,118,17,23,PHO,133,26,8,43,31
2005-01-25,MEM,95,23,19,ORL,83,22,18,45,37
2005-01-25,CHI,111,20,19,DEN,107,17,23,37,42
2005-01-25,SAC,113,27,12,NJN,93,15,25,42,37
2005-01-25,LAL,93,22,16,SEA,104,28,11,50,27
2005-01-26,BOS,100,19,22,IND,86,20,19,39,41
2005-01-26,TOR,96,18,24,MIA,111,30,13,48,37
2005-01-26,WAS,117,25,15,PHI,107,15,17,40,32
2005-01-26,CLE,114,24,16,MEM,111,24,19,48,35
2005-01-26,DET,87,23,18,DEN,70,17,24,40,42
2005-01-26,MIL,115,15,24,PHO,121,27,8,42,32
2005-01-26,NOK,77,7,32,HOU,82,23,19,30,51
2005-01-26,MIN,104,22,19,ATL,87,8,31,30,50
2005-01-26,UTA,109,8,27,SEA,100,29,11,37,38
2005-01-26,POR,88,16,24,DAL,95,27,13,43,37
2005-01-26,LAC,105,19,22,LAL,89,22,17,41,39
2005-01-26,GSW,99,11,24,NJN,113,15,26,26,50
2005-01-27,IND,76,20,20,DET,88,24,18,44,38
2005-01-27,CHI,101,21,19,CHA,93,8,30,29,49
2005-01-27,SAS,90,28,9,SAC,80,28,12,56,21
2005-01-28,NYK,99,17,24,CLE,96,25,16,42,40
2005-01-28,CHA,101,8,31,TOR,94,18,25,26,56
2005-01-28,ORL,108,22,19,WAS,101,26,15,48,34
2005-01-28,BOS,119,20,22,PHO,128,28,8,48,30
2005-01-28,ATL,96,8,32,MIA,106,31,13,39,45
2005-01-28,NOK,99,7,33,PHI,95,15,18,22,51
2005-01-28,MIN,93,23,19,UTA,91,9,27,32,46
2005-01-28,MIL,100,15,25,DEN,106,17,25,32,50
2005-01-28,HOU,111,24,19,SAC,117,28,13,52,32
2005-01-28,POR,90,16,25,LAC,86,20,22,36,47
2005-01-28,LAL,103,22,18,NJN,109,16,26,38,44
2005-01-28,GSW,85,11,25,SEA,88,29,12,40,37
2005-01-29,WAS,97,26,16,ORL,103,23,19,49,35
2005-01-29,DET,91,25,18,NYK,61,18,24,43,42
2005-01-29,IND,88,20,21,DEN,95,18,25,38,46
2005-01-29,MEM,84,24,20,ATL,83,8,33,32,53
2005-01-29,CHI,97,22,19,BOS,101,20,23,42,42
2005-01-29,DAL,89,28,13,PHI,93,15,19,43,32
2005-01-29,SAS,93,29,9,NOK,83,8,33,37,42
2005-01-29,UTA,82,9,28,NJN,99,17,26,26,54
2005-01-29,LAC,96,20,23,GSW,85,11,26,31,49
2005-01-30,MIA,104,32,13,HOU,95,24,20,56,33
2005-01-30,TOR,105,18,26,PHO,123,29,8,47,34
2005-01-30,MIN,84,24,19,SAC,94,29,13,53,32
2005-01-30,CLE,104,25,17,MIL,87,15,26,40,43
2005-01-30,LAL,101,22,19,CHA,90,9,31,31,50
2005-01-31,BOS,94,21,23,HOU,97,24,21,45,44
2005-01-31,PHI,89,16,19,IND,88,20,22,36,41
2005-01-31,ATL,80,8,34,ORL,79,24,19,32,53
2005-01-31,NOK,91,8,34,MEM,98,25,20,33,54
2005-01-31,SEA,84,30,12,SAS,103,30,9,60,21
2005-01-31,LAC,96,21,23,NYK,89,18,25,39,48
2005-02-01,WAS,96,26,17,DET,105,26,18,52,35
2005-02-01,ORL,105,24,20,CLE,102,26,17,50,37
2005-02-01,NJN,107,18,26,CHI,97,22,20,40,46
2005-02-01,MIL,91,15,27,MIN,86,24,20,39,47
2005-02-01,MEM,108,26,20,PHO,97,30,8,56,28
2005-02-01,DAL,109,28,14,MIA,104,33,13,61,27
2005-02-01,DEN,96,19,25,NYK,76,18,26,37,51
2005-02-01,UTA,105,9,29,CHA,109,9,32,18,61
2005-02-01,SAC,101,30,13,SEA,106,30,13,60,26
2005-02-01,LAL,92,23,19,POR,79,17,25,40,44
2005-02-02,BOS,110,21,24,NJN,89,19,26,40,50
2005-02-02,PHI,95,17,19,HOU,118,25,21,42,40
2005-02-02,IND,97,20,23,TOR,98,18,27,38,50
2005-02-02,DET,99,27,18,ATL,84,9,34,36,52
2005-02-02,NOK,82,8,35,DAL,90,29,14,37,49
2005-02-02,MIN,79,24,21,PHO,108,30,9,54,30
2005-02-02,POR,97,17,26,DEN,94,20,25,37,51
2005-02-02,GSW,107,11,27,SAC,111,30,14,41,41
2005-02-03,MIA,100,33,14,CLE,88,26,18,59,32
2005-02-03,MEM,103,27,20,LAC,106,22,23,49,43
2005-02-03,LAL,91,24,19,SAS,103,31,9,55,28
2005-02-04,TOR,103,19,27,WAS,100,26,18,45,45
2005-02-04,PHI,103,17,20,ATL,85,9,35,26,55
2005-02-04,IND,95,20,24,DAL,94,30,14,50,38
2005-02-04,BOS,112,22,24,ORL,100,25,20,47,44
2005-02-04,MIL,92,16,27,LAC,90,23,23,39,50
2005-02-04,MIN,113,24,22,HOU,119,26,21,50,43
2005-02-04,SAC,116,31,14,NYK,115,18,27,49,41
2005-02-04,POR,101,18,26,CHA,89,10,32,28,58
2005-02-04,GSW,90,11,28,NOK,82,8,36,19,64
2005-02-05,NJN,107,19,27,DET,85,28,18,47,45
2005-02-05,WAS,112,26,19,MIL,94,17,27,43,46
2005-02-05,ATL,79,9,36,IND,84,21,24,30,60
2005-02-05,MIA,108,34,14,CHI,97,22,21,56,35
2005-02-05,CLE,101,26,19,ORL,92,25,21,51,40
2005-02-05,DEN,107,20,26,GSW,91,12,28,32,54
2005-02-05,UTA,108,9,30,NOK,92,8,37,17,67
2005-02-05,PHO,114,31,9,NYK,106,18,28,49,37
2005-02-05,POR,114,19,26,SAC,108,32,14,51,40
2005-02-05,SEA,113,31,13,CHA,99,10,33,41,46
2005-02-06,TOR,113,20,27,DAL,122,30,15,50,42
2005-02-06,PHI,106,18,20,LAC,104,23,24,41,44
2005-02-06,MIN,100,24,23,BOS,103,23,24,47,47
2005-02-06,HOU,103,27,21,LAL,102,24,20,51,41
2005-02-07,WAS,108,27,19,IND,104,22,24,49,43
2005-02-07,NJN,107,20,27,PHI,97,19,20,39,47
2005-02-07,ATL,114,9,37,LAL,108,24,21,33,58
2005-02-07,MIA,105,35,14,GSW,96,12,29,47,43
2005-02-07,UTA,99,10,30,NYK,102,18,29,28,59
2005-02-08,CHA,85,10,34,SAS,104,32,9,42,43
2005-02-08,ORL,109,25,22,GSW,113,12,30,37,52
2005-02-08,CLE,104,27,19,TOR,91,20,28,47,47
2005-02-08,MIL,121,17,28,BOS,97,24,24,41,52
2005-02-08,MEM,108,27,21,MIN,96,24,24,51,45
2005-02-08,DAL,100,31,15,CHI,107,22,22,53,37
2005-02-08,DEN,97,21,26,UTA,87,10,31,31,57
2005-02-08,SAC,123,32,15,PHO,125,32,9,64,24
2005-02-08,SEA,108,32,13,NOK,91,8,38,40,51
2005-02-09,BOS,94,24,25,LAC,89,23,25,47,50
2005-02-09,TOR,107,20,29,MIL,110,18,28,38,57
2005-02-09,PHI,95,19,21,MEM,98,28,21,47,42
2005-02-09,WAS,95,28,19,SAS,87,33,9,61,28
2005-02-09,IND,94,22,25,CHA,87,10,35,32,60
2005-02-09,NJN,103,21,27,LAL,104,24,22,45,49
2005-02-09,NYK,110,19,29,MIA,116,36,14,55,43
2005-02-09,MIN,98,24,25,DEN,92,22,26,46,51
2005-02-09,HOU,105,28,21,CHI,92,23,22,51,43
2005-02-09,POR,80,20,26,NOK,91,8,39,28,65
2005-02-10,ORL,101,25,23,ATL,96,10,37,35,60
2005-02-10,DET,103,28,19,LAL,81,25,22,53,41
2005-02-10,SEA,115,33,13,SAC,107,32,16,65,29
2005-02-11,TOR,91,20,30,PHI,106,19,22,39,52
2005-02-11,WAS,94,29,19,LAC,91,23,26,52,45
2005-02-11,CHA,87,10,36,MIA,97,37,14,47,50
2005-02-11,IND,83,23,25,HOU,91,29,21,52,46
2005-02-11,BOS,111,25,25,NYK,94,19,30,44,55
2005-02-11,NJN,91,21,28,SAS,101,33,10,54,38
2005-02-11,CLE,101,28,19,DEN,106,22,27,50,46
2005-02-11,MEM,88,29,21,POR,82,20,27,49,48
2005-02-11,NOK,111,9,39,GSW,108,13,30,22,69
2005-02-11,UTA,100,10,32,MIN,82,25,25,35,57
2005-02-11,PHO,105,33,9,SEA,113,34,13,67,22
2005-02-11,SAC,113,32,17,DAL,115,31,16,63,33
2005-02-12,PHI,112,20,22,ORL,99,26,23,46,45
2005-02-12,DET,107,29,19,WAS,86,30,19,59,38
2005-02-12,MIL,113,19,28,ATL,83,10,38,29,66
2005-02-13,MIA,96,38,14,SAS,92,34,10,72,24
2005-02-13,CLE,103,28,20,LAL,89,25,23,53,43
2005-02-13,MIN,83,25,26,CHI,87,23,23,48,49
2005-02-13,BOS,100,26,25,SAC,104,32,18,58,43
2005-02-13,TOR,109,20,31,LAC,106,23,27,43,58
2005-02-13,NJN,94,21,29,DEN,79,23,27,44,56
2005-02-13,NYK,102,19,31,CHA,99,10,37,29,68
2005-02-13,ORL,97,26,24,NOK,94,10,39,36,63
2005-02-13,IND,76,23,26,MEM,73,30,21,53,47
2005-02-13,SEA,92,35,13,DAL,95,32,16,67,29
2005-02-13,HOU,81,30,21,POR,80,20,28,50,49
2005-02-13,GSW,102,13,31,PHX,106,6,2,19,33
2005-02-14,PHI,106,21,22,NYK,105,20,31,41,53
2005-02-14,CHA,77,10,38,POR,80,20,29,30,67
2005-02-14,DET,107,30,19,MIL,83,20,28,50,47
2005-02-14,NOK,98,10,40,WAS,96,30,20,40,60
2005-02-14,PHO,136,33,10,UTA,128,11,32,44,42
2005-02-15,ORL,99,27,24,LAC,94,23,28,50,52
2005-02-15,ATL,96,10,39,DEN,100,23,28,33,67
2005-02-15,MIN,82,25,27,NJN,71,22,29,47,56
2005-02-15,CHI,107,24,23,SAC,102,33,18,57,41
2005-02-15,HOU,123,31,21,WAS,93,30,21,61,42
2005-02-15,LAL,102,25,24,UTA,95,11,33,36,57
2005-02-15,GSW,107,13,32,DAL,114,33,16,46,48
2005-02-16,BOS,90,26,26,MEM,88,30,22,56,48
2005-02-16,TOR,115,21,31,CHI,121,25,23,46,54
2005-02-16,PHI,75,22,22,DET,93,31,19,53,41
2005-02-16,CHA,94,10,39,DEN,88,24,28,34,67
2005-02-16,CLE,111,29,20,ATL,89,10,40,39,60
2005-02-16,IND,95,24,26,POR,87,21,29,45,55
2005-02-16,NJN,96,22,30,SAC,85,33,19,55,49
2005-02-16,NYK,108,20,32,MIL,90,20,29,40,61
2005-02-16,MIA,113,39,14,LAC,95,23,29,62,43
2005-02-16,NOK,78,11,40,SAS,101,34,11,45,51
2005-02-16,SEA,110,35,14,GSW,117,13,33,48,47
2005-02-17,MIN,94,26,27,CLE,88,30,20,56,47
2005-02-17,PHO,113,34,10,DAL,119,34,16,68,26
2005-02-22,CHA,102,11,39,MIL,112,20,30,31,69
2005-02-22,ORL,84,28,24,IND,108,25,26,53,50
2005-02-22,NJN,82,23,30,TOR,100,21,32,44,62
2005-02-22,DET,97,32,19,NYK,88,21,32,53,51
2005-02-22,CHI,105,26,23,MIA,101,40,14,66,37
2005-02-22,HOU,85,32,21,SEA,87,35,15,67,36
2005-02-22,SAC,114,33,20,ATL,104,10,41,43,61
2005-02-22,LAL,104,26,24,BOS,95,27,26,53,50
2005-02-23,WAS,93,30,22,MEM,83,30,23,60,45
2005-02-23,CLE,100,30,21,CHI,91,27,23,57,44
2005-02-23,IND,93,26,26,MIA,91,40,15,66,41
2005-02-23,MIL,100,21,30,NJN,81,23,31,44,61
2005-02-23,NOK,85,11,41,SEA,103,36,15,47,56
2005-02-23,SAS,99,35,11,HOU,81,32,22,67,33
2005-02-23,DEN,107,24,29,BOS,86,27,27,51,56
2005-02-23,UTA,83,11,34,DAL,101,35,16,46,50
2005-02-23,PHO,118,34,11,LAC,101,23,30,57,41
2005-02-23,POR,83,21,30,LAL,86,27,24,48,54
2005-02-23,GSW,101,14,33,ATL,96,10,42,24,75
2005-02-24,NYK,113,21,33,PHL,101,4,4,25,37
2005-02-24,DAL,122,36,16,SAC,113,34,20,70,36
2005-02-24,LAC,92,23,31,MIN,86,27,27,50,58
2005-02-25,NJN,93,23,32,CHA,86,11,40,34,72
2005-02-25,IND,106,27,26,CLE,82,31,21,58,47
2005-02-25,MEM,94,30,24,DEN,97,25,29,55,53
2005-02-25,CHI,97,27,24,WAS,90,31,22,58,46
2005-02-25,MIL,102,22,30,TOR,106,22,32,44,62
2005-02-25,UTA,102,11,35,BOS,109,27,28,38,63
2005-02-25,POR,102,21,31,ATL,101,10,43,31,74
2005-02-25,LAL,90,28,24,DET,111,33,19,61,43
2005-02-25,SEA,98,37,15,MIN,88,27,28,64,43
2005-02-26,MIA,101,40,16,ORL,98,28,25,68,41
2005-02-26,CHA,90,11,41,CHI,94,28,24,39,65
2005-02-26,NYK,90,22,33,IND,79,28,26,50,59
2005-02-26,PHI,99,22,23,SAC,101,34,21,56,44
2005-02-26,DAL,123,37,16,PHO,124,35,11,72,27
2005-02-26,SAS,82,36,11,MEM,84,30,25,66,36
2005-02-27,TOR,108,23,32,LAL,102,28,25,51,57
2005-02-27,NJN,104,24,32,CLE,98,31,22,55,54
2005-02-27,MIL,99,22,31,SEA,73,38,15,60,46
2005-02-27,HOU,92,32,23,UTA,99,11,36,43,59
2005-02-27,WAS,108,31,23,SAC,110,35,21,66,44
2005-02-27,NOK,93,11,42,DEN,94,26,29,37,71
2005-02-27,ORL,103,28,26,MIA,112,41,16,69,42
2005-02-27,PHO,113,36,11,BOS,120,28,28,64,39
2005-02-27,POR,83,22,31,MIN,91,27,29,49,60
2005-02-27,GSW,88,15,33,DET,94,34,19,49,52
2005-02-27,LAC,111,24,31,ATL,104,10,44,34,75
2005-02-28,CLE,92,31,23,SAS,94,36,12,67,35
2005-02-28,NYK,117,23,33,LAL,115,28,26,51,59
2005-02-28,DAL,90,37,17,NOK,86,11,43,48,60
2005-02-28,UTA,87,12,36,LAC,86,25,31,37,67
2005-03-01,MEM,99,31,25,GSW,97,15,34,46,59
2005-03-01,CHA,94,11,42,SAC,87,36,21,47,63
2005-03-01,IND,93,28,27,SEA,101,38,16,66,43
2005-03-01,MIL,111,23,31,PHI,118,22,24,45,55
2005-03-01,CHI,89,29,24,HOU,119,32,24,61,48
2005-03-01,DEN,97,27,29,ATL,74,10,45,37,74
2005-03-01,POR,93,22,32,DET,103,35,19,57,51
2005-03-02,PHI,93,23,24,NJN,99,25,32,48,56
2005-03-02,WAS,101,31,24,HOU,98,33,24,64,48
2005-03-02,ORL,114,28,27,SAC,111,36,22,64,49
2005-03-02,CLE,86,31,24,SEA,103,39,16,70,40
2005-03-02,BOS,104,29,28,LAL,101,28,27,57,55
2005-03-02,MIN,93,28,29,GSW,99,15,35,43,64
2005-03-02,SAS,92,37,12,TOR,86,24,32,61,44
2005-03-02,NOK,94,11,44,CHA,85,12,42,23,86
2005-03-02,UTA,96,13,36,ATL,74,10,46,23,82
2005-03-02,LAC,101,25,32,DAL,92,38,17,63,49
2005-03-03,NJN,90,26,32,MIA,106,42,16,68,48
2005-03-03,DEN,96,28,29,IND,87,28,28,56,57
2005-03-03,PHO,100,36,12,DET,97,36,19,72,31
2005-03-04,PHI,98,23,25,CLE,89,31,25,54,50
2005-03-04,WAS,90,32,24,GSW,103,16,35,48,59
2005-03-04,ORL,111,29,27,NYK,89,24,33,53,60
2005-03-04,BOS,104,30,28,CHA,84,12,43,42,71
2005-03-04,MIA,104,43,16,SAC,83,36,23,79,39
2005-03-04,MEM,86,32,25,TOR,75,24,33,56,58
2005-03-04,NOK,92,12,44,UTA,85,14,36,26,80
2005-03-04,MIN,103,28,30,MIL,97,23,32,51,62
2005-03-04,SAS,102,38,12,CHI,99,29,25,67,37
2005-03-04,POR,97,22,33,IND,106,28,29,50,62
2005-03-04,LAL,108,28,28,DAL,103,38,18,66,46
2005-03-04,SEA,95,40,16,DET,87,36,20,76,36
2005-03-05,LAC,89,26,32,DEN,105,29,29,55,61
2005-03-05,CHA,84,12,44,WAS,86,32,25,44,69
2005-03-05,ATL,97,10,47,PHI,98,24,25,34,72
2005-03-05,NJN,81,26,33,ORL,105,30,27,56,60
2005-03-05,MIL,95,23,33,CHI,87,29,26,52,59
2005-03-05,PHO,129,37,12,POR,116,22,34,59,46
2005-03-06,HOU,90,33,25,DAL,69,38,19,71,44
2005-03-06,SAC,100,36,24,DET,85,36,21,72,45
2005-03-06,BOS,97,31,28,MIN,99,29,30,60,58
2005-03-06,NOK,84,13,44,TOR,95,24,34,37,78
2005-03-06,SAS,101,39,12,UTA,94,14,37,53,49
2005-03-06,NYK,115,24,34,GSW,99,17,35,41,69
2005-03-06,CLE,82,31,26,MIA,102,44,16,75,42
2005-03-06,SEA,99,41,16,PHO,110,38,12,79,28
2005-03-06,LAL,103,29,28,IND,94,29,29,58,57
2005-03-07,MIA,108,45,16,PHI,100,25,25,70,41
2005-03-07,CHI,90,29,27,MIL,85,24,33,53,60
2005-03-07,DAL,113,38,20,TOR,105,25,34,63,54
2005-03-07,DEN,111,30,29,POR,98,22,35,52,64
2005-03-07,LAC,102,26,33,MEM,105,33,25,59,58
2005-03-08,PHI,85,25,26,GSW,104,17,36,42,62
2005-03-08,CLE,111,31,27,ORL,92,31,27,62,54
2005-03-08,NYK,93,25,34,WAS,83,33,25,58,59
2005-03-08,MIL,105,24,34,ATL,101,10,48,34,82
2005-03-08,MIN,102,30,30,CHA,97,12,45,42,75
2005-03-08,SAS,90,40,12,NJN,74,26,34,66,46
2005-03-08,UTA,83,14,38,IND,89,29,30,43,68
2005-03-08,SAC,85,37,24,MEM,82,34,25,71,49
2005-03-08,SEA,95,41,17,HOU,97,34,25,75,42
2005-03-08,LAL,101,30,28,LAC,110,26,34,56,62
2005-03-09,BOS,95,31,29,ATL,91,10,49,41,78
2005-03-09,TOR,106,25,35,ORL,96,31,28,56,63
2005-03-09,DET,92,36,22,GSW,88,18,36,54,58
2005-03-09,NOK,85,13,45,NJN,86,26,35,39,80
2005-03-09,PHO,107,39,12,SAS,101,41,12,80,24
2005-03-09,POR,84,22,36,CHI,97,30,27,52,63
2005-03-10,MIA,107,46,16,MIN,90,31,30,77,46
2005-03-10,DAL,95,39,20,LAL,100,30,29,69,49
2005-03-11,TOR,112,26,35,ATL,116,10,50,36,85
2005-03-11,PHI,112,25,27,CHA,80,12,46,37,73
2005-03-11,ORL,96,31,29,MIN,101,31,31,62,60
2005-03-11,IND,101,30,30,GSW,83,18,37,48,67
2005-03-11,BOS,115,32,29,DET,113,37,22,69,51
2005-03-11,MIL,110,25,34,DAL,112,39,21,64,55
2005-03-11,UTA,82,14,39,MEM,94,34,26,48,65
2005-03-11,PHO,107,40,12,HOU,127,35,25,75,37
2005-03-11,SAC,113,38,24,LAC,112,27,34,65,58
2005-03-11,SEA,97,41,18,CHI,100,31,27,72,45
2005-03-12,MIA,90,47,16,NJN,65,27,35,74,51
2005-03-12,CHA,116,12,47,LAL,117,31,29,43,76
2005-03-12,ATL,92,11,50,GSW,105,18,38,29,88
2005-03-12,NOK,111,13,46,MIL,107,25,35,38,81
2005-03-12,SAS,87,41,13,DEN,90,31,29,72,42
2005-03-12,POR,80,22,37,MEM,66,35,26,57,63
2005-03-13,MIN,93,32,31,DAL,102,40,21,72,52
2005-03-13,LAC,83,27,35,CHI,78,32,27,59,62
2005-03-13,SAC,96,39,24,HOU,111,36,25,75,49
2005-03-13,BOS,105,33,29,WAS,101,33,26,66,55
2005-03-13,TOR,128,26,36,PHI,110,26,27,52,63
2005-03-13,NYK,80,26,34,SEA,90,41,19,67,53
2005-03-13,ORL,82,31,30,NJN,98,27,36,58,66
2005-03-13,DET,64,37,23,UTA,62,14,40,51,63
2005-03-13,CLE,98,32,27,IND,86,31,30,63,57
2005-03-13,DEN,101,32,29,PHO,106,40,13,72,42
2005-03-14,WAS,95,33,27,LAL,81,32,29,65,56
2005-03-14,CHA,110,12,48,BOS,119,34,29,46,77
2005-03-14,ATL,108,11,51,DET,114,38,23,49,74
2005-03-14,MIA,110,48,16,MIL,71,25,36,73,52
2005-03-14,MEM,104,35,27,POR,83,23,37,58,64
2005-03-14,SAS,112,41,14,NOK,89,14,46,55,60
2005-03-14,GSW,94,19,38,HOU,97,37,25,56,63
2005-03-15,PHI,108,26,28,LAL,91,32,30,58,58
2005-03-15,CLE,92,33,27,UTA,73,14,41,47,68
2005-03-15,NYK,96,26,35,MIA,98,49,16,75,51
2005-03-15,CHI,93,32,28,SEA,99,42,19,74,47
2005-03-15,DAL,91,41,21,MIN,100,32,32,73,53
2005-03-15,SAC,105,39,25,ORL,94,31,31,70,56
2005-03-16,BOS,110,35,29,TOR,109,27,36,62,65
2005-03-16,IND,103,31,31,UTA,84,14,42,45,73
2005-03-16,NJN,100,28,36,CHI,84,32,29,60,65
2005-03-16,ATL,93,11,52,WAS,122,34,27,45,79
2005-03-16,DET,102,39,23,SEA,95,43,19,82,42
2005-03-16,MIL,96,25,37,CLE,88,34,27,59,64
2005-03-16,NOK,82,14,47,MEM,88,36,27,50,74
2005-03-16,HOU,108,38,25,POR,77,23,38,61,63
2005-03-16,SAS,89,42,14,MIN,73,33,32,75,46
2005-03-16,DEN,120,32,30,CHA,101,12,49,44,79
2005-03-16,LAC,110,28,35,ORL,102,31,32,59,67
2005-03-17,MIA,102,50,16,LAL,89,32,31,82,47
2005-03-17,DAL,98,41,22,POR,94,23,39,64,61
2005-03-17,GSW,100,19,39,SAC,97,40,25,59,64
2005-03-18,NJN,94,29,36,UTA,80,14,43,43,79
2005-03-18,ATL,92,11,53,NYK,106,26,36,37,89
2005-03-18,CLE,81,34,28,PHI,93,27,28,61,56
2005-03-18,IND,103,32,31,LAL,97,32,32,64,63
2005-03-18,DET,103,40,23,TOR,92,27,37,67,60
2005-03-18,MEM,88,37,27,MIN,83,33,33,70,60
2005-03-18,CHI,90,32,30,NOK,94,14,48,46,78
2005-03-18,MIL,99,26,37,WAS,90,35,27,61,64
2005-03-18,HOU,92,39,25,BOS,103,36,29,75,54
2005-03-18,SAS,93,43,14,CHA,76,12,50,55,64
2005-03-18,DEN,115,33,30,LAC,96,29,35,62,65
2005-03-18,PHO,100,41,13,GSW,110,20,39,61,52
2005-03-18,SEA,98,43,20,ORL,90,31,33,74,53
2005-03-19,PHI,88,28,28,CHI,94,32,31,60,59
2005-03-19,WAS,96,35,28,UTA,95,14,44,49,72
2005-03-19,MIA,97,51,16,NYK,82,27,36,78,52
2005-03-19,NOK,100,15,48,BOS,113,37,29,52,77
2005-03-19,DAL,104,42,22,CHA,93,12,51,54,73
2005-03-19,POR,92,23,40,ORL,97,31,34,54,74
2005-03-19,LAC,107,29,36,SAC,111,40,26,69,62
2005-03-20,TOR,105,27,38,CLE,98,34,29,61,67
2005-03-20,DET,110,41,23,SAS,101,44,14,85,37
2005-03-20,IND,85,33,31,NJN,94,30,36,63,67
2005-03-20,MEM,91,38,27,PHO,97,41,14,79,41
2005-03-20,MIN,94,33,34,HOU,86,39,26,72,60
2005-03-20,DEN,114,34,30,MIL,103,27,37,61,67
2005-03-20,SAC,94,41,26,GSW,104,21,39,62,65
2005-03-20,LAL,100,32,33,SEA,102,44,20,76,53
2005-03-21,CHA,102,12,52,ORL,97,32,34,44,86
2005-03-21,NYK,88,27,37,SAS,75,44,15,71,52
2005-03-21,CHI,105,33,31,ATL,91,11,54,44,85
2005-03-21,DAL,103,43,22,NOK,86,15,49,58,71
2005-03-21,LAC,96,29,37,POR,89,23,41,52,78
2005-03-22,CLE,91,34,30,DET,76,42,23,76,53
2005-03-22,NJN,98,31,36,IND,91,33,32,64,68
2005-03-22,ATL,94,11,55,PHO,105,42,14,53,69
2005-03-22,DEN,127,35,30,WAS,98,36,28,71,58
2005-03-22,UTA,115,14,45,LAL,107,32,34,46,79
2005-03-22,HOU,84,39,27,MIA,82,52,16,91,43
2005-03-22,SAC,112,41,27,POR,93,23,42,64,69
2005-03-22,SEA,92,45,20,MIL,84,27,38,72,58
2005-03-23,TOR,85,28,38,CHI,94,34,31,62,69
2005-03-23,CHA,105,13,52,PHO,120,43,14,56,66
2005-03-23,IND,100,33,33,SAS,93,44,16,77,49
2005-03-23,NYK,107,28,37,BOS,82,38,29,66,66
2005-03-23,PHI,107,28,29,DET,84,42,24,70,53
2005-03-23,MIN,107,34,34,NOK,102,15,50,49,84
2005-03-23,LAC,116,30,37,MIL,108,27,39,57,76
2005-03-23,GSW,97,22,39,DAL,109,44,22,66,61
2005-03-24,ORL,94,32,35,CHA,108,13,53,45,88
2005-03-24,NJN,96,32,36,MEM,105,38,28,70,64
2005-03-24,HOU,99,40,27,CLE,80,35,30,75,57
2005-03-24,DEN,117,36,30,LAL,96,32,35,68,65
2005-03-24,UTA,84,15,45,WAS,85,36,29,51,74
2005-03-24,SAC,109,42,27,DAL,101,45,22,87,49
2005-03-24,POR,91,23,43,SEA,96,46,20,69,63
2005-03-25,PHI,103,29,29,TOR,101,28,39,57,68
2005-03-25,BOS,86,38,30,CHI,94,35,31,73,61
2005-03-25,MIA,125,52,17,PHO,115,44,14,96,31
2005-03-25,DET,81,42,25,IND,94,34,33,76,58
2005-03-25,NOK,68,15,51,HOU,81,41,27,56,78
2005-03-25,SAS,111,44,17,ATL,95,11,56,55,73
2005-03-25,LAC,98,31,37,WAS,94,37,29,68,66
2005-03-25,GSW,118,22,40,MIL,117,27,40,49,80
2005-03-25,SEA,109,47,20,NYK,101,29,37,76,57
2005-03-26,NJN,75,32,37,MIN,96,35,34,67,71
2005-03-26,CHA,94,14,53,MIA,92,53,17,67,70
2005-03-26,ATL,104,11,57,TOR,109,28,40,39,97
2005-03-26,ORL,116,32,36,PHX,118,7,2,39,38
2005-03-26,DET,105,42,26,BOS,99,38,31,80,57
2005-03-26,MEM,85,39,28,NOK,96,15,52,54,80
2005-03-26,CHI,100,36,31,IND,96,35,33,71,64
2005-03-26,DAL,117,45,23,CLE,86,35,31,80,54
2005-03-26,DEN,113,37,30,SAC,99,43,27,80,57
2005-03-26,UTA,94,15,46,MIL,89,27,41,42,87
2005-03-26,POR,103,23,44,NYK,96,29,38,52,82
2005-03-27,SAS,83,45,17,HOU,70,42,27,87,44
2005-03-27,MIN,89,36,34,LAC,85,32,37,68,71
2005-03-27,LAL,89,32,36,PHI,96,30,29,62,65
2005-03-27,SEA,94,48,20,WAS,95,37,30,85,50
2005-03-28,CHA,91,15,53,NJN,95,32,38,47,91
2005-03-28,ORL,109,32,37,ATL,102,11,58,43,95
2005-03-28,DET,88,43,26,DAL,95,46,23,89,49
2005-03-28,MIL,76,27,42,IND,90,35,34,62,76
2005-03-28,NOK,108,16,52,CLE,109,35,32,51,84
2005-03-28,CHI,94,37,31,MEM,86,39,29,76,60
2005-03-28,UTA,85,16,46,HOU,99,42,28,58,74
2005-03-28,PHO,123,44,15,DEN,114,38,30,82,45
2005-03-28,SAC,118,43,28,PHI,109,31,29,74,57
2005-03-28,POR,106,24,44,WAS,114,38,30,62,74
2005-03-28,GSW,108,23,40,NYK,100,29,39,52,79
2005-03-29,CLE,94,36,32,LAC,84,32,38,68,70
2005-03-29,MIA,103,53,18,TOR,91,29,40,82,58
2005-03-29,MEM,99,39,30,SEA,102,48,21,87,51
2005-03-29,LAL,117,32,37,NYK,107,29,40,61,77
2005-03-30,BOS,100,38,32,DAL,112,47,23,85,55
2005-03-30,WAS,102,39,30,ATL,99,11,59,50,89
2005-03-30,CHA,99,15,54,CHI,102,38,31,53,85
2005-03-30,ORL,108,33,37,TOR,96,29,41,62,78
2005-03-30,NJN,95,33,38,LAC,78,32,39,65,77
2005-03-30,DET,99,43,27,SAC,82,44,28,87,55
2005-03-30,MIL,109,27,43,GSW,113,24,40,51,83
2005-03-30,SAS,89,46,17,SEA,76,49,21,95,38
2005-03-30,UTA,98,16,47,DEN,109,38,31,54,78
2005-03-30,PHO,116,45,15,PHI,87,31,30,76,45
2005-03-30,POR,84,24,45,HOU,100,43,28,67,73
2005-03-31,IND,114,36,34,MIA,108,54,18,90,52
2005-03-31,CHI,102,39,31,CLE,90,37,32,76,63
2005-03-31,LAL,96,33,37,MIN,105,37,34,70,71
2005-04-01,PHI,83,31,31,DAL,100,48,23,79,54
2005-04-01,CHA,107,15,55,TOR,119,29,42,44,97
2005-04-01,ORL,102,34,37,WAS,111,40,30,74,67
2005-04-01,ATL,100,11,60,BOS,116,38,33,49,93
2005-04-01,NYK,91,29,41,NJN,93,34,38,63,79
2005-04-01,DET,97,44,27,LAC,84,32,40,76,67
2005-04-01,CLE,109,37,33,SAC,128,44,29,81,62
2005-04-01,MIL,82,27,44,MEM,93,39,31,66,75
2005-04-01,HOU,73,44,28,NOK,76,16,53,60,81
2005-04-01,UTA,91,16,48,GSW,108,25,40,41,88
2005-04-01,PHO,107,46,15,MIN,98,38,34,84,49
2005-04-01,DEN,102,39,31,SAS,84,47,17,86,48
2005-04-01,SEA,89,49,22,POR,87,24,46,73,68
2005-04-02,NJN,102,35,38,ORL,103,34,38,69,76
2005-04-02,NOK,99,17,53,MIA,111,54,19,71,72
2005-04-02,CHI,112,40,31,CHA,97,15,56,55,87
2005-04-02,SAS,95,47,18,LAL,94,33,38,80,56
2005-04-02,POR,97,24,47,DEN,103,40,31,64,78
2005-04-03,WAS,76,41,30,IND,79,37,34,78,64
2005-04-03,CLE,100,37,34,DAL,80,49,23,86,57
2005-04-03,MIL,106,27,45,NYK,102,29,42,56,87
2005-04-03,SAC,100,45,29,MIN,112,38,35,83,64
2005-04-03,BOS,93,39,33,PHI,97,31,32,70,65
2005-04-03,TOR,103,30,42,DET,113,45,27,75,69
2005-04-03,ATL,91,11,61,LAC,111,32,41,43,102
2005-04-03,GSW,101,26,40,SEA,92,50,22,76,62
2005-04-03,MEM,102,40,31,LAL,82,33,39,73,70
2005-04-03,HOU,78,44,29,PHX,91,8,2,52,31
2005-04-05,WAS,108,41,31,BOS,116,39,34,80,65
2005-04-05,CHA,102,15,57,LAC,104,33,41,48,98
2005-04-05,CLE,80,38,34,NJN,111,35,39,73,73
2005-04-05,NYK,79,29,43,IND,97,38,34,67,77
2005-04-05,ATL,86,11,62,NOK,96,17,54,28,116
2005-04-05,MIA,104,55,19,CHI,86,41,31,96,50
2005-04-05,MEM,91,41,31,DEN,94,41,31,82,62
2005-04-05,DAL,114,49,24,ORL,105,35,38,84,62
2005-04-05,UTA,90,16,49,POR,79,24,48,40,97
2005-04-05,PHO,125,47,15,LAL,99,33,40,80,55
2005-04-05,SAC,122,45,30,SEA,101,50,23,95,53
2005-04-05,GSW,122,27,40,HOU,117,44,30,71,70
2005-04-06,BOS,103,40,34,MIL,97,28,45,68,79
2005-04-06,TOR,74,30,43,MEM,104,41,32,71,75
2005-04-06,PHI,106,32,32,CHA,103,15,58,47,90
2005-04-06,ORL,101,35,39,CHI,102,41,32,76,71
2005-04-06,IND,98,39,34,CLE,77,38,35,77,69
2005-04-06,DET,105,46,27,WAS,93,41,32,87,59
2005-04-06,NOK,83,18,54,DEN,94,42,31,60,85
2005-04-06,SAS,91,48,18,LAC,82,34,41,82,59
2005-04-06,MIN,111,39,35,UTA,86,17,49,56,84
2005-04-06,POR,102,24,49,GSW,104,28,40,52,89
2005-04-07,NJN,110,36,39,NYK,98,29,44,65,83
2005-04-07,DAL,104,50,24,SAS,68,49,18,99,42
2005-04-07,LAL,100,33,41,HOU,114,44,31,77,72
2005-04-08,TOR,109,30,44,ATL,101,11,63,41,107
2005-04-08,PHI,103,33,32,CLE,98,38,36,71,68
2005-04-08,ORL,102,35,40,DET,114,47,27,82,67
2005-04-08,NYK,94,29,45,CHI,102,42,32,71,77
2005-04-08,IND,93,40,34,WAS,83,41,33,81,67
2005-04-08,MEM,97,42,32,MIA,81,56,19,98,51
2005-04-08,NOK,87,18,55,UTA,98,17,50,35,105
2005-04-08,MIL,93,28,46,CHA,75,15,59,43,105
2005-04-08,MIN,104,40,35,DEN,107,43,31,83,66
2005-04-08,POR,115,24,50,SAC,119,46,30,70,80
2005-04-08,GSW,127,29,40,PHO,119,48,15,77,55
2005-04-08,SEA,94,50,24,LAL,117,33,42,83,66
2005-04-09,NJN,99,37,39,BOS,86,41,34,78,73
2005-04-09,WAS,106,41,34,PHI,112,34,32,75,66
2005-04-09,ATL,105,11,64,MIN,98,40,36,51,100
2005-04-09,CLE,98,38,37,MIL,81,29,46,67,83
2005-04-09,CHI,110,43,32,TOR,97,31,44,74,76
2005-04-09,DAL,88,51,24,UTA,81,18,50,69,74
2005-04-09,DEN,121,44,31,SEA,105,50,25,94,56
2005-04-09,PHO,97,48,16,HOU,98,45,31,93,47
2005-04-09,LAC,124,34,42,SAS,125,49,19,83,61
2005-04-10,MIA,72,56,20,DET,80,48,27,104,47
2005-04-10,IND,112,41,34,NYK,113,29,46,70,80
2005-04-10,SAC,124,47,30,LAL,105,34,42,81,72
2005-04-10,NOK,81,18,56,POR,90,24,51,42,107
2005-04-10,MEM,102,43,32,CHA,95,15,60,58,92
2005-04-10,GSW,134,30,40,SAS,136,50,19,80,59
2005-04-11,TOR,90,31,45,IND,94,41,35,72,80
2005-04-11,WAS,119,41,35,MIL,112,29,47,70,82
2005-04-11,ORL,106,35,41,CLE,114,39,37,74,78
2005-04-11,ATL,105,12,64,CHA,110,15,61,27,125
2005-04-11,CHI,84,44,32,DET,85,49,27,93,59
2005-04-11,DAL,110,52,24,MEM,89,44,32,96,56
2005-04-11,DEN,122,45,31,GSW,106,30,41,75,72
2005-04-11,SEA,78,50,26,HOU,90,46,31,96,57
2005-04-11,LAL,97,34,43,PHO,108,48,17,82,60
2005-04-12,PHI,98,35,32,BOS,105,41,35,76,67
2005-04-12,NYK,93,30,46,TOR,105,31,46,61,92
2005-04-12,SAS,95,51,19,POR,89,25,51,76,70
2005-04-12,PHO,99,49,17,NOK,85,18,57,67,74
2005-04-12,LAC,94,34,43,UTA,85,18,51,52,94
2005-04-13,WAS,93,42,35,CHI,82,44,33,86,68
2005-04-13,CHA,105,16,61,ATL,84,12,65,28,126
2005-04-13,DET,103,50,27,ORL,94,35,42,85,69
2005-04-13,IND,90,42,35,NJN,86,38,39,80,74
2005-04-13,MIL,108,29,48,BOS,111,42,35,71,83
2005-04-13,MIN,116,40,37,GSW,100,30,42,70,79
2005-04-13,HOU,100,47,31,MEM,92,44,33,91,64
2005-04-13,DEN,116,46,31,NOK,102,18,58,64,89
2005-04-13,SEA,90,50,27,DAL,95,53,24,103,51
2005-04-13,UTA,93,18,52,SAS,91,52,19,70,71
2005-04-14,PHI,126,35,33,MIA,119,56,21,91,54
2005-04-14,CLE,89,40,37,NYK,95,30,47,70,84
2005-04-14,POR,90,25,52,DAL,102,54,24,79,76
2005-04-15,TOR,90,32,46,NJN,101,38,40,70,86
2005-04-15,WAS,119,43,35,CLE,111,40,38,83,73
2005-04-15,BOS,101,43,35,MIA,99,56,22,99,57
2005-04-15,DET,99,51,27,MIL,73,29,49,80,76
2005-04-15,IND,86,43,35,PHI,90,36,33,79,68
2005-04-15,CHI,117,44,34,ORL,77,35,43,79,77
2005-04-15,DEN,111,47,31,MEM,102,44,34,91,65
2005-04-15,UTA,84,19,52,MIN,100,41,37,60,89
2005-04-15,PHO,98,50,17,LAC,91,35,43,85,60
2005-04-15,LAL,106,34,44,SAC,115,48,30,82,74
2005-04-15,GSW,108,30,43,POR,88,25,53,55,96
2005-04-15,SEA,97,50,28,NOK,72,18,59,68,87
2005-04-16,CHA,98,17,61,NYK,100,31,47,48,108
2005-04-16,ATL,105,12,66,CHI,114,45,34,57,100
2005-04-16,HOU,115,48,31,DEN,87,48,31,96,62
2005-04-16,MIL,113,29,50,ORL,103,35,44,64,94
2005-04-16,SAS,97,52,20,MEM,75,44,35,96,55
2005-04-16,PHO,116,51,17,SAC,98,49,30,100,47
2005-04-16,LAC,94,35,44,NOK,89,18,60,53,104
2005-04-17,WAS,106,44,35,CHA,104,17,62,61,97
2005-04-17,MIA,84,56,23,IND,80,43,36,99,59
2005-04-17,DET,90,52,27,CLE,87,40,39,92,66
2005-04-17,MIN,94,42,37,SEA,109,51,28,93,65
2005-04-17,LAL,112,34,45,DAL,114,55,24,89,69
2005-04-17,TOR,98,32,47,BOS,103,44,35,76,82
2005-04-17,NJN,104,39,40,PHI,83,37,33,76,73
2005-04-17,NYK,135,32,47,ATL,139,12,67,44,114
2005-04-17,POR,100,25,54,UTA,82,19,53,44,107
2005-04-18,PHI,122,37,34,MIL,106,30,50,67,84
2005-04-18,ORL,92,35,45,IND,88,43,37,78,82
2005-04-18,MEM,94,44,36,SAS,92,53,20,97,56
2005-04-18,NOK,99,18,61,MIN,102,42,38,60,99
2005-04-18,HOU,115,49,31,LAC,90,36,44,85,75
2005-04-18,UTA,92,19,54,SAC,82,49,31,68,85
2005-04-18,PHO,128,52,17,DEN,114,48,32,100,49
2005-04-18,GSW,126,31,43,LAL,99,34,46,65,89
2005-04-19,CLE,100,40,40,BOS,86,45,35,85,75
2005-04-19,NJN,109,40,40,WAS,101,45,35,85,75
2005-04-19,ATL,68,13,67,DET,95,53,27,66,94
2005-04-19,MIA,99,57,23,CHA,80,17,63,74,86
2005-04-19,MIL,109,30,51,TOR,127,32,48,62,99
2005-04-19,CHI,92,46,34,NYK,91,32,48,78,82
2005-04-19,DAL,101,56,24,SEA,96,52,28,108,52
2005-04-19,DEN,119,48,33,POR,115,26,54,74,87
2005-04-20,BOS,93,45,36,NJN,102,41,40,86,76
2005-04-20,TOR,95,33,48,CLE,104,41,40,74,88
2005-04-20,PHI,110,38,34,ATL,86,13,68,51,102
2005-04-20,CHA,97,17,64,DET,86,54,27,71,91
2005-04-20,ORL,93,36,45,MIA,98,58,23,94,68
2005-04-20,NYK,113,32,49,WAS,105,45,36,77,85
2005-04-20,IND,85,43,38,CHI,83,47,34,90,72
2005-04-20,MEM,88,45,36,DAL,108,57,24,102,60
2005-04-20,NOK,75,18,62,LAC,86,36,45,54,107
2005-04-20,MIN,95,43,38,SAS,73,53,21,96,59
2005-04-20,HOU,106,50,31,SEA,78,52,29,102,60
2005-04-20,POR,106,26,55,LAL,103,34,47,60,102
2005-04-20,GSW,106,32,43,UTA,89,20,54,52,97
2005-11-01,PHI,108,0,0,MIL,117,0,0,0,0
2005-11-01,SAS,102,0,0,DEN,91,0,0,0,0
2005-11-01,PHX,108,0,0,DAL,111,0,0,0,0
2005-11-01,NOK,93,0,1,SAC,67,0,1,0,2
2005-11-02,TOR,96,0,0,WAS,99,0,0,0,0
2005-11-02,ORL,78,0,0,IND,90,0,0,0,0
2005-11-02,CLE,109,0,0,NOK,87,0,0,0,0
2005-11-02,BOS,114,0,0,NYK,100,0,0,0,0
2005-11-02,NJN,96,0,0,MIL,110,1,0,1,0
2005-11-02,DET,108,0,0,PHI,88,0,1,0,1
2005-11-02,MEM,78,0,0,MIA,97,0,0,0,0
2005-11-02,MIN,90,0,0,POR,86,0,0,0,0
2005-11-02,CHI,109,0,0,CHA,105,0,0,0,0
2005-11-02,HOU,98,0,0,SAC,89,0,0,0,0
2005-11-02,UTA,93,0,0,DAL,82,1,0,1,0
2005-11-02,SEA,93,0,0,LAC,101,0,0,0,0
2005-11-02,DEN,97,0,1,LAL,99,0,0,0,1
2005-11-02,GSW,122,0,0,ATL,97,0,0,0,0
2005-11-03,MIA,102,1,0,IND,105,1,0,2,0
2005-11-03,LAL,112,1,0,PHX,122,0,1,1,1
2005-11-04,TOR,92,0,1,NJN,102,0,1,0,2
2005-11-04,PHI,93,0,2,CHA,110,0,1,0,3
2005-11-04,ORL,85,0,1,MEM,94,0,1,0,2
2005-11-04,BOS,81,1,0,DET,82,1,0,2,0
2005-11-04,NYK,75,0,1,WAS,86,1,0,1,1
2005-11-04,SAS,102,1,0,CLE,76,1,0,2,0
2005-11-04,DEN,107,0,2,POR,68,0,1,0,3
2005-11-04,LAC,92,1,0,ATL,77,0,1,1,1
2005-11-04,GSW,85,1,0,UTA,91,1,0,2,0
2005-11-04,SEA,107,0,1,MIN,102,1,0,1,1
2005-11-05,WAS,87,2,0,ORL,79,0,2,2,2
2005-11-05,NJN,100,1,1,CHI,99,1,0,2,1
2005-11-05,CHA,107,1,1,BOS,105,1,1,2,2
2005-11-05,DET,117,2,0,TOR,84,0,2,2,2
2005-11-05,IND,109,2,0,PHI,111,0,3,2,3
2005-11-05,MEM,113,1,1,CLE,106,1,1,2,2
2005-11-05,MIL,105,2,0,MIA,100,1,1,3,1
2005-11-05,HOU,84,1,0,NOK,91,1,1,2,1
2005-11-05,DAL,103,1,1,SAS,84,2,0,3,1
2005-11-05,UTA,88,2,0,PHX,97,1,1,3,1
2005-11-05,POR,94,0,2,ATL,93,0,2,0,4
2005-11-05,LAC,100,2,0,MIN,99,1,1,3,1
2005-11-06,NYK,81,0,2,GSW,83,1,1,1,3
2005-11-06,PHX,117,2,1,SAC,118,0,2,2,3
2005-11-06,LAL,112,1,1,DEN,92,1,2,2,3
2005-11-07,TOR,93,0,3,CLE,105,1,2,1,5
2005-11-07,CHA,91,2,1,UTA,95,2,1,4,2
2005-11-07,MIA,90,1,2,NJN,89,2,1,3,3
2005-11-07,MIN,93,1,2,LAC,78,3,0,4,2
2005-11-07,CHI,95,1,1,SAS,104,2,1,3,2
2005-11-08,ATL,97,0,3,LAL,103,2,1,2,4
2005-11-08,MIL,103,3,0,GSW,110,2,1,5,1
2005-11-08,MEM,94,2,1,SEA,69,1,1,3,2
2005-11-08,HOU,74,1,1,ORL,76,0,3,1,4
2005-11-08,SAC,88,1,2,DET,102,3,0,4,2
2005-11-09,PHI,112,1,3,DAL,97,2,1,3,4
2005-11-09,WAS,97,3,0,LAC,102,3,1,6,1
2005-11-09,CLE,112,2,2,SEA,85,1,2,3,4
2005-11-09,BOS,99,1,2,MEM,98,3,1,4,3
2005-11-09,NJN,91,2,2,UTA,83,3,1,5,3
2005-11-09,CHA,86,2,2,SAS,94,3,1,5,3
2005-11-09,IND,95,2,1,MIA,90,2,2,4,3
2005-11-09,NOK,83,2,1,ORL,88,1,3,3,4
2005-11-09,MIN,88,2,2,LAL,74,3,1,5,3
2005-11-09,CHI,85,1,2,GSW,84,3,1,4,3
2005-11-09,POR,95,1,2,NYK,83,0,3,1,5
2005-11-09,DEN,107,1,3,SAC,91,1,3,2,6
2005-11-10,ATL,95,0,4,LAC,102,4,1,4,5
2005-11-10,MIA,88,2,3,HOU,84,1,2,3,5
2005-11-10,PHX,104,2,2,DET,111,4,0,6,2
2005-11-11,TOR,84,0,4,UTA,99,3,2,3,6
2005-11-11,WAS,137,3,1,SEA,96,1,3,4,4
2005-11-11,IND,102,3,1,NJN,90,3,2,6,3
2005-11-11,BOS,82,2,2,SAS,103,4,1,6,3
2005-11-11,CHA,88,2,3,DAL,98,2,2,4,5
2005-11-11,CLE,89,3,2,MEM,70,3,2,6,4
2005-11-11,PHI,85,2,3,LAL,81,3,2,5,5
2005-11-11,SAC,101,1,4,DEN,85,2,3,3,7
2005-11-11,GSW,86,3,2,NYK,84,0,4,3,6
2005-11-11,POR,81,2,2,DET,84,5,0,7,2
2005-11-12,WAS,110,4,1,SAS,95,5,1,9,2
2005-11-12,ATL,84,0,5,MEM,85,3,3,3,8
2005-11-12,MIA,108,3,3,CHA,99,2,4,5,7
2005-11-12,NJN,91,3,3,HOU,99,1,3,4,6
2005-11-12,NOK,103,2,2,DAL,109,3,2,5,4
2005-11-12,CHI,103,2,2,UTA,98,4,2,6,4
2005-11-12,MIL,103,3,1,IND,102,4,1,7,2
2005-11-12,PHX,101,2,3,GSW,86,4,2,6,5
2005-11-13,TOR,121,0,5,SEA,126,1,4,1,9
2005-11-13,BOS,102,2,3,HOU,82,2,3,4,6
2005-11-13,PHI,113,3,3,LAC,108,5,1,8,4
2005-11-13,ORL,100,2,3,CLE,108,4,2,6,5
2005-11-13,DEN,102,2,4,MIN,91,3,2,5,6
2005-11-13,SAC,95,2,4,NYK,105,0,5,2,9
2005-11-14,MEM,85,4,3,LAL,73,3,3,7,6
2005-11-14,UTA,62,4,3,NYK,73,1,5,5,8
2005-11-14,GSW,100,4,3,CHI,82,3,2,7,5
2005-11-15,PHI,104,4,3,TOR,92,0,6,4,9
2005-11-15,ORL,85,2,4,CHA,77,2,5,4,9
2005-11-15,CLE,114,5,2,WAS,99,5,1,10,3
2005-11-15,NJN,109,3,4,SEA,99,2,4,5,8
2005-11-15,MIA,109,4,3,NOK,102,2,3,6,6
2005-11-15,DET,115,6,0,BOS,100,3,3,9,3
2005-11-15,MIN,89,3,3,HOU,94,2,4,5,7
2005-11-15,DAL,83,4,2,DEN,80,3,4,7,6
2005-11-15,SAS,103,5,2,ATL,79,0,6,5,8
2005-11-15,SAC,119,2,5,UTA,83,4,4,6,9
2005-11-15,LAC,109,5,2,MIL,85,4,1,9,3
2005-11-16,TOR,115,0,7,PHI,121,5,3,5,10
2005-11-16,BOS,100,3,4,SEA,113,2,5,5,9
2005-11-16,CHA,122,2,6,IND,90,4,2,6,8
2005-11-16,NOK,81,2,4,DEN,91,3,5,5,9
2005-11-16,PHX,103,3,3,MEM,115,5,3,8,6
2005-11-16,LAL,97,3,4,NYK,92,2,5,5,9
2005-11-16,POR,96,2,3,CHI,93,3,3,5,6
2005-11-16,GSW,87,5,3,MIL,90,4,2,9,5
2005-11-17,SAS,86,6,2,HOU,80,3,4,9,6
2005-11-17,DAL,87,5,2,ATL,78,0,7,5,9
2005-11-17,MIN,109,3,4,WAS,98,5,2,8,6
2005-11-18,CLE,102,6,2,ORL,84,3,4,9,6
2005-11-18,IND,93,4,3,CHA,85,3,6,7,9
2005-11-18,BOS,100,3,5,TOR,93,0,8,3,13
2005-11-18,MIA,106,5,3,PHI,96,6,3,11,6
2005-11-18,NOK,95,2,5,ATL,92,0,8,2,13
2005-11-18,DEN,95,4,5,NYK,86,2,6,6,11
2005-11-18,PHX,102,3,4,UTA,94,4,5,7,9
2005-11-18,HOU,70,3,5,DET,78,7,0,10,5
2005-11-18,SAC,103,3,5,MIL,82,5,2,8,7
2005-11-18,POR,80,3,3,GSW,91,5,4,8,7
2005-11-18,LAL,91,4,4,LAC,97,6,2,10,6
2005-11-18,SEA,98,3,5,CHI,84,3,4,6,9
2005-11-19,PHI,120,6,4,CLE,123,7,2,13,6
2005-11-19,ORL,95,3,5,NOK,98,3,5,6,10
2005-11-19,NJN,89,4,4,WAS,83,5,3,9,7
2005-11-19,MIN,102,4,4,CHA,89,3,7,7,11
2005-11-19,DAL,119,6,2,DET,82,8,0,14,2
2005-11-19,SAS,97,7,2,PHX,91,4,4,11,6
2005-11-19,UTA,72,4,6,MEM,80,6,3,10,9
2005-11-20,NYK,103,2,7,POR,92,3,4,5,11
2005-11-20,TOR,107,0,9,MIA,94,6,3,6,12
2005-11-20,LAC,113,7,2,GSW,101,6,4,13,6
2005-11-20,IND,85,5,3,HOU,74,3,6,8,9
2005-11-20,DEN,99,5,5,MEM,83,7,3,12,8
2005-11-20,SEA,106,4,5,SAC,104,4,5,8,10
2005-11-20,LAL,93,4,5,CHI,96,3,5,7,10
2005-11-21,PHI,103,6,5,NOK,91,4,5,10,10
2005-11-21,UTA,100,4,7,MIL,80,5,3,9,10
2005-11-21,SAC,93,4,6,SAS,96,8,2,12,8
2005-11-21,GSW,100,6,5,NJN,97,5,4,11,9
2005-11-22,WAS,105,5,4,DEN,108,6,5,11,9
2005-11-22,CLE,115,8,2,BOS,93,4,5,12,7
2005-11-22,MEM,87,7,4,POR,95,3,5,10,9
2005-11-22,DAL,102,7,2,HOU,93,3,7,10,9
2005-11-22,PHX,90,4,5,TOR,82,1,9,5,14
2005-11-22,SEA,87,5,5,UTA,93,5,7,10,12
2005-11-23,ATL,120,0,9,BOS,117,4,6,4,15
2005-11-23,ORL,91,3,6,WAS,83,5,5,8,11
2005-11-23,CHA,108,3,8,NYK,95,3,7,6,15
2005-11-23,MIA,100,6,4,POR,79,4,5,10,9
2005-11-23,DET,114,8,1,DEN,89,7,5,15,6
2005-11-23,HOU,88,3,8,PHX,100,5,5,8,13
2005-11-23,MIL,108,5,4,PHI,97,7,5,12,9
2005-11-23,NOK,84,4,6,MIN,80,5,4,9,10
2005-11-23,SAC,114,4,7,NJN,105,5,5,9,12
2005-11-23,LAC,103,8,2,TOR,100,1,10,9,12
2005-11-23,GSW,89,7,5,SAS,113,9,2,16,7
2005-11-24,IND,98,6,3,CLE,76,9,2,15,5
2005-11-24,LAL,108,4,6,SEA,96,5,6,9,12
2005-11-25,ORL,104,4,6,POR,89,4,6,8,12
2005-11-25,IND,85,7,3,ATL,87,1,9,8,12
2005-11-25,BOS,90,4,7,CHA,89,4,8,8,15
2005-11-25,MIA,90,7,4,DAL,103,8,2,15,6
2005-11-25,DET,114,9,1,WAS,120,5,6,14,7
2005-11-25,MEM,86,7,5,HOU,81,3,9,10,14
2005-11-25,MIN,99,5,5,MIL,91,6,4,11,9
2005-11-25,SAS,99,10,2,CHI,106,4,5,14,7
2005-11-25,DEN,105,7,6,LAC,95,9,2,16,8
2005-11-25,UTA,90,6,7,GSW,94,7,6,13,13
2005-11-25,SAC,106,5,7,TOR,104,1,11,6,18
2005-11-25,PHX,92,6,5,NJN,81,5,6,11,11
2005-11-26,SEA,99,5,7,NOK,105,5,6,10,13
2005-11-26,NYK,105,3,8,PHI,102,7,6,10,14
2005-11-26,ORL,80,5,6,MIA,77,7,5,12,11
2005-11-26,CHA,100,4,9,WAS,82,6,6,10,15
2005-11-26,CLE,85,9,3,MIN,89,6,5,15,8
2005-11-26,HOU,89,3,10,CHI,94,5,5,8,15
2005-11-26,DAL,92,9,2,MEM,112,8,5,17,7
2005-11-26,MIL,76,6,5,DET,85,9,2,15,7
2005-11-26,GSW,117,8,6,TOR,91,1,12,9,18
2005-11-27,ATL,75,2,9,POR,77,4,7,6,16
2005-11-27,LAC,92,9,3,IND,97,7,4,16,7
2005-11-27,LAL,96,5,6,NJN,102,5,7,10,13
2005-11-28,TOR,91,1,13,DAL,93,9,3,10,16
2005-11-28,BOS,83,5,7,ORL,87,6,6,11,13
2005-11-28,MIA,107,7,6,NYK,94,4,8,11,14
2005-11-28,DEN,92,8,6,NJN,101,6,7,14,13
2005-11-28,GSW,99,9,6,NOK,83,6,6,15,12
2005-11-29,PHI,107,7,7,POR,83,5,7,12,14
2005-11-29,MIL,113,6,6,DAL,111,10,3,16,9
2005-11-29,MIN,84,7,5,LAC,93,9,4,16,9
2005-11-29,CHI,85,6,5,ORL,76,7,6,13,11
2005-11-29,HOU,100,3,11,ATL,85,2,10,5,21
2005-11-29,SAS,90,10,3,LAL,84,5,7,15,10
2005-11-29,UTA,60,6,8,IND,84,8,4,14,12
2005-11-29,SAC,110,6,7,CHA,92,5,9,11,16
2005-11-30,TOR,66,1,14,MEM,92,9,5,10,19
2005-11-30,WAS,96,6,7,POR,89,5,8,11,15
2005-11-30,ATL,74,2,11,MIA,96,8,6,10,17
2005-11-30,CLE,112,9,4,LAC,105,10,4,19,8
2005-11-30,BOS,110,5,8,PHI,103,8,7,13,15
2005-11-30,NJN,83,7,7,DET,93,10,2,17,9
2005-11-30,NYK,109,4,9,CHI,101,7,5,11,14
2005-11-30,DEN,95,8,7,NOK,102,6,7,14,14
2005-11-30,PHX,109,7,5,IND,91,9,4,16,9
2005-11-30,SEA,104,5,8,CHA,94,5,10,10,18
2005-11-30,GSW,113,10,6,SAC,106,7,7,17,13
2005-12-01,DAL,90,10,4,SAS,92,11,3,21,7
2005-12-01,UTA,101,6,9,LAL,105,5,8,11,17
2005-12-02,WAS,102,7,7,MIL,105,7,6,14,13
2005-12-02,ATL,101,2,12,TOR,102,1,15,3,27
2005-12-02,BOS,102,6,8,CHI,106,7,6,13,14
2005-12-02,DET,106,11,2,NYK,98,5,9,16,11
2005-12-02,MEM,91,10,5,ORL,69,7,7,17,12
2005-12-02,NOK,88,7,7,PHI,86,8,8,15,15
2005-12-02,PHX,102,8,5,DEN,97,8,8,16,13
2005-12-02,SAC,87,7,8,MIA,98,9,6,16,14
2005-12-02,POR,78,5,9,IND,98,9,5,14,14
2005-12-02,LAL,108,6,8,MIN,113,7,6,13,14
2005-12-02,GSW,107,11,6,CHA,100,5,11,16,17
2005-12-02,SEA,115,6,8,CLE,108,10,4,16,12
2005-12-03,NJN,82,7,8,TOR,95,2,15,9,23
2005-12-03,CHI,79,8,6,DET,92,12,2,20,8
2005-12-03,MIL,104,8,6,ORL,84,7,8,15,14
2005-12-03,HOU,75,4,11,MEM,90,11,5,15,16
2005-12-03,DAL,97,10,5,NOK,88,8,7,18,12
2005-12-03,SAS,100,12,3,PHI,91,8,9,20,12
2005-12-03,DEN,101,8,9,MIA,99,10,6,18,15
2005-12-03,LAC,102,10,5,CLE,90,10,5,20,10
2005-12-04,NYK,99,5,10,BOS,102,6,9,11,19
2005-12-04,PHX,112,9,5,ATL,94,2,13,11,18
2005-12-04,SAC,77,7,9,MIN,85,8,6,15,15
2005-12-04,POR,93,5,10,UTA,98,6,10,11,20
2005-12-04,SEA,107,7,8,IND,102,10,5,17,13
2005-12-04,LAL,99,6,9,CHA,98,5,12,11,21
2005-12-05,ORL,85,7,9,SAS,110,13,3,20,12
2005-12-05,CHI,94,8,7,DAL,102,11,5,19,12
2005-12-05,UTA,77,7,10,MIN,91,9,6,16,16
2005-12-05,LAC,99,11,5,MIA,89,10,7,21,12
2005-12-06,WAS,119,7,8,TOR,111,3,15,10,23
2005-12-06,IND,75,10,6,DAL,84,12,5,22,11
2005-12-06,MIL,92,9,6,LAL,111,7,9,16,15
2005-12-06,MEM,89,12,5,NOK,73,8,8,20,13
2005-12-06,HOU,91,4,12,BOS,73,7,9,11,21
2005-12-06,DEN,125,9,9,ATL,116,2,14,11,23
2005-12-06,PHX,130,10,5,POR,85,5,11,15,16
2005-12-06,SAC,97,7,10,CLE,102,10,6,17,16
2005-12-06,SEA,101,8,8,NYK,104,5,11,13,19
2005-12-07,TOR,91,3,16,LAL,102,8,9,11,25
2005-12-07,PHI,85,8,10,MIL,88,9,7,17,17
2005-12-07,ORL,93,7,10,CHI,102,8,8,15,18
2005-12-07,CHA,84,5,13,NJN,97,7,9,12,22
2005-12-07,NOK,87,8,9,BOS,101,7,10,15,19
2005-12-07,SAS,98,14,3,MIA,84,10,8,24,11
2005-12-07,UTA,95,7,11,ATL,83,2,15,9,26
2005-12-07,POR,74,5,12,MIN,84,10,6,15,18
2005-12-07,LAC,84,12,5,NYK,79,6,11,18,16
2005-12-07,GSW,110,12,6,PHX,118,11,5,23,11
2005-12-08,IND,111,10,7,WAS,87,8,8,18,15
2005-12-08,SAC,95,7,11,HOU,106,5,12,12,23
2005-12-09,PHI,119,8,11,CHA,115,5,14,13,25
2005-12-09,MIA,92,10,9,DEN,100,10,9,20,18
2005-12-09,CLE,100,11,6,NJN,109,8,9,19,15
2005-12-09,MEM,83,13,5,DAL,90,13,5,26,10
2005-12-09,CHI,80,9,8,LAL,93,9,9,18,17
2005-12-09,SAS,101,15,3,BOS,89,8,10,23,13
2005-12-09,UTA,90,8,11,SEA,106,8,9,16,20
2005-12-09,PHX,85,12,5,NYK,81,6,12,18,17
2005-12-09,POR,98,5,13,NOK,95,8,10,13,23
2005-12-09,GSW,103,12,7,DET,106,13,2,25,9
2005-12-10,WAS,111,8,9,CHI,118,9,9,17,18
2005-12-10,ATL,94,2,16,SAS,84,16,3,18,19
2005-12-10,ORL,94,7,11,DEN,83,11,9,18,20
2005-12-10,NJN,95,9,9,PHI,107,9,11,18,20
2005-12-10,CHA,103,5,15,TOR,111,3,17,8,32
2005-12-10,IND,80,11,7,MEM,66,13,6,24,13
2005-12-10,MIN,95,11,6,LAL,82,10,9,21,15
2005-12-10,MIL,111,10,7,CLE,106,11,7,21,14
2005-12-10,DAL,103,14,5,BOS,94,8,11,22,16
2005-12-10,SEA,104,9,9,SAC,123,7,12,16,21
2005-12-10,LAC,101,13,5,PHX,91,13,5,26,10
2005-12-11,MIA,104,10,10,WAS,101,8,10,18,20
2005-12-11,LAC,101,14,5,DET,109,14,2,28,7
2005-12-11,SAC,110,8,12,NOK,100,8,11,16,23
2005-12-11,POR,86,6,13,HOU,100,6,12,12,25
2005-12-12,PHI,90,10,11,MIN,89,12,6,22,17
2005-12-12,NYK,92,6,13,MIL,112,11,7,17,20
2005-12-12,DAL,106,15,5,LAL,109,10,10,25,15
2005-12-12,UTA,92,8,12,DET,78,15,2,23,14
2005-12-12,PHX,87,13,6,NOK,91,8,12,21,18
2005-12-13,WAS,94,8,11,NJN,74,9,10,17,21
2005-12-13,CLE,94,11,8,ATL,100,3,16,14,24
2005-12-13,CHA,85,5,16,DEN,101,11,10,16,26
2005-12-13,MIN,91,12,7,SAC,93,9,12,21,19
2005-12-13,CHI,97,10,9,MIA,100,11,10,21,19
2005-12-13,SAS,95,16,4,LAC,87,14,6,30,10
2005-12-13,SEA,107,9,10,GSW,110,12,8,21,18
2005-12-14,TOR,94,4,17,CHI,105,10,10,14,27
2005-12-14,PHI,106,11,11,ATL,101,4,16,15,27
2005-12-14,BOS,85,8,12,IND,71,12,7,20,19
2005-12-14,NJN,83,9,11,CHA,91,5,17,14,28
2005-12-14,NYK,90,6,14,ORL,105,8,11,14,25
2005-12-14,DET,109,15,3,SAC,98,10,12,25,15
2005-12-14,MIL,83,12,7,MIA,100,12,10,24,17
2005-12-14,MEM,79,13,7,LAL,94,11,10,24,17
2005-12-14,NOK,102,9,12,LAC,89,14,7,23,19
2005-12-14,DAL,102,15,6,PHX,96,13,7,28,13
2005-12-14,UTA,82,9,12,POR,77,6,14,15,26
2005-12-14,GSW,105,13,8,HOU,111,7,12,20,20
2005-12-15,CLE,94,11,9,DEN,85,12,10,23,19
2005-12-15,MIN,88,12,8,SAS,90,17,4,29,12
2005-12-15,SEA,98,9,11,HOU,104,8,12,17,23
2005-12-16,TOR,98,4,18,GSW,108,13,9,17,27
2005-12-16,PHI,105,12,11,MIA,112,13,10,25,21
2005-12-16,ATL,122,4,17,NYK,111,6,15,10,32
2005-12-16,IND,93,12,8,UTA,83,10,12,22,20
2005-12-16,BOS,96,9,12,MIL,100,12,8,21,20
2005-12-16,NJN,115,9,12,DEN,106,12,11,21,23
2005-12-16,DET,110,16,3,CHI,82,11,10,27,13
2005-12-16,NOK,88,10,12,PHX,101,13,8,23,20
2005-12-16,DAL,109,16,6,ORL,103,9,11,25,17
2005-12-16,POR,99,6,15,SEA,111,9,12,15,27
2005-12-16,LAL,97,12,10,WAS,91,9,11,21,21
2005-12-17,LAC,89,14,8,HOU,81,9,12,23,20
2005-12-17,NYK,96,6,16,IND,102,13,8,19,24
2005-12-17,CHA,78,6,17,DET,103,17,3,23,20
2005-12-17,CLE,115,12,9,MIA,107,14,10,26,19
2005-12-17,MEM,91,13,8,PHX,87,14,8,27,16
2005-12-17,CHI,118,11,11,BOS,86,9,13,20,24
2005-12-17,MIL,80,13,8,UTA,88,10,13,23,21
2005-12-17,SAS,90,18,4,SAC,89,10,13,28,17
2005-12-18,TOR,80,4,19,PHI,107,12,12,16,31
2005-12-18,ATL,110,5,17,DEN,107,12,12,17,29
2005-12-18,NJN,118,10,12,GSW,90,14,9,24,21
2005-12-18,DAL,102,17,6,MIN,95,12,9,29,15
2005-12-18,POR,97,6,16,WAS,92,9,12,15,28
2005-12-18,LAL,74,13,10,HOU,76,9,13,22,23
2005-12-18,NOK,89,27,25,SAS,76,41,11,68,36
2005-12-19,ORL,90,9,12,TOR,92,4,20,13,32
2005-12-19,BOS,109,9,14,GSW,98,14,10,23,24
2005-12-19,CHA,106,6,18,SAC,103,10,14,16,32
2005-12-19,MEM,104,14,8,DET,106,18,3,32,11
2005-12-19,SEA,111,10,12,WAS,101,9,13,19,25
2005-12-20,CLE,110,13,9,UTA,85,11,13,24,22
2005-12-20,NJN,99,11,12,LAC,85,15,8,26,20
2005-12-20,MIA,111,14,11,ATL,92,6,17,20,28
2005-12-20,DET,93,19,3,POR,89,7,16,26,19
2005-12-20,MIL,109,13,9,SAS,107,19,4,32,13
2005-12-20,CHI,92,12,11,CHA,105,7,18,19,29
2005-12-20,PHX,111,14,9,SEA,83,11,12,25,21
2005-12-20,LAL,112,13,11,DAL,90,18,6,31,17
2005-12-21,PHI,111,13,12,GSW,100,14,11,27,23
2005-12-21,ORL,85,9,13,NJN,96,12,12,21,25
2005-12-21,IND,97,14,8,LAC,75,15,9,29,17
2005-12-21,BOS,101,10,14,UTA,89,11,14,21,28
2005-12-21,NYK,96,6,17,SAS,109,19,5,25,22
2005-12-21,MEM,89,14,9,POR,79,7,17,21,26
2005-12-21,MIN,88,12,10,NOK,69,10,13,22,23
2005-12-21,HOU,81,10,13,TOR,94,5,20,15,33
2005-12-21,DEN,110,12,13,WAS,116,9,14,21,27
2005-12-22,CHI,100,12,12,CLE,108,14,9,26,21
2005-12-22,SAC,95,10,15,DAL,105,18,7,28,22
2005-12-23,ATL,111,6,18,PHI,108,14,12,20,30
2005-12-23,ORL,88,9,14,LAL,104,14,11,23,25
2005-12-23,NYK,98,6,18,UTA,90,11,15,17,33
2005-12-23,CHA,88,8,18,LAC,97,15,10,23,28
2005-12-23,MIA,88,15,11,NJN,95,13,12,28,23
2005-12-23,DET,97,20,3,GSW,85,14,12,34,15
2005-12-23,CLE,94,15,9,IND,89,15,8,30,17
2005-12-23,MEM,95,15,9,CHI,77,12,13,27,22
2005-12-23,MIN,83,13,10,POR,91,7,18,20,28
2005-12-23,MIL,101,14,9,NOK,94,10,14,24,23
2005-12-23,SAS,95,20,5,TOR,90,6,20,26,25
2005-12-23,DEN,108,12,14,HOU,86,10,14,22,28
2005-12-23,PHX,111,15,9,WAS,112,10,14,25,23
2005-12-23,SEA,98,11,13,DAL,101,19,7,30,20
2005-12-25,DET,85,21,3,SAS,70,21,5,42,8
2005-12-25,MIA,97,15,12,LAL,92,15,11,30,23
2005-12-26,WAS,94,11,14,LAL,91,15,12,26,26
2005-12-26,ORL,108,9,15,MIL,93,15,9,24,24
2005-12-26,CLE,102,16,9,CHI,91,12,14,28,23
2005-12-26,NYK,101,7,18,NJN,109,14,12,21,30
2005-12-26,MIN,89,13,11,PHX,103,15,10,28,21
2005-12-26,DAL,102,20,7,IND,80,15,9,35,16
2005-12-26,UTA,105,11,16,MEM,102,16,9,27,25
2005-12-26,SAC,92,10,16,POR,105,8,18,18,34
2005-12-26,SEA,118,11,14,BOS,111,11,14,22,28
2005-12-26,GSW,112,14,13,DEN,118,13,14,27,27
2005-12-27,ATL,90,7,18,CHA,93,8,19,15,37
2005-12-27,NJN,96,15,12,CLE,91,17,9,32,21
2005-12-27,MIA,109,16,12,MIL,98,15,10,31,22
2005-12-27,DET,113,22,3,TOR,106,6,21,28,24
2005-12-27,HOU,74,10,15,UTA,82,12,16,22,31
2005-12-27,SAS,99,21,6,IND,86,15,10,36,16
2005-12-27,DEN,106,14,14,PHI,108,14,13,28,27
2005-12-27,LAC,93,16,10,SAC,110,10,17,26,27
2005-12-28,TOR,108,6,22,ATL,102,7,19,13,41
2005-12-28,WAS,99,12,14,PHX,104,16,10,28,24
2005-12-28,ORL,105,10,15,NYK,95,7,19,17,34
2005-12-28,CHA,93,9,19,CHI,80,12,15,21,34
2005-12-28,NOK,92,10,15,HOU,90,10,16,20,31
2005-12-28,MIN,108,13,12,SEA,95,12,14,25,26
2005-12-28,POR,95,9,18,PHI,91,15,13,24,31
2005-12-28,LAL,99,15,13,MEM,100,16,10,31,23
2005-12-28,GSW,111,14,14,BOS,109,11,15,25,29
2005-12-29,DET,106,23,3,MIA,101,17,12,40,15
2005-12-29,SAS,111,22,6,NOK,84,11,15,33,21
2005-12-29,DEN,105,14,15,SEA,112,12,15,26,30
2005-12-30,WAS,113,12,15,MIA,128,17,13,29,28
2005-12-30,ORL,107,11,15,MIN,87,14,12,25,27
2005-12-30,IND,97,15,11,TOR,99,7,22,22,33
2005-12-30,NJN,99,16,12,ATL,91,7,20,23,32
2005-12-30,CHA,100,10,19,PHX,110,17,10,27,29
2005-12-30,MIL,113,15,11,NYK,108,7,20,22,31
2005-12-30,DAL,109,21,7,GSW,111,15,14,36,21
2005-12-30,SAC,116,11,17,BOS,112,11,16,22,33
2005-12-30,POR,90,10,18,MEM,93,17,10,27,28
2005-12-31,CLE,97,17,10,DET,84,24,3,41,13
2005-12-31,CHI,98,12,16,PHX,107,18,10,30,26
2005-12-31,NOK,90,11,16,DAL,95,21,8,32,24
2005-12-31,HOU,89,10,17,GSW,94,16,14,26,31
2005-12-31,UTA,108,13,16,PHI,102,15,14,28,30
2005-12-31,DEN,88,14,16,SAS,98,23,6,37,22
2005-12-31,SEA,96,13,15,MEM,100,18,10,31,25
2005-12-31,LAC,92,16,11,BOS,111,11,17,27,28
2006-01-01,MIA,97,18,13,MIN,70,14,13,32,26
2006-01-01,POR,94,10,19,LAC,100,16,12,26,31
2006-01-01,LAL,94,15,14,UTA,98,14,16,29,30
2006-01-02,IND,115,15,12,SEA,96,13,16,28,28
2006-01-02,NYK,140,7,21,PHX,133,19,10,26,31
2006-01-02,CHI,92,12,17,MIL,93,16,11,28,28
2006-01-02,DEN,120,14,17,BOS,110,12,17,26,34
2006-01-02,NOK,103,30,27,CHA,86,16,43,46,70
2006-01-03,WAS,111,12,16,HOU,123,10,18,22,34
2006-01-03,ATL,97,7,21,TOR,108,8,22,15,43
2006-01-03,DET,108,24,4,ORL,99,12,15,36,19
2006-01-03,MEM,104,19,10,GSW,94,17,14,36,24
2006-01-03,DAL,95,22,8,POR,81,10,20,32,28
2006-01-03,UTA,90,15,16,LAL,80,15,15,30,31
2006-01-03,SAC,98,12,17,PHI,111,15,15,27,32
2006-01-04,TOR,121,9,22,ORL,97,12,16,21,38
2006-01-04,BOS,109,12,18,CHA,106,10,20,22,38
2006-01-04,MIL,84,17,11,CLE,91,18,10,35,21
2006-01-04,NOK,107,11,17,MIA,92,19,13,30,30
2006-01-04,MIN,91,14,14,DAL,78,23,8,37,22
2006-01-04,CHI,97,12,18,SEA,101,13,17,25,35
2006-01-04,SAS,106,24,6,POR,75,10,21,34,27
2006-01-04,DEN,106,15,17,IND,86,16,12,31,29
2006-01-04,PHX,105,19,11,PHI,85,16,15,35,26
2006-01-05,CLE,81,19,10,HOU,90,11,18,30,28
2006-01-05,GSW,89,17,15,IND,99,16,13,33,28
2006-01-06,TOR,112,10,22,HOU,92,12,18,22,40
2006-01-06,BOS,98,13,18,ATL,103,7,22,20,40
2006-01-06,NJN,113,17,12,ORL,106,12,17,29,29
2006-01-06,NYK,113,8,21,WAS,92,12,17,20,38
2006-01-06,DET,97,25,4,SEA,85,14,17,39,21
2006-01-06,MEM,87,20,10,UTA,65,16,16,36,26
2006-01-06,NOK,90,12,17,POR,80,10,22,22,39
2006-01-06,SAS,83,25,6,MIN,77,15,14,40,20
2006-01-06,MIL,91,17,12,CHI,105,12,19,29,31
2006-01-06,DEN,112,16,17,DAL,114,23,9,39,26
2006-01-06,SAC,118,12,18,LAC,114,17,12,29,30
2006-01-06,PHX,111,20,11,MIA,93,19,14,39,25
2006-01-06,LAL,119,15,16,PHI,93,16,16,31,32
2006-01-07,WAS,103,12,18,BOS,102,13,19,25,37
2006-01-07,ATL,101,8,22,NOK,93,13,17,21,39
2006-01-07,ORL,108,12,18,CHA,92,10,21,22,39
2006-01-07,DET,90,26,4,UTA,94,16,17,42,21
2006-01-07,CLE,96,19,11,MIL,88,17,13,36,24
2006-01-07,CHI,111,13,19,MEM,82,21,10,34,29
2006-01-07,DAL,83,24,9,MIN,79,15,15,39,24
2006-01-07,PHX,91,21,11,SAS,86,26,6,47,17
2006-01-07,LAC,109,17,13,LAL,112,16,16,33,29
2006-01-08,TOR,104,11,22,NJN,105,18,12,29,34
2006-01-08,NYK,120,9,21,SEA,116,14,18,23,39
2006-01-08,HOU,90,12,19,DEN,92,16,18,28,37
2006-01-08,SAC,83,13,18,IND,108,17,13,30,31
2006-01-08,POR,89,10,23,MIA,118,19,15,29,38
2006-01-09,PHI,107,16,17,SEA,98,14,19,30,36
2006-01-09,WAS,89,13,18,UTA,97,17,17,30,35
2006-01-09,BOS,102,13,20,DAL,104,25,9,38,29
2006-01-09,CHI,113,14,19,TOR,104,11,23,25,42
2006-01-09,LAL,96,17,16,IND,90,18,13,35,29
2006-01-10,ATL,94,9,22,BOS,98,13,21,22,43
2006-01-10,CLE,84,20,11,NYK,92,10,21,30,32
2006-01-10,CHA,111,10,22,HOU,106,12,20,22,42
2006-01-10,MIL,95,17,14,MIN,92,15,16,32,30
2006-01-10,MEM,99,21,11,SAC,85,13,19,34,30
2006-01-10,NOK,86,13,18,DET,96,26,5,39,23
2006-01-10,SAS,96,26,7,NJN,91,19,12,45,19
2006-01-10,DEN,139,17,18,PHX,137,22,11,39,29
2006-01-10,LAC,90,17,14,ORL,73,13,18,30,32
2006-01-11,TOR,95,11,24,CHA,86,11,22,22,46
2006-01-11,PHI,102,17,17,UTA,110,18,17,35,34
2006-01-11,WAS,103,13,19,ATL,72,9,23,22,42
2006-01-11,NYK,117,11,21,DAL,115,26,9,37,30
2006-01-11,IND,112,18,14,MIL,88,18,14,36,28
2006-01-11,MIN,99,15,17,CHI,93,15,19,30,36
2006-01-11,HOU,80,12,21,SAC,88,13,20,25,41
2006-01-11,POR,113,10,24,LAL,103,18,16,28,40
2006-01-11,SEA,113,14,20,ORL,104,13,19,27,39
2006-01-11,GSW,96,17,16,MIA,110,20,15,37,31
2006-01-12,SAS,68,27,7,DET,83,27,5,54,12
2006-01-12,PHX,112,22,12,GSW,99,17,17,39,29
2006-01-12,LAL,99,18,17,CLE,98,20,12,38,29
2006-01-13,IND,85,19,14,WAS,94,14,19,33,33
2006-01-13,NYK,105,12,21,ATL,94,9,24,21,45
2006-01-13,CHA,102,11,23,MIL,103,18,15,29,38
2006-01-13,PHI,125,17,18,BOS,124,14,21,31,39
2006-01-13,MEM,81,22,11,NJN,69,19,13,41,24
2006-01-13,NOK,90,13,19,SAC,76,14,20,27,39
2006-01-13,MIN,103,16,17,DEN,89,18,18,34,35
2006-01-13,POR,113,11,24,ORL,108,13,20,24,44
2006-01-13,SEA,104,15,20,MIA,117,21,15,36,35
2006-01-14,ATL,106,9,25,WAS,114,15,19,24,44
2006-01-14,DET,114,28,5,CHA,91,11,24,39,29
2006-01-14,CHI,89,15,20,IND,91,19,15,34,35
2006-01-14,MIL,93,19,15,DEN,100,18,19,37,34
2006-01-14,HOU,80,12,22,NOK,86,14,19,26,41
2006-01-14,DAL,110,26,10,NJN,77,19,14,45,24
2006-01-14,SAS,80,27,8,MEM,79,23,11,50,19
2006-01-14,UTA,94,19,17,MIA,100,22,15,41,32
2006-01-14,PHX,115,23,12,CLE,106,20,13,43,25
2006-01-14,LAC,98,18,14,SEA,72,15,21,33,35
2006-01-14,GSW,104,17,18,LAL,110,19,17,36,35
2006-01-15,TOR,129,12,24,NYK,103,13,21,25,45
2006-01-15,SAC,104,14,21,ORL,100,13,21,27,42
2006-01-15,POR,89,12,24,CLE,87,20,14,32,38
2006-01-16,NYK,90,13,22,MIN,96,17,17,30,39
2006-01-16,WAS,104,16,19,PHI,76,18,18,34,37
2006-01-16,CHA,92,11,25,NOK,107,15,19,26,44
2006-01-16,ATL,94,9,26,HOU,83,12,23,21,49
2006-01-16,CHI,94,15,21,DEN,97,19,19,34,40
2006-01-16,NJN,97,19,15,IND,92,20,15,39,30
2006-01-16,DET,94,29,5,BOS,84,14,22,43,27
2006-01-16,LAC,102,19,14,UTA,93,19,18,38,32
2006-01-16,GSW,109,17,19,SEA,93,15,22,32,41
2006-01-16,MEM,83,23,12,SAS,93,28,8,51,20
2006-01-16,DAL,114,27,10,MIL,95,19,16,46,26
2006-01-16,LAL,100,20,17,MIA,92,23,15,43,32
2006-01-17,UTA,111,19,19,TOR,98,13,24,32,43
2006-01-17,SAC,119,15,21,PHX,90,24,12,39,33
2006-01-18,PHI,90,18,19,NJN,101,20,15,38,34
2006-01-18,ATL,89,10,26,DET,117,30,5,40,31
2006-01-18,ORL,106,13,22,WAS,98,17,19,30,41
2006-01-18,IND,98,20,16,CHA,92,11,26,31,42
2006-01-18,BOS,103,14,23,MIN,96,18,17,32,40
2006-01-18,NOK,87,16,19,MEM,79,23,13,39,32
2006-01-18,CHI,106,15,22,NYK,104,13,23,28,45
2006-01-18,HOU,76,12,24,DAL,103,28,10,40,34
2006-01-18,SAS,95,29,8,MIL,92,19,17,48,25
2006-01-18,DEN,90,20,19,CLE,89,20,15,40,34
2006-01-18,POR,96,13,24,TOR,94,13,25,26,49
2006-01-18,LAC,102,20,14,PHX,112,24,13,44,27
2006-01-19,NYK,79,13,24,DET,105,31,5,44,29
2006-01-19,SAC,118,16,21,LAL,109,21,17,37,38
2006-01-20,PHI,89,18,20,MEM,86,23,14,41,34
2006-01-20,WAS,110,17,20,NOK,99,17,19,34,39
2006-01-20,ATL,102,10,27,MIL,118,19,18,29,45
2006-01-20,BOS,99,15,23,NJN,96,21,15,36,38
2006-01-20,CHA,93,11,27,ORL,104,14,22,25,49
2006-01-20,MIA,94,23,16,SAS,101,30,8,53,24
2006-01-20,MIN,90,18,18,IND,85,21,16,39,34
2006-01-20,CHI,108,16,22,HOU,109,12,25,28,47
2006-01-20,DEN,113,21,19,UTA,83,20,19,41,38
2006-01-20,PHX,106,25,13,LAL,93,21,18,46,31
2006-01-20,LAC,81,20,15,DAL,101,29,10,49,25
2006-01-20,GSW,99,18,19,CLE,79,20,16,38,35
2006-01-20,SEA,113,15,23,TOR,121,13,26,28,49
2006-01-21,ORL,83,15,22,SAC,78,17,21,32,43
2006-01-21,NYK,98,13,25,NOK,109,17,20,30,45
2006-01-21,NJN,103,21,16,BOS,83,16,23,37,39
2006-01-21,IND,89,21,17,CHI,101,16,23,37,40
2006-01-21,MIL,101,20,18,CHA,91,11,28,31,46
2006-01-21,UTA,90,20,20,CLE,108,20,17,40,37
2006-01-22,SAS,85,31,8,DEN,89,22,19,53,27
2006-01-22,WAS,82,18,20,MEM,93,23,15,41,35
2006-01-22,MIN,84,19,18,PHI,86,19,20,38,38
2006-01-22,LAC,105,20,16,GSW,92,19,19,39,35
2006-01-22,MIA,119,23,17,SAC,99,17,22,40,39
2006-01-22,DET,99,32,5,HOU,97,13,25,45,30
2006-01-22,PHX,149,26,13,SEA,152,15,24,41,37
2006-01-22,POR,89,14,24,DAL,95,30,10,44,34
2006-01-22,LAL,122,21,19,TOR,104,14,26,35,45
2006-01-23,ATL,104,10,28,IND,94,21,18,31,46
2006-01-23,BOS,91,16,24,NOK,78,18,20,34,44
2006-01-23,MIL,80,21,18,HOU,97,13,26,34,44
2006-01-23,DEN,107,23,19,TOR,101,14,27,37,46
2006-01-23,UTA,89,20,21,NJN,78,22,16,42,37
2006-01-23,GSW,93,19,20,LAC,96,21,16,40,36
2006-01-24,PHI,109,20,20,SAC,103,17,23,37,43
2006-01-24,ORL,111,16,22,PHX,102,26,14,42,36
2006-01-24,CLE,96,21,17,IND,66,21,19,42,36
2006-01-24,MIA,94,24,17,MEM,82,24,15,48,32
2006-01-24,MIN,83,19,19,DET,107,33,5,52,24
2006-01-24,SAS,104,31,9,CHA,76,11,29,42,38
2006-01-25,TOR,88,14,28,CHI,104,17,23,31,51
2006-01-25,ATL,97,11,28,CLE,106,22,17,33,45
2006-01-25,BOS,87,17,24,WAS,89,18,21,35,45
2006-01-25,NYK,102,13,26,SAC,106,17,24,30,50
2006-01-25,DET,106,34,5,MIL,102,21,19,55,24
2006-01-25,NOK,68,18,21,SAS,84,32,9,50,30
2006-01-25,HOU,102,14,26,CHA,78,11,30,25,56
2006-01-25,MEM,107,24,16,MIN,87,19,20,43,36
2006-01-25,UTA,94,21,21,SEA,113,16,24,37,45
2006-01-25,POR,94,14,25,DEN,97,24,19,38,44
2006-01-25,LAC,90,22,16,NJN,77,22,17,44,33
2006-01-25,GSW,93,19,21,DAL,102,31,10,50,31
2006-01-26,PHI,115,21,20,ORL,119,17,22,38,42
2006-01-26,MIA,98,25,17,PHX,107,26,15,51,32
2006-01-26,SEA,97,17,24,DAL,104,32,10,49,34
2006-01-27,ATL,106,11,29,PHX,110,27,15,38,44
2006-01-27,IND,89,21,20,CLE,93,23,17,44,37
2006-01-27,BOS,84,17,25,SAC,74,18,24,35,49
2006-01-27,NYK,97,13,27,ORL,94,18,22,31,49
2006-01-27,CHA,85,11,31,MIA,91,25,18,36,49
2006-01-27,DET,95,35,5,MEM,89,25,16,60,21
2006-01-27,CHI,90,18,23,WAS,79,19,21,37,44
2006-01-27,MIL,108,21,20,TOR,87,14,29,35,49
2006-01-27,DEN,87,25,19,LAC,105,23,16,48,35
2006-01-27,HOU,92,15,26,MIN,96,19,21,34,47
2006-01-27,POR,88,14,26,NJN,83,22,18,36,44
2006-01-27,LAL,106,22,19,GSW,105,19,22,41,41
2006-01-28,WAS,107,19,22,CHA,97,11,32,30,54
2006-01-28,PHI,91,21,21,NYK,76,14,27,35,48
2006-01-28,MEM,86,25,17,NOK,95,18,23,43,40
2006-01-28,CHI,111,19,23,ATL,99,11,30,30,53
2006-01-28,SAS,102,33,9,MIN,88,20,21,53,30
2006-01-28,DAL,103,33,10,UTA,89,22,22,55,32
2006-01-28,SEA,113,17,25,NJN,104,22,19,39,44
2006-01-28,LAC,112,24,16,DEN,79,25,20,49,36
2006-01-28,GSW,98,19,23,POR,83,15,26,34,49
2006-01-29,TOR,124,14,30,SAC,123,18,25,32,55
2006-01-29,CLE,113,24,17,PHX,106,28,15,52,32
2006-01-29,MIL,83,22,20,BOS,79,18,25,40,45
2006-01-29,HOU,95,15,27,MIA,101,26,18,41,45
2006-01-29,ORL,81,18,23,PHI,89,22,21,40,44
2006-01-29,DET,102,36,5,LAL,93,23,19,59,24
2006-01-30,ATL,120,11,31,NYK,101,14,28,25,59
2006-01-30,CHA,91,11,33,CLE,103,25,17,36,50
2006-01-30,MIA,118,27,18,LAC,114,25,16,52,34
2006-01-30,MEM,86,25,18,HOU,77,15,28,40,46
2006-01-30,NOK,94,19,23,MIL,93,23,20,42,43
2006-01-30,MIN,110,20,22,BOS,85,18,26,38,48
2006-01-30,UTA,70,22,23,SAS,79,34,9,56,32
2006-01-30,SEA,111,18,25,POR,116,15,27,33,52
2006-01-31,PHI,99,23,21,PHX,123,28,16,51,37
2006-01-31,WAS,84,20,22,IND,79,21,21,41,43
2006-01-31,NJN,91,22,20,DET,84,37,5,59,25
2006-01-31,NYK,97,14,29,LAL,130,23,20,37,49
2006-01-31,DAL,98,34,10,CHI,94,20,23,54,33
2006-01-31,SAC,98,18,26,DEN,91,25,21,43,47
2006-02-01,TOR,117,15,30,WAS,112,21,22,36,52
2006-02-01,ORL,94,18,24,LAC,106,25,17,43,41
2006-02-01,CLE,91,26,17,NJN,85,23,20,49,37
2006-02-01,IND,105,21,22,LAL,79,24,20,45,42
2006-02-01,BOS,94,18,27,PHX,102,29,16,47,43
2006-02-01,CHA,92,11,34,ATL,102,12,31,23,65
2006-02-01,DET,90,37,6,MIN,74,21,22,58,28
2006-02-01,MEM,80,26,18,DAL,81,35,10,61,28
2006-02-01,NOK,100,20,23,CHI,95,20,24,40,47
2006-02-01,HOU,86,15,29,MIL,84,23,21,38,50
2006-02-01,UTA,103,22,24,DEN,90,25,22,47,46
2006-02-01,POR,82,16,27,SAS,86,35,9,51,36
2006-02-01,SEA,111,18,26,GSW,107,20,23,38,49
2006-02-02,MIA,101,28,18,CLE,73,27,17,55,35
2006-02-02,GSW,86,20,24,SAS,89,36,9,56,33
2006-02-03,TOR,104,16,30,NYK,90,14,30,30,60
2006-02-03,ATL,96,13,31,ORL,94,18,25,31,56
2006-02-03,BOS,81,18,28,LAC,98,26,17,44,45
2006-02-03,CHA,112,11,35,LAL,102,24,21,35,56
2006-02-03,PHI,80,23,22,DET,87,38,6,61,28
2006-02-03,HOU,100,16,29,SEA,77,19,26,35,55
2006-02-03,UTA,89,23,24,SAC,79,19,26,42,50
2006-02-03,POR,89,16,28,MIN,85,21,23,37,51
2006-02-04,NJN,105,23,21,MIA,92,29,18,52,39
2006-02-04,WAS,98,21,23,ATL,85,14,31,35,54
2006-02-04,ORL,100,18,26,BOS,91,18,29,36,55
2006-02-04,CLE,95,27,18,PHI,100,23,23,50,41
2006-02-04,IND,93,22,22,DET,85,39,6,61,28
2006-02-04,NOK,106,21,23,LAL,90,24,22,45,45
2006-02-04,MIL,88,23,22,MEM,78,26,19,49,41
2006-02-04,DAL,110,36,10,SEA,91,19,27,55,37
2006-02-04,DEN,105,25,23,POR,104,17,28,42,51
2006-02-04,PHX,118,30,16,CHI,101,20,25,50,41
2006-02-04,GSW,109,20,25,MIN,77,21,24,41,49
2006-02-05,NYK,89,14,31,HOU,93,17,29,31,60
2006-02-05,TOR,113,17,30,LAC,115,27,17,44,47
2006-02-05,SAC,96,19,27,UTA,78,24,24,43,51
2006-02-06,PHI,81,24,23,HOU,87,18,29,42,52
2006-02-06,WAS,94,22,23,ORL,82,19,26,41,49
2006-02-06,NJN,99,24,21,NOK,91,22,23,46,44
2006-02-06,CHA,119,12,35,SEA,106,19,28,31,63
2006-02-06,MIA,114,29,19,BOS,98,18,30,47,49
2006-02-06,UTA,109,24,25,CHI,107,20,26,44,51
2006-02-06,PHX,101,31,16,MIN,103,21,25,52,41
2006-02-06,GSW,122,21,25,DEN,114,26,23,47,48
2006-02-06,CLE,89,27,19,MIL,86,24,22,51,41
2006-02-07,ATL,99,14,32,DET,98,39,7,53,39
2006-02-07,NYK,82,14,32,LAC,85,28,17,42,49
2006-02-07,DAL,102,37,10,LAL,87,24,23,61,33
2006-02-07,SAC,104,20,27,MEM,96,26,20,46,47
2006-02-08,TOR,118,17,31,SAS,125,37,9,54,40
2006-02-08,WAS,129,23,23,GSW,124,22,25,45,48
2006-02-08,IND,101,23,22,POR,69,17,29,40,51
2006-02-08,NJN,96,25,21,NYK,83,14,33,39,54
2006-02-08,CHA,100,13,35,PHI,92,24,24,37,59
2006-02-08,DET,97,39,8,LAC,87,29,17,68,25
2006-02-08,MIL,94,24,23,ORL,89,19,27,43,50
2006-02-08,NOK,109,22,24,SEA,102,19,29,41,53
2006-02-08,MIN,91,22,25,CLE,97,28,19,50,44
2006-02-08,HOU,78,19,29,LAL,89,24,24,43,53
2006-02-08,PHX,108,31,17,MEM,102,26,21,57,38
2006-02-08,DEN,107,26,24,CHI,110,20,27,46,51
2006-02-09,DAL,112,38,10,MIA,76,30,19,68,29
2006-02-09,SAC,98,21,27,CHI,80,21,27,42,54
2006-02-10,WAS,101,24,23,CLE,89,29,19,53,42
2006-02-10,ORL,73,19,28,DET,84,40,8,59,36
2006-02-10,BOS,115,18,31,POR,83,17,30,35,61
2006-02-10,NJN,73,26,21,SAS,83,38,9,64,30
2006-02-10,CHA,73,14,35,TOR,88,17,32,31,67
2006-02-10,IND,107,24,22,GSW,95,22,26,46,48
2006-02-10,NOK,111,23,24,NYK,100,14,34,37,58
2006-02-10,MIN,80,22,26,UTA,94,25,25,47,51
2006-02-10,PHX,112,32,17,SAC,104,22,27,54,44
2006-02-10,DEN,113,26,25,DAL,104,39,10,65,35
2006-02-10,LAC,91,29,18,MEM,87,26,22,55,40
2006-02-10,SEA,99,19,30,ATL,91,15,32,34,62
2006-02-11,CLE,91,29,20,GSW,99,22,27,51,47
2006-02-11,MIN,94,22,27,NOK,100,24,24,46,51
2006-02-11,MIL,99,25,23,CHA,93,14,36,39,59
2006-02-11,HOU,102,19,30,UTA,88,26,25,45,55
2006-02-11,LAL,99,25,24,MEM,100,26,23,51,47
2006-02-12,TOR,114,18,32,POR,81,17,31,35,63
2006-02-12,WAS,107,25,23,PHI,97,24,25,49,48
2006-02-12,IND,88,25,22,SAS,92,39,9,64,31
2006-02-12,MIA,100,30,20,DET,98,41,8,71,28
2006-02-12,BOS,102,19,31,ORL,94,19,29,38,60
2006-02-12,NJN,94,26,22,MIL,79,26,23,52,45
2006-02-12,HOU,90,20,30,NYK,83,14,35,34,65
2006-02-12,SAC,109,22,28,ATL,84,15,33,37,61
2006-02-12,SEA,112,20,30,DEN,120,27,25,47,55
2006-02-12,LAC,91,30,18,CHI,97,21,28,51,46
2006-02-13,CHA,83,14,37,POR,91,17,32,31,69
2006-02-13,NOK,97,25,24,WAS,96,26,23,51,47
2006-02-13,MIN,94,22,28,TOR,98,19,32,41,60
2006-02-13,DAL,100,39,11,NYK,72,14,36,53,47
2006-02-13,LAL,94,25,25,UTA,88,26,26,51,51
2006-02-13,GSW,79,23,27,MEM,81,27,23,50,50
2006-02-13,CLE,101,29,21,SAS,87,40,9,69,30
2006-02-14,MIA,107,31,20,ORL,93,19,30,50,50
2006-02-14,DET,85,41,9,NJN,71,27,22,68,31
2006-02-14,MIL,106,26,24,SEA,91,20,31,46,55
2006-02-14,CHI,101,22,28,SAC,105,23,28,45,56
2006-02-14,LAC,97,30,19,HOU,128,21,30,51,49
2006-02-15,PHI,103,24,26,SAS,100,40,10,64,36
2006-02-15,ORL,100,19,31,MIA,110,32,20,51,51
2006-02-15,IND,88,25,23,MIL,77,27,24,52,47
2006-02-15,BOS,109,20,31,CLE,113,30,21,50,52
2006-02-15,NYK,98,14,37,TOR,96,20,32,34,69
2006-02-15,CHA,94,14,38,NJN,95,27,23,41,61
2006-02-15,MEM,84,28,23,SAC,78,24,28,52,51
2006-02-15,NOK,102,26,24,POR,86,18,32,44,56
2006-02-15,MIN,102,22,29,SEA,92,20,32,42,61
2006-02-15,DAL,103,40,11,WAS,97,26,24,66,35
2006-02-15,DEN,101,28,25,PHX,116,33,17,61,42
2006-02-15,LAL,110,26,25,ATL,114,15,34,41,59
2006-02-15,GSW,88,23,28,LAC,81,30,20,53,48
2006-02-16,CHI,117,22,29,PHI,84,25,26,47,55
2006-02-16,PHX,109,34,17,HOU,75,22,30,56,47
2006-02-21,WAS,90,26,25,MIN,78,23,29,49,54
2006-02-21,CLE,105,31,21,ORL,92,19,32,50,53
2006-02-21,IND,97,26,23,NOK,75,27,24,53,47
2006-02-21,DET,97,42,9,ATL,87,16,34,58,43
2006-02-21,MIL,85,27,25,NJN,89,28,23,55,48
2006-02-21,MEM,94,29,23,TOR,88,20,33,49,56
2006-02-21,DAL,93,41,11,LAC,91,30,21,71,32
2006-02-21,SAS,103,40,11,SEA,78,20,33,60,44
2006-02-21,DEN,100,28,26,CHA,84,14,39,42,65
2006-02-21,UTA,83,26,27,BOS,103,20,32,46,59
2006-02-21,SAC,102,24,29,GSW,77,24,28,48,57
2006-02-21,LAL,99,26,26,POR,82,18,33,44,59
2006-02-22,NOK,76,18,22,UTA,82,21,22,39,44
2006-02-22,PHI,116,25,27,CLE,107,32,21,57,48
2006-02-22,ATL,109,16,35,SEA,114,20,34,36,69
2006-02-22,NJN,96,29,23,ORL,93,19,33,48,56
2006-02-22,NYK,83,15,37,MIA,103,33,20,48,57
2006-02-22,CHI,97,23,29,MIL,91,27,26,50,55
2006-02-22,HOU,106,22,31,LAC,102,30,22,52,53
2006-02-22,PHX,103,35,17,BOS,94,21,32,56,49
2006-02-22,POR,106,18,34,CHA,110,14,40,32,74
2006-02-23,DET,88,43,9,IND,83,27,23,70,32
2006-02-23,DAL,97,42,11,MEM,87,30,23,72,34
2006-02-23,LAL,106,27,26,SAC,85,25,29,52,55
2006-02-24,ORL,102,19,34,SEA,89,21,34,40,68
2006-02-24,IND,112,27,24,ATL,117,16,36,43,60
2006-02-24,CLE,94,32,22,WAS,102,27,25,59,47
2006-02-24,NYK,90,15,38,NJN,94,30,23,45,61
2006-02-24,MEM,80,30,24,SAS,83,41,12,71,36
2006-02-24,MIN,101,23,30,DEN,102,29,26,52,56
2006-02-24,CHI,87,24,29,DET,95,44,9,68,38
2006-02-24,MIL,111,27,27,PHI,116,26,27,53,54
2006-02-24,HOU,91,23,31,GSW,88,24,29,47,60
2006-02-24,POR,96,18,35,BOS,102,21,33,39,68
2006-02-24,LAC,102,30,23,LAL,83,28,26,58,49
2006-02-25,DAL,115,43,11,TOR,113,20,34,63,45
2006-02-25,PHI,108,27,27,CHI,102,24,30,51,57
2006-02-25,WAS,110,28,25,NYK,89,15,39,43,64
2006-02-25,ATL,89,17,36,MIL,99,27,28,44,64
2006-02-25,MIA,115,34,20,SEA,106,21,35,55,55
2006-02-25,SAS,92,42,12,GSW,75,24,30,66,42
2006-02-25,UTA,95,26,28,NOK,100,28,25,54,53
2006-02-25,PHX,136,36,17,CHA,121,15,40,51,57
2006-02-26,DET,90,45,9,CLE,78,32,23,77,32
2006-02-26,ORL,84,20,34,HOU,89,24,31,44,65
2006-02-26,MIN,105,23,31,MEM,99,30,25,53,56
2006-02-26,NJN,91,31,23,IND,101,27,25,58,48
2006-02-26,LAL,111,28,27,BOS,112,22,33,50,60
2006-02-26,POR,75,18,36,NOK,88,29,25,47,61
2006-02-27,ATL,104,17,37,NJN,102,31,24,48,61
2006-02-27,CLE,72,32,24,DET,84,46,9,78,33
2006-02-27,MIA,101,35,20,TOR,94,20,35,55,55
2006-02-27,MEM,108,30,26,WAS,98,29,25,59,51
2006-02-27,HOU,94,25,31,PHX,111,37,17,62,48
2006-02-27,DAL,104,44,11,PHI,92,28,27,72,38
2006-02-27,SAS,121,43,12,NYK,93,15,40,58,52
2006-02-27,DEN,89,30,26,MIL,110,28,28,58,54
2006-02-27,SAC,115,25,30,POR,91,18,37,43,67
2006-02-27,LAC,95,31,23,CHA,87,15,41,46,64
2006-02-27,GSW,108,24,31,UTA,117,26,29,50,60
2006-02-28,CHI,111,24,31,MIN,100,24,31,48,62
2006-02-28,SEA,114,21,36,NOK,104,30,25,51,61
2006-02-28,LAL,102,28,28,ORL,87,20,35,48,63
2006-03-01,TOR,111,20,36,ATL,113,18,37,38,73
2006-03-01,WAS,93,29,26,IND,99,28,25,57,51
2006-03-01,CLE,90,32,25,SAC,97,26,30,58,55
2006-03-01,BOS,96,23,33,MIA,103,36,20,59,53
2006-03-01,MEM,101,31,26,NYK,99,15,41,46,67
2006-03-01,MIN,100,24,32,NJN,90,31,25,55,57
2006-03-01,HOU,101,25,32,PHI,106,28,28,53,60
2006-03-01,DEN,98,30,27,DET,87,47,9,77,36
2006-03-01,UTA,89,27,29,CHA,104,15,42,42,71
2006-03-01,PHX,123,38,17,MIL,110,29,28,67,45
2006-03-01,POR,99,18,38,LAL,93,29,28,47,66
2006-03-01,LAC,89,32,23,NOK,67,30,26,62,49
2006-03-01,GSW,98,24,32,ORL,94,20,36,44,68
2006-03-02,CHI,91,25,31,CLE,92,32,26,57,57
2006-03-02,SAS,98,44,12,DAL,89,45,11,89,23
2006-03-03,PHI,119,29,28,WAS,113,29,27,58,55
2006-03-03,ATL,93,19,37,SAC,102,27,30,46,67
2006-03-03,BOS,99,23,34,IND,98,29,25,52,59
2006-03-03,NYK,101,15,42,CHI,108,25,32,40,74
2006-03-03,HOU,89,25,33,DEN,78,31,27,56,60
2006-03-03,DAL,90,45,12,CHA,76,16,42,61,54
2006-03-03,UTA,105,27,30,LAC,103,33,23,60,53
2006-03-03,PHX,123,39,17,ORL,118,20,37,59,54
2006-03-03,GSW,94,25,32,LAL,106,29,29,54,61
2006-03-03,SEA,96,22,36,DET,98,47,10,69,46
2006-03-04,NJN,105,31,26,TOR,100,20,37,51,63
2006-03-04,MIA,95,37,20,ATL,93,19,38,56,58
2006-03-04,MIL,98,29,29,NYK,103,15,43,44,72
2006-03-04,SAS,101,45,12,POR,81,19,38,64,50
2006-03-04,DEN,110,31,28,ORL,94,20,38,51,66
2006-03-04,LAL,105,30,29,DET,94,48,10,78,39
2006-03-05,TOR,111,20,38,BOS,105,24,34,44,72
2006-03-05,PHI,93,30,28,IND,94,29,26,59,54
2006-03-05,WAS,117,29,28,SAC,107,28,30,57,58
2006-03-05,DAL,107,46,12,PHX,115,40,17,86,29
2006-03-05,MIN,103,25,32,GSW,90,25,33,50,65
2006-03-05,CLE,91,33,26,CHI,72,26,32,59,58
2006-03-05,HOU,102,26,33,POR,84,19,39,45,72
2006-03-05,LAC,86,33,24,MEM,102,32,26,65,50
2006-03-05,SEA,113,22,37,UTA,81,28,30,50,67
2006-03-06,NJN,84,32,26,SAC,109,28,31,60,57
2006-03-06,CHA,105,16,44,MIA,106,38,20,54,64
2006-03-06,NOK,88,31,27,PHX,101,41,17,72,44
2006-03-06,DEN,115,32,28,MEM,101,33,26,65,54
2006-03-06,UTA,90,28,31,ORL,85,20,39,48,70
2006-03-06,LAL,96,31,29,SAS,103,46,12,77,41
2006-03-07,WAS,115,30,28,BOS,116,24,35,54,63
2006-03-07,ATL,113,19,39,GSW,106,25,34,44,73
2006-03-07,CLE,106,34,26,TOR,99,21,38,55,64
2006-03-07,IND,92,30,26,NYK,107,16,43,46,69
2006-03-07,MIN,87,26,32,HOU,93,27,33,53,65
2006-03-07,CHI,95,26,33,NJN,87,32,27,58,60
2006-03-07,DAL,93,46,13,POR,87,19,40,65,53
2006-03-07,LAC,98,33,25,SAS,85,47,12,80,37
2006-03-08,TOR,97,21,39,CLE,98,35,26,56,65
2006-03-08,BOS,104,25,35,PHI,101,30,29,55,64
2006-03-08,CHA,104,16,45,GSW,101,25,35,41,80
2006-03-08,MIA,118,39,20,WAS,112,30,29,69,49
2006-03-08,DET,106,48,11,CHI,101,27,33,75,44
2006-03-08,MIL,116,29,30,SAC,123,29,31,58,61
2006-03-08,NOK,107,31,28,LAL,113,31,30,62,58
2006-03-08,HOU,103,28,33,IND,99,30,27,58,60
2006-03-08,UTA,96,29,31,MIN,93,26,33,55,64
2006-03-08,SEA,74,23,37,MEM,99,33,27,56,64
2006-03-09,PHI,93,30,30,DEN,97,33,28,63,58
2006-03-09,POR,92,19,41,DAL,109,47,13,66,54
2006-03-09,PHX,93,42,17,SAS,117,47,13,89,30
2006-03-10,TOR,97,21,40,DEN,108,34,28,55,68
2006-03-10,ORL,102,20,40,CLE,73,36,26,56,66
2006-03-10,BOS,86,26,35,MIL,92,29,31,55,66
2006-03-10,MIA,106,40,20,GSW,111,25,36,65,56
2006-03-10,NOK,90,31,29,IND,92,30,28,61,57
2006-03-10,CHI,96,27,34,LAC,107,34,25,61,59
2006-03-10,SAS,92,48,13,LAL,100,32,30,80,43
2006-03-10,SAC,105,30,31,MEM,93,34,27,64,58
2006-03-10,SEA,107,23,38,MIN,96,26,34,49,72
2006-03-11,WAS,110,30,30,DET,92,49,11,79,41
2006-03-11,ATL,90,20,39,CHI,95,27,35,47,74
2006-03-11,ORL,103,21,40,GSW,92,26,36,47,76
2006-03-11,CHA,116,17,45,NYK,109,17,43,34,88
2006-03-11,MIL,98,30,31,LAC,106,35,25,65,56
2006-03-11,UTA,87,30,31,DAL,90,48,13,78,44
2006-03-11,PHX,110,42,18,MIN,102,26,35,68,53
2006-03-12,BOS,106,26,36,DEN,101,35,28,61,64
2006-03-12,TOR,93,21,41,IND,89,31,28,52,69
2006-03-12,SAS,88,48,14,HOU,81,29,33,77,47
2006-03-12,MIA,98,40,21,CLE,92,36,27,76,48
2006-03-12,LAL,113,33,30,SEA,120,24,38,57,68
2006-03-12,MEM,91,34,28,PHI,94,30,31,64,59
2006-03-12,DET,94,49,12,CHA,78,18,45,67,57
2006-03-12,NOK,84,31,30,NJN,95,32,28,63,58
2006-03-12,SAC,85,31,31,DAL,80,49,13,80,44
2006-03-12,POR,111,19,42,PHX,101,43,18,62,60
2006-03-13,IND,97,31,29,ORL,83,22,40,53,69
2006-03-13,NYK,96,17,44,DEN,108,35,29,52,73
2006-03-13,MIL,88,30,32,ATL,87,20,40,50,72
2006-03-13,HOU,77,29,34,NJN,90,33,28,62,62
2006-03-13,LAC,95,36,25,MIN,87,26,36,62,61
2006-03-14,PHI,97,31,31,TOR,111,22,41,53,72
2006-03-14,CHA,114,18,46,WAS,119,31,30,49,76
2006-03-14,MIA,121,41,21,UTA,83,30,32,71,53
2006-03-14,MEM,93,34,29,BOS,76,27,36,61,65
2006-03-14,CHI,95,28,35,POR,66,20,42,48,77
2006-03-14,DAL,91,49,14,CLE,87,36,28,85,42
2006-03-14,SAS,96,49,14,NOK,81,31,31,80,45
2006-03-14,SAC,114,32,31,LAL,98,33,31,65,62
2006-03-14,SEA,120,25,38,PHX,129,43,19,68,57
2006-03-15,TOR,98,23,41,DET,105,50,12,73,53
2006-03-15,WAS,107,32,30,CHA,99,18,47,50,77
2006-03-15,ORL,114,22,41,UTA,108,30,33,52,74
2006-03-15,IND,99,32,29,DEN,101,36,29,68,58
2006-03-15,NJN,78,34,28,POR,65,20,43,54,71
2006-03-15,NYK,121,17,45,ATL,117,20,41,37,86
2006-03-15,MIL,104,31,32,CHI,88,29,35,60,67
2006-03-15,HOU,81,29,35,DAL,95,50,14,79,49
2006-03-15,PHX,126,44,19,LAC,95,37,25,81,44
2006-03-15,LAL,92,33,32,MIN,89,26,37,59,69
2006-03-16,MIA,107,42,21,BOS,104,27,37,69,58
2006-03-16,GSW,105,26,37,MIN,97,26,38,52,75
2006-03-16,SEA,102,25,39,PHI,98,31,32,56,71
2006-03-17,TOR,97,23,42,MIL,96,32,32,55,74
2006-03-17,WAS,94,33,30,DAL,104,51,14,84,44
2006-03-17,ATL,101,20,42,UTA,111,30,34,50,76
2006-03-17,ORL,84,23,41,BOS,77,27,38,50,79
2006-03-17,IND,98,32,30,SAC,93,33,31,65,61
2006-03-17,NJN,92,35,28,LAL,89,34,32,69,60
2006-03-17,NYK,105,18,45,DET,103,51,12,69,57
2006-03-17,CLE,99,36,29,POR,84,20,44,56,73
2006-03-17,MEM,116,35,29,DEN,102,37,29,72,58
2006-03-17,SAS,108,50,14,PHX,102,45,19,95,33
2006-03-17,LAC,99,37,26,PHI,89,31,33,68,59
2006-03-18,CHI,84,29,36,MIA,85,43,21,72,57
2006-03-18,CHA,103,18,48,DET,108,51,13,69,61
2006-03-18,NOK,94,31,32,DEN,109,37,30,68,62
2006-03-18,MIL,97,32,33,POR,93,20,45,52,78
2006-03-18,HOU,77,29,36,SAS,92,51,14,80,50
2006-03-19,NJN,100,36,28,DAL,89,52,14,88,42
2006-03-19,WAS,113,33,31,CHI,104,29,37,62,68
2006-03-19,CLE,96,37,29,LAL,95,34,33,71,62
2006-03-19,IND,88,33,30,BOS,103,27,39,60,69
2006-03-19,ATL,108,20,43,ORL,107,24,41,44,84
2006-03-19,MIN,95,26,39,SAC,89,33,32,59,71
2006-03-19,MEM,90,36,29,UTA,84,31,34,67,63
2006-03-19,GSW,98,27,37,PHI,89,31,34,58,71
2006-03-19,NYK,100,19,45,MIA,111,44,21,63,66
2006-03-20,BOS,97,28,39,LAL,105,34,34,62,73
2006-03-20,DET,91,52,13,ATL,84,21,43,73,56
2006-03-20,HOU,91,29,37,LAC,99,38,26,67,63
2006-03-20,POR,93,20,46,MIL,100,33,33,53,79
2006-03-21,WAS,100,34,31,NJN,112,37,28,71,59
2006-03-21,NYK,109,19,46,TOR,114,24,42,43,88
2006-03-21,CHA,108,18,49,ORL,102,24,42,42,91
2006-03-21,MEM,105,37,29,IND,75,33,31,70,60
2006-03-21,NOK,120,31,33,LAC,108,39,26,70,59
2006-03-21,DAL,88,52,15,HOU,72,29,38,81,53
2006-03-21,MIN,100,27,39,MIA,96,45,21,72,60
2006-03-21,SAS,107,52,14,GSW,96,28,37,80,51
2006-03-21,UTA,107,31,35,PHX,99,45,20,76,55
2006-03-21,SAC,105,33,33,SEA,96,26,39,59,72
2006-03-22,PHI,115,31,35,ATL,106,21,44,52,79
2006-03-22,ORL,111,24,43,NYK,87,19,47,43,90
2006-03-22,CLE,120,38,29,CHA,118,19,49,57,78
2006-03-22,IND,95,33,32,CHI,85,29,38,62,70
2006-03-22,BOS,110,28,40,TOR,96,25,42,53,82
2006-03-22,DET,82,53,13,MIA,73,45,22,98,35
2006-03-22,DEN,104,38,30,SAS,92,53,14,91,44
2006-03-22,SEA,114,26,40,MIL,105,34,33,60,73
2006-03-22,LAL,87,35,34,SAC,80,34,33,69,67
2006-03-23,NJN,86,38,28,MIN,82,28,39,66,67
2006-03-23,MEM,95,38,29,LAC,85,39,27,77,56
2006-03-23,NOK,92,32,33,HOU,93,29,39,61,72
2006-03-23,DAL,121,53,15,GSW,122,28,38,81,53
2006-03-23,UTA,97,32,35,WAS,109,34,32,66,67
2006-03-23,PHX,125,45,21,POR,108,20,47,65,68
2006-03-24,TOR,97,25,43,MIN,77,28,40,53,83
2006-03-24,PHI,86,32,35,ORL,102,25,43,57,78
2006-03-24,IND,72,34,32,DET,75,54,13,88,45
2006-03-24,NYK,75,19,48,MEM,91,39,29,58,77
2006-03-24,MIA,114,45,23,CHA,93,19,50,64,73
2006-03-24,CLE,94,39,29,BOS,82,29,40,68,69
2006-03-24,CHI,96,29,39,NOK,82,32,34,61,73
2006-03-24,DEN,117,39,30,SEA,104,27,40,66,70
2006-03-24,POR,79,20,48,SAS,98,53,15,73,63
2006-03-24,LAL,101,36,34,MIL,96,34,34,70,68
2006-03-25,LAC,116,39,28,WAS,101,35,32,74,60
2006-03-25,ATL,83,21,45,DAL,98,53,16,74,61
2006-03-25,UTA,89,32,36,SAC,91,34,34,66,70
2006-03-25,PHX,107,46,21,DEN,96,40,30,86,51
2006-03-26,BOS,97,29,41,CHI,101,30,39,59,80
2006-03-26,IND,92,34,33,PHI,79,32,36,66,69
2006-03-26,HOU,102,30,39,CLE,104,40,29,70,68
2006-03-26,MIN,98,28,41,NYK,94,19,49,47,90
2006-03-26,DET,74,55,13,NJN,79,39,28,94,41
2006-03-26,MIL,125,34,35,TOR,116,26,43,60,78
2006-03-26,MEM,102,40,29,CHA,95,19,51,59,80
2006-03-26,ORL,108,26,43,ATL,101,21,46,47,89
2006-03-26,SEA,106,27,41,SAS,102,54,15,81,56
2006-03-26,SAC,83,35,34,GSW,90,29,38,64,72
2006-03-26,POR,83,20,49,LAC,97,40,28,60,77
2006-03-26,LAL,105,37,34,NOK,94,32,35,69,69
2006-03-27,NJN,110,40,28,PHX,72,47,21,87,49
2006-03-27,MIA,96,46,23,IND,91,35,33,81,56
2006-03-27,UTA,104,32,37,NOK,80,32,36,64,73
2006-03-27,GSW,98,30,38,WAS,116,35,33,65,71
2006-03-28,CHA,125,19,52,ATL,117,21,47,40,99
2006-03-28,DET,97,55,14,DAL,90,54,16,109,30
2006-03-28,MIL,132,35,35,PHX,110,47,22,82,57
2006-03-28,MEM,97,41,29,SEA,98,28,41,69,70
2006-03-28,CHI,93,31,39,ORL,97,27,43,58,82
2006-03-28,SAC,84,35,35,WAS,97,36,33,71,68
2006-03-28,LAC,87,41,28,SAS,98,54,16,95,44
2006-03-29,TOR,94,26,44,MIA,98,47,23,73,67
2006-03-29,PHI,91,32,37,DET,101,56,14,88,51
2006-03-29,ATL,94,21,48,IND,93,35,34,56,82
2006-03-29,CLE,107,41,29,DAL,94,54,17,95,46
2006-03-29,NJN,86,41,28,MEM,74,41,30,82,58
2006-03-29,NYK,98,19,50,BOS,123,29,42,48,92
2006-03-29,MIN,103,29,41,ORL,91,28,43,57,84
2006-03-29,HOU,115,30,40,SEA,87,29,41,59,81
2006-03-29,DEN,104,40,31,UTA,115,33,37,73,68
2006-03-29,POR,90,20,50,SAC,106,35,36,55,86
2006-03-29,GSW,85,30,39,NOK,86,32,37,62,76
2006-03-30,IND,104,35,35,PHX,114,47,23,82,58
2006-03-30,LAL,85,38,34,SAS,96,55,16,93,50
2006-03-31,TOR,126,26,45,PHX,140,48,23,74,68
2006-03-31,ATL,88,22,48,NJN,91,42,28,64,76
2006-03-31,ORL,108,28,44,DAL,99,54,18,82,62
2006-03-31,NYK,112,19,51,PHI,117,32,38,51,89
2006-03-31,CHA,107,20,52,CHI,113,31,40,51,92
2006-03-31,DET,112,57,14,MIL,105,36,35,93,49
2006-03-31,NOK,107,33,37,MEM,102,41,31,74,68
2006-03-31,HOU,105,31,40,WAS,103,37,33,68,73
2006-03-31,DEN,106,40,32,MIN,94,30,41,70,73
2006-03-31,LAC,106,41,29,UTA,91,34,37,75,66
2006-03-31,GSW,93,30,40,SAC,96,36,36,66,76
2006-03-31,SEA,93,29,42,LAL,106,38,35,67,77
2006-04-01,CLE,106,42,29,MIA,99,48,23,90,52
2006-04-01,CHI,100,32,40,BOS,94,30,42,62,82
2006-04-01,MIL,96,36,36,IND,89,35,36,71,72
2006-04-01,SAS,106,56,16,WAS,99,37,34,93,50
2006-04-01,POR,89,20,51,UTA,102,34,38,54,89
2006-04-02,TOR,113,26,46,NOK,120,34,37,60,83
2006-04-02,PHI,114,33,38,NYK,95,19,52,52,90
2006-04-02,DET,109,58,14,PHX,102,49,23,107,37
2006-04-02,DAL,103,54,19,DEN,79,41,32,95,51
2006-04-02,MIN,106,30,42,GSW,104,30,41,60,83
2006-04-02,LAL,104,39,35,HOU,88,32,40,71,75
2006-04-02,MEM,98,41,32,ATL,87,22,49,63,81
2006-04-02,NJN,90,43,28,MIA,78,48,24,91,52
2006-04-02,CHA,97,20,53,CLE,101,43,29,63,82
2006-04-02,SAC,106,37,36,LAC,96,42,29,79,65
2006-04-02,SEA,122,29,43,POR,83,20,52,49,95
2006-04-04,TOR,120,26,47,BOS,124,30,43,56,90
2006-04-04,WAS,105,37,35,NYK,90,19,53,56,88
2006-04-04,CLE,124,44,29,PHI,91,34,38,78,67
2006-04-04,NJN,96,44,28,ATL,94,22,50,66,78
2006-04-04,CHA,97,20,54,MIN,92,31,42,51,96
2006-04-04,MIA,115,48,25,MIL,89,37,36,85,61
2006-04-04,DET,101,59,14,NOK,93,35,37,94,51
2006-04-04,MEM,100,42,32,GSW,75,30,42,72,74
2006-04-04,CHI,102,33,40,IND,96,35,37,68,77
2006-04-04,DAL,127,55,19,SAC,101,38,36,93,55
2006-04-04,UTA,86,35,38,SAS,95,57,16,92,54
2006-04-04,SEA,104,30,43,HOU,87,32,41,62,84
2006-04-04,LAC,111,42,30,DEN,109,41,33,83,63
2006-04-05,BOS,91,31,43,WAS,108,38,35,69,78
2006-04-05,PHI,92,34,39,CHI,99,34,40,68,79
2006-04-05,ATL,101,22,51,MIN,99,31,43,53,94
2006-04-05,ORL,108,29,44,MIL,105,37,37,66,81
2006-04-05,IND,111,35,38,TOR,103,26,48,61,86
2006-04-05,NYK,96,19,54,CLE,94,45,29,64,83
2006-04-05,NOK,114,35,38,GSW,109,30,43,65,81
2006-04-05,SAS,87,58,16,SAC,97,38,37,96,53
2006-04-05,PHX,105,49,24,LAC,119,43,30,92,54
2006-04-05,POR,76,20,53,HOU,75,32,42,52,95
2006-04-06,NJN,113,45,28,CHA,102,21,54,66,82
2006-04-06,MIA,82,49,25,DET,95,60,14,109,39
2006-04-06,DEN,110,41,34,LAL,108,40,35,81,69
2006-04-07,PHI,99,34,40,BOS,109,31,44,65,84
2006-04-07,ATL,114,23,51,WAS,101,39,35,62,86
2006-04-07,ORL,89,30,44,DET,87,61,14,91,58
2006-04-07,NYK,98,20,54,IND,96,36,38,56,92
2006-04-07,MEM,100,43,32,MIL,90,37,38,80,70
2006-04-07,NOK,95,36,38,TOR,89,26,49,62,87
2006-04-07,MIN,95,31,44,UTA,103,35,39,66,83
2006-04-07,SAS,86,58,17,DAL,92,56,19,114,36
2006-04-07,POR,108,21,53,SEA,121,31,43,52,96
2006-04-07,PHX,107,49,25,LAL,96,40,36,89,61
2006-04-07,LAC,93,44,30,SAC,96,39,37,83,67
2006-04-07,GSW,93,30,44,HOU,100,32,43,62,87
2006-04-08,NJN,102,46,28,CLE,108,45,30,91,58
2006-04-08,WAS,86,39,36,MIA,99,49,26,88,62
2006-04-08,CHI,75,35,40,PHI,89,34,41,69,81
2006-04-08,DAL,101,57,19,NOK,77,37,38,94,57
2006-04-08,DEN,95,42,34,GSW,92,30,45,72,79
2006-04-08,UTA,110,36,39,POR,93,21,54,57,93
2006-04-09,BOS,86,32,44,NYK,101,21,54,53,98
2006-04-09,TOR,88,26,50,CHA,94,21,55,47,105
2006-04-09,DET,98,61,15,IND,73,36,39,97,54
2006-04-09,MIL,83,37,39,NJN,95,46,29,83,68
2006-04-09,SAS,83,58,18,MEM,81,44,32,102,50
2006-04-09,MIN,84,31,45,ATL,83,24,51,55,96
2006-04-09,MIA,84,50,26,ORL,93,31,44,81,70
2006-04-09,SAC,86,40,37,HOU,77,33,43,73,80
2006-04-09,SEA,116,32,43,PHX,114,50,25,82,68
2006-04-09,LAL,100,40,37,LAC,83,44,31,84,68
2006-04-10,PHI,105,35,41,WAS,97,39,37,74,78
2006-04-10,ORL,105,32,44,ATL,88,24,52,56,96
2006-04-10,IND,101,36,40,NYK,82,22,54,58,94
2006-04-10,NOK,101,37,39,CLE,103,46,30,83,69
2006-04-10,UTA,85,37,39,HOU,83,33,44,70,83
2006-04-10,POR,98,21,55,DEN,110,43,34,64,89
2006-04-10,LAC,73,44,32,DAL,75,58,19,102,51
2006-04-11,MIA,106,50,27,TOR,97,26,51,76,78
2006-04-11,MEM,92,44,33,MIN,76,32,45,76,78
2006-04-11,CHI,104,35,41,NJN,101,47,29,82,70
2006-04-11,SAS,104,59,18,SEA,95,33,43,92,61
2006-04-11,SAC,110,41,37,PHX,123,50,26,91,63
2006-04-11,LAL,111,41,37,GSW,100,30,46,71,83
2006-04-12,ATL,90,24,53,CHI,96,36,41,60,94
2006-04-12,ORL,103,33,44,TOR,96,26,52,59,96
2006-04-12,IND,117,37,40,BOS,112,32,45,69,85
2006-04-12,NJN,96,47,30,PHI,116,36,41,83,71
2006-04-12,CHA,88,22,55,MEM,96,45,33,67,88
2006-04-12,DET,96,62,15,CLE,73,47,30,109,45
2006-04-12,MIL,100,37,40,WAS,97,39,38,76,78
2006-04-12,NOK,104,37,40,SEA,99,33,44,70,84
2006-04-12,HOU,79,33,45,MIN,82,32,46,65,91
2006-04-12,UTA,104,38,39,DEN,83,44,34,82,73
2006-04-12,LAC,97,44,33,POR,93,21,56,65,89
2006-04-12,GSW,114,30,47,DAL,102,59,19,89,66
2006-04-13,CLE,91,47,31,NYK,87,22,55,69,86
2006-04-13,SAS,80,60,18,ORL,92,34,44,94,62
2006-04-13,PHX,117,51,26,DAL,104,59,20,110,46
2006-04-14,TOR,108,26,53,DET,103,63,15,89,68
2006-04-14,ATL,110,24,54,CHA,116,22,56,46,110
2006-04-14,BOS,74,32,46,NJN,79,47,31,79,77
2006-04-14,NYK,80,22,56,MIL,97,38,40,60,96
2006-04-14,MIA,104,51,27,PHI,85,37,41,88,68
2006-04-14,IND,89,38,40,MIN,77,33,46,71,86
2006-04-14,NOK,104,38,40,UTA,105,39,39,77,79
2006-04-14,CHI,103,37,41,WAS,101,39,39,76,80
2006-04-14,LAL,110,42,37,POR,99,21,57,63,94
2006-04-14,GSW,110,31,47,PHX,102,52,26,83,73
2006-04-14,SEA,97,33,45,LAC,101,45,33,78,78
2006-04-15,ORL,102,35,44,PHI,97,37,42,72,86
2006-04-15,CHA,92,23,56,IND,91,39,40,62,96
2006-04-15,MIL,114,39,40,ATL,120,24,55,63,95
2006-04-15,HOU,81,33,46,MEM,93,46,33,79,79
2006-04-15,DEN,82,44,35,SAC,100,41,38,85,73
2006-04-15,POR,81,21,58,GSW,86,32,47,53,105
2006-04-16,MIA,93,52,27,CHI,117,38,41,90,68
2006-04-16,MIN,90,33,47,SAS,103,60,19,93,66
2006-04-16,LAL,109,43,37,PHX,89,52,27,95,64
2006-04-16,WAS,104,39,40,CLE,92,48,31,87,71
2006-04-16,DET,103,63,16,NYK,97,22,57,85,73
2006-04-16,NJN,95,48,31,BOS,93,32,47,80,78
2006-04-16,DAL,111,59,21,UTA,95,40,39,99,60
2006-04-16,LAC,98,46,33,SEA,114,33,46,79,79
2006-04-16,SAC,96,42,38,NOK,79,38,41,80,79
2006-04-17,TOR,95,27,53,IND,120,39,41,66,94
2006-04-17,ORL,112,36,44,CHI,116,39,41,75,85
2006-04-17,BOS,88,32,48,CLE,93,48,32,80,80
2006-04-17,NYK,91,22,58,CHA,98,24,56,46,114
2006-04-17,MIL,113,39,41,DET,93,64,16,103,57
2006-04-17,SAS,115,61,19,UTA,82,40,40,101,59
2006-04-17,DEN,83,44,36,HOU,86,33,47,77,83
2006-04-17,PHX,115,52,28,NOK,78,38,42,90,70
2006-04-17,GSW,93,33,47,POR,79,21,59,54,106
2006-04-18,PHI,91,37,43,NJN,88,49,31,86,74
2006-04-18,WAS,116,40,40,MIL,103,40,41,80,81
2006-04-18,ATL,103,25,55,MIA,100,52,28,77,83
2006-04-18,MEM,101,47,33,LAC,95,46,34,93,67
2006-04-18,SAC,111,43,38,SEA,105,34,46,77,84
2006-04-19,CLE,100,49,32,ATL,99,26,55,75,87
2006-04-19,IND,89,40,41,ORL,83,36,45,76,86
2006-04-19,BOS,85,32,49,MIA,78,52,29,84,78
2006-04-19,NJN,83,49,32,NYK,90,22,59,71,91
2006-04-19,CHA,96,25,56,PHI,86,38,43,63,99
2006-04-19,DET,80,64,17,WAS,96,41,40,105,57
2006-04-19,HOU,87,34,47,SAS,89,62,19,96,66
2006-04-19,MIN,92,33,48,MEM,102,48,33,81,81
2006-04-19,CHI,127,40,41,TOR,106,27,54,67,95
2006-04-19,DAL,71,60,21,LAC,85,46,35,106,56
2006-04-19,UTA,105,40,41,GSW,102,34,47,74,88
2006-04-19,POR,96,21,60,PHX,106,53,28,74,88
2006-04-19,LAL,115,44,37,NOK,95,38,43,82,80
2006-10-31,MIA,66,0,0,CHI,108,0,0,0,0
2006-10-31,LAL,114,0,0,PHX,106,0,0,0,0
2006-11-01,PHI,88,0,0,ATL,75,0,0,0,0
2006-11-01,CHA,99,0,0,IND,106,0,0,0,0
2006-11-01,ORL,109,0,0,CHI,94,1,0,1,0
2006-11-01,BOS,87,0,0,NOK,91,0,0,0,0
2006-11-01,NJN,102,0,0,TOR,92,0,0,0,0
2006-11-01,DET,97,0,0,MIL,105,0,0,0,0
2006-11-01,CLE,97,0,0,WAS,94,0,0,0,0
2006-11-01,MEM,117,0,0,NYK,118,0,0,0,0
2006-11-01,MIN,92,0,0,SAC,83,0,0,0,0
2006-11-01,UTA,107,0,0,HOU,97,0,0,0,0
2006-11-01,SEA,106,0,0,POR,110,0,0,0,0
2006-11-01,PHX,112,0,1,LAC,104,0,0,0,1
2006-11-01,GSW,98,0,0,LAL,110,1,0,1,0
2006-11-02,DAL,91,0,0,SAS,97,0,0,0,0
2006-11-02,LAC,96,0,1,DEN,95,0,0,0,1
2006-11-03,TOR,109,0,1,MIL,92,1,0,1,1
2006-11-03,ORL,103,1,0,PHI,105,1,0,2,0
2006-11-03,IND,91,1,0,NOK,100,1,0,2,0
2006-11-03,BOS,88,0,1,DET,101,0,1,0,2
2006-11-03,ATL,102,0,1,NYK,92,1,0,1,1
2006-11-03,MIA,91,0,1,NJN,85,1,0,1,1
2006-11-03,MEM,96,0,1,CHA,83,0,1,0,2
2006-11-03,SAS,81,1,0,CLE,88,1,0,2,0
2006-11-03,CHI,88,1,1,SAC,89,0,1,1,2
2006-11-03,DEN,109,0,1,MIN,112,1,0,1,1
2006-11-03,PHX,104,1,1,UTA,108,1,0,2,1
2006-11-03,LAL,118,2,0,SEA,112,0,1,2,1
2006-11-03,GSW,102,0,1,POR,89,1,0,1,1
2006-11-04,WAS,124,0,1,BOS,117,0,2,0,3
2006-11-04,CHA,92,0,2,CLE,88,2,0,2,2
2006-11-04,NYK,95,1,1,IND,109,1,1,2,2
2006-11-04,DET,95,1,1,MEM,86,1,1,2,2
2006-11-04,MIL,104,1,1,SAC,91,1,1,2,2
2006-11-04,HOU,107,0,1,DAL,76,0,1,0,2
2006-11-04,UTA,106,2,0,GSW,82,1,1,3,1
2006-11-04,POR,88,1,1,MIN,86,2,0,3,1
2006-11-04,LAC,114,1,1,PHX,108,1,2,2,3
2006-11-05,TOR,94,1,1,SAS,103,1,1,2,2
2006-11-05,PHI,107,2,0,MIA,98,1,1,3,1
2006-11-05,ATL,95,1,1,ORL,82,1,1,2,2
2006-11-05,NOK,96,2,0,HOU,90,1,1,3,1
2006-11-05,SEA,117,0,2,LAL,101,3,0,3,2
2006-11-06,ORL,106,1,2,WAS,103,1,1,2,3
2006-11-06,NYK,93,1,2,SAS,105,2,1,3,3
2006-11-06,CHI,110,1,2,MIL,85,2,1,3,3
2006-11-06,DAL,104,0,2,GSW,107,1,2,1,4
2006-11-06,UTA,103,3,0,DET,101,2,1,5,1
2006-11-06,SAC,93,1,2,MIN,81,2,1,3,3
2006-11-06,LAC,102,2,1,POR,89,2,1,4,2
2006-11-07,CLE,95,2,1,ATL,104,2,1,4,2
2006-11-07,IND,97,2,1,PHI,86,3,0,5,1
2006-11-07,MIA,90,1,2,SEA,87,1,2,2,4
2006-11-07,MEM,80,1,2,HOU,86,1,2,2,4
2006-11-07,NOK,97,3,0,GSW,93,2,2,5,2
2006-11-07,LAL,95,3,1,MIN,88,2,2,5,3
2006-11-08,TOR,106,1,2,PHI,104,3,1,4,3
2006-11-08,WAS,117,1,2,IND,91,3,1,4,3
2006-11-08,ORL,88,2,2,SEA,87,1,3,3,5
2006-11-08,BOS,110,0,3,CHA,108,1,2,1,5
2006-11-08,NJN,96,1,1,UTA,89,4,0,5,1
2006-11-08,MIL,93,2,2,HOU,97,2,2,4,4
2006-11-08,SAS,111,3,1,PHX,106,1,3,4,4
2006-11-08,DEN,107,0,2,NYK,109,1,3,1,5
2006-11-08,POR,101,2,2,LAL,90,4,1,6,3
2006-11-08,LAC,103,3,1,DAL,85,0,3,3,4
2006-11-08,SAC,99,2,2,DET,86,2,2,4,4
2006-11-09,CLE,113,2,2,CHI,94,2,2,4,4
2006-11-09,PHX,112,1,4,DAL,119,0,4,1,8
2006-11-09,GSW,121,2,3,NOK,116,4,0,6,3
2006-11-10,TOR,102,2,2,ATL,111,3,1,5,3
2006-11-10,PHI,101,3,2,DEN,108,0,3,3,5
2006-11-10,WAS,116,2,2,MIL,111,2,3,4,5
2006-11-10,CHA,85,1,3,SEA,99,1,4,2,7
2006-11-10,IND,93,3,2,ORL,83,3,2,6,4
2006-11-10,BOS,100,1,3,UTA,107,4,1,5,4
2006-11-10,NJN,106,2,1,MIA,113,2,2,4,3
2006-11-10,HOU,103,3,2,NYK,94,2,3,5,5
2006-11-10,POR,92,3,2,NOK,91,4,1,7,3
2006-11-10,LAL,83,4,2,DET,97,2,3,6,5
2006-11-11,ATL,112,4,1,SEA,113,2,4,6,5
2006-11-11,CLE,94,3,2,BOS,93,1,4,4,6
2006-11-11,SAS,100,4,1,NYK,92,2,4,6,5
2006-11-11,MIN,98,2,3,ORL,109,3,3,5,6
2006-11-11,CHI,89,2,3,IND,80,4,2,6,5
2006-11-11,MIL,111,2,4,UTA,113,5,1,7,5
2006-11-11,PHX,96,1,5,MEM,87,1,3,2,8
2006-11-11,GSW,111,3,3,DET,79,3,3,6,6
2006-11-12,LAC,92,4,1,NOK,76,4,2,8,3
2006-11-12,WAS,93,3,2,NJN,105,2,2,5,4
2006-11-12,CHA,101,1,4,DEN,108,1,3,2,7
2006-11-12,MIA,72,3,2,HOU,94,4,2,7,4
2006-11-12,SAC,107,3,2,TOR,92,2,3,5,5
2006-11-12,POR,96,4,2,DAL,103,1,4,5,6
2006-11-12,LAL,91,4,3,MEM,81,1,4,5,7
2006-11-13,BOS,89,1,5,ORL,92,4,3,5,8
2006-11-13,NJN,113,3,2,SEA,119,3,4,6,6
2006-11-13,NYK,96,2,5,CLE,102,4,2,6,7
2006-11-14,ATL,101,4,2,MIL,103,2,5,6,7
2006-11-14,MIA,105,3,3,DEN,112,2,3,5,6
2006-11-14,NOK,94,4,3,CHA,85,1,5,5,8
2006-11-14,MIN,101,2,4,POR,89,4,3,6,7
2006-11-14,HOU,84,5,2,SAS,92,5,1,10,3
2006-11-14,DAL,111,2,4,CHI,99,3,3,5,7
2006-11-14,UTA,112,6,1,LAC,90,5,1,11,2
2006-11-14,GSW,110,4,3,TOR,99,2,4,6,7
2006-11-15,ORL,108,5,3,DEN,99,3,3,8,6
2006-11-15,CLE,100,5,2,POR,87,4,4,9,6
2006-11-15,BOS,114,1,6,IND,88,4,3,5,9
2006-11-15,NJN,100,3,3,MIL,87,3,5,6,8
2006-11-15,NYK,102,2,6,WAS,82,3,3,5,9
2006-11-15,DET,99,3,4,NOK,100,5,3,8,7
2006-11-15,SAS,92,6,1,CHA,95,1,6,7,7
2006-11-15,SAC,115,4,2,MEM,111,1,5,5,7
2006-11-15,SEA,90,4,4,PHI,96,3,3,7,7
2006-11-16,HOU,101,5,3,CHI,100,3,4,8,7
2006-11-16,GSW,117,5,3,SAC,105,5,2,10,5
2006-11-17,IND,91,4,4,NJN,100,4,3,8,7
2006-11-17,BOS,118,2,6,POR,90,4,5,6,11
2006-11-17,MIA,76,3,4,NYK,100,3,6,6,10
2006-11-17,CLE,92,6,2,MIN,76,3,4,9,6
2006-11-17,DET,100,3,5,WAS,91,3,4,6,9
2006-11-17,MEM,103,1,6,DAL,115,3,4,4,10
2006-11-17,SAS,100,6,2,CHI,83,3,5,9,7
2006-11-17,PHX,106,2,5,PHI,94,4,3,6,8
2006-11-17,LAL,107,5,3,TOR,100,2,5,7,8
2006-11-17,SEA,109,4,5,UTA,118,7,1,11,6
2006-11-18,WAS,111,3,5,CLE,99,7,2,10,7
2006-11-18,ATL,88,4,3,MIA,93,3,5,7,8
2006-11-18,ORL,97,6,3,CHA,83,2,6,8,9
2006-11-18,NJN,68,5,3,POR,86,4,6,9,9
2006-11-18,NYK,118,4,6,BOS,122,3,6,7,12
2006-11-18,DET,104,4,5,HOU,92,6,3,10,8
2006-11-18,MIN,96,3,5,NOK,99,6,3,9,8
2006-11-18,MIL,100,3,6,IND,102,4,5,7,11
2006-11-18,DAL,89,4,4,MEM,84,1,7,5,11
2006-11-18,DEN,117,3,4,TOR,109,2,6,5,10
2006-11-18,UTA,120,8,1,PHX,117,3,5,11,6
2006-11-18,LAC,103,5,2,PHI,97,4,4,9,6
2006-11-18,GSW,107,6,3,SEA,95,4,6,10,9
2006-11-19,LAL,82,6,3,CHI,72,3,6,9,9
2006-11-19,SAC,99,5,3,SAS,108,7,2,12,5
2006-11-20,CHA,85,2,7,DAL,93,5,4,7,11
2006-11-20,NYK,90,4,7,HOU,97,6,4,10,11
2006-11-20,MEM,95,1,8,ORL,86,7,3,8,11
2006-11-20,UTA,101,9,1,TOR,96,2,7,11,8
2006-11-20,POR,98,5,6,SAS,107,8,2,13,8
2006-11-20,SEA,99,4,7,NJN,87,5,4,9,11
2006-11-20,GSW,110,7,3,PHX,113,3,6,10,9
2006-11-21,PHI,87,4,5,DET,97,5,5,9,10
2006-11-21,CLE,97,7,3,MEM,94,2,8,9,11
2006-11-21,IND,93,5,5,MIL,88,3,7,8,12
2006-11-21,NOK,101,7,3,MIA,86,4,5,11,8
2006-11-21,DAL,107,6,4,WAS,80,4,5,10,9
2006-11-21,DEN,113,4,4,CHI,109,3,7,7,11
2006-11-21,LAL,105,7,3,LAC,101,6,2,13,5
2006-11-22,TOR,95,2,8,CLE,87,8,3,10,11
2006-11-22,CHA,92,2,8,BOS,83,4,6,6,14
2006-11-22,ORL,96,7,4,IND,91,6,5,13,9
2006-11-22,DET,103,6,5,ATL,98,4,4,10,9
2006-11-22,SAS,106,9,2,MIA,86,4,6,13,8
2006-11-22,MIL,98,3,8,PHI,94,4,6,7,14
2006-11-22,MIN,107,3,6,NYK,89,4,8,7,14
2006-11-22,HOU,86,7,4,WAS,82,4,6,11,10
2006-11-22,PHX,92,4,6,NOK,83,8,3,12,9
2006-11-22,SAC,101,5,4,UTA,110,10,1,15,5
2006-11-22,POR,100,5,7,NJN,97,5,5,10,12
2006-11-22,LAC,85,6,3,SEA,95,5,7,11,10
2006-11-22,GSW,112,7,4,DEN,115,5,4,12,8
2006-11-24,BOS,77,4,7,NYK,101,4,9,8,16
2006-11-24,PHI,123,4,7,CHI,108,3,8,7,15
2006-11-24,ATL,97,4,5,TOR,93,3,8,7,13
2006-11-24,MIA,104,4,7,ORL,107,8,4,12,11
2006-11-24,DET,104,7,5,CHA,95,3,8,10,13
2006-11-24,IND,97,6,6,CLE,87,8,4,14,10
2006-11-24,MEM,95,2,9,WAS,80,4,7,6,16
2006-11-24,NOK,79,8,4,MIN,86,4,6,12,10
2006-11-24,SAS,92,10,2,DAL,95,7,4,17,6
2006-11-24,DEN,140,6,4,GSW,129,7,5,13,9
2006-11-24,UTA,114,11,1,LAL,108,8,3,19,4
2006-11-24,PHX,99,5,6,NJN,93,5,6,10,12
2006-11-24,SEA,100,6,7,SAC,109,5,5,11,12
2006-11-25,WAS,111,4,8,DET,115,8,5,12,13
2006-11-25,CHA,93,3,9,MIA,102,4,8,7,17
2006-11-25,ORL,98,9,4,ATL,79,5,5,14,9
2006-11-25,NYK,95,5,9,CHI,106,3,9,8,18
2006-11-25,CLE,108,8,5,PHI,95,5,7,13,12
2006-11-25,MIN,104,5,6,LAC,96,6,4,11,10
2006-11-25,HOU,85,8,4,MEM,76,3,9,11,13
2006-11-25,DAL,85,8,4,NOK,73,8,5,16,9
2006-11-25,MIL,98,4,8,BOS,111,4,8,8,16
2006-11-25,SAC,105,6,5,POR,85,6,7,12,12
2006-11-25,GSW,91,7,6,UTA,78,12,1,19,7
2006-11-26,TOR,92,3,9,IND,83,7,6,10,15
2006-11-26,DEN,103,7,4,LAC,88,6,5,13,9
2006-11-26,POR,101,6,8,PHX,119,6,6,12,14
2006-11-26,SEA,78,6,8,SAS,98,10,3,16,11
2006-11-26,LAL,99,8,4,NJN,93,5,7,13,11
2006-11-27,MIA,103,5,8,PHI,91,5,8,10,16
2006-11-27,DAL,93,9,4,MIN,87,6,6,15,10
2006-11-27,UTA,75,12,2,ORL,88,10,4,22,6
2006-11-27,GSW,111,8,6,SAS,102,11,3,19,9
2006-11-28,WAS,96,4,9,ATL,95,5,6,9,15
2006-11-28,NJN,92,5,8,CHA,96,3,10,8,18
2006-11-28,NOK,77,8,6,TOR,94,4,9,12,15
2006-11-28,CHI,102,4,9,NYK,85,5,10,9,19
2006-11-28,HOU,82,9,4,MIN,75,6,7,15,11
2006-11-28,DEN,96,8,4,MEM,108,3,10,11,14
2006-11-28,SAC,93,7,5,LAC,80,6,6,13,11
2006-11-28,POR,97,6,9,IND,105,7,7,13,16
2006-11-28,LAL,105,9,4,MIL,109,4,9,13,13
2006-11-29,ATL,99,5,7,CHA,90,4,10,9,17
2006-11-29,CLE,98,9,5,NYK,101,5,11,14,16
2006-11-29,BOS,103,5,8,NJN,106,5,9,10,17
2006-11-29,DAL,117,10,4,TOR,98,5,9,15,13
2006-11-29,UTA,83,12,3,SAS,75,11,4,23,7
2006-11-29,PHX,102,7,6,HOU,91,10,4,17,10
2006-11-29,SEA,84,6,9,ORL,94,11,4,17,13
2006-11-29,LAC,105,6,7,MEM,90,4,10,10,17
2006-11-29,GSW,106,9,6,IND,108,8,7,17,13
2006-11-30,MIA,85,6,8,DET,87,9,5,15,13
2006-11-30,LAL,132,9,5,UTA,102,13,3,22,8
2006-12-01,TOR,106,5,10,BOS,102,5,9,10,19
2006-12-01,WAS,121,5,9,CHA,109,4,11,9,20
2006-12-01,ATL,95,6,7,CLE,106,9,6,15,13
2006-12-01,DET,108,10,5,NYK,100,6,11,16,16
2006-12-01,NOK,108,8,7,CHI,111,5,9,13,16
2006-12-01,MIN,92,6,8,DEN,106,8,5,14,13
2006-12-01,DAL,109,11,4,SAC,90,8,5,19,9
2006-12-01,PHX,122,8,6,MIL,116,5,9,13,15
2006-12-01,POR,89,6,10,ORL,91,12,4,18,14
2006-12-01,SEA,105,6,10,IND,103,9,7,15,17
2006-12-02,NJN,112,6,9,PHI,107,5,9,11,18
2006-12-02,NYK,100,6,12,TOR,103,6,10,12,22
2006-12-02,MEM,97,4,11,MIA,98,6,9,10,20
2006-12-02,SAS,100,11,5,SAC,98,8,6,19,11
2006-12-02,CHI,112,6,9,WAS,94,6,9,12,18
2006-12-02,HOU,81,10,5,CLE,63,10,6,20,11
2006-12-02,DEN,121,9,5,IND,101,9,8,18,13
2006-12-02,UTA,109,13,4,SEA,107,7,10,20,14
2006-12-02,LAC,88,7,7,LAL,97,10,5,17,12
2006-12-02,GSW,110,9,7,MIL,115,5,10,14,17
2006-12-03,PHI,84,5,10,MIN,95,6,9,11,19
2006-12-03,CHA,97,4,12,DET,89,11,5,15,17
2006-12-03,POR,96,6,11,ATL,107,6,8,12,19
2006-12-03,LAC,116,7,8,ORL,91,13,4,20,12
2006-12-04,WAS,106,6,10,DAL,97,12,4,18,14
2006-12-04,NYK,98,6,13,MEM,90,4,12,10,25
2006-12-04,SAS,129,12,5,GSW,89,9,8,21,13
2006-12-04,CHI,100,7,9,BOS,82,5,10,12,19
2006-12-04,UTA,101,14,4,MIL,88,6,10,20,14
2006-12-04,SAC,89,8,7,ORL,92,13,5,21,12
2006-12-04,LAL,101,11,5,IND,87,9,9,20,14
2006-12-05,NJN,75,7,9,DAL,92,12,5,19,14
2006-12-05,DET,85,11,6,POR,88,6,12,17,18
2006-12-05,HOU,118,11,5,GSW,90,9,9,20,14
2006-12-05,PHX,127,9,6,SAC,102,8,8,17,14
2006-12-05,SEA,102,7,11,ATL,87,7,8,14,19
2006-12-05,LAC,101,8,8,MIA,97,7,9,15,17
2006-12-06,CHA,76,5,12,SAS,96,13,5,18,17
2006-12-06,CLE,95,10,7,TOR,91,7,10,17,17
2006-12-06,IND,94,9,10,ORL,80,14,5,23,15
2006-12-06,BOS,96,5,11,MEM,98,4,13,9,24
2006-12-06,NYK,102,7,13,WAS,113,7,10,14,23
2006-12-06,MIL,102,6,11,POR,94,7,12,13,23
2006-12-06,MIN,90,7,9,HOU,84,12,5,19,14
2006-12-06,CHI,121,8,9,PHI,94,5,11,13,20
2006-12-06,DEN,96,10,5,ATL,98,7,9,17,14
2006-12-06,LAL,89,12,5,NOK,105,8,8,20,13
2006-12-07,NJN,157,7,10,PHX,161,10,6,17,16
2006-12-07,DAL,82,13,5,DET,92,11,7,24,12
2006-12-07,SAC,91,8,9,MIA,93,7,10,15,19
2006-12-08,CHA,62,5,13,HOU,92,12,6,17,19
2006-12-08,ORL,83,14,6,DET,87,12,7,26,13
2006-12-08,IND,108,10,10,POR,95,7,13,17,23
2006-12-08,BOS,111,5,12,PHX,116,11,6,16,18
2006-12-08,PHI,98,5,12,WAS,113,8,10,13,22
2006-12-08,SAS,111,14,5,LAC,82,9,8,23,13
2006-12-08,MIN,110,8,9,UTA,103,15,4,23,13
2006-12-08,CHI,93,9,9,TOR,90,7,11,16,20
2006-12-08,MIL,100,7,11,MEM,94,5,13,12,24
2006-12-08,DEN,123,10,6,MIA,107,8,10,18,16
2006-12-08,LAL,106,12,6,ATL,95,8,9,20,15
2006-12-08,SEA,94,8,11,NOK,74,9,8,17,19
2006-12-09,WAS,109,9,10,HOU,114,13,6,22,16
2006-12-09,ORL,86,14,7,PHI,84,5,13,19,20
2006-12-09,NJN,90,7,11,BOS,92,5,13,12,24
2006-12-09,NYK,115,7,14,MIL,107,8,11,15,25
2006-12-09,CLE,107,11,7,IND,75,11,10,22,17
2006-12-09,MEM,82,5,14,LAC,89,9,9,14,23
2006-12-09,CHI,81,10,9,MIN,91,9,9,19,18
2006-12-09,DAL,105,13,6,DEN,90,11,6,24,12
2006-12-09,GSW,101,9,10,NOK,80,9,9,18,19
2006-12-10,TOR,83,7,12,POR,93,7,14,14,26
2006-12-10,CHA,84,5,14,PHX,114,12,6,17,20
2006-12-10,SAC,117,8,10,ATL,92,8,10,16,20
2006-12-10,SEA,117,9,11,GSW,115,10,10,19,21
2006-12-10,LAL,106,13,6,SAS,99,15,5,28,11
2006-12-11,PHI,79,5,14,POR,81,8,14,13,28
2006-12-11,ORL,89,15,7,PHX,103,13,6,28,13
2006-12-11,NJN,105,7,12,MEM,92,5,15,12,27
2006-12-11,NYK,90,8,14,BOS,97,6,13,14,27
2006-12-11,MIA,99,8,11,TOR,77,7,13,15,24
2006-12-11,NOK,95,9,10,CLE,89,12,7,21,17
2006-12-11,CHI,106,10,10,IND,91,11,11,21,21
2006-12-11,UTA,101,15,5,DAL,79,14,6,29,11
2006-12-11,LAC,81,10,9,SAS,103,15,6,25,15
2006-12-12,ATL,87,8,11,DEN,100,11,7,19,18
2006-12-12,MIL,94,8,12,SEA,93,10,11,18,23
2006-12-12,HOU,94,14,6,LAL,102,14,6,28,12
2006-12-12,GSW,126,10,11,SAC,113,9,10,19,21
2006-12-13,PHI,81,5,15,BOS,101,7,13,12,28
2006-12-13,WAS,120,9,11,DEN,91,12,7,21,18
2006-12-13,ORL,84,15,8,TOR,91,7,14,22,22
2006-12-13,MIA,89,9,11,PHX,99,14,6,23,17
2006-12-13,CLE,104,12,8,CHA,101,5,15,17,23
2006-12-13,IND,101,11,12,DET,90,13,7,24,19
2006-12-13,NJN,108,8,12,MIL,95,9,12,17,24
2006-12-13,NYK,94,8,15,ATL,82,8,12,16,27
2006-12-13,MEM,79,5,16,POR,85,9,14,14,30
2006-12-13,SAS,95,16,6,MIN,82,10,9,26,15
2006-12-13,CHI,99,11,10,SEA,84,10,12,21,22
2006-12-13,DAL,110,14,7,LAL,101,15,6,29,13
2006-12-13,LAC,86,10,10,UTA,105,16,5,26,15
2006-12-14,CHA,99,5,16,ORL,89,15,9,20,25
2006-12-14,NOK,77,10,10,SAS,103,17,6,27,16
2006-12-14,GSW,109,11,11,HOU,107,14,7,25,18
2006-12-15,TOR,90,8,14,NJN,78,9,12,17,26
2006-12-15,WAS,106,10,11,MIA,95,9,12,19,23
2006-12-15,IND,112,12,12,NYK,96,9,15,21,27
2006-12-15,BOS,119,8,13,DEN,114,12,8,20,21
2006-12-15,CLE,106,13,8,SEA,84,10,13,23,21
2006-12-15,MEM,88,5,17,ATL,97,8,13,13,30
2006-12-15,DAL,93,15,7,PHI,79,5,16,20,23
2006-12-15,CHI,117,12,10,MIL,111,9,13,21,23
2006-12-15,UTA,97,17,5,SAC,98,9,11,26,16
2006-12-15,PHX,105,15,6,GSW,101,12,11,27,17
2006-12-15,POR,109,10,14,LAC,99,10,11,20,25
2006-12-15,LAL,112,15,7,HOU,101,14,8,29,15
2006-12-16,CHA,100,6,16,BOS,106,9,13,15,29
2006-12-16,ATL,104,9,13,CHI,106,13,10,22,23
2006-12-16,ORL,81,15,10,CLE,74,14,8,29,18
2006-12-16,NYK,100,9,16,DEN,123,12,9,21,25
2006-12-16,MIA,98,9,13,MEM,90,5,18,14,31
2006-12-16,NJN,82,9,13,DET,90,13,8,22,21
2006-12-16,NOK,79,10,11,DAL,90,16,7,26,18
2006-12-16,SAS,103,18,6,PHI,98,5,17,23,23
2006-12-16,MIL,108,9,14,MIN,104,10,10,19,24
2006-12-16,SAC,98,10,11,PHX,105,16,6,26,17
2006-12-17,TOR,120,9,14,GSW,115,12,12,21,26
2006-12-17,IND,94,13,12,UTA,104,17,6,30,18
2006-12-17,LAC,103,10,12,HOU,108,14,9,24,21
2006-12-17,DET,97,14,8,SEA,93,10,14,24,22
2006-12-17,LAL,141,16,7,WAS,147,11,11,27,18
2006-12-18,NJN,105,9,14,GSW,97,12,13,21,27
2006-12-18,NYK,97,9,17,UTA,96,18,6,27,23
2006-12-18,MIA,101,10,13,NOK,99,10,12,20,25
2006-12-18,MEM,134,5,19,SEA,126,10,15,15,34
2006-12-18,DEN,117,13,9,WAS,108,12,11,25,20
2006-12-18,SAC,91,10,12,DAL,109,17,7,27,19
2006-12-19,CHI,94,14,10,LAL,89,16,8,30,18
2006-12-19,PHX,115,17,6,TOR,98,10,14,27,20
2006-12-20,PHI,93,5,18,IND,101,13,13,18,31
2006-12-20,ATL,106,9,14,UTA,112,18,7,27,21
2006-12-20,ORL,86,16,10,NOK,83,10,13,26,23
2006-12-20,BOS,95,10,13,GSW,96,12,14,22,27
2006-12-20,NYK,111,10,17,CHA,109,6,17,16,34
2006-12-20,NJN,113,10,14,CLE,111,14,9,24,23
2006-12-20,MIL,121,10,14,MIA,95,11,13,21,27
2006-12-20,SAS,105,19,6,MEM,98,6,19,25,25
2006-12-20,MIN,94,10,11,LAL,111,16,9,26,20
2006-12-20,POR,89,11,14,HOU,87,15,9,26,23
2006-12-20,LAC,96,10,13,TOR,98,10,15,20,28
2006-12-20,SEA,95,10,16,DAL,103,18,7,28,23
2006-12-21,CLE,71,14,10,DET,87,15,8,29,18
2006-12-21,SAC,119,10,13,WAS,126,12,12,22,25
2006-12-22,CHA,101,6,18,UTA,89,19,7,25,25
2006-12-22,ORL,108,17,10,GSW,117,13,14,30,24
2006-12-22,NJN,95,11,14,LAL,99,17,9,28,23
2006-12-22,NYK,103,11,17,CHI,92,15,10,26,27
2006-12-22,ATL,90,9,15,IND,100,14,13,23,28
2006-12-22,BOS,83,10,14,PHI,98,5,19,15,33
2006-12-22,NOK,100,10,14,MEM,97,6,20,16,34
2006-12-22,SAS,78,20,6,HOU,97,15,10,35,16
2006-12-22,MIN,107,10,12,MIL,113,11,14,21,26
2006-12-22,DAL,115,19,7,LAC,83,10,14,29,21
2006-12-22,DEN,96,14,10,SAC,101,10,14,24,24
2006-12-22,POR,100,12,14,TOR,101,11,15,23,29
2006-12-22,PHX,139,19,6,WAS,144,13,12,32,18
2006-12-23,IND,71,15,13,MIN,78,10,13,25,26
2006-12-23,PHI,98,6,19,NYK,77,12,17,18,36
2006-12-23,MIA,105,11,14,GSW,92,14,14,25,28
2006-12-23,DET,108,16,8,ATL,81,9,16,25,24
2006-12-23,CLE,86,14,11,ORL,83,17,11,31,22
2006-12-23,MEM,97,6,21,UTA,100,19,8,25,29
2006-12-23,NOK,77,11,14,SAS,112,20,7,31,21
2006-12-23,CHI,115,15,11,CHA,76,7,18,22,29
2006-12-23,MIL,115,12,14,NJN,104,11,15,23,29
2006-12-23,HOU,93,16,10,LAC,98,10,15,26,25
2006-12-23,SEA,110,10,17,TOR,97,12,15,22,32
2006-12-25,MIA,101,12,14,LAL,85,18,9,30,23
2006-12-26,WAS,116,14,12,MEM,101,6,22,20,34
2006-12-26,IND,81,15,14,HOU,76,16,11,31,25
2006-12-26,DET,92,17,8,NJN,91,11,16,28,24
2006-12-26,SAS,107,21,7,MIL,114,13,14,34,21
2006-12-26,MIN,100,11,13,CHI,98,16,11,27,24
2006-12-26,DAL,97,20,7,CHA,84,7,19,27,26
2006-12-26,DEN,116,14,11,BOS,105,10,15,24,26
2006-12-26,UTA,102,20,8,LAC,92,11,15,31,23
2006-12-26,PHX,110,19,7,POR,87,12,15,31,22
2006-12-26,SEA,102,11,17,NOK,94,11,15,22,32
2006-12-26,GSW,116,14,15,PHI,97,7,19,21,34
2006-12-27,TOR,100,12,16,MIN,97,12,13,24,29
2006-12-27,CHA,107,7,20,WAS,114,15,12,22,32
2006-12-27,ATL,76,9,17,CLE,89,15,11,24,28
2006-12-27,ORL,93,17,12,LAL,106,18,10,35,22
2006-12-27,NJN,71,11,17,HOU,96,16,12,27,29
2006-12-27,NYK,151,12,18,DET,145,18,8,30,26
2006-12-27,MEM,96,6,23,MIL,112,14,14,20,37
2006-12-27,CHI,109,16,12,MIA,103,13,14,29,26
2006-12-27,SAC,101,11,14,PHI,76,7,20,18,34
2006-12-27,POR,100,12,16,NOK,85,11,16,23,32
2006-12-27,LAC,100,11,16,BOS,77,10,16,21,32
2006-12-28,DAL,101,21,7,PHX,99,20,7,41,14
2006-12-28,SAS,106,21,8,UTA,83,21,8,42,16
2006-12-28,DEN,112,15,11,SEA,98,12,17,27,28
2006-12-29,TOR,97,13,16,CHI,107,17,12,30,28
2006-12-29,WAS,112,16,12,ORL,111,17,13,33,25
2006-12-29,CHA,133,7,21,LAL,124,19,10,26,31
2006-12-29,MIA,81,13,15,NJN,91,11,18,24,33
2006-12-29,CLE,109,16,11,MIL,99,15,14,31,25
2006-12-29,DET,92,18,9,IND,93,16,14,34,23
2006-12-29,NOK,99,11,17,DEN,89,16,11,27,28
2006-12-29,MIN,101,12,14,SEA,82,12,18,24,32
2006-12-29,HOU,94,17,12,ATL,68,9,18,26,30
2006-12-29,PHX,108,20,8,NYK,86,13,18,33,26
2006-12-29,POR,95,13,16,PHI,98,7,21,20,37
2006-12-29,LAC,102,12,16,SAC,93,12,14,24,30
2006-12-29,GSW,110,15,15,BOS,100,10,17,25,32
2006-12-30,ORL,97,17,14,MIA,68,13,16,30,30
2006-12-30,IND,102,17,14,CHA,113,8,21,25,35
2006-12-30,NJN,100,12,18,MIN,92,13,14,25,32
2006-12-30,MEM,110,6,24,TOR,104,13,17,19,41
2006-12-30,CHI,103,18,12,CLE,96,17,11,35,23
2006-12-30,MIL,119,15,15,WAS,102,17,12,32,27
2006-12-30,DAL,94,22,7,NOK,80,12,17,34,24
2006-12-30,UTA,96,21,9,POR,86,13,17,34,26
2006-12-30,SAC,119,12,15,GSW,96,16,15,28,30
2006-12-31,SAS,95,22,8,ATL,81,9,19,31,27
2006-12-31,LAC,90,13,16,NYK,80,13,19,26,35
2006-12-31,DET,101,18,10,PHX,108,21,8,39,18
2006-12-31,HOU,111,18,12,MEM,109,7,24,25,36
2006-12-31,DEN,85,16,12,DAL,89,23,7,39,19
2006-12-31,LAL,104,19,11,PHI,94,8,21,27,32
2006-12-31,SEA,101,12,19,BOS,95,10,18,22,37
2007-01-01,CHA,96,9,21,MIN,102,13,15,22,36
2007-01-01,POR,81,13,18,BOS,89,10,19,23,37
2007-01-02,ORL,91,18,14,LAC,86,14,16,32,30
2007-01-02,CLE,82,17,12,SAS,78,23,8,40,20
2007-01-02,NOK,89,12,18,GSW,97,16,16,28,34
2007-01-02,CHI,96,19,12,PHX,97,22,8,41,20
2007-01-02,DAL,112,24,7,SEA,88,13,19,37,26
2007-01-02,DEN,97,16,13,PHI,108,8,22,24,35
2007-01-02,SAC,112,13,15,NYK,100,13,20,26,35
2007-01-03,TOR,98,13,18,PHX,100,23,8,36,26
2007-01-03,WAS,108,17,13,MIL,105,16,15,33,28
2007-01-03,BOS,104,11,19,CLE,107,18,12,29,31
2007-01-03,MIA,95,13,17,LAC,110,14,17,27,34
2007-01-03,MEM,144,7,25,GSW,135,17,16,24,41
2007-01-03,MIN,103,14,15,SAS,101,23,9,37,24
2007-01-03,HOU,103,19,12,SEA,96,13,20,32,32
2007-01-03,UTA,98,22,9,PHI,87,9,22,31,31
2007-01-03,POR,81,13,19,NYK,99,13,21,26,40
2007-01-04,NOK,68,12,19,DET,92,18,11,30,30
2007-01-04,DAL,100,25,7,IND,91,17,15,42,22
2007-01-04,SAC,128,14,15,LAL,132,20,11,34,26
2007-01-05,TOR,105,13,19,ATL,92,9,20,22,39
2007-01-05,WAS,116,18,13,LAC,105,15,17,33,30
2007-01-05,ORL,106,19,14,CHA,74,9,22,28,36
2007-01-05,NJN,91,13,18,CHI,86,19,13,32,31
2007-01-05,MEM,119,8,25,BOS,128,11,20,19,45
2007-01-05,SAS,85,23,10,DAL,90,26,7,49,17
2007-01-05,MIN,104,15,15,PHI,102,9,23,24,38
2007-01-05,MIL,86,16,16,CLE,95,19,12,35,28
2007-01-05,HOU,100,20,12,UTA,86,23,9,43,21
2007-01-05,PHX,108,24,8,MIA,80,13,18,37,26
2007-01-05,LAL,123,21,11,DEN,104,16,14,37,25
2007-01-05,SEA,93,13,21,NYK,111,14,21,27,42
2007-01-06,ATL,86,9,21,LAC,74,15,18,24,39
2007-01-06,CLE,96,20,12,NJN,91,14,18,34,30
2007-01-06,NOK,93,12,20,IND,100,17,16,29,36
2007-01-06,CHI,106,19,14,DET,89,19,11,38,25
2007-01-06,DEN,84,16,15,UTA,96,23,10,39,25
2007-01-06,SAC,105,14,16,POR,110,13,20,27,36
2007-01-06,GSW,108,17,17,SEA,104,13,22,30,39
2007-01-07,TOR,116,14,19,WAS,111,19,13,33,32
2007-01-07,MIN,103,16,15,HOU,99,21,12,37,27
2007-01-07,MEM,96,8,26,SAS,110,23,11,31,37
2007-01-07,ORL,87,20,14,BOS,79,12,20,32,34
2007-01-07,PHX,128,25,8,GSW,105,18,17,43,25
2007-01-07,POR,90,14,20,MIA,93,13,19,27,39
2007-01-07,LAL,101,22,11,DAL,98,27,7,49,18
2007-01-08,NOK,90,12,21,LAC,100,15,19,27,40
2007-01-08,CHI,77,20,14,HOU,84,21,13,41,27
2007-01-08,DEN,104,16,16,MIL,92,16,17,32,33
2007-01-09,PHI,89,9,24,DET,98,19,12,28,36
2007-01-09,IND,91,18,16,ATL,72,10,21,28,37
2007-01-09,NJN,101,14,19,TOR,86,15,19,29,38
2007-01-09,MEM,128,8,27,LAL,118,23,11,31,38
2007-01-09,SAS,98,24,11,POR,84,14,21,38,32
2007-01-09,UTA,105,24,10,DAL,108,27,8,51,18
2007-01-09,PHX,113,26,8,SEA,102,13,23,39,31
2007-01-09,SAC,98,14,17,CLE,108,21,12,35,29
2007-01-10,WAS,113,19,14,CHI,103,20,15,39,29
2007-01-10,ATL,77,10,22,NOK,96,12,22,22,44
2007-01-10,BOS,84,12,21,IND,97,19,16,31,37
2007-01-10,NYK,106,15,21,PHI,99,9,25,24,46
2007-01-10,DET,96,20,12,CHA,103,9,23,29,35
2007-01-10,MIL,77,16,18,TOR,90,15,20,31,38
2007-01-10,MIN,91,17,15,LAC,92,16,19,33,34
2007-01-10,HOU,102,22,13,LAL,77,23,12,45,25
2007-01-10,DAL,99,28,8,POR,74,14,22,42,30
2007-01-10,DEN,83,17,16,SAS,92,25,11,42,27
2007-01-10,SEA,103,13,24,MIA,107,14,19,27,43
2007-01-10,GSW,76,18,18,ORL,91,21,14,39,32
2007-01-11,CHI,83,20,16,NJN,86,15,19,35,35
2007-01-11,PHX,109,27,8,CLE,90,22,12,49,20
2007-01-12,PHI,110,9,26,MIL,97,16,19,25,45
2007-01-12,IND,113,20,16,DAL,115,29,8,49,24
2007-01-12,BOS,86,12,22,TOR,95,16,20,28,42
2007-01-12,NYK,110,16,21,CHA,126,10,23,26,44
2007-01-12,ATL,99,10,23,DET,93,20,13,30,36
2007-01-12,MEM,110,9,27,MIN,116,17,16,26,43
2007-01-12,NOK,104,13,22,WAS,97,20,14,33,36
2007-01-12,POR,95,14,23,SAC,87,14,18,28,41
2007-01-12,DEN,86,17,17,HOU,90,23,13,40,30
2007-01-12,LAL,109,23,13,ORL,106,22,14,45,27
2007-01-12,GSW,96,18,19,MIA,118,15,19,33,38
2007-01-12,SEA,122,13,25,UTA,114,24,11,37,36
2007-01-13,CHA,89,11,23,PHI,83,10,26,21,49
2007-01-13,DET,81,20,14,BOS,73,12,23,32,37
2007-01-13,SAS,93,26,11,WAS,80,20,15,46,26
2007-01-13,MIN,109,18,16,NJN,98,16,19,34,35
2007-01-13,CHI,111,20,17,MEM,66,9,28,29,45
2007-01-13,UTA,110,24,12,MIA,119,16,19,40,31
2007-01-13,PHX,107,28,8,ORL,101,22,15,50,23
2007-01-13,SAC,111,14,19,HOU,115,24,13,38,32
2007-01-13,LAC,92,17,19,CLE,104,22,13,39,32
2007-01-14,TOR,96,17,20,DAL,97,30,8,47,28
2007-01-14,POR,93,15,23,DEN,109,17,18,32,41
2007-01-15,NYK,102,16,22,SAC,97,14,20,30,42
2007-01-15,WAS,114,20,16,UTA,111,24,13,44,29
2007-01-15,CHA,91,12,23,MIL,99,16,21,28,44
2007-01-15,PHI,86,10,27,TOR,104,17,21,27,48
2007-01-15,ATL,100,11,23,BOS,96,12,24,23,47
2007-01-15,CHI,99,21,17,SAS,87,27,11,48,28
2007-01-15,NJN,105,16,20,IND,95,20,17,36,37
2007-01-15,DET,90,21,14,MIN,94,19,16,40,30
2007-01-15,GSW,108,18,20,LAC,93,17,20,35,40
2007-01-15,MEM,122,9,29,PHX,137,29,8,38,37
2007-01-15,LAL,124,24,13,MIA,118,17,19,41,32
2007-01-16,NOK,84,15,22,ORL,78,22,16,37,38
2007-01-16,DAL,109,31,8,HOU,96,25,13,56,21
2007-01-16,SEA,101,14,25,CLE,96,23,13,37,38
2007-01-17,TOR,101,18,21,SAC,85,14,21,32,42
2007-01-17,WAS,99,21,16,NYK,98,17,22,38,38
2007-01-17,CHA,85,12,24,NJN,92,17,20,29,44
2007-01-17,DET,99,21,15,UTA,100,24,14,45,29
2007-01-17,MIL,90,17,21,CHI,99,22,17,39,38
2007-01-17,MEM,118,9,30,PHI,102,10,28,19,58
2007-01-17,MIN,88,20,16,ATL,105,12,23,32,39
2007-01-17,HOU,91,25,14,PHX,100,30,8,55,22
2007-01-17,SAS,96,27,12,LAL,100,25,13,52,25
2007-01-17,POR,94,15,24,CLE,76,23,14,38,38
2007-01-17,LAC,115,17,21,GSW,109,19,20,36,41
2007-01-18,MIA,104,17,20,IND,101,20,18,37,38
2007-01-18,DAL,114,32,8,LAL,95,26,13,58,21
2007-01-19,TOR,94,19,21,UTA,102,25,14,44,35
2007-01-19,PHI,98,10,29,MIA,95,18,20,28,49
2007-01-19,ORL,93,22,17,WAS,114,22,16,44,33
2007-01-19,BOS,91,12,25,SAC,96,14,22,26,47
2007-01-19,NYK,100,17,23,NJN,101,18,20,35,43
2007-01-19,ATL,75,13,23,CHA,96,12,25,25,48
2007-01-19,SAS,99,27,13,NOK,86,16,22,43,35
2007-01-19,MIN,98,20,17,DET,104,21,16,41,33
2007-01-19,PHX,106,31,8,POR,101,16,24,47,32
2007-01-19,DEN,110,18,18,CLE,99,23,15,41,33
2007-01-19,SEA,99,15,25,MIL,72,17,22,32,47
2007-01-20,LAC,112,18,21,MEM,91,10,30,28,51
2007-01-20,CHA,104,13,25,ATL,85,13,24,26,49
2007-01-20,IND,106,20,19,NYK,108,17,24,37,43
2007-01-20,WAS,115,23,16,BOS,110,12,26,35,42
2007-01-20,DET,91,22,16,SAC,74,15,22,37,38
2007-01-20,NJN,101,19,20,ORL,94,22,18,41,38
2007-01-20,NOK,113,16,23,LAL,103,26,14,42,37
2007-01-20,CHI,85,23,17,UTA,95,26,14,49,31
2007-01-20,HOU,113,25,15,DEN,121,19,18,44,33
2007-01-20,GSW,104,19,21,CLE,106,23,16,42,37
2007-01-21,MIA,93,18,21,DAL,99,33,8,51,29
2007-01-21,PHI,85,11,29,SAS,99,28,13,39,42
2007-01-21,PHX,131,32,8,MIN,102,20,18,52,26
2007-01-21,POR,99,16,25,MIL,95,17,23,33,48
2007-01-22,TOR,105,19,22,CHA,84,14,25,33,47
2007-01-22,CLE,79,24,16,ORL,90,22,19,46,35
2007-01-22,IND,98,20,20,CHI,91,23,18,43,38
2007-01-22,BOS,89,12,27,SAS,93,29,13,41,40
2007-01-22,MIA,101,18,22,NYK,83,18,24,36,46
2007-01-22,DEN,115,20,18,MEM,98,10,31,30,49
2007-01-22,UTA,106,27,14,MIN,91,20,19,47,33
2007-01-22,SAC,88,15,23,NJN,87,20,20,35,43
2007-01-22,LAL,108,26,15,GSW,103,19,22,45,37
2007-01-23,PHI,102,11,30,NOK,96,17,23,28,53
2007-01-23,WAS,105,24,16,PHX,127,33,8,57,24
2007-01-23,ORL,95,23,19,DAL,111,34,8,57,27
2007-01-23,CHI,94,23,19,ATL,86,13,25,36,44
2007-01-23,SEA,112,16,25,DEN,117,21,18,37,43
2007-01-23,LAC,115,19,21,MIL,96,17,24,36,45
2007-01-24,TOR,90,20,22,NOK,88,17,24,37,46
2007-01-24,CHA,92,14,26,DET,103,23,16,37,42
2007-01-24,CLE,115,24,17,PHI,118,12,30,36,47
2007-01-24,IND,96,21,20,MIA,94,19,22,40,42
2007-01-24,BOS,76,12,28,ATL,82,13,26,25,54
2007-01-24,NYK,107,18,25,PHX,112,34,8,52,33
2007-01-24,SAS,85,30,13,HOU,90,25,16,55,29
2007-01-24,UTA,130,28,14,MEM,132,10,32,38,46
2007-01-24,SAC,114,16,23,MIL,106,17,25,33,48
2007-01-24,POR,101,17,25,MIN,98,20,20,37,45
2007-01-24,GSW,110,19,23,NJN,109,20,21,39,44
2007-01-25,CHI,96,24,19,DAL,85,35,8,59,27
2007-01-25,LAC,102,20,21,NJN,101,20,22,40,43
2007-01-26,TOR,96,21,22,BOS,90,12,29,33,51
2007-01-26,PHI,97,13,30,CLE,105,24,18,37,48
2007-01-26,ORL,90,23,20,ATL,93,14,26,37,46
2007-01-26,NYK,116,18,26,MIA,96,19,23,37,49
2007-01-26,DET,96,24,16,WAS,99,24,17,48,33
2007-01-26,NOK,88,17,25,SAC,84,17,23,34,48
2007-01-26,SAS,112,30,14,MEM,96,11,32,41,46
2007-01-26,MIL,90,17,26,PHX,98,35,8,52,34
2007-01-26,HOU,99,26,16,POR,69,18,25,44,41
2007-01-26,UTA,116,28,15,DEN,111,22,18,50,33
2007-01-26,LAL,97,27,15,CHA,106,14,27,41,42
2007-01-26,SEA,102,16,26,MIN,100,20,21,36,47
2007-01-27,ATL,89,15,26,PHI,104,13,31,28,57
2007-01-27,IND,102,22,20,TOR,84,22,22,44,42
2007-01-27,MEM,132,11,33,POR,135,18,26,29,59
2007-01-27,NOK,94,18,25,UTA,83,29,15,47,40
2007-01-27,CHI,100,25,19,MIA,97,19,24,44,43
2007-01-27,DAL,106,35,9,SAC,104,17,24,52,33
2007-01-27,DEN,102,22,19,NJN,112,20,23,42,42
2007-01-27,LAC,87,21,21,MIN,101,20,22,41,43
2007-01-27,GSW,131,20,23,CHA,105,15,27,35,50
2007-01-28,CLE,100,25,18,PHX,115,36,8,61,26
2007-01-28,MIL,107,17,27,NYK,105,19,26,36,53
2007-01-28,LAL,94,27,16,SAS,96,31,14,58,30
2007-01-28,BOS,91,12,30,WAS,105,25,17,37,47
2007-01-28,DET,95,24,17,IND,87,23,20,47,37
2007-01-28,SEA,76,17,26,LAC,98,21,22,38,48
2007-01-29,ATL,93,15,27,ORL,83,23,21,38,48
2007-01-29,MEM,124,11,34,SAC,117,17,25,28,59
2007-01-29,NOK,103,19,25,POR,91,19,26,38,51
2007-01-29,MIN,121,21,22,PHX,112,37,8,58,30
2007-01-29,HOU,105,27,16,PHI,84,14,31,41,47
2007-01-29,DEN,101,22,20,CHA,105,15,28,37,48
2007-01-29,UTA,115,29,16,NJN,116,21,23,50,39
2007-01-30,WAS,104,26,17,DET,99,25,17,51,34
2007-01-30,CLE,124,25,19,GSW,97,21,23,46,42
2007-01-30,IND,103,23,21,BOS,96,12,31,35,52
2007-01-30,NYK,99,19,27,LAL,94,27,17,46,44
2007-01-30,MIA,110,19,25,MIL,80,18,27,37,52
2007-01-30,DAL,122,36,9,SEA,102,17,27,53,36
2007-01-31,TOR,119,22,23,WAS,109,27,17,49,40
2007-01-31,CHA,104,16,28,NYK,87,20,27,36,55
2007-01-31,ATL,115,16,27,GSW,94,21,24,37,51
2007-01-31,ORL,98,23,22,MIL,73,18,28,41,50
2007-01-31,BOS,98,12,32,LAL,111,27,18,39,50
2007-01-31,NJN,89,22,23,DET,113,25,18,47,41
2007-01-31,MEM,94,12,34,DAL,95,37,9,49,43
2007-01-31,NOK,78,20,25,PHI,89,14,32,34,57
2007-01-31,HOU,112,28,16,SEA,102,17,28,45,44
2007-01-31,MIN,98,22,22,SAC,100,17,26,39,48
2007-01-31,UTA,97,29,17,SAS,93,32,14,61,31
2007-01-31,POR,100,19,27,DEN,91,22,21,41,48
2007-01-31,LAC,110,22,22,CHI,98,26,19,48,41
2007-02-01,MIA,92,20,25,CLE,89,26,19,46,44
2007-02-01,PHX,103,37,9,SAS,87,32,15,69,24
2007-02-02,PHI,101,15,32,GSW,102,21,25,36,57
2007-02-02,ORL,119,24,22,NJN,86,22,24,46,46
2007-02-02,IND,95,24,21,LAL,84,28,18,52,39
2007-02-02,BOS,89,12,33,LAC,100,23,22,35,55
2007-02-02,ATL,91,17,27,TOR,103,23,23,40,50
2007-02-02,CLE,101,26,20,CHA,81,17,28,43,48
2007-02-02,DET,96,26,18,MIL,86,18,29,44,47
2007-02-02,NOK,90,20,26,MIN,83,22,23,42,49
2007-02-02,DEN,114,22,22,POR,107,20,27,42,49
2007-02-02,SEA,101,17,29,CHI,107,26,20,43,49
2007-02-03,WAS,102,27,18,LAL,118,28,19,55,37
2007-02-03,CHA,98,17,29,GSW,90,22,25,39,54
2007-02-03,ORL,86,25,22,NYK,94,20,28,45,50
2007-02-03,MEM,110,12,35,IND,116,25,21,37,56
2007-02-03,MIL,98,18,30,MIA,117,21,25,39,55
2007-02-03,HOU,74,29,16,NOK,87,21,26,50,42
2007-02-03,DAL,94,38,9,MIN,93,22,24,60,33
2007-02-03,PHX,105,38,9,UTA,108,30,17,68,26
2007-02-03,SAC,94,18,26,DEN,87,23,22,41,48
2007-02-03,POR,86,20,28,CHI,88,27,20,47,48
2007-02-04,TOR,122,24,23,LAC,110,24,22,48,45
2007-02-04,NJN,99,22,25,ATL,101,17,28,39,53
2007-02-04,CLE,78,27,20,DET,90,27,18,54,38
2007-02-05,DEN,108,14,9,PHX,113,18,6,32,15
2007-02-05,PHI,100,15,33,NJN,98,22,26,37,59
2007-02-05,WAS,118,27,19,SEA,108,17,30,44,49
2007-02-05,ATL,83,18,28,LAL,90,29,19,47,47
2007-02-05,IND,98,26,21,GSW,113,22,26,48,47
2007-02-05,MIA,113,22,25,CHA,93,18,29,40,54
2007-02-05,HOU,105,29,17,MIN,77,22,25,51,42
2007-02-05,UTA,100,31,17,CHI,95,28,20,59,37
2007-02-05,SAC,105,19,26,NOK,99,22,26,41,52
2007-02-06,NYK,102,21,28,LAC,90,24,23,45,51
2007-02-06,DET,109,28,18,BOS,102,12,34,40,52
2007-02-06,MIL,116,18,31,ORL,111,25,23,43,54
2007-02-06,MEM,90,12,36,HOU,98,30,17,42,53
2007-02-06,POR,102,20,29,PHX,109,38,10,58,39
2007-02-07,TOR,113,25,23,ORL,103,25,24,50,47
2007-02-07,PHI,92,16,33,CHA,83,18,30,34,63
2007-02-07,WAS,83,28,19,SAS,110,32,16,60,35
2007-02-07,ATL,85,18,29,NJN,87,22,27,40,56
2007-02-07,CLE,94,27,21,LAC,77,24,24,51,45
2007-02-07,IND,102,26,22,SEA,103,17,31,43,53
2007-02-07,BOS,79,12,35,MIA,91,23,25,35,60
2007-02-07,MIN,121,22,26,GSW,93,23,26,45,52
2007-02-07,DAL,113,39,9,MEM,97,12,37,51,46
2007-02-07,DEN,112,23,23,NOK,114,22,27,45,50
2007-02-08,DET,93,29,18,LAL,78,30,19,59,37
2007-02-08,NOK,109,23,27,MIL,101,19,31,42,58
2007-02-08,SAC,86,20,26,CHI,77,28,21,48,47
2007-02-09,TOR,96,26,23,LAL,92,30,20,56,43
2007-02-09,PHI,89,17,33,LAC,90,24,25,41,58
2007-02-09,CHA,100,18,31,POR,108,20,30,38,61
2007-02-09,ORL,106,25,25,SAS,104,33,16,58,41
2007-02-09,IND,95,26,23,DEN,102,23,24,49,47
2007-02-09,BOS,78,12,36,NJN,92,23,27,35,63
2007-02-09,CLE,103,28,21,MIA,79,24,25,52,46
2007-02-09,MEM,105,12,38,MIN,97,23,26,35,64
2007-02-09,DAL,95,40,9,HOU,74,31,17,71,26
2007-02-09,PHX,111,39,10,ATL,120,18,30,57,40
2007-02-09,GSW,123,23,27,CHI,121,28,22,51,49
2007-02-10,NJN,93,24,27,ORL,78,26,25,50,52
2007-02-10,DET,98,30,18,TOR,92,27,23,57,41
2007-02-10,NOK,114,24,27,MEM,99,13,38,37,65
2007-02-10,MIL,102,19,32,DEN,109,24,24,43,56
2007-02-10,HOU,104,31,18,CHA,83,18,32,49,50
2007-02-10,UTA,104,32,17,NYK,102,22,28,54,45
2007-02-10,SEA,93,18,31,SAC,114,21,26,39,57
2007-02-11,WAS,73,28,20,POR,94,21,30,49,50
2007-02-11,MIA,100,24,26,SAS,85,33,17,57,43
2007-02-11,IND,94,26,24,LAC,80,25,25,51,49
2007-02-11,CLE,99,29,21,LAL,90,30,21,59,42
2007-02-11,MIN,109,23,27,BOS,107,12,37,35,64
2007-02-11,PHI,89,17,34,DAL,106,41,9,58,43
2007-02-11,PHX,103,39,11,CHI,116,28,23,67,34
2007-02-11,GSW,105,24,27,ATL,106,19,30,43,57
2007-02-11,SAC,103,22,26,SEA,114,18,32,40,58
2007-02-12,DET,92,31,18,LAC,74,25,26,56,44
2007-02-12,DEN,123,25,24,GSW,111,24,28,49,52
2007-02-12,UTA,102,33,17,ATL,76,20,30,53,47
2007-02-13,NJN,82,25,27,SAS,107,33,18,58,45
2007-02-13,MIA,104,25,26,POR,85,22,30,47,56
2007-02-13,MIL,93,19,33,DAL,99,42,9,61,42
2007-02-13,MEM,108,13,39,NOK,104,25,27,38,66
2007-02-13,CHI,111,29,23,TOR,112,27,24,56,47
2007-02-13,HOU,109,32,18,SAC,104,22,27,54,45
2007-02-13,LAL,106,30,22,NYK,107,22,29,52,51
2007-02-14,TOR,120,28,24,NJN,109,25,28,53,52
2007-02-14,PHI,85,17,35,WAS,92,28,21,45,56
2007-02-14,CHA,100,18,33,CHI,85,29,24,47,57
2007-02-14,ORL,103,26,26,POR,91,22,31,48,57
2007-02-14,IND,114,27,24,MEM,104,14,39,41,63
2007-02-14,BOS,117,12,38,MIL,97,19,34,31,72
2007-02-14,DET,81,32,18,SAS,90,34,18,66,36
2007-02-14,NOK,110,25,28,SAC,93,22,28,47,56
2007-02-14,MIN,99,24,27,DEN,94,26,24,50,51
2007-02-14,UTA,99,34,17,CLE,98,30,21,64,38
2007-02-14,SEA,114,19,32,PHX,90,39,12,58,44
2007-02-14,LAC,93,25,27,ATL,96,20,31,45,58
2007-02-14,GSW,120,24,29,NYK,101,23,29,47,58
2007-02-15,HOU,77,33,18,DAL,80,43,9,76,27
2007-02-15,LAL,108,30,23,CLE,114,30,22,60,45
2007-02-20,WAS,112,29,21,MIN,100,25,27,54,48
2007-02-20,CHA,104,19,33,NOK,100,26,28,45,61
2007-02-20,NYK,100,23,30,ORL,94,27,26,50,56
2007-02-20,MIL,83,19,35,DET,84,32,19,51,54
2007-02-20,SAS,95,35,18,DEN,80,26,25,61,43
2007-02-20,CHI,106,29,25,ATL,81,21,31,50,56
2007-02-20,SAC,104,22,29,BOS,101,13,38,35,67
2007-02-20,POR,103,22,32,UTA,100,35,17,57,49
2007-02-20,SEA,121,20,32,MEM,105,14,40,34,72
2007-02-20,LAC,90,25,28,PHX,115,39,13,64,41
2007-02-21,TOR,85,29,24,CLE,86,31,22,60,46
2007-02-21,PHI,104,17,36,NYK,84,24,30,41,66
2007-02-21,ATL,96,21,32,SAS,103,36,18,57,50
2007-02-21,IND,136,28,24,MIL,129,19,36,47,60
2007-02-21,NJN,107,25,29,NOK,111,26,29,51,58
2007-02-21,DET,110,33,19,ORL,88,27,27,60,46
2007-02-21,MIN,95,25,28,CHA,100,20,33,45,61
2007-02-21,HOU,112,33,19,MIA,102,26,26,59,45
2007-02-21,PHX,118,40,13,BOS,108,13,39,53,52
2007-02-21,LAL,108,30,24,POR,112,23,32,53,56
2007-02-21,GSW,118,25,29,MEM,115,14,41,39,70
2007-02-22,WAS,109,30,21,SAC,106,23,29,53,50
2007-02-22,CLE,78,32,22,CHI,84,30,25,62,47
2007-02-22,DAL,112,44,9,MIA,100,26,27,70,36
2007-02-23,TOR,110,29,25,IND,88,29,24,58,49
2007-02-23,CHA,102,21,33,PHI,87,18,36,39,69
2007-02-23,ORL,89,27,28,DET,94,34,19,61,47
2007-02-23,NJN,109,25,30,SAC,96,23,30,48,60
2007-02-23,NYK,95,24,31,MIL,93,19,37,43,68
2007-02-23,ATL,105,21,33,HOU,99,34,19,55,52
2007-02-23,CHI,105,31,25,WAS,90,31,21,62,46
2007-02-23,NOK,98,27,29,SEA,97,21,32,48,61
2007-02-23,MIN,104,25,29,PHX,116,41,13,66,42
2007-02-23,POR,102,24,32,MEM,103,14,42,38,74
2007-02-23,DEN,104,26,26,UTA,114,35,18,61,44
2007-02-23,LAL,122,30,25,BOS,96,13,40,43,65
2007-02-24,LAC,103,25,29,GSW,90,26,29,51,58
2007-02-24,CHA,76,22,33,TOR,93,30,25,52,58
2007-02-24,SAS,102,37,18,SEA,71,21,33,58,51
2007-02-24,MIL,109,19,38,PHI,90,18,37,37,75
2007-02-24,DAL,115,45,9,DEN,95,26,27,71,36
2007-02-24,UTA,105,36,18,BOS,87,13,41,49,59
2007-02-25,DET,95,35,19,CHI,93,32,25,67,44
2007-02-25,ATL,106,22,33,PHX,115,42,13,64,46
2007-02-25,ORL,93,27,29,HOU,97,34,20,61,49
2007-02-25,MIA,86,26,28,CLE,81,32,23,58,51
2007-02-25,MIN,98,25,30,WAS,94,31,22,56,52
2007-02-25,NJN,101,26,30,NYK,92,25,31,51,61
2007-02-25,GSW,85,26,30,LAL,102,31,25,57,55
2007-02-25,IND,93,29,25,SAC,110,23,31,52,56
2007-02-26,PHI,89,18,38,SAC,82,24,31,42,69
2007-02-26,NYK,99,25,32,MIA,93,27,28,52,60
2007-02-26,MEM,107,15,42,DEN,111,26,28,41,70
2007-02-26,SAS,107,38,18,TOR,91,31,25,69,43
2007-02-26,CHI,87,32,26,ORL,94,27,30,59,56
2007-02-26,HOU,72,35,20,BOS,77,13,42,48,62
2007-02-26,DAL,110,46,9,ATL,87,22,34,68,43
2007-02-26,UTA,94,37,18,LAL,102,32,25,69,43
2007-02-26,SEA,97,21,34,POR,73,24,33,45,67
2007-02-26,LAC,100,26,29,CHA,93,22,34,48,63
2007-02-27,CLE,97,32,24,NOK,89,28,29,60,53
2007-02-27,IND,92,29,26,PHX,103,43,13,72,39
2007-02-27,NJN,113,27,30,WAS,101,31,23,58,53
2007-02-27,MIL,122,20,38,GSW,101,26,31,46,69
2007-02-27,MIN,65,26,30,DAL,91,47,9,73,39
2007-02-28,PHI,99,19,38,PHX,94,44,13,63,51
2007-02-28,WAS,83,31,24,MIA,92,27,29,58,53
2007-02-28,BOS,102,14,42,NYK,94,26,32,40,74
2007-02-28,MEM,88,15,43,UTA,104,37,19,52,62
2007-02-28,NOK,107,28,30,ATL,100,22,35,50,65
2007-02-28,CHI,113,32,27,GSW,83,26,32,58,59
2007-02-28,HOU,90,35,21,TOR,106,31,26,66,47
2007-02-28,DEN,111,27,28,ORL,101,28,30,55,58
2007-02-28,SAC,135,24,32,CHA,120,22,35,46,67
2007-02-28,LAC,96,27,29,SEA,91,22,34,49,63
2007-03-01,DAL,95,48,9,CLE,92,33,24,81,33
2007-03-01,POR,127,24,34,CHA,90,22,36,46,70
2007-03-01,SEA,77,22,35,LAC,75,28,29,50,64
2007-03-02,TOR,81,32,26,MIL,94,21,38,53,64
2007-03-02,PHI,117,20,38,MEM,112,15,44,35,82
2007-03-02,WAS,93,31,25,ATL,92,22,36,53,61
2007-03-02,NYK,106,26,33,GSW,97,26,33,52,66
2007-03-02,MIA,85,28,29,DET,82,36,19,64,48
2007-03-02,SAS,98,39,18,ORL,74,28,31,67,49
2007-03-02,MIN,83,26,31,UTA,109,38,19,64,50
2007-03-02,CHI,104,33,27,NOK,93,29,30,62,57
2007-03-02,DEN,97,28,28,HOU,108,35,22,63,50
2007-03-02,PHX,115,44,14,IND,90,29,27,73,41
2007-03-02,LAL,108,33,25,SAC,116,25,32,58,57
2007-03-03,NJN,88,28,30,BOS,96,15,42,43,72
2007-03-03,ATL,100,22,37,NYK,104,27,33,49,70
2007-03-03,CLE,120,33,25,TOR,97,32,27,65,52
2007-03-03,MEM,89,15,45,DET,92,36,20,51,65
2007-03-03,HOU,74,36,22,SAS,97,40,18,76,40
2007-03-03,DAL,103,49,9,ORL,98,28,32,77,41
2007-03-03,POR,96,25,34,SAC,104,26,32,51,66
2007-03-03,LAC,87,28,30,IND,64,29,28,57,58
2007-03-04,BOS,124,16,42,MIN,117,26,32,42,74
2007-03-04,WAS,107,32,25,GSW,106,26,34,58,59
2007-03-04,MIL,121,22,38,CHI,126,34,27,56,65
2007-03-04,PHX,99,45,14,LAL,94,33,26,78,40
2007-03-04,NOK,94,29,31,UTA,108,39,19,68,50
2007-03-04,PHI,99,21,38,NJN,86,28,31,49,69
2007-03-04,SEA,96,23,35,CHA,89,22,37,45,72
2007-03-05,ORL,99,28,33,MIL,81,22,39,50,72
2007-03-05,CLE,91,34,25,HOU,85,36,23,70,48
2007-03-05,MIA,88,29,29,ATL,81,22,38,51,67
2007-03-05,DET,93,37,20,GSW,111,26,35,63,55
2007-03-05,UTA,120,40,19,CHA,95,22,38,62,57
2007-03-05,LAC,74,29,30,SAS,88,41,18,70,48
2007-03-06,WAS,129,33,25,TOR,109,32,28,65,53
2007-03-06,NYK,99,28,33,SEA,100,24,35,52,68
2007-03-06,MIN,117,26,33,LAL,107,33,27,59,60
2007-03-06,DAL,102,50,9,NJN,89,28,32,78,41
2007-03-06,DEN,106,28,29,NOK,91,29,32,57,61
2007-03-06,SAC,102,27,32,IND,98,29,29,56,61
2007-03-06,POR,94,25,35,SAS,99,42,18,67,53
2007-03-07,TOR,94,32,29,MEM,87,15,46,47,75
2007-03-07,PHI,92,22,38,SEA,89,25,35,47,73
2007-03-07,ATL,100,22,39,WAS,97,34,25,56,64
2007-03-07,BOS,80,17,42,HOU,111,36,24,53,66
2007-03-07,MIA,103,30,29,CHI,70,35,27,65,56
2007-03-07,DET,97,37,21,CLE,101,35,25,72,46
2007-03-07,MIL,110,22,40,LAL,90,33,28,55,68
2007-03-07,UTA,94,41,19,IND,72,29,30,70,49
2007-03-07,PHX,115,46,14,CHA,106,22,39,68,53
2007-03-07,GSW,110,27,35,DEN,96,29,29,56,64
2007-03-08,ORL,76,29,33,CHI,100,35,28,64,61
2007-03-08,SAC,93,28,32,SAS,100,43,18,71,50
2007-03-09,PHI,108,23,38,LAL,92,33,29,56,67
2007-03-09,BOS,118,17,43,SEA,103,25,36,42,79
2007-03-09,ATL,106,23,39,MEM,105,15,47,38,86
2007-03-09,MIA,105,31,29,MIN,91,27,33,58,62
2007-03-09,HOU,112,37,24,NJN,91,28,33,65,57
2007-03-09,DEN,82,29,30,DET,95,37,22,66,52
2007-03-09,PHX,104,47,14,NOK,103,29,33,76,47
2007-03-09,GSW,99,28,35,LAC,89,29,31,57,66
2007-03-10,WAS,89,34,26,NYK,90,28,34,62,60
2007-03-10,CHA,107,22,40,MEM,115,15,48,37,88
2007-03-10,ATL,99,24,39,MIN,93,27,34,51,73
2007-03-10,IND,96,29,31,PHI,100,24,38,53,69
2007-03-10,SAS,93,44,18,NJN,77,28,34,72,52
2007-03-10,MIL,92,23,40,CLE,94,36,25,59,65
2007-03-10,UTA,96,42,19,NOK,86,29,34,71,53
2007-03-11,TOR,120,33,29,SEA,119,25,37,58,66
2007-03-11,LAC,80,29,32,DET,98,38,22,67,54
2007-03-11,BOS,78,18,43,CHI,94,36,28,54,71
2007-03-11,HOU,103,38,24,ORL,92,29,34,67,58
2007-03-11,SAC,101,28,33,DEN,113,29,31,57,64
2007-03-11,MIA,106,32,29,WAS,104,34,27,66,56
2007-03-11,CLE,99,37,25,IND,88,29,32,66,57
2007-03-11,LAL,72,33,30,DAL,108,51,9,84,39
2007-03-11,POR,106,25,36,GSW,87,29,35,54,71
2007-03-12,CHA,119,22,41,ORL,108,29,35,51,76
2007-03-12,MIL,93,23,41,TOR,108,34,29,57,70
2007-03-12,MEM,102,16,48,NJN,113,28,35,44,83
2007-03-12,PHX,103,48,14,HOU,82,39,24,87,38
2007-03-12,GSW,117,29,36,DAL,100,52,9,81,45
2007-03-13,ATL,104,25,39,PHI,92,25,38,50,77
2007-03-13,CLE,124,38,25,SAC,100,28,34,66,59
2007-03-13,MIA,88,33,29,UTA,86,43,19,76,48
2007-03-13,NOK,108,29,35,NJN,112,29,35,58,70
2007-03-13,SAS,93,45,18,LAC,84,29,33,74,51
2007-03-13,MIN,86,27,35,IND,81,29,33,56,68
2007-03-13,CHI,95,37,28,BOS,87,18,44,55,72
2007-03-13,DEN,107,30,31,POR,99,26,36,56,67
2007-03-13,SEA,97,25,38,DET,101,39,22,64,60
2007-03-14,TOR,104,35,29,NYK,94,29,34,64,63
2007-03-14,PHI,87,25,39,CHI,88,38,28,63,67
2007-03-14,CHA,111,23,41,SAC,108,28,35,51,76
2007-03-14,ORL,101,29,36,UTA,90,43,20,72,56
2007-03-14,IND,96,29,34,WAS,112,34,28,63,62
2007-03-14,BOS,109,18,45,ATL,88,26,39,44,84
2007-03-14,MEM,96,16,49,CLE,118,39,25,55,74
2007-03-14,HOU,109,39,25,LAC,105,29,34,68,59
2007-03-14,DAL,127,52,10,PHX,129,49,14,101,24
2007-03-14,POR,75,26,37,DET,87,40,22,66,59
2007-03-15,NJN,86,30,35,MIA,93,34,29,64,64
2007-03-15,MIL,101,23,42,SAS,90,46,18,69,60
2007-03-15,DEN,113,31,31,LAL,86,33,31,64,62
2007-03-16,TOR,100,36,29,HOU,114,40,25,76,54
2007-03-16,PHI,89,25,40,UTA,88,43,21,68,61
2007-03-16,CHA,93,24,41,LAC,102,29,35,53,76
2007-03-16,NYK,90,29,35,NOK,92,29,36,58,71
2007-03-16,MIA,103,35,29,SAC,97,28,36,63,65
2007-03-16,DAL,106,52,11,BOS,101,19,45,71,56
2007-03-16,PHX,83,50,14,DET,105,41,22,91,36
2007-03-16,LAL,116,33,32,POR,111,26,38,59,70
2007-03-16,GSW,106,30,36,MIN,86,28,35,58,71
2007-03-17,WAS,125,35,28,NOK,103,30,36,65,64
2007-03-17,ORL,83,30,36,SAC,95,28,37,58,73
2007-03-17,IND,113,29,35,ATL,90,26,40,55,75
2007-03-17,CLE,82,40,25,UTA,73,43,22,83,47
2007-03-17,MEM,104,16,50,CHI,103,39,28,55,78
2007-03-17,SAS,85,46,19,BOS,91,19,46,65,65
2007-03-17,MIL,97,24,42,CHA,91,24,42,48,84
2007-03-17,DEN,131,32,31,PHX,107,50,15,82,46
2007-03-17,SEA,98,25,39,GSW,99,31,36,56,75
2007-03-18,NYK,92,29,36,TOR,74,36,30,65,66
2007-03-18,DET,88,42,22,DAL,92,53,11,95,33
2007-03-18,NJN,101,30,36,LAC,95,30,35,60,71
2007-03-18,MIA,83,36,29,ORL,97,30,37,66,66
2007-03-18,PHI,74,26,40,HOU,124,41,25,67,65
2007-03-18,POR,77,26,39,SEA,95,25,40,51,79
2007-03-18,LAL,109,34,32,MIN,102,28,36,62,68
2007-03-19,ATL,99,26,41,SAC,76,29,37,55,78
2007-03-19,NOK,106,30,37,BOS,88,20,46,50,83
2007-03-20,NJN,90,31,36,DEN,94,33,31,64,67
2007-03-20,CHA,108,24,43,CLE,100,41,25,65,68
2007-03-20,NYK,77,30,36,DAL,92,54,11,84,47
2007-03-20,DET,96,42,23,PHI,75,26,41,68,64
2007-03-20,MEM,103,17,50,NOK,114,31,37,48,87
2007-03-20,CHI,89,39,29,LAC,103,30,36,69,65
2007-03-20,UTA,104,43,23,GSW,100,32,36,75,59
2007-03-20,HOU,86,42,25,IND,76,30,35,72,60
2007-03-20,PHX,108,50,16,MIN,90,28,37,78,53
2007-03-20,POR,100,26,40,WAS,98,36,28,62,68
2007-03-21,TOR,92,36,31,ORL,85,31,37,67,68
2007-03-21,ATL,83,27,41,MIA,91,36,30,63,71
2007-03-21,BOS,84,20,47,CHA,92,25,43,45,90
2007-03-21,CLE,90,41,26,DAL,98,55,11,96,37
2007-03-21,MIL,103,25,42,LAC,104,31,36,56,78
2007-03-21,SAS,90,46,20,IND,72,30,36,76,56
2007-03-21,SAC,89,29,38,MIN,95,28,38,57,76
2007-03-21,SEA,106,26,40,WAS,108,36,29,62,69
2007-03-22,NYK,86,30,37,POR,92,27,40,57,77
2007-03-22,MEM,119,17,51,LAL,121,35,32,52,83
2007-03-22,CHI,109,39,30,DEN,108,34,31,73,61
2007-03-22,HOU,91,43,25,DET,85,43,23,86,48
2007-03-22,PHX,118,51,16,SAC,100,29,39,80,55
2007-03-23,TOR,121,37,31,DEN,94,34,32,71,63
2007-03-23,PHI,106,26,42,CHA,97,26,43,52,85
2007-03-23,ORL,90,31,38,NJN,82,31,37,62,75
2007-03-23,IND,95,30,37,MIA,70,37,30,67,67
2007-03-23,BOS,95,20,48,DAL,109,56,11,76,59
2007-03-23,ATL,100,27,42,POR,102,28,40,55,82
2007-03-23,CLE,90,41,27,NYK,68,30,38,71,65
2007-03-23,NOK,105,32,37,LAL,111,36,32,68,69
2007-03-23,SAS,90,47,20,DET,89,43,24,90,44
2007-03-23,LAC,104,32,36,UTA,72,44,23,76,59
2007-03-23,GSW,135,32,37,WAS,128,37,29,69,66
2007-03-23,SEA,85,26,41,MIN,82,29,38,55,79
2007-03-24,CHA,107,26,44,NJN,113,31,38,57,82
2007-03-24,MIA,85,37,31,PHI,93,27,42,64,73
2007-03-24,UTA,118,44,24,MEM,108,17,52,61,76
2007-03-24,LAC,111,33,36,WAS,105,37,30,70,66
2007-03-25,ATL,97,27,43,DAL,104,57,11,84,54
2007-03-25,IND,90,31,37,CHI,92,40,30,71,67
2007-03-25,MIL,95,25,43,DET,121,43,25,68,68
2007-03-25,NOK,106,32,38,HOU,94,44,25,76,63
2007-03-25,MIN,94,29,39,POR,93,29,40,58,79
2007-03-25,SAC,107,29,40,PHX,100,52,16,81,56
2007-03-25,CLE,93,42,27,DEN,105,34,33,76,60
2007-03-25,SEA,79,27,41,SAS,120,48,20,75,61
2007-03-25,LAL,115,37,32,GSW,113,33,37,70,69
2007-03-26,BOS,95,20,49,TOR,87,38,31,58,80
2007-03-26,NYK,89,30,39,ORL,94,32,38,62,77
2007-03-26,MIA,106,37,32,ATL,89,27,44,64,76
2007-03-26,DET,113,44,25,DEN,109,35,33,79,58
2007-03-26,CHI,100,41,30,POR,89,29,41,70,71
2007-03-26,HOU,106,44,26,MIL,87,25,44,69,70
2007-03-26,UTA,103,45,24,WAS,97,37,31,82,55
2007-03-26,PHX,105,52,17,MEM,87,17,53,69,70
2007-03-26,GSW,89,33,38,SAS,126,49,20,82,58
2007-03-27,IND,94,31,38,CLE,105,42,28,73,66
2007-03-27,NOK,89,33,38,DAL,105,58,11,91,49
2007-03-27,MIN,106,30,39,SEA,114,27,42,57,81
2007-03-27,LAL,86,38,32,MEM,88,17,54,55,86
2007-03-28,TOR,96,38,32,MIA,83,38,32,76,64
2007-03-28,WAS,111,37,32,PHI,108,28,42,65,74
2007-03-28,CHA,101,26,45,ATL,87,27,45,53,90
2007-03-28,BOS,105,21,49,ORL,96,33,38,54,87
2007-03-28,NJN,118,32,38,IND,94,31,39,63,77
2007-03-28,NYK,97,30,40,CLE,93,43,28,73,68
2007-03-28,SAS,92,50,20,NOK,88,33,39,83,59
2007-03-28,DAL,105,59,11,MIL,103,25,45,84,56
2007-03-28,DEN,97,35,34,SEA,100,28,42,63,76
2007-03-28,UTA,108,46,24,MIN,102,30,40,76,64
2007-03-28,LAC,87,34,36,HOU,92,45,26,79,62
2007-03-29,CHI,83,42,30,DET,81,45,25,87,55
2007-03-29,POR,92,29,42,MEM,96,18,54,47,96
2007-03-29,GSW,124,33,39,PHX,119,53,17,86,56
2007-03-30,PHI,88,28,43,BOS,82,22,49,50,92
2007-03-30,WAS,118,38,32,TOR,123,39,32,77,64
2007-03-30,CHA,97,27,45,MIL,81,25,46,52,91
2007-03-30,ORL,95,33,39,IND,87,31,40,64,79
2007-03-30,DET,110,45,26,NJN,105,33,38,78,64
2007-03-30,SAS,102,51,20,UTA,93,47,24,98,44
2007-03-30,MIN,77,30,41,MIA,92,38,33,68,74
2007-03-30,DAL,105,60,11,NYK,103,31,40,91,51
2007-03-30,PHX,125,53,18,DEN,108,35,35,88,53
2007-03-30,LAL,104,38,33,HOU,107,46,26,84,59
2007-03-30,SAC,101,30,40,LAC,105,34,37,64,77
2007-03-30,SEA,120,29,42,MEM,93,19,54,48,96
2007-03-31,CHI,108,43,30,CLE,112,43,29,86,59
2007-03-31,NJN,86,33,39,PHI,82,29,43,62,82
2007-03-31,NOK,103,33,40,NYK,94,31,41,64,81
2007-03-31,POR,86,29,43,LAC,99,35,37,64,80
2007-04-01,DET,94,46,26,MIA,88,39,33,85,59
2007-04-01,ATL,97,27,46,CHI,105,43,31,70,77
2007-04-01,IND,100,31,41,SAS,99,52,20,83,61
2007-04-01,MIL,107,25,47,WAS,121,38,33,63,80
2007-04-01,PHX,126,54,18,DAL,104,61,11,115,29
2007-04-01,GSW,122,34,39,MEM,117,19,55,53,94
2007-04-01,BOS,98,22,50,CLE,96,44,29,66,79
2007-04-01,TOR,107,40,32,CHA,94,28,45,68,77
2007-04-01,ORL,104,34,39,MIN,105,30,42,64,81
2007-04-01,HOU,83,47,26,UTA,86,47,25,94,51
2007-04-01,SEA,103,30,42,DEN,114,35,36,65,78
2007-04-01,LAL,126,38,34,SAC,103,30,41,68,75
2007-04-03,MIL,101,16,20,NOK,119,14,22,30,42
2007-04-03,CHA,122,28,46,WAS,102,39,33,67,79
2007-04-03,IND,85,32,41,DET,100,47,26,79,67
2007-04-03,MIA,92,39,34,TOR,89,41,32,80,66
2007-04-03,MEM,111,19,56,PHX,116,55,18,74,74
2007-04-03,SAS,110,52,21,SEA,91,30,43,82,64
2007-04-03,MIN,88,31,42,CLE,101,44,30,75,72
2007-04-03,SAC,93,30,42,DAL,97,61,12,91,54
2007-04-03,LAL,105,39,34,DEN,111,36,36,75,70
2007-04-04,WAS,100,39,34,CHA,108,29,46,68,80
2007-04-04,ORL,108,34,40,TOR,111,41,33,75,73
2007-04-04,NJN,101,34,39,ATL,86,27,47,61,86
2007-04-04,NYK,90,31,42,PHI,92,29,44,60,86
2007-04-04,DET,88,48,26,CHI,106,44,31,92,57
2007-04-04,MIL,98,25,48,BOS,89,23,50,48,98
2007-04-04,NOK,101,34,40,SEA,92,30,44,64,84
2007-04-04,HOU,99,47,27,GSW,110,35,39,82,66
2007-04-04,DEN,120,37,36,SAC,115,30,43,67,79
2007-04-04,POR,94,29,44,UTA,89,48,25,77,69
2007-04-04,LAC,90,36,37,LAL,82,39,35,75,72
2007-04-05,CLE,90,45,30,MIA,94,40,34,85,64
2007-04-05,SAS,92,53,21,PHX,85,56,18,109,39
2007-04-06,PHI,85,30,44,TOR,94,42,33,72,77
2007-04-06,CHA,102,30,46,IND,112,32,42,62,88
2007-04-06,BOS,85,23,51,MIA,88,41,34,64,85
2007-04-06,NYK,94,31,43,MIN,99,31,43,62,86
2007-04-06,ATL,115,27,48,MIL,102,26,48,53,96
2007-04-06,WAS,94,39,35,CLE,99,45,31,84,66
2007-04-06,MEM,104,19,57,GSW,116,36,39,55,96
2007-04-06,NOK,95,35,40,PHX,103,56,19,91,59
2007-04-06,CHI,105,45,31,NJN,74,35,39,80,70
2007-04-06,HOU,78,47,28,POR,85,30,44,77,72
2007-04-06,SAC,107,30,44,UTA,103,48,26,78,70
2007-04-06,DEN,75,38,36,DAL,71,62,12,100,48
2007-04-06,SEA,109,30,45,LAL,112,39,36,69,81
2007-04-07,ORL,116,34,41,MEM,89,19,58,53,99
2007-04-07,IND,105,33,42,BOS,98,23,52,56,94
2007-04-07,NJN,120,35,40,WAS,114,39,36,74,76
2007-04-07,SAS,112,54,21,GSW,99,37,39,91,60
2007-04-07,MIN,94,32,43,NOK,96,35,41,67,84
2007-04-07,MIL,113,26,49,NYK,118,31,44,57,93
2007-04-07,DAL,86,62,13,POR,74,31,44,93,57
2007-04-07,UTA,103,48,27,SEA,106,30,46,78,73
2007-04-07,LAC,93,37,37,DEN,96,39,36,76,73
2007-04-08,DET,87,48,27,CLE,82,46,31,94,58
2007-04-08,LAL,107,40,36,PHX,115,57,19,97,55
2007-04-08,TOR,103,43,33,CHI,89,46,31,89,64
2007-04-08,MIA,103,42,34,CHA,111,30,47,72,81
2007-04-08,PHI,109,30,45,ATL,104,28,48,58,93
2007-04-08,SAC,106,31,44,HOU,112,47,29,78,73
2007-04-09,NYK,83,32,44,DET,91,49,27,81,71
2007-04-09,MIL,94,26,50,ORL,117,35,41,61,91
2007-04-09,SAS,112,55,21,POR,96,31,45,86,66
2007-04-09,MIN,100,32,44,TOR,111,44,33,76,77
2007-04-09,DAL,96,63,13,LAC,86,37,38,100,51
2007-04-09,DEN,115,40,36,LAL,111,40,37,80,73
2007-04-09,SEA,90,31,46,HOU,95,48,29,79,75
2007-04-09,GSW,126,37,40,UTA,102,48,28,85,68
2007-04-10,PHI,90,31,45,IND,86,34,42,65,87
2007-04-10,WAS,92,39,37,NJN,96,36,40,75,77
2007-04-10,CHA,92,31,47,MIA,82,42,35,73,82
2007-04-10,ATL,104,28,49,BOS,96,23,53,51,102
2007-04-10,MEM,100,19,59,SAC,112,31,45,50,104
2007-04-10,NOK,103,36,41,LAC,100,37,39,73,80
2007-04-10,CHI,98,46,32,NYK,69,32,45,78,77
2007-04-11,BOS,94,23,54,PHI,102,32,45,55,99
2007-04-11,MIA,85,42,36,WAS,82,39,38,81,74
2007-04-11,DET,104,50,27,ORL,99,36,41,86,68
2007-04-11,MIL,98,26,51,IND,104,34,43,60,94
2007-04-11,SAS,109,56,21,SAC,100,32,45,88,66
2007-04-11,MIN,88,32,45,DAL,105,64,13,96,58
2007-04-11,UTA,106,48,29,DEN,115,41,36,89,65
2007-04-11,PHX,109,58,19,SEA,91,31,47,89,66
2007-04-11,POR,95,31,46,HOU,99,49,29,80,75
2007-04-12,CLE,94,46,32,NJN,76,37,40,83,72
2007-04-12,LAL,110,40,38,LAC,118,37,40,77,78
2007-04-13,TOR,87,45,33,DET,84,51,27,96,60
2007-04-13,BOS,102,23,55,MIL,104,26,52,49,107
2007-04-13,NJN,100,37,41,NYK,86,32,46,69,87
2007-04-13,ATL,85,29,49,WAS,98,39,39,68,88
2007-04-13,MIA,100,43,36,IND,96,35,43,78,79
2007-04-13,NOK,105,37,41,DEN,107,42,36,79,77
2007-04-13,MIN,91,32,46,SAS,110,57,21,89,67
2007-04-13,CHI,100,47,32,CHA,81,32,47,79,79
2007-04-13,DAL,89,65,13,UTA,104,48,30,113,43
2007-04-13,SAC,108,32,46,GSW,125,38,40,70,86
2007-04-13,PHX,93,59,19,LAL,85,40,39,99,58
2007-04-13,LAC,107,38,40,POR,89,31,47,69,87
2007-04-14,PHI,87,33,45,ORL,104,36,42,69,87
2007-04-14,CLE,110,47,32,ATL,76,29,50,76,82
2007-04-14,MEM,133,19,60,DEN,118,43,36,62,96
2007-04-14,MIL,92,27,52,CHA,113,32,48,59,100
2007-04-14,HOU,123,50,29,NOK,112,37,42,87,71
2007-04-14,UTA,98,49,30,PHX,126,60,19,109,49
2007-04-14,POR,108,31,48,SEA,102,31,48,62,96
2007-04-15,DAL,91,65,14,SAS,86,58,21,123,35
2007-04-15,WAS,68,40,39,CHI,101,48,32,88,71
2007-04-15,IND,107,35,44,NJN,111,38,41,73,85
2007-04-15,LAC,100,39,40,SAC,105,32,47,71,87
2007-04-15,GSW,121,39,40,MIN,108,32,47,71,87
2007-04-15,TOR,107,46,33,NYK,105,32,47,78,80
2007-04-15,ORL,88,37,42,BOS,86,23,56,60,98
2007-04-15,DET,91,51,28,PHI,102,33,46,84,74
2007-04-15,LAL,109,40,40,SEA,98,31,49,71,89
2007-04-16,NYK,95,32,48,NJN,104,39,41,71,89
2007-04-16,MIA,89,44,36,BOS,91,23,57,67,93
2007-04-16,MIL,102,27,53,ATL,96,29,51,56,104
2007-04-16,MEM,101,20,60,SAS,91,58,22,78,82
2007-04-16,HOU,120,51,29,PHX,117,61,19,112,48
2007-04-16,DEN,122,43,37,MIN,107,32,48,75,85
2007-04-16,UTA,130,49,31,POR,93,32,48,81,79
2007-04-16,SAC,118,33,47,NOK,125,37,43,70,90
2007-04-17,PHI,92,34,46,CLE,98,48,32,82,78
2007-04-17,WAS,89,40,40,ORL,95,38,42,78,82
2007-04-17,ATL,118,29,52,IND,102,35,45,64,97
2007-04-17,DET,100,51,29,TOR,84,47,33,98,62
2007-04-17,PHX,99,61,20,LAC,103,39,41,100,61
2007-04-17,GSW,111,40,40,DAL,82,66,14,106,54
2007-04-18,TOR,119,47,34,PHI,122,34,47,81,81
2007-04-18,CHA,93,33,48,NYK,94,32,49,65,97
2007-04-18,ORL,94,39,42,MIA,68,44,37,83,79
2007-04-18,CLE,109,49,32,MIL,96,28,53,77,85
2007-04-18,BOS,89,24,57,DET,91,52,29,76,86
2007-04-18,NJN,106,40,41,CHI,97,49,32,89,73
2007-04-18,IND,95,35,46,WAS,98,40,41,75,87
2007-04-18,SAS,77,58,23,DEN,100,44,37,102,60
2007-04-18,MIN,94,32,49,MEM,116,21,60,53,109
2007-04-18,UTA,101,50,31,HOU,91,52,29,102,60
2007-04-18,SAC,106,33,48,LAL,117,41,40,74,88
2007-04-18,POR,98,32,49,GSW,120,41,40,73,89
2007-04-18,SEA,75,31,50,DAL,106,66,15,97,65
2007-10-30,SAS,106,0,0,POR,97,0,0,0,0
2007-10-30,LAL,93,0,0,HOU,95,0,0,0,0
2007-10-30,GSW,96,0,0,UTA,117,0,0,0,0
2007-10-31,TOR,106,0,0,PHI,97,0,0,0,0
2007-10-31,ORL,102,0,0,MIL,83,0,0,0,0
2007-10-31,IND,119,0,0,WAS,110,0,0,0,0
2007-10-31,NJN,112,0,0,CHI,103,0,0,0,0
2007-10-31,CLE,74,0,0,DAL,92,0,0,0,0
2007-10-31,MEM,101,0,0,SAS,104,1,0,1,0
2007-10-31,NOH,104,0,0,SAC,90,0,0,0,0
2007-10-31,DEN,120,0,0,SEA,103,0,0,0,0
2007-11-01,MIA,80,0,0,DET,91,0,0,0,0
2007-11-01,UTA,95,1,0,HOU,106,1,0,2,0
2007-11-01,SEA,99,0,1,PHX,106,0,0,0,1
2007-11-02,CHA,102,0,0,MIL,99,0,1,0,1
2007-11-02,ORL,92,1,0,DET,116,1,0,2,0
2007-11-02,IND,87,1,0,MIA,85,0,1,1,1
2007-11-02,NJN,69,1,0,TOR,106,1,0,2,0
2007-11-02,ATL,101,0,0,DAL,94,1,0,1,0
2007-11-02,CLE,110,0,1,NYK,106,0,0,0,1
2007-11-02,BOS,103,0,0,WAS,83,0,1,0,1
2007-11-02,NOH,113,1,0,POR,93,0,1,1,1
2007-11-02,MIN,91,0,0,DEN,99,1,0,1,0
2007-11-02,CHI,85,0,1,PHI,96,0,1,0,2
2007-11-02,SAS,96,2,0,SAC,80,0,1,2,1
2007-11-02,PHX,98,1,0,LAL,119,0,1,1,1
2007-11-02,LAC,120,0,0,GSW,114,0,1,0,1
2007-11-03,PHI,88,1,1,NJN,93,1,1,2,2
2007-11-03,WAS,82,0,2,ORL,94,1,1,1,3
2007-11-03,MEM,111,0,1,IND,121,2,0,2,1
2007-11-03,MIL,78,0,2,CHI,72,0,2,0,4
2007-11-03,HOU,89,2,0,POR,80,0,2,2,2
2007-11-03,DAL,123,1,1,SAC,102,0,2,1,3
2007-11-03,UTA,133,1,1,GSW,110,0,2,1,3
2007-11-04,TOR,95,2,0,BOS,98,1,0,3,0
2007-11-04,LAC,115,1,0,SEA,101,0,2,1,2
2007-11-04,NYK,97,0,1,MIN,93,0,1,0,2
2007-11-04,MIA,88,0,2,CHA,90,1,0,1,2
2007-11-04,DET,92,2,0,ATL,91,1,0,3,0
2007-11-04,DEN,88,2,0,NOH,93,2,0,4,0
2007-11-04,PHX,103,1,1,CLE,92,1,1,2,2
2007-11-04,LAL,119,1,1,UTA,109,2,1,3,2
2007-11-05,DAL,107,2,1,HOU,98,3,0,5,1
2007-11-06,CHA,83,2,0,PHX,115,2,1,4,1
2007-11-06,NJN,87,2,1,ATL,82,1,1,3,2
2007-11-06,NYK,119,1,1,DEN,112,2,1,3,2
2007-11-06,MIL,112,1,2,TOR,85,2,1,3,3
2007-11-06,MIN,103,0,2,ORL,111,2,1,2,3
2007-11-06,CHI,91,0,3,LAC,97,2,0,2,3
2007-11-06,HOU,89,3,1,SAS,81,3,0,6,1
2007-11-06,SAC,104,0,3,SEA,98,0,3,0,6
2007-11-06,LAL,104,2,1,NOH,118,3,0,5,1
2007-11-06,GSW,104,0,3,CLE,108,1,2,1,5
2007-11-07,TOR,96,2,2,ORL,105,3,1,5,3
2007-11-07,PHI,94,1,2,CHA,63,2,1,3,3
2007-11-07,ATL,105,1,2,PHX,96,3,1,4,3
2007-11-07,IND,89,3,0,LAC,104,3,0,6,0
2007-11-07,BOS,119,2,0,DEN,93,2,2,4,2
2007-11-07,SAS,88,3,1,MIA,78,0,3,3,4
2007-11-07,UTA,103,2,2,CLE,101,2,2,4,4
2007-11-07,SEA,98,0,4,MEM,105,0,2,0,6
2007-11-07,POR,93,0,3,NOH,90,4,0,4,3
2007-11-08,NJN,87,3,1,WAS,85,0,3,3,4
2007-11-08,CHI,97,0,4,DET,93,3,0,3,4
2007-11-08,GSW,115,0,4,DAL,120,3,1,3,5
2007-11-09,PHI,103,2,2,TOR,105,2,3,4,5
2007-11-09,CHA,96,2,2,IND,87,3,1,5,3
2007-11-09,BOS,106,3,0,ATL,83,2,2,5,2
2007-11-09,NYK,102,2,1,ORL,112,4,1,6,2
2007-11-09,MIA,101,0,4,PHX,106,3,2,3,6
2007-11-09,WAS,92,0,4,DEN,118,2,3,2,7
2007-11-09,DET,103,3,1,LAC,79,4,0,7,1
2007-11-09,NOH,85,4,1,SAS,97,4,1,8,2
2007-11-09,HOU,104,4,1,MIL,88,2,2,6,3
2007-11-09,POR,110,1,3,MEM,98,1,2,2,5
2007-11-09,LAL,107,2,2,MIN,93,0,3,2,5
2007-11-09,SAC,91,1,3,CLE,93,2,3,3,6
2007-11-09,SEA,101,0,5,UTA,103,3,2,3,7
2007-11-10,ORL,96,5,1,PHX,106,4,2,9,3
2007-11-10,IND,106,3,2,DEN,113,3,3,6,5
2007-11-10,NJN,101,4,1,BOS,112,4,0,8,1
2007-11-10,CHI,71,1,4,TOR,101,3,3,4,7
2007-11-10,UTA,118,4,2,MEM,94,1,3,5,5
2007-11-10,SAC,100,1,4,MIN,93,0,4,1,8
2007-11-10,POR,91,2,3,DAL,82,4,1,6,4
2007-11-11,ATL,90,2,3,WAS,101,0,5,2,8
2007-11-11,NYK,72,2,2,MIA,75,0,5,2,7
2007-11-11,PHI,72,2,3,NOH,93,4,2,6,5
2007-11-11,CHA,82,3,2,HOU,85,5,1,8,3
2007-11-11,SAS,113,5,1,MIL,88,2,3,7,4
2007-11-11,SEA,103,0,6,DET,107,4,1,4,7
2007-11-11,LAC,95,4,1,CLE,103,3,3,7,4
2007-11-12,NJN,82,4,2,NOH,84,5,2,9,4
2007-11-12,DEN,122,4,3,CLE,100,4,3,8,6
2007-11-12,UTA,117,5,2,SAC,93,2,4,7,6
2007-11-13,CHA,91,3,3,MIA,76,1,5,4,8
2007-11-13,ORL,103,5,2,SEA,76,0,7,5,9
2007-11-13,IND,86,3,3,BOS,101,5,0,8,3
2007-11-13,MEM,105,1,4,HOU,99,6,1,7,5
2007-11-13,DAL,99,4,2,PHI,84,2,4,6,6
2007-11-13,SAS,107,6,1,LAL,92,3,2,9,3
2007-11-13,PHX,113,5,2,NYK,102,2,3,7,5
2007-11-13,POR,102,3,3,DET,94,5,1,8,4
2007-11-14,TOR,88,4,3,UTA,92,6,2,10,5
2007-11-14,WAS,103,1,5,IND,90,3,4,4,9
2007-11-14,ATL,117,2,4,CHA,109,4,3,6,7
2007-11-14,CLE,116,4,4,ORL,117,6,2,10,6
2007-11-14,BOS,91,6,0,NJN,69,4,3,10,3
2007-11-14,MIA,95,1,6,SEA,104,0,8,1,14
2007-11-14,MIL,102,2,4,MEM,99,2,4,4,8
2007-11-14,NOH,95,6,2,PHI,76,2,5,8,7
2007-11-14,MIN,108,0,5,SAC,103,2,5,2,10
2007-11-14,HOU,90,6,2,LAL,93,3,3,9,5
2007-11-14,DEN,110,5,3,POR,93,4,3,9,6
2007-11-14,LAC,84,4,2,NYK,81,2,4,6,6
2007-11-14,GSW,104,0,5,DET,111,5,2,5,7
2007-11-15,DAL,105,5,2,SAS,92,7,1,12,3
2007-11-15,PHX,112,6,2,CHI,102,1,5,7,7
2007-11-16,TOR,110,4,4,IND,101,3,5,7,9
2007-11-16,PHI,92,2,6,POR,88,4,4,6,10
2007-11-16,BOS,92,7,0,MIA,91,1,7,8,7
2007-11-16,NJN,70,4,4,ORL,95,7,2,11,6
2007-11-16,ATL,123,3,4,SEA,126,1,8,4,12
2007-11-16,CLE,99,4,5,UTA,94,7,2,11,7
2007-11-16,MEM,118,2,5,NOH,120,7,2,9,7
2007-11-16,SAS,90,7,2,HOU,84,6,3,13,5
2007-11-16,MIN,89,1,5,WAS,105,2,5,3,10
2007-11-16,SAC,123,2,6,NYK,118,2,5,4,11
2007-11-16,LAL,103,4,3,DET,91,6,2,10,5
2007-11-16,GSW,122,0,6,LAC,105,5,2,5,8
2007-11-17,WAS,109,3,5,POR,90,4,5,7,10
2007-11-17,CHA,100,4,4,SEA,84,2,8,6,12
2007-11-17,IND,117,3,6,UTA,97,7,3,10,9
2007-11-17,NJN,87,4,5,MIA,91,1,8,5,13
2007-11-17,MIN,82,1,6,NOH,100,8,2,9,8
2007-11-17,MIL,105,3,4,ATL,96,3,5,6,9
2007-11-17,HOU,105,6,4,PHX,115,7,2,13,6
2007-11-17,DAL,108,6,2,MEM,105,2,6,8,8
2007-11-17,DEN,115,6,3,NYK,83,2,6,8,9
2007-11-17,LAC,73,5,3,CHI,92,1,6,6,9
2007-11-18,TOR,100,5,4,GSW,106,1,6,6,10
2007-11-18,ORL,104,8,2,BOS,102,8,0,16,2
2007-11-18,SAC,105,3,6,DET,95,6,3,9,9
2007-11-18,LAL,106,5,3,CHI,78,2,6,7,9
2007-11-19,CHA,101,5,4,POR,92,4,6,9,10
2007-11-19,MEM,125,2,7,SEA,108,2,9,4,16
2007-11-19,NOH,88,9,2,ORL,95,9,2,18,4
2007-11-19,UTA,102,7,4,NJN,75,4,6,11,10
2007-11-20,WAS,116,4,5,PHI,101,3,6,7,11
2007-11-20,ATL,83,3,6,SAS,95,8,2,11,8
2007-11-20,CLE,107,5,5,MIL,111,4,4,9,9
2007-11-20,IND,114,4,6,LAL,134,6,3,10,9
2007-11-20,NYK,82,2,7,GSW,108,2,6,4,13
2007-11-20,DAL,105,7,2,TOR,99,5,5,12,7
2007-11-20,DEN,112,7,3,CHI,91,2,7,9,10
2007-11-20,SAC,98,4,6,PHX,100,8,2,12,8
2007-11-21,CHA,111,6,4,WAS,114,5,5,11,9
2007-11-21,BOS,105,8,1,GSW,82,3,6,11,7
2007-11-21,MIA,79,2,8,ATL,82,3,7,5,15
2007-11-21,HOU,94,6,5,DAL,100,8,2,14,7
2007-11-21,DET,98,6,4,NYK,86,2,8,8,12
2007-11-21,MIL,110,5,4,LAL,103,7,3,12,7
2007-11-21,MEM,89,3,7,TOR,95,5,6,8,13
2007-11-21,NOH,93,9,3,IND,105,4,7,13,10
2007-11-21,MIN,86,1,7,CLE,97,5,6,6,13
2007-11-21,SAS,128,9,2,ORL,110,10,2,19,4
2007-11-21,PHX,127,9,2,SAC,111,4,7,13,9
2007-11-21,POR,101,4,7,NJN,106,4,7,8,14
2007-11-21,LAC,101,5,4,DEN,90,8,3,13,7
2007-11-23,WAS,115,6,5,GSW,123,3,7,9,12
2007-11-23,ORL,105,10,3,CHA,92,6,5,16,8
2007-11-23,BOS,107,9,1,LAL,94,7,4,16,5
2007-11-23,MIA,98,2,9,HOU,91,6,6,8,15
2007-11-23,DET,83,7,4,PHI,78,3,7,10,11
2007-11-23,IND,111,5,7,DAL,107,9,2,14,9
2007-11-23,SAS,101,10,2,MEM,88,3,8,13,10
2007-11-23,DEN,99,8,4,MIN,93,1,8,9,12
2007-11-23,UTA,99,8,4,NOH,71,9,4,17,8
2007-11-23,PHX,113,10,2,LAC,94,6,4,16,6
2007-11-23,POR,87,4,8,SAC,84,4,8,8,16
2007-11-23,SEA,93,2,10,NJN,98,5,7,7,17
2007-11-24,NYK,85,2,9,CHI,78,2,8,4,17
2007-11-24,CLE,111,6,6,TOR,108,6,6,12,12
2007-11-24,PHI,98,3,8,GSW,100,4,7,7,15
2007-11-24,CHA,95,6,6,BOS,96,10,1,16,7
2007-11-24,ORL,120,11,3,MIA,99,3,9,14,12
2007-11-24,MEM,124,3,9,WAS,118,6,6,9,15
2007-11-24,MIN,87,1,9,ATL,94,4,7,5,16
2007-11-24,HOU,109,6,7,DEN,81,9,4,15,11
2007-11-24,MIL,97,6,4,DAL,95,9,3,15,7
2007-11-24,LAC,89,6,5,NOH,98,9,5,15,10
2007-11-25,TOR,93,6,7,CHI,78,2,9,8,16
2007-11-25,IND,106,6,7,CLE,111,7,6,13,13
2007-11-25,DET,93,8,4,UTA,103,9,4,17,8
2007-11-25,SEA,101,2,11,SAS,116,11,2,13,13
2007-11-25,LAL,100,7,5,NJN,102,6,7,13,12
2007-11-26,NYK,113,3,9,UTA,109,10,4,13,13
2007-11-26,NOH,94,10,5,MIN,103,1,10,11,15
2007-11-26,DAL,98,9,4,WAS,110,6,7,15,11
2007-11-26,SAC,112,4,9,SAS,99,12,2,16,11
2007-11-26,POR,74,5,8,ORL,85,12,3,17,11
2007-11-26,LAC,71,6,6,HOU,88,7,7,13,13
2007-11-26,GSW,129,5,7,PHX,114,11,2,16,9
2007-11-27,CLE,109,8,6,BOS,104,11,1,19,7
2007-11-27,NJN,103,7,7,MEM,110,4,9,11,16
2007-11-27,MIA,110,3,10,CHA,90,6,7,9,17
2007-11-27,MIL,99,7,4,PHI,114,3,9,10,13
2007-11-27,CHI,90,2,10,ATL,78,5,7,7,17
2007-11-27,DEN,110,9,5,IND,112,6,8,15,13
2007-11-27,LAL,106,7,6,SEA,99,2,12,9,18
2007-11-28,TOR,103,7,7,MEM,91,5,9,12,16
2007-11-28,PHI,95,4,9,UTA,106,10,5,14,14
2007-11-28,ATL,96,5,8,MIL,80,7,5,12,13
2007-11-28,DET,109,8,5,CLE,74,9,6,17,11
2007-11-28,DAL,109,9,5,MIN,103,2,10,11,15
2007-11-28,SAS,109,12,3,WAS,94,7,7,19,10
2007-11-28,PHX,94,11,3,HOU,100,8,7,19,10
2007-11-28,SAC,96,5,9,GSW,103,6,7,11,16
2007-11-28,POR,89,5,9,IND,95,7,8,12,17
2007-11-28,SEA,94,2,13,ORL,110,13,3,15,16
2007-11-29,BOS,104,11,2,NYK,59,4,9,15,11
2007-11-29,LAL,127,8,6,DEN,99,9,6,17,12
2007-11-29,GSW,113,7,7,HOU,94,9,7,16,14
2007-11-30,TOR,91,8,7,CLE,82,9,7,17,14
2007-11-30,PHI,85,4,10,WAS,84,7,8,11,18
2007-11-30,NYK,91,4,10,MIL,88,7,6,11,16
2007-11-30,ATL,86,6,8,NOH,92,10,6,16,14
2007-11-30,MIA,85,4,10,BOS,95,12,2,16,12
2007-11-30,MIN,91,2,11,SAS,106,13,3,15,14
2007-11-30,DAL,91,10,5,POR,80,5,10,15,15
2007-11-30,UTA,120,11,5,LAL,96,9,6,20,11
2007-11-30,PHX,110,11,4,ORL,106,14,3,25,7
2007-11-30,DEN,123,9,7,LAC,107,6,7,15,14
2007-11-30,SEA,95,2,14,IND,93,8,8,10,22
2007-12-01,WAS,101,7,9,TOR,97,9,7,16,16
2007-12-01,NJN,94,7,8,PHI,92,5,10,12,18
2007-12-01,MEM,109,5,10,MIN,80,2,12,7,22
2007-12-01,NOH,112,11,6,DAL,108,11,5,22,11
2007-12-01,CHI,111,3,10,CHA,95,6,8,9,18
2007-12-01,MIL,91,7,7,DET,117,9,5,16,12
2007-12-01,SAC,107,5,10,HOU,99,9,8,14,18
2007-12-02,BOS,80,13,2,CLE,70,9,8,22,10
2007-12-02,SAS,100,14,3,POR,79,5,11,19,14
2007-12-02,LAC,95,6,8,IND,101,8,9,14,17
2007-12-02,NYK,104,5,10,PHX,115,12,4,17,14
2007-12-02,DET,118,10,5,NJN,95,8,8,18,13
2007-12-02,DEN,115,10,7,MIA,89,4,11,14,18
2007-12-02,SEA,96,3,14,GSW,109,8,7,11,21
2007-12-02,LAL,97,9,7,ORL,104,14,4,23,11
2007-12-03,TOR,98,9,8,CHA,79,6,9,15,17
2007-12-03,PHI,79,5,11,ATL,88,6,9,11,20
2007-12-03,MEM,105,6,10,POR,106,5,12,11,22
2007-12-03,CHI,98,4,10,DAL,103,11,6,15,16
2007-12-03,UTA,110,12,5,MIA,101,4,12,16,17
2007-12-03,GSW,117,9,7,ORL,123,15,4,24,11
2007-12-04,ATL,95,7,9,DET,106,11,5,18,14
2007-12-04,CLE,79,9,9,NJN,100,8,9,17,18
2007-12-04,IND,117,9,9,PHX,121,13,4,22,13
2007-12-04,MIN,95,2,13,LAL,116,9,8,11,21
2007-12-04,SAC,117,6,10,UTA,107,13,5,19,15
2007-12-04,LAC,78,6,9,MIL,87,7,8,13,17
2007-12-05,TOR,123,10,8,PHX,136,14,4,24,12
2007-12-05,PHI,103,5,12,BOS,113,14,2,19,14
2007-12-05,WAS,105,8,9,CLE,86,9,10,17,19
2007-12-05,CHA,82,6,10,CHI,91,4,11,10,21
2007-12-05,NJN,93,9,9,NYK,100,5,11,14,20
2007-12-05,NOH,76,12,6,DET,91,12,5,24,11
2007-12-05,HOU,105,9,9,MEM,92,6,11,15,20
2007-12-05,SAS,97,15,3,DAL,95,12,6,27,9
2007-12-05,DEN,107,11,7,LAL,111,10,8,21,15
2007-12-05,GSW,120,9,8,MIL,90,8,8,17,16
2007-12-05,SEA,95,3,15,LAC,88,6,10,9,25
2007-12-06,ATL,90,7,10,MIN,89,2,14,9,24
2007-12-06,DAL,109,12,7,DEN,122,11,8,23,15
2007-12-06,POR,112,6,12,MIA,106,4,13,10,25
2007-12-07,PHI,101,5,13,NYK,90,6,11,11,24
2007-12-07,WAS,107,9,9,PHX,122,15,4,24,13
2007-12-07,ORL,109,16,4,IND,115,9,10,25,14
2007-12-07,DET,91,13,5,CHI,98,5,11,18,16
2007-12-07,BOS,112,15,2,TOR,84,10,9,25,11
2007-12-07,NJN,89,9,10,HOU,96,10,9,19,19
2007-12-07,NOH,118,12,7,MEM,116,6,12,18,19
2007-12-07,SAS,104,16,3,UTA,98,13,6,29,9
2007-12-07,SAC,87,7,10,LAC,97,6,11,13,21
2007-12-07,GSW,120,10,8,MIA,113,4,14,14,22
2007-12-07,SEA,104,4,15,MIL,98,8,9,12,24
2007-12-08,CHA,96,6,11,CLE,93,9,11,15,22
2007-12-08,ATL,86,8,10,MEM,78,6,13,14,23
2007-12-08,NYK,77,6,12,PHI,105,6,13,12,25
2007-12-08,MIN,100,2,15,PHX,93,16,4,18,19
2007-12-08,CHI,81,6,11,BOS,92,16,2,22,13
2007-12-08,DAL,125,12,8,UTA,117,13,7,25,15
2007-12-08,DEN,101,12,8,SAC,97,7,11,19,19
2007-12-09,TOR,93,10,10,HOU,80,11,9,21,19
2007-12-09,LAC,94,7,11,MIA,100,4,15,11,26
2007-12-09,DET,104,13,6,CHA,85,7,11,20,17
2007-12-09,POR,117,7,12,MIL,113,8,10,15,22
2007-12-09,WAS,104,9,10,NJN,89,9,11,18,21
2007-12-09,NOH,91,13,7,SEA,88,5,15,18,22
2007-12-09,LAL,123,11,8,GSW,113,11,8,22,16
2007-12-10,PHI,100,7,13,HOU,88,11,10,18,23
2007-12-10,ORL,87,16,5,ATL,98,9,10,25,15
2007-12-10,NYK,89,6,13,DAL,99,13,8,19,21
2007-12-10,PHX,113,16,5,MIA,117,5,15,21,20
2007-12-10,SAC,96,7,12,MIL,93,8,11,15,23
2007-12-11,WAS,102,10,10,MIN,88,3,15,13,25
2007-12-11,ATL,88,10,10,TOR,100,11,10,21,20
2007-12-11,CLE,118,9,12,IND,105,10,10,19,22
2007-12-11,NJN,82,9,12,LAC,91,7,12,16,24
2007-12-11,MEM,103,6,14,DET,113,14,6,20,20
2007-12-11,CHI,123,6,12,SEA,96,5,16,11,28
2007-12-11,UTA,89,13,8,POR,97,8,12,21,20
2007-12-11,GSW,96,11,9,SAS,84,17,3,28,12
2007-12-12,TOR,92,12,10,DAL,76,14,8,26,18
2007-12-12,PHI,98,8,13,MIN,94,3,16,11,29
2007-12-12,CHA,108,7,12,LAC,103,8,12,15,24
2007-12-12,IND,117,10,11,CHI,102,7,12,17,23
2007-12-12,BOS,90,17,2,SAC,78,8,12,25,14
2007-12-12,NYK,110,6,14,SEA,117,5,17,11,31
2007-12-12,MIL,100,8,12,ORL,86,16,6,24,18
2007-12-12,HOU,80,11,11,DET,77,15,6,26,17
2007-12-12,DEN,105,13,8,NOH,99,14,7,27,15
2007-12-12,POR,105,9,12,GSW,95,12,9,21,21
2007-12-12,PHX,103,16,6,UTA,98,13,9,29,15
2007-12-13,MIA,91,6,15,WAS,104,11,10,17,25
2007-12-13,LAL,102,12,8,SAS,97,17,4,29,12
2007-12-14,PHI,99,9,13,SAC,109,8,13,17,26
2007-12-14,CHA,87,8,12,ORL,103,16,7,24,19
2007-12-14,IND,93,11,11,TOR,104,13,10,24,21
2007-12-14,BOS,104,18,2,MIL,82,9,12,27,14
2007-12-14,NJN,105,9,13,CLE,97,10,12,19,25
2007-12-14,DET,91,15,7,ATL,81,10,11,25,18
2007-12-14,MEM,91,6,15,LAC,98,8,13,14,28
2007-12-14,MIN,88,3,17,SEA,99,6,17,9,34
2007-12-14,CHI,101,7,13,NYK,96,6,15,13,28
2007-12-14,DAL,89,14,9,NOH,80,14,8,28,17
2007-12-14,POR,99,10,12,UTA,91,13,10,23,22
2007-12-14,GSW,108,12,10,LAL,106,13,8,25,18
2007-12-15,WAS,92,12,10,SAC,79,9,13,21,23
2007-12-15,ATL,93,10,12,CHA,84,8,13,18,25
2007-12-15,ORL,119,17,7,MEM,123,6,16,23,23
2007-12-15,NYK,94,6,16,NJN,86,10,13,16,29
2007-12-15,MIA,103,6,16,IND,106,11,12,17,28
2007-12-15,CLE,86,10,13,PHI,92,9,14,19,27
2007-12-15,NOH,101,14,9,PHX,98,17,6,31,15
2007-12-15,MIL,95,9,13,MIN,92,3,18,12,31
2007-12-15,HOU,83,12,11,DAL,96,15,9,27,20
2007-12-15,SAS,102,17,5,DEN,91,14,8,31,13
2007-12-15,UTA,96,13,11,SEA,75,7,17,20,28
2007-12-16,DET,109,16,7,GSW,87,13,10,29,17
2007-12-16,TOR,77,14,10,BOS,90,19,2,33,12
2007-12-16,DEN,105,14,9,POR,116,11,12,25,21
2007-12-16,LAL,113,13,9,LAC,92,9,13,22,22
2007-12-17,ATL,116,11,12,UTA,111,14,11,25,23
2007-12-17,CLE,104,10,14,MIL,99,10,13,20,27
2007-12-17,NYK,92,7,16,IND,119,12,12,19,28
2007-12-17,MIA,91,6,17,MIN,87,3,19,9,36
2007-12-17,MEM,117,7,16,GSW,125,13,11,20,27
2007-12-17,DAL,111,16,9,ORL,108,17,8,33,17
2007-12-17,SAS,95,18,5,PHX,100,17,7,35,12
2007-12-17,POR,88,12,12,NOH,76,15,9,27,21
2007-12-18,NJN,101,10,14,SAC,106,9,14,19,28
2007-12-18,CHI,91,8,13,LAL,103,14,9,22,22
2007-12-18,LAC,77,9,14,TOR,80,14,11,23,25
2007-12-19,WAS,84,13,10,CHI,95,8,14,21,24
2007-12-19,CHA,98,8,14,UTA,92,14,12,22,26
2007-12-19,ATL,114,12,12,MIA,111,7,17,19,29
2007-12-19,IND,102,13,12,PHI,85,10,14,23,26
2007-12-19,BOS,85,20,2,DET,87,17,7,37,9
2007-12-19,NYK,108,7,17,CLE,90,11,14,18,31
2007-12-19,MIL,89,10,14,SAC,102,10,14,20,28
2007-12-19,MEM,88,7,17,SAS,85,18,6,25,23
2007-12-19,MIN,98,3,20,GSW,111,14,11,17,31
2007-12-19,HOU,92,12,12,ORL,97,17,9,29,21
2007-12-19,DAL,108,17,9,PHX,105,18,7,35,16
2007-12-19,POR,101,13,12,TOR,96,15,11,28,23
2007-12-19,SEA,93,7,18,NOH,107,15,10,22,28
2007-12-20,MIA,103,7,18,NJN,107,10,15,17,33
2007-12-20,CLE,94,11,15,LAL,90,15,9,26,24
2007-12-20,DEN,112,14,10,HOU,111,12,13,26,23
2007-12-21,BOS,107,20,3,CHI,82,9,14,29,17
2007-12-21,PHI,101,10,15,LAL,106,15,10,25,25
2007-12-21,WAS,92,13,11,ATL,97,13,12,26,23
2007-12-21,CHA,105,9,14,NYK,95,8,17,17,31
2007-12-21,ORL,94,18,9,UTA,113,14,13,32,22
2007-12-21,DET,94,18,7,MEM,67,8,17,26,24
2007-12-21,MIN,131,3,21,IND,118,14,12,17,33
2007-12-21,DAL,102,18,9,LAC,89,9,15,27,24
2007-12-21,POR,99,14,12,DEN,96,15,10,29,22
2007-12-21,SEA,123,7,19,TOR,115,15,12,22,31
2007-12-22,IND,93,14,13,WAS,85,13,12,27,25
2007-12-22,NJN,100,11,15,GSW,95,15,11,26,26
2007-12-22,MIA,104,7,19,UTA,102,15,13,22,32
2007-12-22,MEM,97,8,18,PHI,99,10,16,18,34
2007-12-22,NOH,110,16,10,MIN,76,4,21,20,31
2007-12-22,CHI,98,9,15,HOU,116,12,14,21,29
2007-12-22,MIL,103,10,15,CHA,99,10,14,20,29
2007-12-22,SAS,99,18,7,LAC,90,9,16,27,23
2007-12-22,PHX,122,18,8,TOR,103,15,13,33,21
2007-12-23,NYK,90,8,18,LAL,95,16,10,24,28
2007-12-23,DET,94,19,7,HOU,82,13,14,32,21
2007-12-23,CLE,96,12,15,GSW,105,15,12,27,27
2007-12-23,BOS,103,21,3,ORL,91,18,10,39,13
2007-12-23,SAC,105,11,14,DEN,106,15,11,26,25
2007-12-25,CLE,96,12,16,MIA,82,8,19,20,35
2007-12-25,LAL,122,17,10,PHX,115,19,8,36,18
2007-12-25,POR,89,15,12,SEA,79,8,19,23,31
2007-12-26,PHI,96,11,16,MIA,85,8,20,19,36
2007-12-26,CHA,104,10,15,WAS,108,13,13,23,28
2007-12-26,ATL,107,14,12,IND,95,15,13,29,25
2007-12-26,ORL,110,18,11,NYK,96,8,19,26,30
2007-12-26,NJN,83,12,15,DET,101,20,7,32,22
2007-12-26,MEM,98,8,19,NOH,116,17,10,25,29
2007-12-26,SAS,94,19,7,CHI,79,9,16,28,23
2007-12-26,DEN,125,16,11,MIL,105,11,15,27,26
2007-12-26,UTA,99,15,14,DAL,90,19,9,34,23
2007-12-26,SAC,69,11,15,BOS,89,22,3,33,18
2007-12-26,GSW,105,16,12,MIN,101,4,22,20,34
2007-12-27,DAL,81,19,10,CLE,88,13,16,32,26
2007-12-27,LAC,88,9,17,PHX,108,19,9,28,26
2007-12-27,SEA,96,8,20,BOS,104,23,3,31,23
2007-12-28,CHA,85,10,16,NOH,99,18,10,28,26
2007-12-28,NJN,109,12,16,WAS,106,14,13,26,29
2007-12-28,MIA,114,8,21,ORL,121,19,11,27,32
2007-12-28,DET,114,21,7,IND,101,15,14,36,21
2007-12-28,MEM,83,8,20,HOU,103,13,15,21,35
2007-12-28,CHI,103,9,17,MIL,99,11,16,20,33
2007-12-28,SAS,73,20,7,TOR,83,15,14,35,21
2007-12-28,PHX,94,20,9,LAC,88,9,18,29,27
2007-12-28,SAC,80,11,16,PHI,92,12,16,23,32
2007-12-28,POR,109,16,12,MIN,98,4,23,20,35
2007-12-28,LAL,123,18,10,UTA,109,16,14,34,24
2007-12-28,GSW,120,17,12,DEN,124,17,11,34,23
2007-12-29,DAL,97,19,11,ATL,84,15,12,34,23
2007-12-29,WAS,96,14,14,MIA,74,8,22,22,36
2007-12-29,ORL,104,20,11,CHA,95,10,17,30,28
2007-12-29,IND,92,15,15,DET,98,22,7,37,22
2007-12-29,NOH,86,19,10,CLE,76,14,16,33,26
2007-12-29,MIL,95,11,17,NJN,97,13,16,24,33
2007-12-29,HOU,91,14,15,TOR,79,16,14,30,29
2007-12-29,UTA,98,16,15,BOS,104,24,3,40,18
2007-12-29,SEA,109,8,21,MIN,90,4,24,12,45
2007-12-30,NYK,83,8,20,CHI,100,10,17,18,37
2007-12-30,POR,97,17,12,PHI,72,13,16,30,28
2007-12-30,DEN,95,18,11,GSW,105,17,13,35,24
2007-12-30,SAS,111,20,8,MEM,87,8,21,28,29
2007-12-30,SAC,102,11,17,PHX,117,21,9,32,26
2007-12-30,LAL,91,19,10,BOS,110,25,3,44,13
2007-12-31,CHA,107,10,18,IND,103,15,16,25,34
2007-12-31,CHI,110,11,17,ORL,112,21,11,32,28
2007-12-31,DET,114,23,7,MIL,69,11,18,34,25
2007-12-31,HOU,95,15,15,GSW,112,18,13,33,28
2007-12-31,NOH,92,20,10,TOR,97,16,15,36,25
2007-12-31,UTA,111,16,16,POR,101,18,12,34,28
2007-12-31,LAC,91,9,19,MIN,82,4,25,13,44
2007-12-31,SEA,90,9,21,PHI,98,13,17,22,38
2008-01-02,WAS,93,15,14,DET,106,24,7,39,21
2008-01-02,CHA,97,11,18,CHI,109,11,18,22,36
2008-01-02,ORL,95,22,11,NJN,96,14,16,36,27
2008-01-02,CLE,98,14,17,ATL,94,15,13,29,30
2008-01-02,IND,72,15,17,MEM,90,8,22,23,39
2008-01-02,BOS,97,26,3,HOU,93,15,16,41,19
2008-01-02,NYK,97,8,21,SAC,107,11,18,19,39
2008-01-02,MIA,98,8,23,MIL,103,11,19,19,42
2008-01-02,MIN,79,4,26,POR,90,18,13,22,39
2008-01-02,DAL,121,20,11,GSW,99,19,13,39,24
2008-01-02,UTA,110,17,16,PHI,107,14,17,31,33
2008-01-02,LAC,81,10,19,NOH,95,20,11,30,30
2008-01-03,CHI,109,12,18,POR,115,19,13,31,31
2008-01-03,DEN,80,18,12,SAS,77,21,8,39,20
2008-01-03,PHX,104,22,9,SEA,96,9,22,31,31
2008-01-04,TOR,85,17,15,DET,101,25,7,42,22
2008-01-04,ORL,94,22,12,HOU,96,15,17,37,29
2008-01-04,IND,113,15,18,ATL,91,15,14,30,32
2008-01-04,BOS,100,27,3,MEM,96,9,22,36,25
2008-01-04,NJN,102,15,16,CHA,96,11,19,26,35
2008-01-04,CLE,97,15,17,SAC,93,12,18,27,35
2008-01-04,MIN,107,4,27,DEN,118,19,12,23,39
2008-01-04,MIL,77,12,19,WAS,101,15,15,27,34
2008-01-04,SAS,97,21,9,NYK,93,8,22,29,31
2008-01-04,DAL,94,21,11,MIA,89,8,24,29,35
2008-01-04,LAL,124,19,11,PHI,93,14,18,33,29
2008-01-04,GSW,104,19,14,NOH,116,21,11,40,25
2008-01-05,ATL,107,15,15,NJN,113,16,16,31,31
2008-01-05,DET,85,26,7,BOS,92,28,3,54,10
2008-01-05,CHI,94,12,19,SAC,93,12,19,24,38
2008-01-05,HOU,103,16,17,NYK,91,8,23,24,40
2008-01-05,PHX,113,23,9,NOH,118,22,11,45,20
2008-01-05,POR,103,20,13,UTA,89,18,16,38,29
2008-01-06,TOR,90,17,16,CLE,93,16,17,33,33
2008-01-06,WAS,108,16,15,SEA,86,9,23,25,38
2008-01-06,MIN,78,4,28,DAL,101,22,11,26,39
2008-01-06,LAC,82,10,20,SAS,88,22,9,32,29
2008-01-06,MEM,101,9,23,MIA,94,8,25,17,48
2008-01-06,CHA,89,11,20,MIL,93,12,20,23,40
2008-01-06,DEN,109,20,12,PHI,96,14,19,34,31
2008-01-06,LAL,112,20,11,IND,96,16,18,36,29
2008-01-07,PHX,137,23,10,DEN,115,21,12,44,22
2008-01-07,GSW,130,19,15,SAS,121,23,9,42,24
2008-01-08,PHI,83,14,20,MIL,87,13,20,27,40
2008-01-08,WAS,84,17,15,HOU,92,17,17,34,32
2008-01-08,CHA,115,11,21,NJN,99,17,16,28,37
2008-01-08,CLE,95,17,17,SEA,79,9,24,26,41
2008-01-08,MEM,101,10,23,LAL,117,21,11,31,34
2008-01-08,MIN,101,4,29,MIA,91,8,26,12,55
2008-01-08,CHI,100,13,19,NYK,105,8,24,21,43
2008-01-08,UTA,111,18,17,IND,89,16,19,34,36
2008-01-08,SAC,104,12,20,ORL,100,22,13,34,33
2008-01-09,TOR,109,17,17,PHI,96,14,21,31,38
2008-01-09,ATL,90,15,16,CLE,81,18,17,33,33
2008-01-09,BOS,83,29,3,CHA,95,12,21,41,24
2008-01-09,NJN,99,17,17,SEA,88,9,25,26,42
2008-01-09,NYK,92,9,24,HOU,101,18,17,27,41
2008-01-09,MIL,98,14,20,MIA,92,8,27,22,47
2008-01-09,NOH,80,23,11,LAL,109,22,11,45,22
2008-01-09,DAL,102,23,11,DET,86,26,8,49,19
2008-01-09,PHX,129,24,10,IND,122,16,20,40,30
2008-01-09,POR,109,21,13,GSW,91,20,15,41,28
2008-01-09,LAC,106,10,21,ORL,113,22,14,32,35
2008-01-10,SAS,80,23,10,DET,90,26,9,49,19
2008-01-10,SAC,116,13,20,MEM,113,10,24,23,44
2008-01-10,UTA,108,19,17,PHX,86,25,10,44,27
2008-01-11,PHI,97,14,22,CHI,100,13,20,27,42
2008-01-11,NJN,77,18,17,BOS,86,29,4,47,21
2008-01-11,NYK,90,9,25,TOR,99,18,17,27,42
2008-01-11,ATL,98,16,16,WAS,102,17,16,33,32
2008-01-11,CLE,113,18,18,CHA,106,13,21,31,39
2008-01-11,NOH,114,23,12,MIA,88,8,28,31,40
2008-01-11,HOU,113,19,17,MIN,82,5,29,24,46
2008-01-11,DEN,113,21,13,ORL,103,23,14,44,27
2008-01-11,LAL,110,23,11,MIL,105,15,20,38,31
2008-01-11,GSW,116,20,16,MEM,104,10,25,30,41
2008-01-11,SEA,70,9,26,DAL,90,24,11,33,37
2008-01-12,WAS,85,18,16,BOS,78,30,4,48,20
2008-01-12,CHA,100,13,22,DET,103,27,9,40,31
2008-01-12,SAS,105,23,11,MIN,88,5,30,28,41
2008-01-12,UTA,119,20,17,ORL,115,23,15,43,32
2008-01-12,PHX,122,25,11,MIL,114,15,21,40,32
2008-01-12,SAC,105,14,20,IND,111,16,21,30,41
2008-01-12,LAC,94,10,22,DAL,95,25,11,35,33
2008-01-13,TOR,116,19,17,POR,109,22,13,41,30
2008-01-13,ATL,105,16,17,CHI,84,14,20,30,37
2008-01-13,HOU,82,20,17,NOH,87,24,12,44,29
2008-01-13,NYK,89,9,26,DET,65,28,9,37,35
2008-01-13,GSW,106,21,16,IND,101,17,21,38,37
2008-01-13,LAL,100,24,11,MEM,99,10,26,34,37
2008-01-14,CHA,119,13,23,DEN,116,22,13,35,36
2008-01-14,BOS,83,30,5,WAS,88,19,16,49,21
2008-01-14,NJN,73,18,18,POR,99,22,14,40,32
2008-01-14,SAS,89,24,11,PHI,82,14,23,38,34
2008-01-14,UTA,98,21,17,MIL,87,15,22,36,39
2008-01-14,SAC,122,14,21,DAL,120,26,11,40,32
2008-01-14,SEA,121,9,27,LAL,123,25,11,34,38
2008-01-15,ATL,104,17,17,DEN,93,22,14,39,31
2008-01-15,ORL,102,23,16,CHI,88,14,21,37,37
2008-01-15,NYK,105,10,26,WAS,93,20,16,30,42
2008-01-15,DET,103,28,10,TOR,89,20,17,48,27
2008-01-15,MEM,124,10,27,CLE,132,19,18,29,45
2008-01-15,MIN,98,5,31,GSW,105,22,16,27,47
2008-01-15,HOU,107,20,18,PHI,111,14,24,34,42
2008-01-15,LAC,97,10,23,PHX,90,26,11,36,34
2008-01-16,TOR,116,20,18,SAC,91,15,21,35,39
2008-01-16,CHA,99,14,23,ORL,93,24,16,38,39
2008-01-16,MIA,96,8,29,CHI,126,14,22,22,51
2008-01-16,IND,125,17,22,GSW,117,23,16,40,38
2008-01-16,BOS,100,30,6,POR,90,23,14,53,20
2008-01-16,NJN,105,18,19,NYK,111,11,26,29,45
2008-01-16,MIL,87,15,23,ATL,80,18,17,33,40
2008-01-16,NOH,123,25,12,SEA,92,9,28,34,40
2008-01-17,SAS,88,25,11,CLE,90,20,18,45,29
2008-01-17,DEN,120,22,15,UTA,109,22,17,44,32
2008-01-17,LAL,98,26,11,PHX,106,26,12,52,23
2008-01-18,TOR,89,21,18,ATL,78,18,18,39,36
2008-01-18,WAS,111,20,17,NYK,98,12,26,32,43
2008-01-18,MIA,91,8,30,POR,98,23,15,31,45
2008-01-18,BOS,116,31,6,PHI,89,15,24,46,30
2008-01-18,DET,93,29,10,SAC,100,15,22,44,32
2008-01-18,MEM,124,10,28,SEA,100,9,29,19,57
2008-01-18,NOH,112,26,12,CHA,84,15,23,41,35
2008-01-18,UTA,106,22,18,LAC,88,11,23,33,41
2008-01-18,PHX,115,27,12,MIN,95,5,32,32,44
2008-01-18,CHI,111,15,22,GSW,119,23,17,38,39
2008-01-19,PHI,99,15,25,TOR,95,22,18,37,43
2008-01-19,CHA,105,15,24,MEM,87,11,28,26,52
2008-01-19,ORL,101,24,17,POR,94,24,15,48,32
2008-01-19,IND,104,18,22,SAC,110,16,22,34,44
2008-01-19,MIA,84,8,31,NYK,88,12,27,20,58
2008-01-19,CHI,97,15,23,DET,81,29,11,44,34
2008-01-19,MIL,99,16,23,GSW,119,24,17,40,40
2008-01-19,HOU,83,20,19,SAS,81,25,12,45,31
2008-01-19,DAL,111,26,12,SEA,96,9,30,35,42
2008-01-19,DEN,111,23,15,MIN,108,5,33,28,48
2008-01-19,LAC,120,11,24,NJN,107,18,20,29,44
2008-01-20,PHX,116,28,12,NJN,92,18,21,46,33
2008-01-21,NYK,93,13,27,BOS,109,32,6,45,33
2008-01-21,WAS,102,21,17,DAL,84,27,12,48,29
2008-01-21,CHA,86,16,24,SAS,95,25,13,41,37
2008-01-21,PHI,103,16,25,IND,110,18,23,34,48
2008-01-21,ATL,109,18,19,POR,111,24,16,42,35
2008-01-21,HOU,96,21,19,SEA,89,9,31,30,50
2008-01-21,NOH,106,27,12,MIL,92,16,24,43,36
2008-01-21,LAC,93,12,24,UTA,109,23,18,35,42
2008-01-21,GSW,108,25,17,MIN,109,5,34,30,51
2008-01-21,MEM,104,11,29,CHI,90,16,23,27,52
2008-01-21,ORL,102,25,17,DET,100,29,12,54,29
2008-01-21,MIA,90,8,32,CLE,97,21,18,29,50
2008-01-21,LAL,116,26,12,DEN,99,24,15,50,27
2008-01-22,MIL,105,16,25,PHX,114,29,12,45,37
2008-01-22,SAC,128,17,22,NJN,94,18,22,35,44
2008-01-23,PHI,78,16,26,DET,86,29,13,45,39
2008-01-23,CHA,95,16,25,DAL,102,27,13,43,38
2008-01-23,CLE,121,22,18,WAS,85,22,17,44,35
2008-01-23,BOS,112,33,6,TOR,114,22,19,55,25
2008-01-23,MEM,85,12,29,ORL,112,26,17,38,46
2008-01-23,NOH,96,28,12,POR,81,25,16,53,28
2008-01-23,MIN,117,6,34,PHX,107,30,12,36,46
2008-01-23,CHI,108,16,24,IND,95,19,23,35,47
2008-01-23,SAS,103,26,13,LAL,91,27,12,53,25
2008-01-23,DEN,107,24,16,ATL,100,18,20,42,36
2008-01-23,SEA,107,9,32,HOU,109,22,19,31,51
2008-01-23,LAC,111,12,25,SAC,85,18,22,30,47
2008-01-24,MIA,89,8,33,SAS,90,27,13,35,46
2008-01-24,MIL,104,16,26,IND,92,19,24,35,50
2008-01-24,GSW,121,25,18,NJN,119,18,23,43,41
2008-01-25,TOR,106,23,19,MIL,75,17,26,40,45
2008-01-25,WAS,104,22,18,MEM,93,12,30,34,48
2008-01-25,CLE,108,23,18,PHX,110,30,13,53,31
2008-01-25,BOS,87,33,7,MIN,86,7,34,40,41
2008-01-25,NYK,89,13,28,PHI,81,16,27,29,55
2008-01-25,DET,101,30,13,ORL,93,27,17,57,30
2008-01-25,NOH,111,29,12,LAC,92,13,25,42,37
2008-01-25,CHI,77,17,24,CHA,90,16,26,33,50
2008-01-25,DAL,112,28,13,LAL,105,27,13,55,26
2008-01-25,DEN,100,25,16,NJN,85,18,24,43,40
2008-01-25,UTA,127,24,18,SAC,113,18,23,42,41
2008-01-25,POR,79,25,17,HOU,89,23,19,48,36
2008-01-25,SEA,90,9,33,ATL,99,18,21,27,54
2008-01-26,MIA,98,8,34,IND,96,19,25,27,59
2008-01-26,CHA,96,17,26,PHI,103,16,28,33,54
2008-01-26,MEM,125,12,31,LAC,120,13,26,25,57
2008-01-26,SAS,78,28,13,NOH,102,30,12,58,25
2008-01-27,CHI,77,17,25,PHX,88,31,13,48,38
2008-01-27,LAL,95,27,14,CLE,98,23,19,50,33
2008-01-27,ORL,96,27,18,BOS,93,34,7,61,25
2008-01-27,MIL,105,17,27,WAS,102,23,18,40,45
2008-01-27,POR,94,25,18,ATL,93,19,21,44,39
2008-01-27,DAL,90,29,13,DEN,85,26,16,55,29
2008-01-27,MIN,98,7,35,NJN,95,18,25,25,60
2008-01-27,HOU,89,24,19,UTA,97,25,18,49,37
2008-01-27,GSW,106,26,18,NYK,104,14,28,40,46
2008-01-27,SEA,101,9,34,SAC,103,18,24,27,58
2008-01-28,MEM,84,13,31,DAL,103,30,13,43,44
2008-01-28,NOH,117,31,12,DEN,93,26,17,57,29
2008-01-28,UTA,97,26,18,SAS,91,28,14,54,32
2008-01-28,LAC,100,13,27,CHA,107,17,27,30,54
2008-01-29,WAS,108,23,19,TOR,104,24,19,47,38
2008-01-29,IND,104,19,26,DET,110,31,13,50,39
2008-01-29,NJN,87,18,26,MIL,80,18,27,36,53
2008-01-29,MIA,87,9,34,BOS,117,34,8,43,42
2008-01-29,CHI,96,17,26,MIN,85,8,35,25,61
2008-01-29,HOU,111,24,20,GSW,107,27,18,51,38
2008-01-29,PHX,125,32,13,ATL,92,19,22,51,35
2008-01-29,SEA,88,9,35,SAS,85,28,15,37,50
2008-01-29,LAL,120,27,15,NYK,109,14,29,41,44
2008-01-30,TOR,122,24,20,WAS,83,24,19,48,39
2008-01-30,PHI,112,17,28,MIL,69,18,28,35,56
2008-01-30,ORL,107,28,18,MIA,91,9,35,37,53
2008-01-30,MEM,102,13,32,DEN,106,26,18,39,50
2008-01-30,NOH,103,32,12,GSW,116,27,19,59,31
2008-01-30,MIN,83,8,36,CHI,67,18,26,26,62
2008-01-30,UTA,100,27,18,NYK,89,14,30,41,48
2008-01-30,POR,83,26,18,CLE,84,24,19,50,37
2008-01-30,SAC,105,19,24,CHA,91,18,27,37,51
2008-01-30,LAC,95,13,28,ATL,88,19,23,32,51
2008-01-31,DET,90,32,13,LAL,89,28,15,60,28
2008-01-31,BOS,96,35,8,DAL,90,31,13,66,21
2008-01-31,SEA,101,10,35,CLE,95,25,19,35,54
2008-01-31,PHX,81,33,13,SAS,84,28,16,61,29
2008-02-01,TOR,101,25,20,LAL,121,28,16,53,36
2008-02-01,PHI,106,18,28,ORL,108,29,18,47,46
2008-02-01,WAS,87,24,20,UTA,96,28,18,52,38
2008-02-01,IND,103,19,27,HOU,106,25,20,44,47
2008-02-01,MIA,85,9,36,NJN,94,19,26,28,62
2008-02-01,MIN,104,9,36,LAC,83,14,28,23,64
2008-02-01,SAC,112,20,24,NOH,103,32,13,52,37
2008-02-01,GSW,127,28,19,CHA,96,18,28,46,47
2008-02-01,POR,94,26,19,NYK,88,14,31,40,50
2008-02-02,ATL,104,19,24,NJN,92,20,26,39,50
2008-02-02,IND,115,19,28,ORL,121,30,18,49,46
2008-02-02,CLE,98,25,20,LAC,84,14,29,39,49
2008-02-02,MEM,91,13,33,UTA,110,29,18,42,51
2008-02-02,MIL,83,18,29,HOU,91,26,20,44,49
2008-02-02,DEN,117,27,18,CHA,101,18,29,45,47
2008-02-02,SAC,105,21,24,CHI,101,18,27,39,51
2008-02-02,SEA,86,11,35,NYK,85,14,32,25,67
2008-02-03,WAS,91,24,21,LAL,103,29,16,53,37
2008-02-03,DET,90,33,13,DAL,67,31,14,64,27
2008-02-04,ATL,96,20,24,PHI,91,18,29,38,53
2008-02-04,ORL,98,31,18,DAL,107,31,15,62,33
2008-02-04,NYK,94,14,33,LAC,103,14,30,28,63
2008-02-04,MIA,82,9,37,TOR,114,25,21,34,58
2008-02-04,MIN,86,10,36,HOU,92,27,20,37,56
2008-02-04,UTA,110,30,18,NOH,88,32,14,62,32
2008-02-04,PHX,118,33,14,CHA,104,18,30,51,44
2008-02-04,POR,103,27,19,DEN,105,28,18,55,37
2008-02-04,SEA,108,12,35,CHI,118,18,28,30,63
2008-02-05,PHI,101,18,30,WAS,96,24,22,42,52
2008-02-05,CLE,114,26,20,BOS,113,36,8,62,28
2008-02-05,IND,89,19,29,SAS,116,29,16,48,45
2008-02-05,NJN,90,20,27,LAL,105,30,16,50,43
2008-02-05,MEM,97,13,34,MIL,102,18,30,31,64
2008-02-06,WAS,77,24,23,SAS,85,30,16,54,39
2008-02-06,ATL,98,21,24,LAL,95,31,16,52,40
2008-02-06,ORL,100,31,19,NJN,84,20,28,51,47
2008-02-06,BOS,111,36,9,LAC,100,15,30,51,39
2008-02-06,NYK,100,14,34,IND,103,19,30,33,64
2008-02-06,DET,100,34,13,MIA,95,9,38,43,51
2008-02-06,DAL,107,32,15,MIL,96,19,30,51,45
2008-02-06,DEN,115,29,18,UTA,118,31,18,60,36
2008-02-06,PHX,130,34,14,NOH,132,32,15,66,29
2008-02-06,SAC,92,22,24,SEA,105,12,36,34,60
2008-02-06,POR,100,27,20,CHI,97,19,28,46,48
2008-02-07,PHI,101,19,30,MIA,84,9,39,28,69
2008-02-07,HOU,92,28,20,CLE,77,27,20,55,40
2008-02-07,GSW,108,29,19,CHI,114,19,29,48,48
2008-02-08,TOR,98,26,21,LAC,102,15,31,41,52
2008-02-08,CHA,90,18,31,NJN,104,20,29,38,60
2008-02-08,ORL,113,32,19,LAL,117,31,17,63,36
2008-02-08,NYK,93,14,35,SAS,99,31,16,45,51
2008-02-08,ATL,95,22,24,CLE,100,27,21,49,45
2008-02-08,DET,91,35,13,POR,82,28,20,63,33
2008-02-08,MIN,86,10,37,BOS,88,37,9,47,46
2008-02-08,DAL,92,33,15,MEM,81,13,35,46,50
2008-02-08,PHX,103,34,15,SEA,99,13,36,47,51
2008-02-08,SAC,117,22,25,UTA,104,32,18,54,43
2008-02-08,DEN,111,29,19,WAS,100,24,24,53,43
2008-02-09,IND,101,20,30,POR,93,28,21,48,51
2008-02-09,PHI,101,20,30,LAC,80,16,31,36,61
2008-02-09,NOH,112,33,15,MEM,99,13,36,46,51
2008-02-09,MIL,98,19,31,NYK,99,14,36,33,67
2008-02-09,HOU,108,29,20,ATL,89,22,25,51,45
2008-02-09,UTA,97,32,19,CHI,87,20,29,52,48
2008-02-09,GSW,105,29,20,SAC,102,23,25,52,45
2008-02-10,CLE,83,28,21,DEN,113,30,19,58,40
2008-02-10,MIA,94,9,40,LAL,104,32,17,41,57
2008-02-10,NJN,101,21,29,DAL,82,34,15,55,44
2008-02-10,DET,113,36,13,CHA,87,18,32,54,45
2008-02-10,MIN,82,10,38,TOR,105,26,22,36,60
2008-02-10,BOS,98,38,9,SAS,90,32,16,70,25
2008-02-10,PHX,108,35,15,WAS,107,24,25,59,40
2008-02-11,TOR,88,27,22,SAS,93,32,17,59,39
2008-02-11,PHI,84,21,30,DAL,76,34,16,55,46
2008-02-11,CHA,97,18,33,LAL,106,33,17,51,50
2008-02-11,ORL,111,32,20,CLE,118,28,22,60,42
2008-02-11,MIL,89,19,32,LAC,96,16,32,35,64
2008-02-11,HOU,95,30,20,POR,83,28,22,58,42
2008-02-11,GSW,120,30,20,WAS,117,24,26,54,46
2008-02-12,ATL,90,22,26,DET,94,37,13,59,39
2008-02-12,IND,97,21,30,BOS,104,39,9,60,39
2008-02-12,NJN,92,22,29,MIN,88,10,39,32,68
2008-02-12,MIA,113,9,41,DEN,114,31,19,40,60
2008-02-12,MEM,107,13,37,SAC,94,23,26,36,63
2008-02-12,CHI,86,20,30,NOH,100,34,15,54,45
2008-02-13,TOR,109,27,23,NJN,91,23,29,50,52
2008-02-13,PHI,102,22,30,MEM,88,14,37,36,67
2008-02-13,CHA,100,18,34,ATL,98,22,27,40,61
2008-02-13,ORL,109,32,21,DEN,98,32,19,64,40
2008-02-13,CLE,105,29,22,SAS,112,33,17,62,39
2008-02-13,BOS,111,40,9,NYK,103,15,36,55,45
2008-02-13,DET,96,38,13,IND,80,21,31,59,44
2008-02-13,MIL,107,19,33,NOH,111,35,15,54,48
2008-02-13,MIN,92,10,40,LAL,117,34,17,44,57
2008-02-13,HOU,89,31,20,SAC,87,23,27,54,47
2008-02-13,DAL,96,34,17,POR,76,28,23,62,40
2008-02-13,GSW,120,31,20,PHX,118,36,15,67,35
2008-02-13,SEA,93,13,37,UTA,112,33,19,46,56
2008-02-13,LAC,89,17,32,WAS,91,24,27,41,59
2008-02-14,CHI,99,20,31,MIA,92,9,42,29,73
2008-02-14,PHX,109,36,16,DAL,97,35,17,71,33
2008-02-19,WAS,100,25,27,NYK,113,15,37,40,64
2008-02-19,CLE,85,29,23,HOU,93,32,20,61,43
2008-02-19,DET,85,39,13,ORL,103,33,21,72,34
2008-02-19,MIN,104,10,41,PHI,88,23,30,33,71
2008-02-19,SAS,85,34,17,CHA,65,19,34,53,51
2008-02-19,DEN,124,32,20,BOS,118,41,9,73,29
2008-02-19,UTA,119,34,19,GSW,109,32,20,66,39
2008-02-19,POR,94,28,24,SAC,105,23,28,51,52
2008-02-19,SEA,108,13,38,MEM,101,14,38,27,76
2008-02-19,LAL,122,35,17,ATL,93,22,28,57,45
2008-02-20,TOR,127,28,23,ORL,110,34,21,62,44
2008-02-20,PHI,124,23,31,NYK,84,16,37,39,68
2008-02-20,IND,97,21,32,CLE,106,29,24,50,56
2008-02-20,NJN,110,23,30,CHI,102,21,31,44,61
2008-02-20,MIL,103,19,34,DET,98,39,14,58,48
2008-02-20,NOH,104,36,15,DAL,93,35,18,71,33
2008-02-20,PHX,124,37,16,LAL,130,36,17,73,33
2008-02-20,SAC,119,24,28,ATL,107,22,29,46,57
2008-02-20,LAC,100,17,33,MEM,86,14,39,31,72
2008-02-20,GSW,119,32,21,BOS,117,41,10,73,31
2008-02-21,HOU,112,33,20,MIA,100,9,43,42,63
2008-02-21,MIN,99,11,41,SAS,100,35,17,46,58
2008-02-21,POR,92,28,25,SEA,88,14,38,42,63
2008-02-22,CHA,115,19,35,SAC,116,25,28,44,63
2008-02-22,ORL,115,34,22,PHI,99,24,31,58,53
2008-02-22,IND,113,21,33,NJN,103,24,30,45,63
2008-02-22,NYK,103,16,38,TOR,99,29,23,45,61
2008-02-22,CLE,90,30,24,WAS,89,25,28,55,52
2008-02-22,DET,127,39,15,MIL,100,20,34,59,49
2008-02-22,CHI,135,21,32,DEN,121,33,20,54,52
2008-02-22,MEM,83,14,40,DAL,98,35,19,49,59
2008-02-22,NOH,80,37,15,HOU,100,34,20,71,35
2008-02-22,PHX,85,37,17,BOS,77,41,11,78,28
2008-02-22,LAC,114,18,33,UTA,104,35,19,53,52
2008-02-22,GSW,110,33,21,ATL,117,22,30,55,51
2008-02-22,SEA,99,14,39,POR,87,29,25,43,64
2008-02-23,WAS,110,25,29,CHA,95,19,36,44,65
2008-02-23,NJN,102,24,31,IND,91,22,33,46,64
2008-02-23,MIA,96,9,44,PHI,101,24,32,33,76
2008-02-23,MIL,115,20,35,DEN,109,33,21,53,56
2008-02-23,SAS,98,36,17,NOH,89,37,16,73,33
2008-02-23,UTA,100,35,20,ATL,94,23,30,58,50
2008-02-23,LAC,95,19,33,LAL,113,37,17,56,50
2008-02-24,PHX,86,38,17,DET,116,40,15,78,32
2008-02-24,TOR,115,29,24,NYK,92,17,38,46,62
2008-02-24,ORL,112,35,22,SAC,93,26,28,61,50
2008-02-24,CLE,109,31,24,MEM,89,14,41,45,65
2008-02-24,POR,102,29,26,BOS,112,41,12,70,38
2008-02-24,MIN,83,11,42,DAL,99,36,19,47,61
2008-02-24,HOU,110,35,20,CHI,97,22,32,57,52
2008-02-24,SEA,91,15,39,LAL,111,38,17,53,56
2008-02-25,IND,98,22,34,TOR,102,30,24,52,58
2008-02-25,NOH,92,37,17,WAS,95,26,29,63,46
2008-02-25,DAL,102,37,19,CHI,94,22,33,59,52
2008-02-25,SAS,89,37,17,ATL,74,23,31,60,48
2008-02-25,DEN,93,33,22,DET,98,41,15,74,37
2008-02-25,LAC,76,19,34,BOS,104,42,12,61,46
2008-02-26,NJN,92,25,31,ORL,102,36,22,61,53
2008-02-26,MIA,107,9,45,SAC,86,26,29,35,74
2008-02-26,MIL,105,21,35,CLE,102,32,24,53,59
2008-02-26,MEM,113,14,42,PHX,127,38,18,52,60
2008-02-26,MIN,111,11,43,UTA,100,36,20,47,63
2008-02-26,HOU,94,36,20,WAS,69,27,29,63,49
2008-02-26,LAL,96,39,17,POR,83,29,27,68,44
2008-02-26,GSW,105,33,22,SEA,99,15,40,48,62
2008-02-27,TOR,107,31,24,MIN,85,12,43,43,67
2008-02-27,PHI,101,25,32,ORL,89,37,22,62,54
2008-02-27,ATL,123,23,32,SAC,117,26,30,49,62
2008-02-27,IND,107,22,35,CHI,113,22,34,44,69
2008-02-27,BOS,92,43,12,CLE,87,32,25,75,37
2008-02-27,NYK,113,17,39,CHA,89,19,37,36,76
2008-02-27,NOH,120,37,18,PHX,103,39,18,76,36
2008-02-27,UTA,103,36,21,DET,95,42,15,78,36
2008-02-27,SEA,96,15,41,DEN,138,33,23,48,64
2008-02-27,LAC,80,19,35,POR,82,29,28,48,63
2008-02-28,NJN,120,25,32,MIL,106,22,35,47,67
2008-02-28,SAS,97,38,17,DAL,94,38,19,76,36
2008-02-28,LAL,106,40,17,MIA,88,10,45,50,62
2008-02-29,TOR,111,32,24,IND,122,22,36,54,60
2008-02-29,BOS,108,44,12,CHA,100,19,38,63,50
2008-02-29,ATL,99,24,32,NYK,93,18,39,42,71
2008-02-29,CLE,92,32,26,MIN,84,12,44,44,70
2008-02-29,CHI,91,23,34,WAS,97,27,30,50,64
2008-02-29,NOH,110,38,18,UTA,98,37,21,75,39
2008-02-29,HOU,116,37,20,MEM,95,14,43,51,63
2008-02-29,DAL,115,38,20,SAC,106,26,31,64,51
2008-02-29,DEN,110,34,23,LAC,104,19,36,53,59
2008-02-29,GSW,119,34,22,PHI,97,26,32,60,54
2008-02-29,POR,119,30,28,LAL,111,41,17,71,45
2008-02-29,SEA,93,15,42,MIA,103,10,46,25,88
2008-03-01,ORL,118,37,23,NYK,92,18,40,55,63
2008-03-01,MEM,92,14,44,UTA,113,37,22,51,66
2008-03-01,MIL,94,22,36,SAS,96,39,17,61,53
2008-03-01,PHX,114,39,19,PHI,119,26,33,65,52
2008-03-01,LAC,73,19,37,DET,103,42,16,61,53
2008-03-02,CLE,95,33,26,CHI,86,23,35,56,61
2008-03-02,LAL,108,41,18,DAL,104,39,20,80,38
2008-03-02,BOS,98,45,12,ATL,88,25,32,70,44
2008-03-02,NJN,83,26,32,SAS,93,40,17,66,49
2008-03-02,WAS,101,28,30,NOH,84,39,18,67,48
2008-03-02,CHA,110,19,39,TOR,98,32,25,51,64
2008-03-02,IND,128,23,36,MIL,106,22,37,45,73
2008-03-02,MIN,108,12,45,SEA,111,15,43,27,88
2008-03-02,HOU,103,38,20,DEN,89,35,23,73,43
2008-03-02,GSW,110,35,22,POR,104,31,28,66,50
2008-03-02,SAC,120,26,32,MIA,109,11,46,37,78
2008-03-03,NYK,88,18,41,NOH,100,39,19,57,60
2008-03-03,UTA,116,38,22,DAL,110,39,21,77,43
2008-03-03,LAC,80,19,38,PHI,106,27,33,46,71
2008-03-04,ATL,118,25,33,GSW,135,36,22,61,55
2008-03-04,ORL,102,38,23,TOR,87,32,26,70,49
2008-03-04,DET,100,43,16,SEA,97,16,43,59,59
2008-03-04,MIN,89,12,46,CHA,109,20,39,32,85
2008-03-04,CHI,112,23,36,MEM,97,14,45,37,81
2008-03-04,SAS,81,41,17,NJN,70,26,33,67,50
2008-03-04,SAC,105,27,32,LAL,117,42,18,69,50
2008-03-04,POR,92,31,29,PHX,97,39,20,70,49
2008-03-05,WAS,92,29,30,ORL,122,39,23,68,53
2008-03-05,CHA,118,21,39,GSW,109,37,22,58,61
2008-03-05,BOS,90,46,12,DET,78,44,16,90,28
2008-03-05,NYK,105,18,42,CLE,119,34,26,52,68
2008-03-05,MIA,83,11,47,TOR,108,32,27,43,74
2008-03-05,MIL,118,22,38,SEA,106,16,44,38,82
2008-03-05,MEM,100,14,46,NJN,93,26,34,40,80
2008-03-05,NOH,116,40,19,ATL,101,25,34,65,53
2008-03-05,HOU,117,39,20,IND,99,24,36,63,56
2008-03-05,DEN,126,35,24,PHX,113,40,20,75,44
2008-03-05,UTA,105,39,22,MIN,76,12,47,51,69
2008-03-05,LAC,116,19,39,SAC,109,27,33,46,72
2008-03-06,CHI,107,24,36,CLE,96,35,26,59,62
2008-03-06,SAS,108,42,17,IND,97,24,37,66,54
2008-03-06,DAL,98,39,22,HOU,113,40,20,79,42
2008-03-07,TOR,106,33,27,WAS,110,29,31,62,58
2008-03-07,PHI,117,28,33,SEA,83,16,45,44,78
2008-03-07,CHA,108,22,39,ATL,93,25,35,47,74
2008-03-07,NYK,97,18,43,DET,101,44,17,62,60
2008-03-07,MIA,99,11,48,GSW,134,37,23,48,71
2008-03-07,BOS,116,47,12,CHI,93,25,36,72,48
2008-03-07,NOH,107,41,19,NJN,96,26,35,67,54
2008-03-07,MIL,101,23,38,POR,103,31,30,54,68
2008-03-07,PHX,118,40,21,UTA,126,40,22,80,43
2008-03-07,SAC,103,27,34,MIN,111,12,48,39,82
2008-03-07,DEN,109,36,24,SAS,96,43,17,79,41
2008-03-07,LAL,119,43,18,LAC,82,20,39,63,57
2008-03-08,CLE,103,35,27,IND,95,24,38,59,65
2008-03-08,WAS,97,30,31,CHA,100,23,39,53,70
2008-03-08,ATL,97,25,36,MIA,94,11,49,36,85
2008-03-08,ORL,95,40,23,GSW,104,38,23,78,46
2008-03-08,NYK,114,18,44,POR,120,32,30,50,74
2008-03-08,MEM,89,15,46,BOS,119,48,12,63,58
2008-03-08,HOU,106,41,20,NOH,96,42,19,83,39
2008-03-08,DAL,111,39,23,NJN,91,26,36,65,59
2008-03-08,UTA,132,41,22,DEN,105,37,24,78,46
2008-03-08,LAC,96,20,40,MIN,99,13,48,33,88
2008-03-09,TOR,114,33,28,SEA,106,16,46,49,74
2008-03-09,MIL,97,23,39,PHI,119,29,33,52,72
2008-03-09,PHX,94,40,22,SAS,87,43,18,83,40
2008-03-09,DET,116,45,17,CHI,109,25,37,70,54
2008-03-09,LAL,113,44,18,SAC,114,27,35,71,53
2008-03-10,PHI,86,30,33,BOS,100,49,12,79,45
2008-03-10,ORL,123,40,24,ATL,112,26,36,66,60
2008-03-10,CLE,88,36,27,POR,80,33,30,69,57
2008-03-10,MIA,98,11,50,LAC,99,20,41,31,91
2008-03-10,HOU,91,42,20,NJN,73,26,37,68,57
2008-03-10,DAL,108,40,23,NYK,79,18,45,58,68
2008-03-10,SAS,107,43,19,DEN,103,37,25,80,44
2008-03-11,WAS,105,30,32,MIL,97,23,40,53,72
2008-03-11,IND,114,24,39,SEA,107,16,47,40,86
2008-03-11,MIN,96,14,48,POR,103,33,31,47,79
2008-03-11,CHI,108,25,38,UTA,96,42,22,67,60
2008-03-11,PHX,132,41,22,MEM,111,15,47,56,69
2008-03-11,LAL,117,44,19,TOR,108,34,28,78,47
2008-03-12,ATL,75,26,37,HOU,83,43,20,69,57
2008-03-12,ORL,110,41,24,LAC,88,21,41,62,65
2008-03-12,BOS,111,50,12,SEA,82,16,48,66,60
2008-03-12,NJN,104,26,38,CLE,99,37,27,63,65
2008-03-12,MIA,88,11,51,NYK,91,18,46,29,97
2008-03-12,DET,82,46,17,PHI,83,30,34,76,51
2008-03-12,MIL,110,23,41,UTA,114,42,23,65,64
2008-03-12,NOH,100,42,20,SAS,75,44,19,86,39
2008-03-12,DAL,118,41,23,CHA,93,24,39,65,62
2008-03-12,DEN,108,37,26,MEM,86,15,48,52,74
2008-03-12,GSW,117,39,23,TOR,106,34,29,73,52
2008-03-13,WAS,101,31,32,CLE,99,37,28,68,60
2008-03-13,SAC,96,28,35,POR,85,34,31,62,66
2008-03-13,PHX,123,42,22,GSW,115,40,23,82,45
2008-03-14,BOS,92,51,12,UTA,110,43,23,94,35
2008-03-14,ATL,117,26,38,LAC,93,21,42,47,80
2008-03-14,MIA,94,11,52,ORL,103,42,24,53,76
2008-03-14,DET,84,46,18,SAS,80,44,20,90,38
2008-03-14,NOH,108,43,20,LAL,98,45,19,88,39
2008-03-14,CHI,106,26,38,PHI,110,31,34,57,72
2008-03-14,HOU,89,44,20,CHA,80,24,40,68,60
2008-03-14,DAL,116,42,23,IND,97,25,39,67,62
2008-03-14,DEN,137,38,26,TOR,105,34,30,72,56
2008-03-14,SEA,116,16,49,MIN,121,14,49,30,98
2008-03-15,PHI,103,32,34,SAS,96,44,21,76,55
2008-03-15,WAS,119,32,32,LAC,109,21,43,53,75
2008-03-15,ORL,122,43,24,IND,111,25,40,68,64
2008-03-15,NJN,117,27,38,UTA,115,44,23,71,61
2008-03-15,MIL,77,23,42,BOS,99,51,13,74,55
2008-03-15,PHX,127,43,22,SAC,99,29,35,72,57
2008-03-15,POR,107,34,32,MIN,96,15,49,49,81
2008-03-15,GSW,110,40,24,MEM,107,15,49,55,73
2008-03-16,MIA,73,11,53,DAL,98,43,23,54,76
2008-03-16,NYK,98,19,46,ATL,109,27,38,46,84
2008-03-16,DET,105,47,18,NOH,84,44,20,91,38
2008-03-16,CLE,98,37,29,CHA,91,24,41,61,70
2008-03-16,HOU,104,45,20,LAL,92,45,20,90,40
2008-03-16,DEN,168,39,26,SEA,116,16,50,55,76
2008-03-16,SAC,106,29,36,TOR,100,34,31,63,67
2008-03-17,WAS,96,33,32,ATL,105,28,38,61,70
2008-03-17,ORL,104,44,24,CLE,90,38,29,82,53
2008-03-17,IND,110,25,41,NYK,98,19,47,44,88
2008-03-17,MEM,98,15,50,CHA,80,24,42,39,92
2008-03-17,NOH,108,44,21,CHI,97,26,39,70,60
2008-03-17,MIN,99,15,50,LAC,90,21,44,36,94
2008-03-17,SAS,91,44,22,BOS,93,52,13,96,35
2008-03-17,UTA,96,44,24,TOR,79,34,32,78,56
2008-03-18,DET,136,48,18,DEN,120,40,26,88,44
2008-03-18,MIL,106,23,43,MIA,112,11,54,34,97
2008-03-18,CHI,112,26,40,NJN,96,28,38,54,78
2008-03-18,HOU,74,46,20,BOS,94,53,13,99,33
2008-03-18,DAL,100,44,23,LAL,102,45,21,89,44
2008-03-18,SAC,122,30,36,GSW,105,41,24,71,60
2008-03-18,POR,98,35,32,PHX,111,44,22,79,54
2008-03-19,TOR,96,34,33,MIA,54,12,54,46,87
2008-03-19,PHI,115,33,34,DEN,113,40,27,73,61
2008-03-19,ORL,86,45,24,WAS,87,33,33,78,57
2008-03-19,IND,102,26,41,CHA,95,24,43,50,84
2008-03-19,NJN,125,28,39,ATL,117,29,38,57,77
2008-03-19,CLE,89,38,30,DET,73,49,18,87,48
2008-03-19,NOH,90,45,21,HOU,69,46,21,91,42
2008-03-19,MIN,98,16,50,MEM,94,16,50,32,100
2008-03-19,SEA,98,16,51,PHX,110,45,22,61,73
2008-03-19,LAC,100,21,45,GSW,116,41,25,62,70
2008-03-20,CHI,80,27,40,SAS,102,44,23,71,63
2008-03-20,DAL,90,44,24,BOS,94,54,13,98,37
2008-03-20,UTA,95,45,24,LAL,106,46,21,91,45
2008-03-21,ORL,113,45,25,PHI,95,34,34,79,59
2008-03-21,IND,124,27,41,MIN,113,17,50,44,91
2008-03-21,NJN,114,29,39,DEN,125,40,28,69,67
2008-03-21,NYK,106,19,48,MEM,120,16,51,35,99
2008-03-21,MIA,86,12,55,WAS,103,34,33,46,88
2008-03-21,CLE,90,39,30,TOR,83,35,33,74,63
2008-03-21,SAS,102,45,23,SAC,89,31,36,76,59
2008-03-21,POR,107,35,33,LAC,102,21,46,56,79
2008-03-21,LAL,130,47,21,SEA,105,16,52,63,73
2008-03-21,GSW,106,42,25,HOU,109,46,22,88,47
2008-03-22,PHI,91,34,35,NJN,87,29,40,63,75
2008-03-22,CHA,94,24,44,MIA,82,12,56,36,100
2008-03-22,ATL,98,29,39,ORL,90,46,25,75,64
2008-03-22,MEM,117,17,51,SAC,111,31,37,48,88
2008-03-22,NOH,113,46,21,BOS,106,55,13,101,34
2008-03-22,MIN,114,17,51,NYK,93,19,49,36,100
2008-03-22,CHI,101,27,41,IND,108,28,41,55,82
2008-03-22,MIL,108,23,44,CLE,98,40,30,63,74
2008-03-22,UTA,115,45,25,SEA,101,16,53,61,78
2008-03-22,PHX,122,46,22,HOU,113,47,22,93,44
2008-03-22,LAC,72,21,47,POR,83,36,33,57,80
2008-03-23,DAL,81,44,25,SAS,88,46,23,90,48
2008-03-23,TOR,100,35,34,DEN,109,41,28,76,62
2008-03-23,WAS,95,35,33,DET,83,49,19,84,52
2008-03-23,LAL,111,48,21,GSW,115,42,26,90,47
2008-03-24,BOS,90,55,14,PHI,95,35,35,90,49
2008-03-24,NYK,91,19,50,NJN,106,29,41,48,91
2008-03-24,MIA,78,12,57,MIL,73,24,44,36,101
2008-03-24,DET,110,49,20,PHX,105,47,22,96,42
2008-03-24,MEM,106,18,51,DEN,120,42,28,60,79
2008-03-24,HOU,108,47,23,SAC,100,31,38,78,61
2008-03-24,SEA,97,16,54,POR,84,37,33,53,87
2008-03-24,GSW,119,43,26,LAL,123,48,22,91,48
2008-03-25,ORL,97,46,26,SAS,107,47,23,93,49
2008-03-25,IND,106,29,41,NOH,114,47,21,76,62
2008-03-25,CHI,103,27,42,ATL,94,30,39,57,81
2008-03-25,DAL,103,44,26,LAC,90,21,48,65,74
2008-03-25,UTA,128,46,25,CHA,106,25,44,71,69
2008-03-25,POR,102,37,34,WAS,82,36,33,73,67
2008-03-26,TOR,89,35,35,DET,82,50,20,85,55
2008-03-26,NYK,103,19,51,MIA,96,13,57,32,108
2008-03-26,PHI,121,36,35,CHI,99,28,42,64,77
2008-03-26,ATL,115,30,40,MIL,96,24,45,54,85
2008-03-26,CLE,99,40,31,NOH,100,48,21,88,52
2008-03-26,BOS,117,55,15,PHX,97,47,23,102,38
2008-03-26,NJN,124,30,41,IND,117,29,42,59,83
2008-03-26,HOU,97,48,23,MIN,86,18,51,66,74
2008-03-26,SAS,97,48,23,LAC,88,21,49,69,72
2008-03-26,SAC,107,31,39,MEM,106,18,52,49,91
2008-03-26,SEA,99,17,54,WAS,104,36,34,53,88
2008-03-26,LAL,95,49,22,CHA,108,25,45,74,67
2008-03-27,DET,85,50,21,MIA,69,13,58,63,79
2008-03-27,DEN,118,43,28,DAL,105,45,26,88,54
2008-03-27,GSW,111,43,27,POR,95,38,34,81,61
2008-03-28,TOR,103,36,35,NYK,95,20,51,56,86
2008-03-28,PHI,93,37,35,PHX,107,47,24,84,59
2008-03-28,IND,123,29,43,NJN,115,31,41,60,84
2008-03-28,BOS,112,56,15,NOH,92,49,21,105,36
2008-03-28,ATL,106,31,40,CHI,103,28,43,59,83
2008-03-28,MIL,86,24,46,ORL,103,46,27,70,73
2008-03-28,SAS,99,49,23,MIN,84,18,52,67,75
2008-03-28,UTA,121,47,25,LAC,101,21,50,68,75
2008-03-28,SAC,108,32,39,WAS,114,37,34,69,73
2008-03-28,LAL,111,49,23,MEM,114,18,53,67,76
2008-03-28,SEA,93,17,55,CHA,96,26,45,43,100
2008-03-29,NJN,104,31,42,PHX,110,48,24,79,66
2008-03-29,DET,85,51,21,CLE,71,40,32,91,53
2008-03-29,CHI,114,28,44,MIL,111,24,47,52,91
2008-03-29,DEN,119,44,28,GSW,112,44,27,88,55
2008-03-29,POR,85,38,35,CHA,93,27,45,65,80
2008-03-29,LAC,110,21,51,MEM,97,19,53,40,104
2008-03-30,SAS,109,50,23,HOU,88,49,23,99,46
2008-03-30,MIN,110,18,53,UTA,103,48,25,66,78
2008-03-30,ATL,114,32,40,NYK,109,20,52,52,92
2008-03-30,BOS,88,57,15,MIA,62,13,59,70,74
2008-03-30,TOR,111,37,35,NOH,118,49,22,86,57
2008-03-30,CLE,91,40,33,PHI,88,37,36,77,69
2008-03-30,GSW,114,44,28,DAL,104,45,27,89,55
2008-03-30,SEA,107,17,56,SAC,120,32,40,49,96
2008-03-30,LAL,126,49,24,WAS,120,38,34,87,58
2008-03-31,CHA,100,28,45,TOR,104,37,36,65,81
2008-03-31,IND,105,30,43,MIA,85,13,60,43,103
2008-03-31,MEM,99,19,54,ATL,116,33,40,52,94
2008-03-31,UTA,129,48,26,WAS,87,38,35,86,61
2008-03-31,PHX,132,49,24,DEN,117,45,28,94,52
2008-03-31,LAC,86,22,51,DAL,93,45,28,67,79
2008-04-01,ORL,97,47,27,NOH,98,50,22,97,49
2008-04-01,NJN,99,31,43,PHI,108,37,37,68,80
2008-04-01,MIL,119,24,48,NYK,115,20,53,44,101
2008-04-01,MIN,90,19,53,DET,94,52,21,71,74
2008-04-01,CHI,92,29,44,BOS,106,58,15,87,59
2008-04-01,SAS,116,51,23,GSW,92,45,28,96,51
2008-04-01,DEN,126,45,29,PHX,120,50,24,95,53
2008-04-01,SAC,99,33,40,HOU,98,49,24,82,64
2008-04-02,WAS,109,38,36,MIL,110,25,48,63,84
2008-04-02,CHA,114,28,46,CLE,118,41,33,69,79
2008-04-02,ATL,127,34,40,TOR,120,38,36,72,76
2008-04-02,BOS,92,59,15,IND,77,31,43,90,58
2008-04-02,MIA,77,13,61,NOH,106,51,22,64,83
2008-04-02,MEM,130,19,55,NYK,114,20,54,39,109
2008-04-02,UTA,117,49,26,MIN,100,19,54,68,80
2008-04-02,DAL,111,46,28,GSW,86,45,29,91,57
2008-04-02,SEA,84,17,57,LAC,102,22,52,39,109
2008-04-02,LAL,104,50,24,POR,91,38,36,88,60
2008-04-03,CLE,98,42,33,CHI,101,29,45,71,78
2008-04-03,SAC,110,34,40,LAC,98,23,52,57,92
2008-04-03,POR,86,38,37,HOU,95,49,25,87,62
2008-04-04,TOR,100,38,37,CHA,105,28,47,66,84
2008-04-04,ATL,104,35,40,PHI,109,38,37,73,77
2008-04-04,WAS,109,38,37,MIA,95,13,62,51,99
2008-04-04,DET,106,53,21,NJN,87,31,44,84,65
2008-04-04,MEM,86,20,55,GSW,117,45,30,65,85
2008-04-04,NOH,118,52,22,NYK,110,20,55,72,77
2008-04-04,MIL,101,26,48,IND,105,31,44,57,92
2008-04-04,UTA,90,50,26,SAS,64,52,23,102,49
2008-04-04,PHX,117,50,25,MIN,88,19,55,69,80
2008-04-04,LAL,112,51,24,DAL,108,47,28,98,52
2008-04-04,SEA,66,17,58,HOU,79,50,25,67,83
2008-04-05,CLE,86,42,34,ORL,101,47,28,89,62
2008-04-05,PHI,85,39,37,ATL,92,35,41,74,78
2008-04-05,CHA,78,29,47,BOS,101,60,15,89,62
2008-04-05,NJN,99,31,45,TOR,90,38,38,69,83
2008-04-05,CHI,87,30,45,WAS,99,39,37,69,82
2008-04-05,DEN,115,46,29,SAC,118,35,40,81,69
2008-04-06,MIA,75,13,63,DET,91,54,21,67,84
2008-04-06,PHX,98,51,25,DAL,105,47,29,98,54
2008-04-06,NYK,100,20,56,ORL,90,48,28,68,84
2008-04-06,IND,105,32,44,MIL,97,26,49,58,93
2008-04-06,POR,65,38,38,SAS,72,52,24,90,62
2008-04-06,MIN,101,19,56,MEM,113,20,56,39,112
2008-04-06,NOH,108,53,22,GSW,96,46,30,99,52
2008-04-06,SAC,92,36,40,LAL,114,52,24,88,64
2008-04-06,SEA,151,17,59,DEN,147,46,30,63,89
2008-04-06,LAC,79,23,53,HOU,105,51,25,74,78
2008-04-08,CHA,121,29,48,MIN,119,19,57,48,105
2008-04-08,IND,112,33,44,ATL,98,36,41,69,85
2008-04-08,MIA,95,13,64,CHI,88,30,46,43,110
2008-04-08,DET,94,55,21,NYK,98,21,56,76,77
2008-04-08,MIL,104,26,50,BOS,107,61,15,87,65
2008-04-08,MEM,113,21,56,PHX,127,51,26,72,82
2008-04-08,NOH,66,54,22,UTA,77,51,26,105,48
2008-04-08,DAL,99,48,29,SEA,83,18,59,66,88
2008-04-08,POR,112,38,39,LAL,103,53,24,91,63
2008-04-08,LAC,99,23,54,DEN,117,46,31,69,85
2008-04-08,GSW,140,46,31,SAC,132,36,41,82,72
2008-04-09,TOR,111,38,39,MIL,93,26,51,64,90
2008-04-09,PHI,101,39,38,DET,94,55,22,94,60
2008-04-09,WAS,109,40,37,BOS,95,62,15,102,52
2008-04-09,ORL,115,48,29,CHI,83,30,47,78,76
2008-04-09,CLE,104,42,35,NJN,83,32,45,74,80
2008-04-09,NYK,109,22,56,CHA,107,30,48,52,104
2008-04-09,MIN,90,19,58,NOH,122,54,23,73,81
2008-04-09,HOU,103,52,25,SEA,80,18,60,70,85
2008-04-09,SAS,79,53,24,PHX,96,52,26,105,50
2008-04-10,GSW,105,47,31,DEN,114,47,31,94,62
2008-04-10,DAL,97,49,29,UTA,94,52,26,101,55
2008-04-10,LAC,78,23,55,LAL,106,53,25,76,80
2008-04-11,TOR,113,39,39,NJN,85,32,46,71,85
2008-04-11,PHI,76,40,38,IND,85,34,44,74,82
2008-04-11,ORL,101,49,29,MIN,102,19,59,68,88
2008-04-11,CHI,100,30,48,CLE,95,43,35,73,83
2008-04-11,BOS,102,62,16,MIL,86,26,52,88,68
2008-04-11,NYK,104,23,56,ATL,116,36,42,59,98
2008-04-11,MIA,91,14,64,MEM,96,21,57,35,121
2008-04-11,DET,102,55,23,WAS,74,41,37,96,60
2008-04-11,HOU,101,53,25,PHX,90,53,26,106,51
2008-04-11,SAS,95,53,25,SEA,74,18,61,71,86
2008-04-11,SAC,103,36,42,POR,86,39,39,75,81
2008-04-11,LAL,107,54,25,NOH,104,55,23,109,48
2008-04-12,WAS,109,41,38,PHI,93,40,39,81,77
2008-04-12,ATL,89,37,42,BOS,99,63,16,100,58
2008-04-12,IND,103,35,44,CHA,107,30,49,65,93
2008-04-12,MEM,105,22,57,MIN,114,20,59,42,116
2008-04-12,MIL,98,26,53,NJN,111,32,47,58,100
2008-04-12,UTA,124,52,27,DEN,97,48,31,100,58
2008-04-12,SAC,94,37,42,NOH,91,55,24,92,66
2008-04-12,POR,108,39,40,DAL,105,50,29,89,69
2008-04-12,GSW,122,47,32,LAC,116,23,56,70,88
2008-04-13,CLE,84,43,36,MIA,76,14,65,57,101
2008-04-13,LAL,106,55,25,SAS,85,54,25,109,50
2008-04-13,DET,91,56,23,TOR,84,40,39,96,62
2008-04-13,CHI,84,31,48,ORL,104,49,30,80,78
2008-04-13,DEN,111,48,32,HOU,94,54,25,102,57
2008-04-13,SEA,99,18,62,DAL,95,50,30,68,92
2008-04-14,TOR,91,40,40,MIA,75,14,66,54,106
2008-04-14,PHI,90,40,40,CLE,91,44,36,84,76
2008-04-14,WAS,117,42,38,IND,110,35,45,77,83
2008-04-14,NYK,93,23,57,BOS,99,64,16,87,73
2008-04-14,MIL,135,26,54,CHI,151,31,49,57,103
2008-04-14,UTA,105,53,27,HOU,96,54,26,107,53
2008-04-14,PHX,122,53,27,GSW,116,48,32,101,59
2008-04-14,SAC,98,38,42,SAS,101,54,26,92,68
2008-04-15,ATL,105,37,43,ORL,121,50,30,87,73
2008-04-15,NJN,112,33,47,CHA,108,31,49,64,96
2008-04-15,DET,115,57,23,MIN,103,21,59,78,82
2008-04-15,NOH,114,55,25,LAC,92,23,57,78,82
2008-04-15,POR,113,40,40,MEM,91,22,58,62,98
2008-04-15,LAL,124,56,25,SAC,101,38,43,94,68
2008-04-16,CHA,115,31,50,PHI,109,40,41,71,91
2008-04-16,ORL,103,51,30,WAS,83,43,38,94,68
2008-04-16,CLE,74,45,36,DET,84,58,23,103,59
2008-04-16,IND,132,35,46,NYK,123,23,58,58,104
2008-04-16,BOS,105,65,16,NJN,94,34,47,99,63
2008-04-16,MIA,113,14,67,ATL,99,37,44,51,111
2008-04-16,SAS,109,55,26,UTA,80,54,27,109,53
2008-04-16,MIN,110,21,60,MIL,101,26,55,47,115
2008-04-16,CHI,107,32,49,TOR,97,41,40,73,89
2008-04-16,HOU,93,54,27,LAC,75,23,58,77,85
2008-04-16,DAL,111,50,31,NOH,98,56,25,106,56
2008-04-16,DEN,120,49,32,MEM,111,22,59,71,91
2008-04-16,PHX,100,54,27,POR,91,41,40,95,67
2008-10-28,BOS,90,0,0,CLE,85,0,0,0,0
2008-10-28,CHI,108,0,0,MIL,95,0,0,0,0
2008-10-28,LAL,96,0,0,POR,76,0,0,0,0
2008-10-29,ORL,85,0,0,ATL,99,0,0,0,0
2008-10-29,PHI,84,0,0,TOR,95,0,0,0,0
2008-10-29,WAS,85,0,0,NJN,95,0,0,0,0
2008-10-29,NYK,120,0,0,MIA,115,0,0,0,0
2008-10-29,DET,100,0,0,IND,94,0,0,0,0
2008-10-29,MIN,98,0,0,SAC,96,0,0,0,0
2008-10-29,OKC,87,0,0,MIL,98,0,1,0,1
2008-10-29,SAS,98,0,0,PHX,103,0,0,0,0
2008-10-29,HOU,82,0,0,MEM,71,0,0,0,0
2008-10-29,UTA,98,0,0,DEN,94,0,0,0,0
2008-10-29,GSW,103,0,0,NOH,108,0,0,0,0
2008-10-29,LAC,79,0,0,LAL,117,1,0,1,0
2008-10-30,CLE,96,0,1,CHA,79,0,0,0,1
2008-10-30,DAL,102,0,0,HOU,112,1,0,1,0
2008-10-30,PHX,95,1,0,NOH,108,1,0,2,0
2008-10-31,PHI,116,0,1,NYK,87,1,0,1,1
2008-10-31,TOR,112,1,0,GSW,108,0,1,1,1
2008-10-31,MIA,103,0,1,SAC,77,0,1,0,2
2008-10-31,BOS,96,1,0,CHI,80,1,0,2,0
2008-10-31,MEM,86,0,1,ORL,84,0,1,0,2
2008-10-31,LAC,103,0,1,DEN,113,0,1,0,2
2008-10-31,POR,100,0,1,SAS,99,0,1,0,2
2008-11-01,ATL,95,1,0,PHI,88,1,1,2,1
2008-11-01,CHA,100,0,1,MIA,87,1,1,1,2
2008-11-01,IND,95,0,1,BOS,79,2,0,2,1
2008-11-01,ORL,121,0,2,SAC,103,0,2,0,4
2008-11-01,DET,117,1,0,WAS,109,0,1,1,1
2008-11-01,NJN,97,1,0,GSW,105,0,2,1,2
2008-11-01,MIN,85,1,0,DAL,95,0,1,1,1
2008-11-01,NOH,104,2,0,CLE,92,1,1,3,1
2008-11-01,CHI,96,1,1,MEM,86,1,1,2,2
2008-11-01,HOU,89,2,0,OKC,77,0,1,2,1
2008-11-01,MIL,87,1,1,TOR,91,2,0,3,1
2008-11-01,DEN,97,1,1,LAL,104,2,0,3,1
2008-11-01,UTA,101,1,0,LAC,79,0,2,1,2
2008-11-01,PHX,107,1,1,POR,96,1,1,2,2
2008-11-02,NYK,86,1,1,MIL,94,1,2,2,3
2008-11-02,OKC,88,0,2,MIN,85,1,1,1,3
2008-11-03,CHA,83,1,1,DET,101,2,0,3,1
2008-11-03,ORL,96,1,2,CHI,93,2,1,3,3
2008-11-03,PHI,125,1,2,SAC,91,0,3,1,5
2008-11-03,MEM,90,1,2,GSW,79,1,2,2,4
2008-11-03,DAL,81,1,1,CLE,100,1,2,2,3
2008-11-03,LAC,73,0,3,UTA,89,2,0,2,3
2008-11-04,NJN,86,1,1,PHX,114,2,1,3,2
2008-11-04,HOU,99,3,0,BOS,103,2,1,5,1
2008-11-04,SAS,81,0,2,DAL,98,1,2,1,4
2008-11-05,IND,103,1,1,PHX,113,3,1,4,2
2008-11-05,TOR,93,3,0,DET,100,3,0,6,0
2008-11-05,MIA,106,1,2,PHI,83,2,2,3,4
2008-11-05,NYK,101,1,2,CHA,98,1,2,2,4
2008-11-05,CLE,107,2,2,CHI,93,2,2,4,4
2008-11-05,MIL,112,2,2,WAS,104,0,2,2,4
2008-11-05,MIN,125,1,2,SAS,129,0,3,1,5
2008-11-05,NOH,79,3,0,ATL,87,2,0,5,0
2008-11-05,OKC,83,1,2,BOS,96,3,1,4,3
2008-11-05,UTA,103,3,0,POR,96,1,2,4,2
2008-11-05,SAC,100,0,4,MEM,95,2,2,2,6
2008-11-05,GSW,111,1,3,DEN,101,1,2,2,5
2008-11-05,LAL,106,3,0,LAC,88,0,4,3,4
2008-11-06,ORL,98,2,2,PHI,88,2,3,4,5
2008-11-06,POR,101,1,3,HOU,99,3,1,4,4
2008-11-07,CHA,92,1,3,NOH,89,3,1,4,4
2008-11-07,WAS,108,0,3,NYK,114,2,2,2,5
2008-11-07,ATL,110,3,0,TOR,92,3,1,6,1
2008-11-07,BOS,101,4,1,MIL,89,3,2,7,3
2008-11-07,CLE,111,3,2,IND,107,1,2,4,4
2008-11-07,NJN,103,1,2,DET,96,4,0,5,2
2008-11-07,SAS,83,1,3,MIA,99,2,2,3,5
2008-11-07,CHI,100,2,3,PHX,83,4,1,6,4
2008-11-07,UTA,104,4,0,OKC,97,1,3,5,3
2008-11-07,SAC,121,1,4,MIN,109,1,3,2,7
2008-11-07,DEN,108,1,3,DAL,105,2,2,3,5
2008-11-07,GSW,104,2,3,MEM,109,2,3,4,6
2008-11-07,LAC,83,0,5,HOU,92,3,2,3,7
2008-11-08,IND,98,1,3,NJN,80,2,2,3,5
2008-11-08,ORL,106,3,2,WAS,81,0,4,3,6
2008-11-08,NOH,100,3,2,MIA,89,3,2,6,4
2008-11-08,CHI,97,3,3,CLE,106,4,2,7,5
2008-11-08,MIL,96,3,3,PHX,104,4,2,7,5
2008-11-08,POR,97,2,3,MIN,93,1,4,3,7
2008-11-09,CHA,79,2,3,TOR,89,3,2,5,5
2008-11-09,NYK,107,3,2,UTA,99,5,0,8,2
2008-11-09,LAC,103,0,6,DAL,92,2,3,2,9
2008-11-09,DET,76,4,1,BOS,88,5,1,9,2
2008-11-09,OKC,85,1,4,ATL,89,4,0,5,4
2008-11-09,DEN,100,2,3,MEM,90,3,3,5,6
2008-11-09,SAC,115,2,4,GSW,98,2,4,4,8
2008-11-09,LAL,111,4,0,HOU,82,4,2,8,2
2008-11-10,IND,107,2,3,OKC,99,1,5,3,8
2008-11-10,ORL,99,4,2,POR,106,3,3,7,5
2008-11-10,BOS,94,6,1,TOR,87,4,2,10,3
2008-11-10,MIA,99,3,3,NJN,94,2,3,5,6
2008-11-10,PHX,107,5,2,MEM,102,3,4,8,6
2008-11-11,CHA,80,2,4,DEN,88,3,3,5,7
2008-11-11,CLE,99,5,2,MIL,93,3,4,8,6
2008-11-11,PHI,80,2,4,UTA,93,5,1,7,5
2008-11-11,CHI,108,3,4,ATL,113,5,0,8,4
2008-11-11,DAL,99,2,4,LAL,106,5,0,7,4
2008-11-11,SAS,92,1,4,NYK,80,4,2,5,6
2008-11-11,SAC,92,3,4,DET,100,4,2,7,6
2008-11-11,GSW,113,2,5,MIN,110,1,5,3,10
2008-11-12,TOR,96,4,3,PHI,106,2,5,6,8
2008-11-12,BOS,103,7,1,ATL,102,6,0,13,1
2008-11-12,MIA,96,4,3,POR,104,4,3,8,6
2008-11-12,NJN,87,2,4,IND,98,3,3,5,7
2008-11-12,MEM,103,3,5,NYK,132,4,3,7,8
2008-11-12,MIL,82,3,5,SAS,78,2,4,5,9
2008-11-12,NOH,86,4,2,LAL,93,6,0,10,2
2008-11-12,OKC,92,1,6,ORL,109,4,3,5,9
2008-11-12,WAS,95,0,5,UTA,87,6,1,6,6
2008-11-12,LAC,98,1,6,SAC,103,3,5,4,11
2008-11-12,PHX,82,6,2,HOU,94,4,3,10,5
2008-11-13,CLE,110,6,2,DEN,99,4,3,10,5
2008-11-13,CHI,98,3,5,DAL,91,2,5,5,10
2008-11-13,GSW,102,3,5,DET,107,5,2,8,7
2008-11-14,CHA,104,2,5,UTA,96,6,2,8,7
2008-11-14,IND,92,4,3,PHI,94,3,5,7,8
2008-11-14,MIA,97,4,4,WAS,77,1,5,5,9
2008-11-14,NJN,115,2,5,ATL,108,6,1,8,6
2008-11-14,NYK,116,5,3,OKC,106,1,7,6,10
2008-11-14,BOS,85,8,1,DEN,94,4,4,12,5
2008-11-14,MEM,96,3,6,MIL,101,4,5,7,11
2008-11-14,NOH,87,4,3,POR,82,5,3,9,6
2008-11-14,DAL,100,2,6,ORL,102,5,3,7,9
2008-11-14,SAS,77,2,5,HOU,75,5,3,7,8
2008-11-14,SAC,95,4,5,PHX,97,6,3,10,8
2008-11-14,LAL,95,7,0,DET,106,6,2,13,2
2008-11-15,LAC,103,1,7,GSW,121,3,6,4,13
2008-11-15,ATL,107,6,2,NJN,119,3,5,9,7
2008-11-15,PHI,110,4,5,OKC,85,1,8,5,13
2008-11-15,CLE,105,7,2,UTA,93,6,3,13,5
2008-11-15,MIN,83,1,6,POR,88,5,4,6,10
2008-11-15,CHI,104,4,5,IND,91,4,4,8,9
2008-11-15,HOU,91,5,4,NOH,82,5,3,10,7
2008-11-15,MIL,97,5,5,BOS,102,8,2,13,7
2008-11-16,TOR,107,4,4,MIA,96,5,4,9,8
2008-11-16,CHA,85,3,5,ORL,90,6,3,9,8
2008-11-16,NYK,114,6,3,DAL,124,2,7,8,10
2008-11-16,DEN,90,5,4,MIN,84,1,7,6,11
2008-11-16,PHX,104,7,3,DET,86,7,2,14,5
2008-11-16,SAC,88,4,6,SAS,90,3,5,7,11
2008-11-17,OKC,89,1,9,HOU,100,6,4,7,13
2008-11-17,UTA,109,6,4,PHX,97,8,3,14,7
2008-11-17,LAC,83,1,8,SAS,86,4,5,5,13
2008-11-18,CHA,83,3,6,DAL,100,3,7,6,13
2008-11-18,IND,113,4,5,ATL,96,6,3,10,8
2008-11-18,ORL,103,7,3,TOR,90,5,4,12,7
2008-11-18,WAS,87,1,6,MIA,94,5,5,6,11
2008-11-18,BOS,110,9,2,NYK,101,6,4,15,6
2008-11-18,NJN,82,4,5,CLE,106,8,2,12,7
2008-11-18,MEM,109,3,7,SAC,94,4,7,7,14
2008-11-18,DEN,114,6,4,MIL,105,5,6,11,10
2008-11-18,GSW,111,4,6,POR,106,6,4,10,10
2008-11-18,LAL,116,7,1,CHI,109,5,5,12,6
2008-11-19,ATL,91,6,4,WAS,87,1,7,7,11
2008-11-19,DET,96,7,3,CLE,89,9,2,16,5
2008-11-19,MIA,95,6,5,TOR,101,5,5,11,10
2008-11-19,HOU,86,7,4,DAL,96,4,7,11,11
2008-11-19,MIN,102,1,8,PHI,96,5,5,6,13
2008-11-19,NOH,96,5,4,SAC,105,4,8,9,12
2008-11-19,OKC,88,1,10,LAC,108,1,9,2,19
2008-11-19,SAS,81,5,5,DEN,91,7,4,12,9
2008-11-19,UTA,105,7,4,MIL,94,5,7,12,11
2008-11-19,POR,116,6,5,CHI,74,5,6,11,11
2008-11-20,BOS,98,10,2,DET,80,8,3,18,5
2008-11-20,PHX,92,8,4,LAL,105,8,1,16,5
2008-11-21,IND,98,5,5,ORL,100,8,3,13,8
2008-11-21,PHI,89,5,6,LAC,88,2,9,7,15
2008-11-21,TOR,127,6,5,NJN,129,4,6,10,11
2008-11-21,WAS,91,1,8,HOU,103,7,5,8,13
2008-11-21,ATL,88,7,4,CHA,83,3,7,10,11
2008-11-21,MIN,78,2,8,BOS,95,11,2,13,10
2008-11-21,DAL,91,5,7,MEM,76,4,7,9,14
2008-11-21,MIL,104,5,8,NYK,87,6,5,11,13
2008-11-21,SAS,119,5,6,UTA,94,8,4,13,10
2008-11-21,OKC,80,1,11,NOH,105,5,5,6,16
2008-11-21,SAC,96,5,8,POR,117,7,5,12,13
2008-11-21,GSW,110,5,6,CHI,115,5,7,10,13
2008-11-21,LAL,104,9,1,DEN,90,8,4,17,5
2008-11-22,CHA,74,3,8,MIL,79,6,8,9,16
2008-11-22,ORL,95,9,3,HOU,100,8,5,17,8
2008-11-22,CLE,110,9,3,ATL,96,8,4,17,7
2008-11-22,MIA,109,6,6,IND,100,5,6,11,12
2008-11-22,NJN,112,5,6,LAC,95,2,10,7,16
2008-11-22,NYK,122,6,6,WAS,117,1,9,7,15
2008-11-22,MEM,94,4,8,UTA,103,8,5,12,13
2008-11-22,NOH,109,6,5,OKC,97,1,12,7,17
2008-11-22,PHX,102,8,5,POR,92,8,5,16,10
2008-11-23,TOR,103,6,6,BOS,118,12,2,18,8
2008-11-23,PHI,89,6,6,GSW,81,5,7,11,13
2008-11-23,DET,80,8,4,MIN,106,2,9,10,13
2008-11-23,DEN,114,8,5,CHI,101,6,7,14,12
2008-11-23,LAL,118,10,1,SAC,108,5,9,15,10
2008-11-24,CHA,93,3,9,PHI,84,7,6,10,15
2008-11-24,ORL,108,9,4,MIL,101,7,8,16,12
2008-11-24,MIA,98,7,6,HOU,107,9,5,16,11
2008-11-24,MEM,81,4,9,SAS,94,6,6,10,15
2008-11-24,UTA,100,9,5,CHI,101,6,8,15,13
2008-11-24,POR,91,8,6,SAC,90,5,10,13,16
2008-11-24,LAC,87,2,11,NOH,99,7,5,9,16
2008-11-25,WAS,124,1,10,GSW,100,5,8,6,18
2008-11-25,NYK,101,7,6,CLE,119,10,3,17,9
2008-11-25,OKC,98,1,13,PHX,99,9,5,10,18
2008-11-25,DAL,109,6,7,IND,106,5,7,11,14
2008-11-25,LAL,120,11,1,NJN,93,6,6,17,7
2008-11-26,ATL,102,8,5,MIL,96,7,9,15,14
2008-11-26,CLE,117,11,3,OKC,82,1,14,12,17
2008-11-26,TOR,93,6,7,CHA,86,4,9,10,16
2008-11-26,BOS,119,13,2,GSW,111,5,9,18,11
2008-11-26,PHI,94,7,7,ORL,96,10,4,17,11
2008-11-26,DET,110,8,5,NYK,96,7,7,15,12
2008-11-26,MIN,102,3,9,PHX,110,10,5,13,14
2008-11-26,HOU,90,10,5,IND,91,5,8,15,13
2008-11-26,SAS,98,7,6,CHI,88,7,8,14,14
2008-11-26,UTA,117,9,6,MEM,100,4,10,13,16
2008-11-26,POR,106,9,6,MIA,68,7,7,16,13
2008-11-26,SAC,114,5,11,NJN,116,6,7,11,18
2008-11-26,LAC,105,2,12,DEN,106,9,5,11,17
2008-11-27,WAS,90,2,10,ORL,105,11,4,13,14
2008-11-27,DEN,101,10,5,NOH,105,8,5,18,10
2008-11-28,TOR,93,7,7,ATL,88,9,5,16,12
2008-11-28,BOS,102,14,2,PHI,78,7,8,21,10
2008-11-28,CLE,112,12,3,GSW,97,5,10,17,13
2008-11-28,DET,107,9,5,MIL,97,7,10,16,15
2008-11-28,IND,108,6,8,CHA,115,4,10,10,18
2008-11-28,OKC,103,1,15,MIN,105,3,10,4,25
2008-11-28,PHX,92,11,5,MIA,107,7,8,18,13
2008-11-28,SAS,109,8,6,MEM,98,4,11,12,17
2008-11-28,UTA,120,10,6,SAC,94,5,12,15,18
2008-11-28,POR,101,10,6,NOH,86,9,5,19,11
2008-11-28,LAL,114,12,1,DAL,107,7,7,19,8
2008-11-29,CHA,84,5,10,BOS,89,15,2,20,12
2008-11-29,ORL,110,12,4,IND,96,6,9,18,13
2008-11-29,WAS,98,2,11,ATL,102,9,6,11,17
2008-11-29,NYK,138,7,8,GSW,125,5,11,12,19
2008-11-29,MEM,103,4,12,OKC,111,1,16,5,28
2008-11-29,MIN,97,4,10,DEN,106,10,6,14,16
2008-11-29,HOU,103,10,6,SAS,84,9,6,19,12
2008-11-29,MIL,85,7,11,CLE,97,13,3,20,14
2008-11-29,UTA,88,11,6,NJN,105,7,7,18,13
2008-11-29,SAC,78,5,13,DAL,101,7,8,12,21
2008-11-29,LAC,97,2,13,MIA,96,8,8,10,21
2008-11-30,DET,85,10,5,POR,96,11,6,21,11
2008-11-30,PHI,92,7,9,CHI,103,7,9,14,18
2008-11-30,DEN,104,11,6,HOU,94,11,6,22,12
2008-11-30,PHX,109,11,6,NJN,117,8,7,19,13
2008-11-30,LAL,112,13,1,TOR,99,8,7,21,8
2008-12-01,CHA,100,5,11,MIN,90,4,11,9,22
2008-12-01,BOS,107,16,2,ORL,88,13,4,29,6
2008-12-01,GSW,129,5,12,MIA,130,8,9,13,21
2008-12-02,IND,118,6,10,LAL,117,14,1,20,11
2008-12-02,NJN,88,9,7,WAS,108,2,12,11,19
2008-12-02,NYK,97,8,8,POR,104,12,6,20,14
2008-12-02,CHI,95,8,9,PHI,103,7,10,15,19
2008-12-02,DAL,100,8,8,LAC,98,3,13,11,21
2008-12-02,SAS,77,9,7,DET,89,10,6,19,13
2008-12-02,DEN,132,12,6,TOR,93,8,8,20,14
2008-12-02,SAC,94,5,14,UTA,99,11,7,16,21
2008-12-03,ATL,105,10,6,MEM,95,4,13,14,19
2008-12-03,CHA,103,6,11,OKC,97,2,16,8,27
2008-12-03,CLE,118,14,3,NYK,82,8,9,22,12
2008-12-03,ORL,100,13,5,MIN,89,4,12,17,17
2008-12-03,PHI,102,8,10,LAL,114,14,2,22,12
2008-12-03,WAS,92,3,12,POR,98,13,6,16,18
2008-12-03,BOS,114,17,2,IND,96,7,10,24,12
2008-12-03,MIL,97,7,12,CHI,90,8,10,15,22
2008-12-03,NOH,104,9,6,PHX,91,11,7,20,13
2008-12-03,HOU,103,11,7,LAC,96,3,14,14,21
2008-12-03,UTA,89,12,7,MIA,93,9,9,21,16
2008-12-04,DAL,112,9,8,PHX,97,11,8,20,16
2008-12-04,DEN,91,13,6,SAS,108,9,8,22,14
2008-12-05,ORL,98,14,5,OKC,89,2,17,16,22
2008-12-05,WAS,104,3,13,LAL,106,15,2,18,15
2008-12-05,ATL,98,11,6,NYK,95,8,10,19,16
2008-12-05,CLE,97,15,3,IND,73,7,11,22,14
2008-12-05,NJN,113,9,8,MIN,84,4,13,13,21
2008-12-05,BOS,93,18,2,POR,78,14,6,32,8
2008-12-05,DET,91,11,6,PHI,96,8,11,19,17
2008-12-05,MEM,93,4,14,LAC,81,3,15,7,29
2008-12-05,HOU,131,12,7,GSW,112,5,13,17,20
2008-12-05,MIL,101,8,12,CHA,96,7,11,15,23
2008-12-05,UTA,114,12,8,TOR,87,8,9,20,17
2008-12-06,CHA,74,7,12,CLE,94,16,3,23,15
2008-12-06,MIA,105,10,9,OKC,99,2,18,12,27
2008-12-06,PHI,84,9,11,NJN,95,10,8,19,19
2008-12-06,MIN,84,4,14,LAC,107,3,16,7,30
2008-12-06,NOH,106,10,6,MEM,87,5,14,15,20
2008-12-06,CHI,117,8,11,WAS,110,3,14,11,25
2008-12-06,DAL,100,10,8,ATL,98,12,6,22,14
2008-12-06,SAS,123,10,8,GSW,88,5,14,15,22
2008-12-06,PHX,106,11,9,UTA,104,13,8,24,17
2008-12-06,SAC,85,5,15,DEN,118,13,7,18,22
2008-12-07,NYK,104,8,11,DET,92,11,7,19,18
2008-12-07,TOR,97,8,10,POR,98,14,7,22,17
2008-12-07,IND,117,7,12,BOS,122,19,2,26,14
2008-12-07,LAL,105,16,2,MIL,92,9,12,25,14
2008-12-08,MIA,100,11,9,CHA,96,7,13,18,22
2008-12-08,MEM,109,5,15,HOU,97,13,7,18,22
2008-12-08,OKC,102,2,19,GSW,112,5,15,7,34
2008-12-08,LAC,88,4,16,ORL,95,15,5,19,21
2008-12-09,CLE,114,17,3,TOR,94,8,11,25,14
2008-12-09,WAS,107,3,15,DET,94,11,8,14,23
2008-12-09,MIN,96,4,15,UTA,99,13,9,17,24
2008-12-09,CHI,105,9,11,NYK,100,9,11,18,22
2008-12-09,DAL,126,11,8,SAS,133,11,8,22,16
2008-12-09,HOU,92,13,8,ATL,84,12,7,25,15
2008-12-09,PHX,125,12,9,MIL,110,9,13,21,22
2008-12-09,POR,108,15,7,ORL,109,16,5,31,12
2008-12-09,SAC,113,5,16,LAL,101,17,2,22,18
2008-12-10,TOR,101,8,12,IND,88,7,13,15,25
2008-12-10,NJN,109,11,8,NYK,121,9,12,20,20
2008-12-10,NOH,105,11,6,CHA,89,7,14,18,20
2008-12-10,OKC,102,2,20,MEM,108,6,15,8,35
2008-12-10,PHI,93,9,12,CLE,101,18,3,27,15
2008-12-10,SAS,95,12,8,ATL,89,12,8,24,16
2008-12-10,DEN,116,14,7,MIN,105,4,16,18,23
2008-12-10,GSW,119,6,15,MIL,96,9,14,15,29
2008-12-10,LAL,115,17,3,PHX,110,13,9,30,12
2008-12-11,WAS,88,4,15,BOS,122,20,2,24,17
2008-12-11,DAL,95,11,9,CHA,90,7,15,18,24
2008-12-11,UTA,97,14,9,POR,88,15,8,29,17
2008-12-12,CLE,88,19,3,PHI,72,9,13,28,16
2008-12-12,MIA,73,12,9,ATL,87,12,9,24,18
2008-12-12,NJN,79,11,9,TOR,101,9,12,20,21
2008-12-12,BOS,94,21,2,NOH,82,12,6,33,8
2008-12-12,DET,114,11,9,IND,110,7,14,18,23
2008-12-12,MEM,103,7,15,CHI,96,10,11,17,26
2008-12-12,MIN,86,4,17,SAS,98,13,8,17,25
2008-12-12,PHX,113,13,10,ORL,112,17,5,30,15
2008-12-12,POR,112,15,9,LAC,120,4,17,19,26
2008-12-12,GSW,108,7,15,HOU,119,14,8,21,23
2008-12-12,LAL,112,18,3,SAC,103,6,16,24,19
2008-12-13,ATL,97,13,9,CLE,92,20,3,33,12
2008-12-13,CHA,86,7,16,DET,90,12,9,19,25
2008-12-13,PHI,104,9,14,WAS,89,4,16,13,30
2008-12-13,CHI,113,10,12,NJN,104,11,10,21,22
2008-12-13,DAL,103,12,9,OKC,99,2,21,14,30
2008-12-13,MIL,121,9,15,IND,103,7,15,16,30
2008-12-13,DEN,123,15,7,GSW,105,7,16,22,23
2008-12-13,UTA,94,15,9,ORL,103,17,6,32,15
2008-12-13,SAC,90,6,17,NYK,114,10,12,16,29
2008-12-13,LAC,95,5,17,HOU,82,15,8,20,25
2008-12-14,TOR,91,10,12,NOH,99,12,7,22,19
2008-12-14,MEM,102,8,15,MIA,86,12,10,20,25
2008-12-14,SAS,109,14,8,OKC,104,2,22,16,30
2008-12-14,LAL,98,19,3,MIN,86,4,18,23,21
2008-12-15,ATL,83,14,9,CHA,79,7,17,21,26
2008-12-15,TOR,87,10,13,NJN,94,11,11,21,24
2008-12-15,WAS,98,4,17,IND,118,7,16,11,33
2008-12-15,BOS,100,22,2,UTA,91,15,10,37,12
2008-12-15,MIA,83,12,11,MIL,98,10,15,22,26
2008-12-15,DAL,88,13,9,DEN,98,16,7,29,16
2008-12-15,PHX,111,14,10,NYK,103,11,12,25,22
2008-12-15,SAC,118,6,18,MIN,103,4,19,10,37
2008-12-15,GSW,98,7,17,ORL,109,18,6,25,23
2008-12-16,CHA,110,7,18,CHI,101,11,12,18,30
2008-12-16,MEM,84,9,15,NOH,91,13,7,22,22
2008-12-16,OKC,88,2,23,LAC,98,6,17,8,40
2008-12-16,HOU,108,15,9,DEN,96,17,7,32,16
2008-12-16,POR,109,15,10,SAC,77,7,18,22,28
2008-12-16,LAL,116,20,3,NYK,114,11,13,31,16
2008-12-17,ATL,85,15,9,BOS,88,23,2,38,11
2008-12-17,IND,127,8,16,GSW,120,7,18,15,34
2008-12-17,PHI,93,10,14,MIL,88,11,15,21,29
2008-12-17,TOR,86,10,14,DAL,96,13,10,23,24
2008-12-17,DET,88,13,9,WAS,74,4,18,17,27
2008-12-17,NJN,92,12,11,UTA,103,15,11,27,22
2008-12-17,MIN,70,4,20,CLE,93,20,4,24,24
2008-12-17,CHI,115,11,13,LAC,109,7,17,18,30
2008-12-17,NOH,90,14,7,SAS,83,15,8,29,15
2008-12-18,ORL,90,19,6,SAS,78,15,9,34,15
2008-12-18,POR,124,16,10,PHX,119,15,10,31,20
2008-12-19,IND,109,9,16,LAC,117,7,18,16,34
2008-12-19,WAS,103,4,19,PHI,109,11,14,15,33
2008-12-19,ATL,115,15,10,GSW,99,7,19,22,29
2008-12-19,BOS,126,24,2,CHI,108,12,13,36,15
2008-12-19,NJN,121,12,12,DAL,97,14,10,26,22
2008-12-19,NYK,81,11,14,MIL,105,11,16,22,30
2008-12-19,DET,114,14,9,UTA,120,16,11,30,20
2008-12-19,MEM,83,9,16,CHA,112,8,18,17,34
2008-12-19,MIA,89,12,12,LAL,87,21,3,33,15
2008-12-19,OKC,91,2,24,TOR,83,10,15,12,39
2008-12-19,HOU,107,16,9,SAC,96,7,19,23,28
2008-12-19,DEN,88,17,8,CLE,105,21,4,38,12
2008-12-20,CHA,103,9,18,GSW,110,7,20,16,38
2008-12-20,ORL,106,20,6,LAL,103,21,4,41,10
2008-12-20,PHI,94,12,14,IND,95,9,17,21,31
2008-12-20,MIN,102,4,21,HOU,109,17,9,21,30
2008-12-20,NJN,103,13,12,MIA,106,13,12,26,24
2008-12-20,NOH,99,15,7,SAC,90,7,20,22,27
2008-12-20,CHI,106,12,14,UTA,98,17,11,29,25
2008-12-20,MIL,119,12,16,LAC,85,8,18,20,34
2008-12-20,SAS,107,15,10,TOR,97,10,16,25,26
2008-12-20,PHX,108,15,11,DEN,101,17,9,32,20
2008-12-21,ATL,85,16,10,DET,78,14,10,30,20
2008-12-21,BOS,124,25,2,NYK,105,11,15,36,17
2008-12-21,WAS,86,4,20,DAL,97,14,11,18,31
2008-12-21,OKC,91,3,24,CLE,102,22,4,25,28
2008-12-22,ORL,113,21,6,GSW,81,8,20,29,26
2008-12-22,NJN,91,13,13,HOU,114,18,9,31,22
2008-12-22,MEM,96,9,17,LAL,105,21,5,30,22
2008-12-22,SAS,101,16,10,SAC,85,7,21,23,31
2008-12-22,DEN,97,17,10,POR,89,17,10,34,20
2008-12-22,LAC,75,8,19,TOR,97,10,17,18,36
2008-12-23,ATL,99,17,10,OKC,88,3,25,20,35
2008-12-23,CHA,80,9,19,WAS,72,4,21,13,40
2008-12-23,CLE,99,23,4,HOU,90,19,9,42,13
2008-12-23,IND,107,10,17,NJN,108,13,14,23,31
2008-12-23,BOS,110,26,2,PHI,91,12,15,38,17
2008-12-23,MIA,96,14,12,GSW,88,8,21,22,33
2008-12-23,DET,104,14,11,CHI,98,13,14,27,25
2008-12-23,MIL,94,13,16,UTA,86,17,12,30,28
2008-12-23,NOH,87,16,7,LAL,100,22,5,38,12
2008-12-23,DAL,100,15,11,MEM,82,9,18,24,29
2008-12-23,SAS,99,17,10,MIN,93,4,22,21,32
2008-12-23,POR,101,17,11,DEN,92,18,10,35,21
2008-12-25,ORL,88,22,6,NOH,68,16,8,38,14
2008-12-25,PHX,90,16,11,SAS,91,18,10,34,21
2008-12-25,LAL,92,23,5,BOS,83,27,2,50,7
2008-12-25,CLE,93,24,4,WAS,89,4,22,28,26
2008-12-25,POR,94,18,11,DAL,102,16,11,34,22
2008-12-26,MIA,90,15,12,CHI,77,13,15,28,27
2008-12-26,NJN,87,14,14,CHA,95,10,19,24,33
2008-12-26,NYK,107,11,16,MIN,120,4,23,15,39
2008-12-26,DET,90,15,11,OKC,88,3,26,18,37
2008-12-26,MEM,108,9,19,IND,105,10,18,19,37
2008-12-26,NOH,88,16,9,HOU,79,19,10,35,19
2008-12-26,DEN,105,18,11,PHI,101,12,16,30,27
2008-12-26,UTA,97,17,13,DAL,88,17,11,34,24
2008-12-26,SAC,101,7,22,TOR,107,11,17,18,39
2008-12-26,GSW,99,8,22,BOS,89,27,3,35,25
2008-12-27,ATL,129,18,10,CHI,117,13,16,31,26
2008-12-27,CHA,103,11,19,NJN,114,14,15,25,34
2008-12-27,WAS,104,4,23,OKC,95,3,27,7,50
2008-12-27,MIN,94,5,23,ORL,118,23,6,28,29
2008-12-27,HOU,120,19,11,UTA,115,18,13,37,24
2008-12-27,MIL,76,14,16,DET,87,16,11,30,27
2008-12-27,SAS,106,19,10,MEM,103,10,19,29,29
2008-12-27,POR,102,18,12,TOR,89,12,17,30,29
2008-12-28,NYK,110,11,17,DEN,117,19,11,30,28
2008-12-28,LAC,76,8,20,DAL,98,17,12,25,32
2008-12-28,CLE,93,25,4,MIA,86,16,12,41,16
2008-12-28,IND,103,10,19,NOH,105,17,9,27,28
2008-12-28,SAC,63,7,23,BOS,108,27,4,34,27
2008-12-28,LAL,130,24,5,GSW,113,9,22,33,27
2008-12-29,ATL,109,19,10,DEN,91,20,11,39,21
2008-12-29,DET,88,17,11,ORL,82,24,6,41,17
2008-12-29,NJN,87,15,15,CHI,100,13,17,28,32
2008-12-29,MIN,108,5,24,MEM,98,10,20,15,44
2008-12-29,OKC,102,3,28,PHX,110,16,12,19,40
2008-12-29,HOU,87,20,11,WAS,89,5,23,25,34
2008-12-29,UTA,112,18,14,PHI,95,12,17,30,31
2008-12-29,GSW,117,9,23,TOR,111,12,18,21,41
2008-12-30,CHA,89,11,20,NYK,93,11,18,22,38
2008-12-30,IND,104,10,20,ATL,110,20,10,30,30
2008-12-30,MIA,104,16,13,CLE,95,26,4,42,17
2008-12-30,MEM,89,10,21,PHX,101,17,12,27,33
2008-12-30,NOH,97,18,9,WAS,85,6,23,24,32
2008-12-30,DAL,107,18,12,MIN,100,6,24,24,36
2008-12-30,SAS,98,20,10,MIL,100,14,17,34,27
2008-12-30,POR,91,19,12,BOS,86,28,4,47,16
2008-12-30,SAC,92,7,24,LAC,90,8,21,15,45
2008-12-31,CHI,94,14,17,ORL,113,24,7,38,24
2008-12-31,DET,83,18,11,NJN,75,15,16,33,27
2008-12-31,HOU,85,20,12,MIL,81,15,17,35,29
2008-12-31,TOR,107,12,19,DEN,114,20,12,32,31
2008-12-31,OKC,107,3,29,GSW,100,10,23,13,52
2008-12-31,LAC,92,8,22,PHI,100,12,18,20,40
2009-01-02,ORL,86,25,7,MIA,76,17,13,42,20
2009-01-02,TOR,94,12,20,HOU,73,21,12,33,32
2009-01-02,BOS,108,28,5,WAS,83,6,24,34,29
2009-01-02,CLE,117,26,5,CHI,92,14,18,40,23
2009-01-02,NJN,93,15,17,ATL,91,21,10,36,27
2009-01-02,NYK,103,12,18,IND,105,10,21,22,39
2009-01-02,DET,98,19,11,SAC,92,8,24,27,35
2009-01-02,MEM,80,10,22,SAS,91,20,11,30,33
2009-01-02,MIN,115,6,25,GSW,108,10,24,16,49
2009-01-02,OKC,120,4,29,DEN,122,21,12,25,41
2009-01-02,DAL,96,19,12,PHI,86,13,18,32,30
2009-01-02,MIL,103,15,18,CHA,75,11,21,26,39
2009-01-02,PHX,106,18,12,LAC,98,8,23,26,35
2009-01-02,POR,77,20,12,NOH,92,19,9,39,21
2009-01-02,LAL,113,25,5,UTA,100,19,14,44,19
2009-01-03,ATL,103,21,11,HOU,100,21,13,42,24
2009-01-03,CHA,102,11,22,MIL,92,16,18,27,40
2009-01-03,IND,122,11,21,SAC,117,8,25,19,46
2009-01-03,MIA,101,17,14,NJN,96,16,17,33,31
2009-01-03,CHI,92,14,19,MIN,102,7,25,21,44
2009-01-03,SAS,108,21,11,PHI,106,13,19,34,30
2009-01-03,DEN,105,22,12,NOH,100,20,9,42,21
2009-01-04,TOR,108,13,20,ORL,102,26,7,39,27
2009-01-04,WAS,80,6,25,CLE,77,27,5,33,30
2009-01-04,LAC,87,8,24,DET,88,20,11,28,35
2009-01-04,MEM,102,10,23,DAL,82,20,12,30,35
2009-01-04,NYK,100,12,19,BOS,88,29,5,41,24
2009-01-04,LAL,100,26,5,POR,86,20,13,46,18
2009-01-05,MIA,84,18,14,SAS,91,22,11,40,25
2009-01-05,NJN,98,16,18,SAC,90,8,26,24,44
2009-01-05,MIL,107,16,19,TOR,97,14,20,30,39
2009-01-05,DEN,135,23,12,IND,115,12,21,35,33
2009-01-05,UTA,119,19,15,GSW,114,10,25,29,40
2009-01-06,CHA,114,12,22,BOS,106,29,6,41,28
2009-01-06,ORL,89,26,8,WAS,80,7,25,33,33
2009-01-06,PHI,104,13,20,HOU,96,21,14,34,34
2009-01-06,MEM,87,11,23,MIN,94,8,25,19,48
2009-01-06,OKC,107,4,30,NYK,99,13,19,17,49
2009-01-06,CHI,99,14,20,SAC,94,8,27,22,47
2009-01-06,DAL,107,20,13,LAC,102,8,25,28,38
2009-01-06,LAL,105,27,5,NOH,116,20,10,47,15
2009-01-07,ATL,102,22,11,ORL,106,27,8,49,19
2009-01-07,CLE,111,27,6,CHA,81,13,22,40,28
2009-01-07,WAS,93,7,26,TOR,99,14,21,21,47
2009-01-07,BOS,85,29,7,HOU,89,21,15,50,22
2009-01-07,NJN,100,17,18,MEM,89,11,24,28,42
2009-01-07,MIL,105,17,19,PHI,110,14,20,31,39
2009-01-07,MIN,129,9,25,OKC,87,5,30,14,55
2009-01-07,DEN,108,24,12,MIA,97,18,15,42,27
2009-01-07,PHX,110,19,12,IND,113,12,22,31,34
2009-01-07,UTA,116,20,15,NOH,90,21,10,41,25
2009-01-07,POR,84,20,14,DET,83,21,11,41,25
2009-01-07,GSW,106,10,26,LAL,114,27,6,37,32
2009-01-08,DAL,99,21,13,NYK,94,13,20,34,33
2009-01-08,SAS,106,23,11,LAC,84,8,26,31,37
2009-01-09,ORL,121,28,8,ATL,87,22,12,50,20
2009-01-09,PHI,93,15,20,CHA,87,13,23,28,43
2009-01-09,TOR,103,15,21,MEM,82,11,25,26,46
2009-01-09,CLE,98,28,6,BOS,83,29,8,57,14
2009-01-09,NOH,107,21,11,LAC,80,8,27,29,38
2009-01-09,OKC,96,5,31,HOU,98,22,15,27,46
2009-01-09,CHI,98,15,20,WAS,86,7,27,22,47
2009-01-09,MIL,104,17,20,NJN,102,18,18,35,38
2009-01-09,DEN,90,25,12,DET,93,21,12,46,24
2009-01-09,SAC,115,8,28,MIA,119,18,16,26,44
2009-01-09,LAL,121,28,6,IND,119,13,22,41,28
2009-01-09,PHX,128,19,13,DAL,100,22,13,41,26
2009-01-10,WAS,89,7,28,CHA,92,13,24,20,52
2009-01-10,MIN,106,10,25,MIL,104,18,20,28,45
2009-01-10,CHI,98,16,20,OKC,109,5,32,21,52
2009-01-10,HOU,96,23,15,NYK,76,13,21,36,36
2009-01-10,UTA,99,21,15,DET,82,22,12,43,27
2009-01-10,POR,113,21,14,GSW,100,10,27,31,41
2009-01-11,TOR,88,16,21,BOS,94,29,9,45,30
2009-01-11,ATL,94,22,13,PHI,109,16,20,38,33
2009-01-11,LAC,103,8,28,PHX,109,20,13,28,41
2009-01-11,SAS,98,24,11,ORL,105,29,8,53,19
2009-01-11,GSW,120,10,28,IND,117,13,23,23,51
2009-01-11,SAC,102,8,29,DAL,95,22,14,30,43
2009-01-11,LAL,108,29,6,MIA,105,19,16,48,22
2009-01-12,WAS,91,7,29,MIL,97,18,21,25,50
2009-01-12,BOS,115,30,9,TOR,109,16,22,46,31
2009-01-12,NJN,103,18,19,OKC,99,6,32,24,51
2009-01-12,NOH,95,22,11,NYK,101,13,22,35,33
2009-01-12,CHI,95,16,21,POR,109,22,14,38,35
2009-01-12,UTA,120,22,15,IND,113,13,24,35,39
2009-01-13,DET,78,22,13,CHA,80,14,24,36,37
2009-01-13,MEM,87,11,26,CLE,102,29,6,40,32
2009-01-13,MIN,96,11,25,MIA,99,19,17,30,42
2009-01-13,HOU,100,24,15,LAL,105,30,6,54,21
2009-01-13,DEN,99,25,13,DAL,97,22,15,47,28
2009-01-13,PHX,107,21,13,ATL,102,22,14,43,27
2009-01-13,SAC,107,9,29,ORL,139,30,8,39,37
2009-01-14,IND,110,13,25,DET,106,22,14,35,39
2009-01-14,PHI,100,17,20,POR,79,23,14,40,34
2009-01-14,TOR,98,16,23,CHI,102,16,22,32,45
2009-01-14,BOS,118,31,9,NJN,86,19,19,50,28
2009-01-14,NYK,128,14,22,WAS,122,7,30,21,52
2009-01-14,MIL,99,19,21,MIA,102,20,17,39,38
2009-01-14,OKC,114,6,33,UTA,93,23,15,29,48
2009-01-14,DAL,97,22,16,NOH,104,22,12,44,28
2009-01-14,SAS,112,24,12,LAL,111,31,6,55,18
2009-01-14,GSW,133,11,28,SAC,135,9,30,20,58
2009-01-14,LAC,80,8,29,ATL,97,22,15,30,44
2009-01-15,NJN,99,19,20,POR,105,23,15,42,35
2009-01-15,CHI,102,17,22,CLE,93,30,6,47,28
2009-01-15,DEN,119,26,13,PHX,113,22,13,48,26
2009-01-16,IND,111,14,25,TOR,104,16,24,30,49
2009-01-16,PHI,109,18,20,SAS,87,25,12,43,32
2009-01-16,WAS,96,7,31,NYK,89,15,22,22,53
2009-01-16,CLE,92,30,7,NOH,78,23,12,53,19
2009-01-16,MEM,91,11,27,UTA,101,23,16,34,43
2009-01-16,OKC,89,7,33,DET,79,22,15,29,48
2009-01-16,PHX,103,22,14,MIN,105,11,26,33,40
2009-01-16,SAC,122,10,30,MIL,129,19,22,29,52
2009-01-16,GSW,119,11,29,ATL,114,23,15,34,44
2009-01-16,LAL,103,31,7,ORL,109,31,8,62,15
2009-01-17,NJN,85,19,21,BOS,105,32,9,51,30
2009-01-17,CHA,102,15,24,POR,97,24,15,39,39
2009-01-17,DET,85,22,16,NOH,91,23,13,45,29
2009-01-17,NYK,97,15,23,PHI,107,19,20,34,43
2009-01-17,CHI,87,18,22,SAS,92,25,13,43,35
2009-01-17,HOU,93,24,16,MIA,86,21,17,45,33
2009-01-17,DAL,115,22,17,UTA,108,24,16,46,33
2009-01-17,DEN,88,27,13,ORL,106,32,8,59,21
2009-01-17,LAC,101,8,30,MIL,92,20,22,28,52
2009-01-18,TOR,113,16,25,PHX,117,22,15,38,40
2009-01-18,OKC,94,8,33,MIA,104,21,18,29,51
2009-01-19,NYK,102,15,24,CHI,98,18,23,33,47
2009-01-19,PHI,93,20,20,DAL,95,23,17,43,37
2009-01-19,ATL,87,23,16,TOR,84,16,26,39,42
2009-01-19,CHA,84,16,24,SAS,86,26,13,42,37
2009-01-19,HOU,115,25,16,DEN,113,27,14,52,30
2009-01-19,LAC,86,9,30,MIN,94,12,26,21,56
2009-01-19,NOH,103,24,13,IND,100,15,25,39,38
2009-01-19,GSW,119,12,29,WAS,98,8,31,20,60
2009-01-19,MEM,79,11,28,DET,87,22,17,33,45
2009-01-19,BOS,104,33,9,PHX,87,23,15,56,24
2009-01-19,POR,102,24,16,MIL,85,20,23,44,39
2009-01-19,LAL,105,31,8,CLE,88,31,7,62,15
2009-01-20,CHI,102,18,24,ATL,105,24,16,42,40
2009-01-20,SAS,99,27,13,IND,81,15,26,42,39
2009-01-20,DEN,118,27,15,SAC,99,10,31,37,46
2009-01-20,UTA,112,24,17,MIN,107,13,26,37,43
2009-01-21,CHA,101,16,25,MEM,86,11,29,27,54
2009-01-21,DET,95,23,17,TOR,76,16,27,39,44
2009-01-21,MIA,83,22,18,BOS,98,34,9,56,27
2009-01-21,NYK,114,16,24,PHX,109,23,16,39,40
2009-01-21,MIL,133,20,24,DAL,99,24,17,44,41
2009-01-21,NOH,102,25,13,NJN,92,19,22,44,35
2009-01-21,HOU,108,26,16,UTA,99,25,17,51,33
2009-01-21,POR,98,25,16,CLE,104,31,8,56,24
2009-01-21,SAC,107,10,32,WAS,110,8,32,18,64
2009-01-21,GSW,121,13,29,OKC,122,8,34,21,63
2009-01-21,LAC,97,9,31,LAL,108,32,8,41,39
2009-01-22,ORL,80,33,8,BOS,90,35,9,68,17
2009-01-22,LAL,117,33,8,WAS,97,9,32,42,40
2009-01-23,CHA,98,17,25,PHX,76,23,17,40,42
2009-01-23,DET,91,24,17,DAL,112,24,18,48,35
2009-01-23,IND,107,15,27,HOU,102,27,16,42,43
2009-01-23,ATL,117,25,16,MIL,87,21,24,46,40
2009-01-23,NYK,108,17,24,MEM,88,11,30,28,54
2009-01-23,MIN,116,13,27,NOH,108,26,13,39,40
2009-01-23,CHI,94,18,25,TOR,114,16,28,34,53
2009-01-23,SAS,94,28,13,NJN,91,19,23,47,36
2009-01-23,GSW,105,13,30,CLE,106,32,8,45,38
2009-01-23,LAC,107,9,32,OKC,104,9,34,18,66
2009-01-24,PHI,116,20,21,NYK,110,18,24,38,45
2009-01-24,MIA,103,22,19,ORL,97,33,9,55,28
2009-01-24,MEM,88,11,31,NJN,99,19,24,30,55
2009-01-24,MIL,106,21,25,SAC,104,10,33,31,58
2009-01-24,UTA,97,25,18,CLE,102,33,8,58,26
2009-01-24,POR,100,25,17,WAS,87,9,33,34,50
2009-01-25,BOS,124,36,9,DAL,100,25,18,61,27
2009-01-25,LAL,99,34,8,SAS,85,29,13,63,21
2009-01-25,ATL,99,26,16,PHX,104,23,18,49,34
2009-01-25,TOR,113,17,28,SAC,97,10,34,27,62
2009-01-25,DET,105,24,18,HOU,108,27,17,51,35
2009-01-25,IND,98,16,27,CHA,93,18,25,34,52
2009-01-25,MIN,109,14,27,CHI,108,18,26,32,53
2009-01-25,DEN,117,28,15,UTA,97,25,19,53,34
2009-01-25,GSW,107,13,31,LAC,92,10,32,23,63
2009-01-26,WAS,87,9,34,PHX,103,24,18,33,52
2009-01-26,MIA,95,23,19,ATL,79,26,17,49,36
2009-01-26,NYK,104,18,25,HOU,98,28,17,46,42
2009-01-26,MIL,83,22,25,MIN,90,15,27,37,52
2009-01-26,NOH,101,26,14,PHI,86,21,21,47,35
2009-01-26,OKC,94,9,35,NJN,85,20,24,29,59
2009-01-26,LAC,88,10,33,POR,113,26,17,36,50
2009-01-27,CLE,117,34,8,SAC,110,10,35,44,43
2009-01-27,ORL,135,33,10,IND,111,17,27,50,37
2009-01-27,MEM,85,11,32,DEN,100,29,15,40,47
2009-01-27,UTA,100,25,20,SAS,106,29,14,54,34
2009-01-27,LAL,110,35,8,CHA,117,18,26,53,34
2009-01-28,IND,107,17,28,MIL,99,22,26,39,54
2009-01-28,BOS,119,37,9,SAC,100,10,36,47,45
2009-01-28,MIA,93,24,19,WAS,71,9,35,33,54
2009-01-28,NJN,106,20,25,TOR,107,18,28,38,53
2009-01-28,NYK,112,19,25,ATL,104,26,18,45,43
2009-01-28,MIN,89,16,27,DET,98,24,19,40,46
2009-01-28,NOH,94,27,14,DEN,81,30,15,57,29
2009-01-28,OKC,114,10,35,MEM,102,11,33,21,68
2009-01-28,HOU,93,28,18,PHI,95,21,22,49,40
2009-01-28,DAL,117,25,19,GSW,93,14,31,39,50
2009-01-28,POR,88,27,17,CHA,74,19,26,46,43
2009-01-28,LAC,75,10,34,CHI,95,18,27,28,61
2009-01-29,ORL,99,34,10,CLE,88,35,8,69,18
2009-01-29,PHX,104,25,18,SAS,114,30,14,55,32
2009-01-30,DET,78,25,19,BOS,86,38,9,63,28
2009-01-30,IND,114,18,28,MIA,103,25,19,43,47
2009-01-30,PHI,104,22,22,WAS,94,9,36,31,58
2009-01-30,TOR,85,19,28,MIL,96,22,27,41,55
2009-01-30,ATL,105,26,19,NJN,88,20,26,46,45
2009-01-30,CLE,112,35,9,LAC,95,10,35,45,44
2009-01-30,MIN,119,16,28,LAL,132,35,9,51,37
2009-01-30,DEN,110,30,16,CHA,99,19,27,49,43
2009-01-30,UTA,110,25,21,OKC,90,11,35,36,56
2009-01-30,NOH,87,28,14,GSW,91,14,32,42,46
2009-01-30,SAC,88,10,37,CHI,109,19,27,29,64
2009-01-31,IND,113,19,28,NYK,122,20,25,39,53
2009-01-31,PHI,83,23,22,NJN,85,20,27,43,49
2009-01-31,MIA,96,25,20,DAL,111,26,19,51,39
2009-01-31,MEM,98,11,34,LAL,115,36,9,47,43
2009-01-31,WAS,106,9,37,LAC,94,10,36,19,73
2009-01-31,HOU,110,28,19,GSW,93,15,32,43,51
2009-01-31,MIL,110,23,27,ATL,107,27,19,50,46
2009-01-31,SAS,106,31,14,NOH,93,28,15,59,29
2009-01-31,PHX,111,25,19,CHI,122,20,27,45,46
2009-01-31,POR,122,28,17,UTA,108,26,21,54,38
2009-02-01,BOS,109,39,9,MIN,101,16,29,55,38
2009-02-01,TOR,90,19,29,ORL,113,35,10,54,39
2009-02-01,DET,80,25,20,CLE,90,36,9,61,29
2009-02-01,SAC,122,10,38,OKC,118,11,36,21,74
2009-02-02,ORL,95,36,10,DAL,105,27,19,63,29
2009-02-02,WAS,97,10,37,MEM,113,11,35,21,72
2009-02-02,MIA,119,25,21,LAC,95,10,37,35,58
2009-02-02,NYK,117,21,25,LAL,126,37,9,58,34
2009-02-02,NOH,89,28,16,POR,97,29,17,57,33
2009-02-02,PHX,129,25,20,SAC,81,11,38,36,58
2009-02-02,UTA,105,26,22,CHA,86,19,28,45,50
2009-02-02,GSW,105,15,33,SAS,110,32,14,47,47
2009-02-03,CLE,101,37,9,TOR,83,19,30,56,39
2009-02-03,IND,111,19,29,MIN,116,16,30,35,59
2009-02-03,PHI,99,23,23,BOS,100,40,9,63,32
2009-02-03,NJN,99,21,27,MIL,85,24,27,45,54
2009-02-03,HOU,107,29,19,CHI,100,21,27,50,46
2009-02-03,DEN,104,31,16,SAS,96,33,14,64,30
2009-02-04,ORL,125,36,11,LAC,96,10,38,46,49
2009-02-04,TOR,107,19,31,LAL,115,38,9,57,40
2009-02-04,WAS,88,10,38,NJN,115,22,27,32,65
2009-02-04,DET,93,25,21,MIA,90,26,21,51,42
2009-02-04,NYK,102,21,26,CLE,107,38,9,59,35
2009-02-04,MEM,104,12,35,HOU,93,30,19,42,54
2009-02-04,MIN,86,17,30,ATL,94,27,20,44,50
2009-02-04,NOH,93,28,17,CHI,107,21,28,49,45
2009-02-04,OKC,113,11,37,DEN,114,32,16,43,53
2009-02-04,DAL,104,28,19,POR,99,30,17,58,36
2009-02-04,GSW,124,15,34,PHX,112,26,20,41,54
2009-02-05,PHI,99,23,24,IND,94,19,30,42,54
2009-02-05,BOS,109,41,9,LAL,110,39,9,80,18
2009-02-05,UTA,115,27,22,DAL,87,29,19,56,41
2009-02-06,CHA,97,19,29,ATL,102,28,20,47,49
2009-02-06,IND,107,19,31,ORL,102,37,11,56,42
2009-02-06,NYK,100,21,27,BOS,110,41,10,62,37
2009-02-06,MEM,105,13,35,LAC,126,10,39,23,74
2009-02-06,NOH,101,28,18,TOR,92,19,32,47,50
2009-02-06,OKC,102,11,38,POR,93,30,18,41,56
2009-02-06,WAS,103,10,39,DEN,124,33,16,43,55
2009-02-06,SAC,107,11,39,UTA,111,28,22,39,61
2009-02-06,PHX,115,26,21,GSW,105,16,34,42,55
2009-02-07,ATL,97,29,20,LAC,121,11,39,40,59
2009-02-07,PHI,94,24,24,MIA,84,26,22,50,46
2009-02-07,NJN,114,23,27,DEN,70,34,16,57,43
2009-02-07,MEM,78,13,36,TOR,70,19,33,32,69
2009-02-07,DAL,115,29,20,CHI,114,22,28,51,48
2009-02-07,HOU,107,30,20,MIN,90,17,31,47,51
2009-02-07,MIL,121,24,28,DET,126,26,21,50,49
2009-02-08,BOS,99,42,10,SAS,105,33,15,75,25
2009-02-08,CLE,91,39,9,LAL,101,40,9,79,18
2009-02-08,MIA,96,26,23,CHA,92,19,30,45,53
2009-02-08,ORL,101,37,12,NJN,84,24,27,61,39
2009-02-08,POR,109,30,19,NYK,108,21,28,51,47
2009-02-08,WAS,119,10,40,IND,117,20,31,30,71
2009-02-08,NOH,101,29,18,MIN,97,17,32,46,50
2009-02-08,OKC,116,12,38,SAC,113,11,40,23,78
2009-02-08,DET,97,27,21,PHX,107,27,21,54,42
2009-02-08,GSW,116,16,35,UTA,96,29,22,45,57
2009-02-09,CHA,94,19,31,LAC,73,12,39,31,70
2009-02-09,PHI,108,25,24,PHX,91,28,21,53,45
2009-02-09,MEM,85,14,36,NOH,80,30,18,44,54
2009-02-09,MIL,124,24,29,HOU,112,31,20,55,49
2009-02-10,ATL,111,29,21,WAS,90,11,40,40,61
2009-02-10,IND,96,20,32,CLE,95,39,10,59,42
2009-02-10,MIA,82,27,23,DEN,99,34,17,61,40
2009-02-10,NJN,93,24,28,SAS,108,34,15,58,43
2009-02-10,MIN,102,17,33,TOR,110,19,34,36,67
2009-02-10,CHI,107,22,29,DET,102,27,22,49,51
2009-02-10,DAL,118,30,20,SAC,100,11,41,41,61
2009-02-10,GSW,144,17,35,NYK,127,21,29,38,64
2009-02-10,LAL,105,41,9,OKC,98,13,38,54,47
2009-02-11,CHA,101,20,31,WAS,89,11,41,31,72
2009-02-11,CLE,109,39,11,PHX,92,28,22,67,33
2009-02-11,ORL,73,38,12,DEN,82,35,17,73,29
2009-02-11,PHI,91,26,24,MEM,87,15,36,41,60
2009-02-11,TOR,91,20,34,SAS,89,35,15,55,49
2009-02-11,DET,95,27,23,ATL,99,30,21,57,44
2009-02-11,MIL,122,25,29,IND,110,21,32,46,61
2009-02-11,NOH,77,30,19,BOS,89,42,11,72,30
2009-02-11,HOU,94,31,21,SAC,82,11,42,42,63
2009-02-11,UTA,113,29,23,LAL,109,42,9,71,32
2009-02-11,POR,106,31,19,OKC,92,13,39,44,58
2009-02-11,LAC,128,12,40,NYK,124,21,30,33,70
2009-02-12,CHI,93,23,29,MIA,95,27,24,50,53
2009-02-12,DAL,92,31,20,BOS,99,43,11,74,31
2009-02-12,GSW,105,18,35,POR,98,32,19,50,54
2009-02-17,IND,100,21,33,PHI,91,27,24,48,57
2009-02-17,ORL,107,38,13,CHA,102,21,31,59,44
2009-02-17,WAS,111,11,42,MIN,103,17,34,28,76
2009-02-17,DET,86,27,24,MIL,92,26,29,53,53
2009-02-17,NYK,112,21,31,SAS,107,35,16,56,47
2009-02-17,OKC,98,13,40,NOH,100,30,20,43,60
2009-02-17,HOU,114,32,21,NJN,88,24,29,56,50
2009-02-17,PHX,140,28,23,LAC,100,13,40,41,63
2009-02-17,UTA,117,30,23,MEM,99,15,37,45,60
2009-02-17,LAL,96,42,10,ATL,83,31,21,73,31
2009-02-18,CHA,103,21,32,IND,94,22,33,43,65
2009-02-18,TOR,76,21,34,CLE,93,40,11,61,45
2009-02-18,MIA,104,28,24,MIN,111,17,35,45,59
2009-02-18,MIL,104,27,29,CHI,113,23,30,50,59
2009-02-18,NOH,117,31,20,ORL,85,39,13,70,33
2009-02-18,PHI,89,27,25,DEN,101,36,17,63,42
2009-02-18,DAL,113,31,21,NJN,98,24,30,55,51
2009-02-18,POR,94,32,20,MEM,90,15,38,47,58
2009-02-18,SAC,100,11,43,ATL,105,31,22,42,65
2009-02-18,GSW,121,19,35,LAL,129,43,10,62,45
2009-02-18,LAC,119,13,41,PHX,142,29,23,42,64
2009-02-19,DET,79,27,25,SAS,83,35,17,62,42
2009-02-19,UTA,90,31,23,BOS,85,44,11,75,34
2009-02-20,CHA,80,22,32,ORL,92,39,14,61,46
2009-02-20,NYK,127,22,31,TOR,97,21,35,43,66
2009-02-20,MEM,106,15,39,SAC,115,11,44,26,83
2009-02-20,MIN,105,18,35,IND,112,22,34,40,69
2009-02-20,NJN,96,24,31,WAS,107,12,42,36,73
2009-02-20,CHI,116,24,30,DEN,99,37,17,61,47
2009-02-20,HOU,93,33,21,DAL,86,32,21,65,42
2009-02-20,MIL,103,27,30,CLE,111,41,11,68,41
2009-02-20,PHX,140,30,23,OKC,118,13,41,43,64
2009-02-20,POR,108,33,20,ATL,98,32,22,65,42
2009-02-20,LAL,115,44,10,NOH,111,32,20,76,30
2009-02-21,MIA,97,28,25,PHI,91,27,26,55,51
2009-02-21,WAS,67,13,42,SAS,98,36,17,49,59
2009-02-21,DAL,116,32,22,SAC,95,12,44,44,66
2009-02-21,UTA,102,32,23,NOH,88,32,21,64,44
2009-02-21,GSW,133,19,36,OKC,120,13,42,32,78
2009-02-22,IND,98,23,34,CHI,91,25,30,48,64
2009-02-22,TOR,111,21,36,NYK,100,23,31,44,67
2009-02-22,PHX,108,31,23,BOS,128,44,12,75,35
2009-02-22,HOU,99,34,21,CHA,78,22,33,56,54
2009-02-22,MIL,120,27,31,DEN,117,37,18,64,49
2009-02-22,ORL,122,40,14,MIA,99,29,25,69,39
2009-02-22,POR,116,34,20,LAC,87,13,42,47,62
2009-02-22,MIN,108,18,36,LAL,111,45,10,63,46
2009-02-22,CLE,99,42,11,DET,78,27,26,69,37
2009-02-23,NJN,98,24,32,PHI,96,27,27,51,59
2009-02-23,NYK,123,23,32,IND,119,24,34,47,66
2009-02-23,DEN,76,37,19,BOS,114,45,12,82,31
2009-02-23,UTA,108,33,23,ATL,89,32,23,65,46
2009-02-23,SAC,105,12,45,NOH,112,32,22,44,67
2009-02-23,LAC,118,13,43,GSW,105,20,36,33,79
2009-02-24,CLE,94,43,11,MEM,79,15,40,58,51
2009-02-24,TOR,118,22,36,MIN,110,18,37,40,73
2009-02-24,MIA,103,29,26,DET,91,27,27,56,53
2009-02-24,CHI,120,25,31,ORL,102,41,14,66,45
2009-02-24,OKC,93,13,43,LAL,107,46,10,59,53
2009-02-24,HOU,98,35,21,POR,94,35,20,70,41
2009-02-24,SAS,93,37,17,DAL,76,33,22,70,39
2009-02-24,PHX,112,31,24,CHA,102,22,34,53,58
2009-02-25,IND,104,24,35,MEM,99,15,41,39,76
2009-02-25,WAS,98,13,43,PHI,106,27,28,40,71
2009-02-25,NJN,111,25,32,CHI,99,26,31,51,63
2009-02-25,NYK,109,24,32,ORL,114,41,15,65,47
2009-02-25,MIN,103,18,38,UTA,120,34,23,52,61
2009-02-25,NOH,90,33,22,DET,87,27,28,60,50
2009-02-25,DAL,116,33,23,MIL,96,28,31,61,54
2009-02-25,SAS,99,38,17,POR,84,35,21,73,38
2009-02-25,DEN,110,37,20,ATL,109,32,24,69,44
2009-02-25,SAC,91,12,46,CHA,98,22,35,34,81
2009-02-25,LAC,93,14,43,BOS,91,46,12,60,55
2009-02-26,HOU,93,36,21,CLE,74,44,11,80,32
2009-02-26,LAL,132,47,10,PHX,106,32,24,79,34
2009-02-27,NOH,95,34,22,MIL,94,28,32,62,54
2009-02-27,ORL,85,42,15,DET,93,27,29,69,44
2009-02-27,WAS,113,13,44,CHI,90,26,32,39,76
2009-02-27,ATL,91,32,25,MIA,83,30,26,62,51
2009-02-27,BOS,104,46,13,IND,99,25,35,71,48
2009-02-27,NYK,103,24,33,PHI,108,28,28,52,61
2009-02-27,MIN,82,18,39,POR,102,35,22,53,61
2009-02-27,DAL,110,34,23,OKC,108,13,44,47,67
2009-02-27,DEN,90,38,20,LAL,79,48,10,86,30
2009-02-27,PHX,133,32,25,TOR,113,23,36,55,61
2009-02-27,SAS,86,39,17,CLE,97,44,12,83,29
2009-02-27,SAC,98,12,47,LAC,86,15,43,27,90
2009-02-27,GSW,109,20,37,CHA,112,23,35,43,72
2009-02-28,PHI,100,29,28,ORL,106,42,16,71,44
2009-02-28,MIA,120,30,27,NYK,115,24,34,54,61
2009-02-28,MEM,92,15,42,OKC,99,13,45,28,87
2009-02-28,CHI,105,26,33,HOU,102,37,21,63,54
2009-02-28,MIL,109,28,33,WAS,93,14,44,42,77
2009-02-28,UTA,102,35,23,SAC,89,13,47,48,70
2009-02-28,LAC,95,15,44,CHA,100,24,35,39,79
2009-03-01,BOS,95,47,13,DET,105,28,29,75,42
2009-03-01,PHX,118,33,25,LAL,111,48,11,81,36
2009-03-01,ATL,87,33,25,CLE,88,45,12,78,37
2009-03-01,NJN,96,26,32,NOH,99,35,22,61,54
2009-03-01,IND,100,25,36,DEN,94,39,20,64,56
2009-03-01,MIN,94,18,40,HOU,105,37,22,55,62
2009-03-01,POR,102,36,22,SAS,84,39,18,75,40
2009-03-01,DAL,109,35,23,TOR,98,23,37,58,60
2009-03-01,GSW,104,20,38,UTA,112,36,23,56,61
2009-03-02,PHI,91,29,29,NOH,98,36,22,65,51
2009-03-02,WAS,89,14,45,ATL,98,33,26,47,71
2009-03-02,MIA,100,31,27,CLE,107,46,12,77,39
2009-03-02,OKC,96,14,45,DAL,87,36,23,50,68
2009-03-02,LAC,78,15,45,SAS,106,39,19,54,64
2009-03-03,CHA,96,25,35,CHI,80,27,33,52,68
2009-03-03,ORL,111,43,16,PHX,99,34,25,77,41
2009-03-03,DET,100,29,29,DEN,95,39,21,68,50
2009-03-03,MIL,95,29,33,NJN,99,26,33,55,66
2009-03-03,MIN,94,18,41,GSW,118,20,39,38,80
2009-03-03,HOU,107,38,22,TOR,97,23,38,61,60
2009-03-03,SAC,109,13,48,IND,117,26,36,39,84
2009-03-03,LAL,99,48,12,MEM,89,15,43,63,55
2009-03-04,CLE,91,47,12,MIL,73,29,34,76,46
2009-03-04,MIA,135,31,28,PHX,129,34,26,65,54
2009-03-04,NJN,111,27,33,BOS,115,47,14,74,47
2009-03-04,NYK,109,24,35,ATL,105,34,26,58,61
2009-03-04,OKC,88,15,45,WAS,83,14,46,29,91
2009-03-04,CHI,110,27,34,GSW,88,21,39,48,73
2009-03-04,DAL,107,36,24,SAS,102,40,19,76,43
2009-03-04,UTA,101,37,23,HOU,94,39,22,76,45
2009-03-04,POR,107,37,22,IND,105,27,36,64,58
2009-03-04,LAC,95,15,46,MEM,118,15,44,30,90
2009-03-05,NOH,104,37,22,DAL,88,37,24,74,46
2009-03-05,DEN,106,39,22,POR,90,38,22,77,44
2009-03-06,CHA,98,26,35,ATL,91,34,27,60,62
2009-03-06,ORL,105,44,16,NJN,102,27,34,71,50
2009-03-06,TOR,102,23,39,MIA,108,32,28,55,67
2009-03-06,BOS,105,48,14,CLE,94,48,12,96,26
2009-03-06,DET,108,30,29,GSW,91,21,40,51,69
2009-03-06,CHI,117,28,34,MIL,102,29,35,57,69
2009-03-06,HOU,116,39,23,PHX,112,34,27,73,50
2009-03-06,SAS,100,40,20,WAS,78,14,47,54,67
2009-03-06,LAL,110,49,12,MIN,90,18,42,67,54
2009-03-06,UTA,97,38,23,DEN,91,40,22,78,45
2009-03-07,ATL,87,34,28,DET,83,31,29,65,57
2009-03-07,CLE,99,48,13,MIA,89,33,28,81,41
2009-03-07,NYK,105,25,35,CHA,114,27,35,52,70
2009-03-07,MEM,105,16,44,PHI,110,29,30,45,74
2009-03-07,NOH,108,38,22,OKC,90,16,45,54,67
2009-03-07,DAL,119,37,25,WAS,103,14,48,51,73
2009-03-07,MIL,127,29,36,GSW,120,21,41,50,77
2009-03-07,POR,95,38,23,MIN,93,18,43,56,66
2009-03-07,LAC,105,15,47,IND,106,27,37,42,84
2009-03-08,BOS,79,49,14,ORL,86,45,16,94,30
2009-03-08,TOR,101,23,40,UTA,109,39,23,62,63
2009-03-08,SAS,103,41,20,PHX,98,34,28,75,48
2009-03-08,NJN,106,27,35,NYK,101,25,36,52,71
2009-03-08,HOU,93,40,23,MEM,83,16,45,56,68
2009-03-08,OKC,89,16,46,PHI,74,30,30,46,76
2009-03-08,SAC,114,13,49,DEN,106,40,23,53,72
2009-03-09,ATL,89,35,28,NOH,79,39,22,74,50
2009-03-09,DET,98,31,30,ORL,94,46,16,77,46
2009-03-09,MIA,130,33,29,CHI,127,29,34,62,63
2009-03-09,MIN,99,18,44,WAS,110,14,49,32,93
2009-03-09,DEN,95,40,24,HOU,97,41,23,81,47
2009-03-09,POR,111,39,23,LAL,94,50,12,89,35
2009-03-10,IND,100,28,37,UTA,112,40,23,68,60
2009-03-10,MIL,112,30,36,NYK,120,25,37,55,73
2009-03-10,SAS,100,42,20,CHA,86,28,35,70,55
2009-03-10,PHX,117,34,29,DAL,122,38,25,72,54
2009-03-10,SAC,98,14,49,OKC,99,17,46,31,95
2009-03-10,LAC,83,15,48,CLE,87,49,13,64,61
2009-03-11,ATL,100,36,28,UTA,93,41,23,77,51
2009-03-11,ORL,107,46,17,CHI,79,29,35,75,52
2009-03-11,PHI,115,30,31,TOR,106,23,41,53,72
2009-03-11,WAS,98,15,49,NOH,109,39,23,54,72
2009-03-11,DET,111,32,30,NYK,116,26,37,58,67
2009-03-11,MIA,107,34,29,BOS,99,49,15,83,44
2009-03-11,MIN,104,18,45,MEM,79,16,46,34,91
2009-03-11,HOU,96,42,23,LAL,102,50,13,92,36
2009-03-11,DEN,112,40,25,OKC,99,18,46,58,71
2009-03-11,POR,89,40,23,DAL,93,39,25,79,48
2009-03-11,GSW,116,21,42,NJN,112,28,35,49,77
2009-03-12,SAS,95,43,20,LAL,102,51,13,94,33
2009-03-12,PHX,111,34,30,CLE,119,50,13,84,43
2009-03-13,CHA,86,28,36,HOU,91,42,24,70,60
2009-03-13,PHI,104,31,31,CHI,101,29,36,60,67
2009-03-13,TOR,95,23,42,DET,99,32,31,55,73
2009-03-13,WAS,103,15,50,ORL,112,47,17,62,67
2009-03-13,ATL,101,37,28,IND,87,28,38,65,66
2009-03-13,BOS,102,49,16,MEM,92,16,47,65,63
2009-03-13,MIN,94,19,45,NYK,102,27,37,46,82
2009-03-13,MIL,86,30,37,NOH,95,40,23,70,60
2009-03-13,POR,109,40,24,NJN,100,28,36,68,60
2009-03-13,SAC,123,14,50,CLE,126,51,13,65,63
2009-03-13,GSW,119,22,42,DAL,110,40,25,62,67
2009-03-14,MIA,140,35,29,UTA,129,41,24,76,53
2009-03-14,MIN,108,19,46,CHA,100,28,37,47,83
2009-03-14,CHI,97,29,37,NOH,79,41,23,70,60
2009-03-14,HOU,85,43,24,SAS,88,43,21,86,45
2009-03-14,DEN,107,41,25,LAC,94,15,49,56,74
2009-03-14,PHX,106,34,31,OKC,95,18,47,52,78
2009-03-15,ATL,98,38,28,POR,80,41,24,79,52
2009-03-15,CLE,98,52,13,NYK,93,28,37,80,50
2009-03-15,DET,84,33,31,MEM,89,16,48,49,79
2009-03-15,MIL,86,30,38,BOS,77,50,16,80,54
2009-03-15,PHI,85,32,31,MIA,77,36,29,68,60
2009-03-15,TOR,110,23,43,IND,87,28,39,51,82
2009-03-15,LAL,107,52,13,DAL,100,40,26,92,39
2009-03-15,ORL,105,48,17,UTA,87,41,25,89,42
2009-03-15,WAS,106,15,51,SAC,104,14,51,29,102
2009-03-15,GSW,130,23,42,PHX,154,35,31,58,73
2009-03-15,LAC,107,15,50,NJN,105,28,37,43,87
2009-03-16,CHA,112,28,38,TOR,86,24,43,52,81
2009-03-16,MEM,92,17,48,POR,103,41,25,58,73
2009-03-16,NOH,84,41,24,HOU,95,43,25,84,49
2009-03-16,OKC,78,18,48,SAS,76,44,21,62,69
2009-03-16,DEN,121,42,25,NJN,96,28,38,70,63
2009-03-17,ATL,119,39,28,SAC,97,14,52,53,80
2009-03-17,CLE,97,53,13,ORL,93,49,17,102,30
2009-03-17,CHI,127,30,37,BOS,121,50,17,80,54
2009-03-17,DAL,103,40,27,DET,101,33,32,73,59
2009-03-17,SAS,93,44,22,MIN,86,20,46,64,68
2009-03-17,UTA,103,41,26,WAS,88,16,51,57,77
2009-03-17,GSW,127,23,43,LAC,120,16,50,39,93
2009-03-17,LAL,93,53,13,PHI,94,33,31,86,44
2009-03-18,BOS,112,50,18,MIA,108,36,30,86,48
2009-03-18,CHA,104,29,38,SAC,88,14,53,43,91
2009-03-18,IND,85,28,40,POR,95,42,25,70,65
2009-03-18,NYK,89,28,38,NJN,115,28,39,56,77
2009-03-18,MEM,109,17,49,DEN,111,43,25,60,74
2009-03-18,MIL,80,31,38,ORL,106,49,18,80,56
2009-03-18,NOH,94,41,25,MIN,93,20,47,61,72
2009-03-18,OKC,96,19,48,CHI,103,31,37,50,85
2009-03-18,HOU,106,44,25,DET,101,33,33,77,58
2009-03-18,PHX,126,36,31,PHI,116,34,31,70,62
2009-03-18,LAC,123,16,51,WAS,108,16,52,32,103
2009-03-19,ATL,95,40,28,DAL,87,41,27,81,55
2009-03-19,CLE,97,54,13,POR,92,43,25,97,38
2009-03-19,LAL,114,53,14,GSW,106,24,43,77,57
2009-03-20,IND,92,28,41,DAL,94,41,28,69,69
2009-03-20,TOR,89,24,44,CHA,102,30,38,54,82
2009-03-20,NJN,96,29,39,MIA,88,36,31,65,70
2009-03-20,NYK,94,28,39,SAC,121,14,54,42,93
2009-03-20,DET,108,33,34,LAC,90,17,51,50,85
2009-03-20,NOH,96,42,25,MEM,84,17,50,59,75
2009-03-20,OKC,94,19,49,UTA,101,42,26,61,75
2009-03-20,HOU,107,45,25,MIN,88,20,48,65,73
2009-03-20,SAS,77,45,22,BOS,80,51,18,96,40
2009-03-20,DEN,116,44,25,WAS,105,16,53,60,78
2009-03-20,GSW,119,24,44,PHI,111,34,32,58,76
2009-03-21,CLE,102,55,13,ATL,96,41,28,96,41
2009-03-21,CHA,83,31,38,IND,108,28,42,59,80
2009-03-21,ORL,110,50,18,NYK,103,28,40,78,58
2009-03-21,MEM,87,17,51,BOS,105,52,18,69,69
2009-03-21,CHI,109,32,37,LAL,117,54,14,86,51
2009-03-21,MIL,84,31,39,POR,96,43,26,74,65
2009-03-21,PHX,128,37,31,WAS,96,16,54,53,85
2009-03-22,DET,96,34,34,MIA,101,36,32,70,66
2009-03-22,SAS,85,45,23,HOU,87,46,25,91,48
2009-03-22,MIN,90,20,49,OKC,97,19,50,39,99
2009-03-22,TOR,100,24,45,LAC,76,17,52,41,97
2009-03-22,NJN,88,30,39,CLE,96,56,13,86,52
2009-03-22,NOH,99,43,25,GSW,89,25,44,68,69
2009-03-22,SAC,100,15,54,PHI,112,34,33,49,87
2009-03-23,ATL,109,41,29,MIN,97,20,50,61,79
2009-03-23,WAS,99,16,55,CHI,101,32,38,48,93
2009-03-23,BOS,90,53,18,LAC,77,17,53,70,71
2009-03-23,MIA,94,37,32,MEM,82,17,52,54,84
2009-03-23,NYK,102,28,41,ORL,106,51,18,79,59
2009-03-23,PHX,118,38,31,DEN,115,45,25,83,56
2009-03-23,POR,108,44,26,PHI,114,35,33,79,59
2009-03-24,CHI,99,33,38,DET,91,34,35,67,73
2009-03-24,OKC,89,20,50,LAL,107,55,14,75,64
2009-03-24,SAS,107,45,24,GSW,106,25,45,70,69
2009-03-24,UTA,99,43,26,HOU,86,47,25,90,51
2009-03-25,ATL,92,42,29,SAS,102,46,24,88,53
2009-03-25,CLE,98,57,13,NJN,87,30,40,87,53
2009-03-25,IND,90,29,42,MIA,88,38,32,67,74
2009-03-25,PHI,96,36,33,MIN,88,20,51,56,84
2009-03-25,TOR,115,25,45,MIL,106,31,40,56,85
2009-03-25,WAS,95,16,56,CHA,93,31,39,47,95
2009-03-25,NYK,135,28,42,LAC,140,17,54,45,96
2009-03-25,NOH,88,44,25,DEN,101,45,26,89,51
2009-03-25,ORL,84,52,18,BOS,82,54,18,106,36
2009-03-25,DAL,128,42,28,GSW,106,25,46,67,74
2009-03-25,PHX,118,39,31,UTA,114,44,26,83,57
2009-03-26,DET,77,34,36,LAL,92,56,14,90,50
2009-03-26,CHI,106,34,38,MIA,87,38,33,72,71
2009-03-26,POR,129,44,27,PHX,109,40,31,84,58
2009-03-27,ORL,110,53,18,MIL,94,31,41,84,59
2009-03-27,PHI,95,37,33,CHA,100,31,40,68,73
2009-03-27,TOR,112,26,45,OKC,96,20,51,46,96
2009-03-27,ATL,93,42,30,BOS,99,54,19,96,49
2009-03-27,CLE,107,58,13,MIN,85,20,52,78,65
2009-03-27,NJN,95,30,41,LAL,103,57,14,87,55
2009-03-27,NYK,103,28,43,NOH,93,44,26,72,69
2009-03-27,DAL,101,43,28,DEN,103,46,26,89,54
2009-03-27,SAS,111,47,24,LAC,98,18,54,65,78
2009-03-27,SAC,95,15,55,MEM,113,17,53,32,108
2009-03-28,CHI,112,35,38,IND,106,30,42,65,80
2009-03-28,CHA,96,32,40,NYK,85,29,43,61,83
2009-03-28,WAS,96,17,56,DET,98,34,37,51,93
2009-03-28,MIA,102,38,34,MIL,85,31,42,69,76
2009-03-28,HOU,110,47,26,LAC,93,18,55,65,81
2009-03-28,DEN,129,47,26,GSW,116,25,47,72,73
2009-03-28,UTA,104,44,27,PHX,99,40,32,84,59
2009-03-28,POR,86,45,27,MEM,66,18,53,63,80
2009-03-29,CLE,102,59,13,DAL,74,43,29,102,42
2009-03-29,ATL,86,42,31,LAL,76,58,14,100,45
2009-03-29,MIN,108,20,53,NJN,99,30,42,50,95
2009-03-29,TOR,134,27,45,CHI,129,36,38,63,83
2009-03-29,DET,101,35,37,PHI,97,37,34,72,71
2009-03-29,BOS,103,55,19,OKC,84,20,52,75,71
2009-03-29,IND,124,30,43,WAS,115,17,57,47,100
2009-03-29,NOH,90,44,27,SAS,86,48,24,92,51
2009-03-29,SAC,126,15,56,PHX,118,40,33,55,89
2009-03-30,MIA,95,39,34,ORL,101,54,18,93,52
2009-03-30,NJN,78,30,43,MIL,107,31,43,61,86
2009-03-30,UTA,112,45,27,NYK,104,29,44,74,71
2009-03-30,GSW,109,25,48,MEM,114,18,54,43,102
2009-03-31,CHA,94,33,40,LAL,84,58,15,91,55
2009-03-31,CLE,79,60,13,DET,73,36,37,96,50
2009-03-31,IND,107,31,43,CHI,105,36,39,67,82
2009-03-31,PHI,98,37,35,ATL,85,43,31,80,66
2009-03-31,MIN,88,21,53,DAL,108,43,30,64,83
2009-03-31,SAS,95,48,25,OKC,96,20,53,68,78
2009-03-31,DEN,111,48,26,NYK,104,29,45,77,71
2009-03-31,POR,125,46,27,UTA,104,46,27,92,54
2009-03-31,SAC,110,16,56,NOH,111,45,27,61,83
2009-04-01,ORL,95,55,18,TOR,99,28,45,83,63
2009-04-01,BOS,111,56,19,CHA,109,34,40,90,59
2009-04-01,NJN,111,30,44,DET,98,36,38,66,82
2009-04-01,MEM,112,19,54,WAS,107,17,58,36,112
2009-04-01,MIL,98,32,43,LAL,104,58,16,90,59
2009-04-01,DAL,98,44,30,MIA,96,39,35,83,65
2009-04-01,PHX,114,40,34,HOU,109,48,26,88,60
2009-04-01,GSW,143,25,49,SAC,141,16,57,41,106
2009-04-01,LAC,98,18,56,NOH,104,46,27,64,83
2009-04-02,PHI,105,38,35,MIL,95,32,44,70,79
2009-04-02,WAS,109,17,59,CLE,101,61,13,78,72
2009-04-02,DEN,114,49,26,UTA,104,46,28,95,54
2009-04-03,CHA,92,34,41,MIA,97,39,36,73,77
2009-04-03,IND,121,32,43,SAS,126,48,26,80,69
2009-04-03,BOS,104,57,19,ATL,92,43,32,100,51
2009-04-03,MEM,107,20,54,DAL,102,45,30,65,84
2009-04-03,OKC,72,21,53,POR,107,47,27,68,80
2009-04-03,ORL,116,55,19,CLE,87,61,14,116,33
2009-04-03,UTA,102,46,29,MIN,103,21,54,67,83
2009-04-03,PHX,139,41,34,SAC,111,16,58,57,92
2009-04-03,GSW,111,26,49,NOH,103,47,27,73,76
2009-04-03,LAL,93,59,16,HOU,81,48,27,107,43
2009-04-04,NYK,95,29,46,TOR,102,29,45,58,91
2009-04-04,CHI,103,36,40,NJN,94,31,44,67,84
2009-04-04,PHI,95,39,35,DET,90,36,39,75,74
2009-04-04,ATL,82,43,33,ORL,88,56,19,99,52
2009-04-04,WAS,104,18,59,MIA,118,40,36,58,95
2009-04-04,MIL,102,32,45,MEM,107,21,54,53,99
2009-04-04,DEN,120,50,26,LAC,104,18,57,68,83
2009-04-05,CLE,101,61,15,SAS,81,49,26,110,41
2009-04-05,DAL,140,45,31,PHX,116,42,34,87,65
2009-04-05,DET,104,36,40,CHA,97,34,42,70,82
2009-04-05,TOR,103,30,45,NYK,112,29,47,59,92
2009-04-05,HOU,102,48,28,POR,88,48,27,96,55
2009-04-05,MIN,87,22,54,DEN,110,51,26,73,80
2009-04-05,NOH,94,47,28,UTA,108,46,30,93,58
2009-04-05,OKC,99,21,54,IND,117,32,44,53,98
2009-04-05,NJN,96,31,45,PHI,67,40,35,71,80
2009-04-05,SAC,100,16,59,GSW,105,27,49,43,108
2009-04-05,LAL,88,60,16,LAC,85,18,58,78,74
2009-04-07,CHA,101,34,43,PHI,98,40,36,74,79
2009-04-07,TOR,110,30,46,ATL,118,43,34,73,80
2009-04-07,MIA,87,41,36,NOH,93,47,29,88,65
2009-04-07,MEM,93,22,54,POR,96,48,28,70,82
2009-04-07,OKC,89,21,55,SAS,99,49,27,70,82
2009-04-07,CHI,110,37,40,NYK,103,30,47,67,87
2009-04-07,HOU,93,49,28,ORL,83,57,19,106,47
2009-04-07,SAC,104,16,60,LAL,122,61,16,77,76
2009-04-07,LAC,77,18,59,MIN,87,22,55,40,114
2009-04-08,CLE,98,62,15,WAS,86,18,60,80,75
2009-04-08,IND,130,33,44,TOR,101,30,47,63,91
2009-04-08,ORL,81,57,20,MEM,78,22,55,79,75
2009-04-08,BOS,106,58,19,NJN,104,32,45,90,64
2009-04-08,NYK,86,30,48,DET,113,37,40,67,88
2009-04-08,MIL,105,32,46,ATL,113,44,34,76,80
2009-04-08,NOH,100,48,29,PHX,105,42,35,90,64
2009-04-08,SAS,83,50,27,POR,95,49,28,99,55
2009-04-08,DEN,122,52,26,OKC,112,21,56,73,82
2009-04-08,DAL,130,46,31,UTA,101,47,30,93,61
2009-04-08,GSW,97,28,49,MIN,105,23,55,51,104
2009-04-09,CHI,113,38,40,PHI,99,40,37,78,77
2009-04-09,SAC,98,16,61,HOU,115,50,28,66,89
2009-04-09,LAL,116,62,16,DEN,102,53,26,115,42
2009-04-10,ORL,95,58,20,NYK,105,30,49,88,69
2009-04-10,PHI,92,40,38,CLE,102,63,15,103,53
2009-04-10,ATL,122,45,34,IND,118,34,44,79,78
2009-04-10,BOS,105,59,19,MIA,98,41,37,100,56
2009-04-10,DET,100,38,40,NJN,93,32,46,70,86
2009-04-10,MEM,106,22,56,PHX,89,43,35,65,91
2009-04-10,OKC,84,21,57,CHA,81,35,43,56,100
2009-04-10,TOR,98,30,48,WAS,100,18,61,48,109
2009-04-10,DAL,100,47,31,NOH,92,48,30,95,61
2009-04-10,SAS,105,50,28,UTA,99,47,31,97,59
2009-04-10,POR,106,50,28,LAL,98,63,16,113,44
2009-04-10,GSW,109,28,50,HOU,113,51,28,79,78
2009-04-10,LAC,109,18,60,SAC,78,16,62,34,122
2009-04-11,IND,106,34,45,DET,102,39,40,73,85
2009-04-11,NJN,103,32,47,ORL,93,58,21,90,68
2009-04-11,MIN,97,24,55,PHX,110,43,36,67,91
2009-04-11,CHI,113,39,40,CHA,106,35,44,74,84
2009-04-11,MIL,115,32,47,OKC,98,22,57,54,104
2009-04-11,UTA,108,47,32,GSW,118,28,51,75,83
2009-04-11,LAC,72,19,60,POR,87,51,28,70,88
2009-04-12,NOH,102,48,31,DAL,92,48,31,96,62
2009-04-12,CLE,107,64,15,BOS,76,60,19,124,34
2009-04-12,MIA,122,41,38,NYK,105,31,49,72,87
2009-04-12,TOR,111,30,49,PHI,104,40,39,70,88
2009-04-12,SAC,92,16,63,SAS,95,51,28,67,91
2009-04-12,LAL,92,63,17,MEM,75,23,56,86,73
2009-04-13,IND,109,35,45,CLE,117,65,15,100,60
2009-04-13,WAS,96,19,61,TOR,97,31,49,50,110
2009-04-13,DET,88,39,41,CHI,91,40,40,79,81
2009-04-13,NJN,91,33,47,CHA,87,35,45,68,92
2009-04-13,MIL,98,33,47,ORL,80,58,22,91,69
2009-04-13,DAL,96,48,32,MIN,94,24,56,72,88
2009-04-13,HOU,86,52,28,NOH,66,49,31,101,59
2009-04-13,DEN,118,53,27,SAC,98,16,64,69,91
2009-04-13,UTA,106,47,33,LAC,85,19,61,66,94
2009-04-13,PHX,119,44,36,MEM,110,23,57,67,93
2009-04-13,POR,113,52,28,OKC,83,22,58,74,86
2009-04-13,GSW,72,29,51,SAS,101,52,28,81,79
2009-04-14,ATL,81,46,34,MIA,79,42,38,88,72
2009-04-14,PHI,98,40,40,BOS,100,60,20,100,60
2009-04-14,LAL,125,64,17,UTA,112,48,33,112,50
2009-04-15,BOS,115,61,20,WAS,107,19,62,80,82
2009-04-15,CHI,98,41,40,TOR,109,32,49,73,89
2009-04-15,CLE,110,66,15,PHI,111,40,41,106,56
2009-04-15,DAL,95,49,32,HOU,84,53,28,102,60
2009-04-15,IND,115,35,46,MIL,108,34,47,69,93
2009-04-15,MEM,98,23,58,ATL,90,47,34,70,92
2009-04-15,MIA,102,42,39,DET,96,39,42,81,81
2009-04-15,MIN,90,24,57,SAC,97,16,65,40,122
2009-04-15,NYK,102,31,50,NJN,73,34,47,65,97
2009-04-15,ORL,98,58,23,CHA,73,35,46,93,69
2009-04-15,SAS,105,53,28,NOH,98,49,32,102,60
2009-04-15,LAC,85,19,62,OKC,126,22,59,41,121
2009-04-15,PHX,117,45,36,GSW,113,29,52,74,88
2009-10-27,CLE,89,0,0,BOS,95,0,0,0,0
2009-10-27,DAL,91,0,0,WAS,102,0,0,0,0
2009-10-27,POR,96,0,0,HOU,87,0,0,0,0
2009-10-27,LAL,99,0,0,LAC,92,0,0,0,0
2009-10-28,ATL,120,0,0,IND,109,0,0,0,0
2009-10-28,ORL,120,0,0,PHI,106,0,0,0,0
2009-10-28,TOR,101,0,0,CLE,91,0,1,0,1
2009-10-28,BOS,92,1,0,CHA,59,0,0,1,0
2009-10-28,MIA,115,0,0,NYK,93,0,0,0,0
2009-10-28,MEM,74,0,0,DET,96,0,0,0,0
2009-10-28,MIN,95,0,0,NJN,93,0,0,0,0
2009-10-28,OKC,102,0,0,SAC,89,0,0,0,0
2009-10-28,SAS,113,0,0,NOH,96,0,0,0,0
2009-10-28,DEN,114,0,0,UTA,105,0,0,0,0
2009-10-28,GSW,107,0,0,HOU,108,0,1,0,1
2009-10-28,LAC,107,0,1,PHX,109,0,0,0,1
2009-10-29,CHI,92,0,0,SAS,85,1,0,1,0
2009-10-29,POR,94,1,0,DEN,97,1,0,2,0
2009-10-30,CHA,102,0,1,NYK,100,0,1,0,2
2009-10-30,PHI,99,0,1,MIL,86,0,0,0,1
2009-10-30,ATL,100,1,0,WAS,89,1,0,2,0
2009-10-30,BOS,118,2,0,CHI,90,1,0,3,0
2009-10-30,DET,83,1,0,OKC,91,1,0,2,0
2009-10-30,IND,83,0,1,MIA,96,1,0,1,1
2009-10-30,MEM,115,0,1,TOR,107,1,0,1,1
2009-10-30,MIN,87,1,0,CLE,104,0,2,1,2
2009-10-30,NJN,85,0,1,ORL,95,1,0,1,1
2009-10-30,NOH,97,0,1,SAC,92,0,1,0,2
2009-10-30,UTA,111,0,1,LAC,98,0,2,0,3
2009-10-30,PHX,123,1,0,GSW,101,0,1,1,1
2009-10-30,LAL,80,1,0,DAL,94,0,1,1,1
2009-10-31,WAS,123,1,1,NJN,104,0,2,1,3
2009-10-31,CLE,90,1,2,CHA,79,1,1,2,3
2009-10-31,NYK,127,0,2,PHI,141,1,1,1,3
2009-10-31,HOU,111,1,1,POR,107,1,1,2,2
2009-10-31,MIL,96,0,1,DET,85,1,1,1,2
2009-10-31,SAS,113,1,1,SAC,94,0,2,1,3
2009-10-31,LAC,84,0,3,DAL,93,1,1,1,4
2009-11-01,TOR,116,1,1,ORL,125,2,0,3,1
2009-11-01,BOS,97,3,0,NOH,87,1,1,4,1
2009-11-01,MIA,95,2,0,CHI,87,1,1,3,1
2009-11-01,OKC,74,2,0,POR,83,1,2,3,2
2009-11-01,DEN,133,2,0,MEM,123,1,1,3,1
2009-11-01,PHX,120,2,0,MIN,112,1,1,3,1
2009-11-01,LAL,118,1,1,ATL,110,2,0,3,1
2009-11-02,CHA,79,1,2,NJN,68,0,3,1,5
2009-11-02,NYK,117,0,3,NOH,111,1,2,1,5
2009-11-02,UTA,96,1,1,HOU,113,2,1,3,2
2009-11-02,SAC,127,0,3,MEM,116,1,2,1,5
2009-11-02,LAC,93,0,4,MIN,90,1,2,1,6
2009-11-03,CLE,102,2,2,WAS,90,2,1,4,3
2009-11-03,IND,93,0,2,DEN,111,3,0,3,2
2009-11-03,PHI,74,2,1,BOS,105,4,0,6,1
2009-11-03,DET,85,1,2,ORL,80,3,0,4,2
2009-11-03,MIA,96,3,0,PHX,104,3,0,6,0
2009-11-03,CHI,83,1,2,MIL,81,1,1,2,3
2009-11-03,OKC,98,2,1,LAL,101,2,1,4,2
2009-11-03,DAL,96,2,1,UTA,85,1,2,3,3
2009-11-03,POR,91,2,2,ATL,97,2,1,4,3
2009-11-04,ORL,122,3,1,PHX,100,4,0,7,1
2009-11-04,TOR,110,1,2,DET,99,2,2,3,4
2009-11-04,WAS,89,2,2,MIA,93,3,1,5,3
2009-11-04,NJN,94,0,4,DEN,122,4,0,4,4
2009-11-04,NYK,89,1,3,IND,101,0,3,1,6
2009-11-04,MIN,90,1,3,BOS,92,5,0,6,3
2009-11-04,HOU,102,3,1,LAL,103,3,1,6,2
2009-11-04,NOH,114,1,3,DAL,107,3,1,4,4
2009-11-04,SAC,105,1,3,ATL,113,3,1,4,4
2009-11-04,GSW,113,0,2,MEM,105,1,3,1,5
2009-11-05,CLE,85,3,2,CHI,86,2,2,5,4
2009-11-05,UTA,113,1,3,SAS,99,2,1,3,4
2009-11-06,CHA,103,2,2,ATL,83,4,1,6,3
2009-11-06,IND,102,1,3,WAS,86,2,3,3,6
2009-11-06,ORL,110,4,1,DET,103,2,3,6,4
2009-11-06,PHI,97,2,2,NJN,94,0,5,2,7
2009-11-06,BOS,103,6,0,PHX,110,4,1,10,1
2009-11-06,MIA,96,4,1,DEN,88,5,0,9,1
2009-11-06,MIN,72,1,4,MIL,87,1,2,2,6
2009-11-06,NOH,90,2,3,TOR,107,2,2,4,5
2009-11-06,NYK,91,1,4,CLE,100,3,3,4,7
2009-11-06,HOU,105,3,2,OKC,94,2,2,5,4
2009-11-06,GSW,90,1,2,LAC,118,1,4,2,6
2009-11-06,LAL,114,4,1,MEM,98,1,4,5,5
2009-11-06,POR,96,2,3,SAS,84,2,2,4,5
2009-11-07,ATL,125,4,2,DEN,100,5,1,9,3
2009-11-07,NJN,76,0,6,BOS,86,6,1,6,7
2009-11-07,CHI,93,3,2,CHA,90,3,2,6,4
2009-11-07,DAL,129,3,2,TOR,101,3,2,6,4
2009-11-07,MIL,102,2,2,NYK,87,1,5,3,7
2009-11-07,UTA,99,2,3,SAC,104,1,4,3,7
2009-11-07,LAC,113,2,4,MEM,110,1,5,3,9
2009-11-08,DET,88,2,4,PHI,81,3,2,5,6
2009-11-08,WAS,90,2,4,PHX,102,5,1,7,5
2009-11-08,OKC,102,2,3,ORL,74,5,1,7,4
2009-11-08,POR,116,3,3,MIN,93,1,5,4,8
2009-11-08,SAC,120,2,4,GSW,107,1,3,3,7
2009-11-08,LAL,104,5,1,NOH,88,2,4,7,5
2009-11-09,PHI,115,3,3,PHX,119,6,1,9,4
2009-11-09,NYK,93,1,6,UTA,95,2,4,3,10
2009-11-09,SAS,131,2,3,TOR,124,3,3,5,6
2009-11-09,GSW,146,1,4,MIN,105,1,6,2,10
2009-11-09,LAC,84,3,4,NOH,112,2,5,5,9
2009-11-10,CHA,81,3,3,ORL,93,5,2,8,5
2009-11-10,MIA,90,5,1,WAS,76,2,5,7,6
2009-11-10,CHI,89,4,2,DEN,90,5,2,9,4
2009-11-10,MEM,79,1,6,POR,93,4,3,5,9
2009-11-10,DAL,121,4,2,HOU,103,4,2,8,4
2009-11-10,SAC,101,3,4,OKC,98,3,3,6,7
2009-11-11,IND,108,2,3,GSW,94,2,4,4,7
2009-11-11,TOR,99,3,4,CHI,89,4,3,7,7
2009-11-11,BOS,105,7,1,UTA,86,3,4,10,5
2009-11-11,DET,98,3,4,CHA,75,3,4,6,8
2009-11-11,NJN,79,0,7,PHI,82,3,4,3,11
2009-11-11,NYK,101,1,7,ATL,114,5,2,6,9
2009-11-11,MIL,108,3,2,DEN,102,6,2,9,4
2009-11-11,MIN,84,1,7,POR,107,5,3,6,10
2009-11-11,ORL,93,6,2,CLE,102,4,3,10,5
2009-11-11,HOU,104,4,3,MEM,79,1,7,5,10
2009-11-11,SAS,92,3,3,DAL,83,5,2,8,5
2009-11-11,LAC,79,3,5,OKC,83,3,4,6,9
2009-11-11,PHX,124,7,1,NOH,104,3,5,10,6
2009-11-12,MIA,104,6,1,CLE,111,5,3,11,4
2009-11-12,LAL,121,6,1,PHX,102,8,1,14,2
2009-11-13,ORL,88,6,3,NJN,72,0,8,6,11
2009-11-13,PHI,90,4,4,UTA,112,3,5,7,9
2009-11-13,NYK,107,1,8,GSW,121,2,5,3,13
2009-11-13,BOS,86,8,1,ATL,97,6,2,14,3
2009-11-13,MIN,77,1,8,DAL,89,5,3,6,11
2009-11-13,NOH,78,3,6,POR,86,6,3,9,9
2009-11-13,SAC,109,4,4,HOU,100,5,3,9,7
2009-11-13,DEN,105,6,3,LAL,79,7,1,13,4
2009-11-13,LAC,89,3,6,TOR,104,4,4,7,10
2009-11-14,ATL,121,7,2,NOH,98,3,7,10,9
2009-11-14,CHA,74,3,5,POR,80,7,3,10,8
2009-11-14,IND,113,3,3,BOS,104,8,2,11,5
2009-11-14,WAS,103,2,6,DET,106,4,4,6,10
2009-11-14,CLE,107,6,3,UTA,103,4,5,10,8
2009-11-14,MIA,81,6,2,NJN,80,0,9,6,11
2009-11-14,CHI,94,4,4,PHI,88,4,5,8,9
2009-11-14,MEM,97,1,8,MIN,87,1,9,2,17
2009-11-14,MIL,129,4,2,GSW,125,3,5,7,7
2009-11-14,SAS,98,4,3,OKC,101,4,4,8,7
2009-11-15,DET,90,5,4,DAL,95,6,3,11,7
2009-11-15,OKC,93,5,4,LAC,101,3,7,8,11
2009-11-15,PHX,101,8,2,TOR,100,5,4,13,6
2009-11-15,LAL,91,7,2,HOU,101,5,4,12,6
2009-11-16,ATL,99,8,2,POR,95,8,3,16,5
2009-11-16,ORL,97,7,3,CHA,91,3,6,10,9
2009-11-16,MIL,113,5,2,DAL,115,7,3,12,5
2009-11-17,CLE,114,7,3,GSW,108,3,6,10,9
2009-11-17,MIA,87,7,2,OKC,100,5,5,12,7
2009-11-17,NJN,83,0,10,IND,91,4,3,4,13
2009-11-17,NOH,110,3,8,LAC,102,4,7,7,15
2009-11-17,HOU,105,6,4,PHX,111,9,2,15,6
2009-11-17,DEN,130,7,3,TOR,112,5,5,12,8
2009-11-17,SAC,87,5,4,CHI,101,5,4,10,8
2009-11-17,LAL,106,7,3,DET,93,5,5,12,8
2009-11-18,ATL,105,9,2,MIA,90,7,3,16,5
2009-11-18,IND,103,5,3,NYK,110,1,9,6,12
2009-11-18,ORL,108,8,3,OKC,94,6,5,14,8
2009-11-18,PHI,86,4,6,CHA,84,3,7,7,13
2009-11-18,WAS,108,2,7,CLE,91,8,3,10,10
2009-11-18,BOS,109,8,3,GSW,95,3,7,11,10
2009-11-18,MEM,106,2,8,LAC,91,4,8,6,16
2009-11-18,MIL,99,5,3,NJN,85,0,11,5,14
2009-11-18,MIN,84,1,10,HOU,97,6,5,7,15
2009-11-18,UTA,104,4,6,TOR,91,5,6,9,12
2009-11-18,DAL,99,8,3,SAS,94,4,4,12,7
2009-11-18,POR,87,8,4,DET,81,5,6,13,10
2009-11-19,NOH,110,4,8,PHX,103,10,2,14,10
2009-11-19,SAS,83,4,5,UTA,90,5,6,9,11
2009-11-19,LAL,108,8,3,CHI,93,6,4,14,7
2009-11-20,IND,95,5,4,CLE,105,8,4,13,8
2009-11-20,PHI,97,5,6,MEM,102,3,8,8,14
2009-11-20,TOR,120,5,7,MIA,113,7,4,12,11
2009-11-20,ATL,105,10,2,HOU,103,7,5,17,7
2009-11-20,BOS,78,9,3,ORL,83,9,3,18,6
2009-11-20,OKC,127,6,6,WAS,108,3,7,9,13
2009-11-20,DAL,104,9,3,SAC,102,5,5,14,8
2009-11-20,MIL,95,6,3,CHA,88,3,8,9,11
2009-11-20,GSW,108,3,8,POR,94,9,4,12,12
2009-11-20,LAC,106,4,9,DEN,99,8,3,12,12
2009-11-21,NJN,91,0,12,NYK,98,2,9,2,21
2009-11-21,CLE,97,9,4,PHI,91,5,7,14,11
2009-11-21,MEM,98,4,8,MIL,103,7,3,11,11
2009-11-21,NOH,96,5,8,ATL,88,11,2,16,10
2009-11-21,HOU,113,7,6,SAC,106,5,6,12,12
2009-11-21,SAS,106,4,6,WAS,84,3,8,7,14
2009-11-21,DEN,112,8,4,CHI,93,6,5,14,9
2009-11-21,UTA,100,6,6,DET,97,5,7,11,13
2009-11-21,POR,106,9,5,MIN,78,1,11,10,16
2009-11-22,TOR,96,6,7,ORL,104,10,3,16,10
2009-11-22,NYK,105,3,9,BOS,107,9,4,12,13
2009-11-22,CHA,104,3,9,IND,88,5,5,8,14
2009-11-22,MIA,102,7,5,NOH,101,6,8,13,13
2009-11-22,PHX,117,10,3,DET,91,5,8,15,11
2009-11-22,LAL,101,9,3,OKC,85,7,6,16,9
2009-11-23,MEM,116,4,9,SAC,105,5,7,9,16
2009-11-23,SAS,112,5,6,MIL,98,8,3,13,9
2009-11-23,POR,122,10,5,CHI,98,6,6,16,11
2009-11-23,LAC,91,5,9,MIN,87,1,12,6,21
2009-11-24,TOR,123,6,8,IND,112,5,6,11,14
2009-11-24,WAS,108,3,9,PHI,107,5,8,8,17
2009-11-24,DAL,103,10,3,GSW,111,4,8,14,11
2009-11-24,DEN,101,9,4,NJN,87,0,13,9,17
2009-11-24,UTA,94,7,6,OKC,104,7,7,14,13
2009-11-24,LAL,100,10,3,NYK,90,3,10,13,13
2009-11-25,CHA,116,4,9,TOR,81,7,8,11,17
2009-11-25,IND,86,5,7,LAC,73,6,9,11,16
2009-11-25,BOS,113,10,4,PHI,110,5,9,15,13
2009-11-25,ORL,98,11,3,MIA,99,8,5,19,8
2009-11-25,DET,88,5,9,CLE,98,10,4,15,13
2009-11-25,MIN,111,1,13,DEN,124,10,4,11,17
2009-11-25,NOH,102,6,9,MIL,99,8,4,14,13
2009-11-25,HOU,99,8,6,DAL,130,10,4,18,10
2009-11-25,SAS,118,6,6,GSW,104,5,8,11,14
2009-11-25,PHX,126,11,3,MEM,111,5,9,16,12
2009-11-25,POR,93,11,5,NJN,83,0,14,11,19
2009-11-25,SAC,111,5,8,NYK,97,3,11,8,19
2009-11-26,ATL,76,11,3,ORL,93,11,4,22,7
2009-11-26,UTA,105,7,7,CHI,86,6,7,13,14
2009-11-27,CHA,94,5,9,CLE,87,11,4,16,13
2009-11-27,MIA,84,9,5,WAS,94,4,9,13,14
2009-11-27,PHI,86,5,10,ATL,100,11,4,16,14
2009-11-27,BOS,116,11,4,TOR,103,7,9,18,13
2009-11-27,DET,96,5,10,LAC,104,6,10,11,20
2009-11-27,IND,92,6,7,DAL,113,11,4,17,11
2009-11-27,OKC,108,8,7,MIL,90,8,5,16,12
2009-11-27,HOU,84,8,7,SAS,92,7,6,15,13
2009-11-27,DEN,128,11,4,NYK,125,3,12,14,16
2009-11-27,MIN,95,1,14,PHX,120,12,3,13,17
2009-11-27,POR,96,12,5,MEM,106,5,10,17,15
2009-11-27,SAC,109,6,8,NJN,96,0,15,6,23
2009-11-28,WAS,76,5,9,CHA,92,6,9,11,18
2009-11-28,CLE,111,11,5,DAL,95,12,4,23,9
2009-11-28,MIL,98,8,6,ORL,100,12,4,20,10
2009-11-28,UTA,108,8,7,POR,92,12,6,20,13
2009-11-28,GSW,97,5,9,LAL,130,11,3,16,12
2009-11-29,DET,94,5,11,ATL,88,12,4,17,15
2009-11-29,LAC,98,7,10,MEM,88,6,10,13,20
2009-11-29,TOR,94,7,10,PHX,113,13,3,20,13
2009-11-29,MIA,85,9,6,BOS,92,12,4,21,10
2009-11-29,NYK,102,3,13,ORL,114,13,4,16,17
2009-11-29,OKC,91,9,7,HOU,100,8,8,17,15
2009-11-29,SAS,97,8,6,PHI,89,5,11,13,17
2009-11-29,DEN,100,12,4,MIN,106,1,15,13,19
2009-11-29,SAC,112,7,8,NOH,96,7,9,14,17
2009-11-29,LAL,106,12,3,NJN,87,0,16,12,19
2009-11-30,MIL,99,8,7,CHI,97,6,8,14,15
2009-11-30,DAL,104,12,5,PHI,102,5,12,17,17
2009-11-30,UTA,120,9,7,MEM,93,6,11,15,18
2009-11-30,GSW,126,5,10,IND,107,6,8,11,18
2009-12-01,CHA,90,7,9,BOS,108,13,4,20,13
2009-12-01,TOR,102,7,11,WAS,106,5,10,12,21
2009-12-01,NYK,126,3,14,PHX,99,14,3,17,17
2009-12-01,DEN,135,12,5,GSW,107,6,10,18,15
2009-12-01,POR,100,12,7,MIA,107,9,7,21,14
2009-12-01,LAL,110,13,3,NOH,99,7,10,20,13
2009-12-02,ATL,146,12,5,TOR,115,7,12,19,17
2009-12-02,CLE,107,12,5,PHX,90,14,4,26,9
2009-12-02,ORL,118,14,4,NYK,104,4,14,18,18
2009-12-02,WAS,104,6,10,MIL,102,9,7,15,17
2009-12-02,NJN,101,0,17,DAL,117,13,5,13,22
2009-12-02,CHI,92,6,9,DET,85,6,11,12,20
2009-12-02,MIN,95,2,15,MEM,97,6,12,8,27
2009-12-02,OKC,117,9,8,PHI,106,5,13,14,21
2009-12-02,SAC,110,8,8,IND,105,6,9,14,17
2009-12-02,LAC,85,8,10,HOU,102,9,8,17,18
2009-12-03,SAS,83,9,6,BOS,90,14,4,23,10
2009-12-03,DEN,114,13,5,MIA,96,10,7,23,12
2009-12-03,GSW,109,6,11,HOU,111,10,8,16,19
2009-12-04,WAS,107,7,10,TOR,109,7,13,14,23
2009-12-04,ATL,107,13,5,NYK,114,4,15,17,20
2009-12-04,CLE,101,13,5,CHI,87,7,9,20,14
2009-12-04,DET,105,6,12,MIL,96,9,8,15,20
2009-12-04,MEM,98,7,12,DAL,82,14,5,21,17
2009-12-04,NJN,97,0,18,CHA,91,7,10,7,28
2009-12-04,NOH,98,7,11,MIN,89,2,16,9,27
2009-12-04,OKC,87,10,8,BOS,105,15,4,25,12
2009-12-04,UTA,96,10,7,IND,87,6,10,16,17
2009-12-04,LAL,108,14,3,MIA,107,10,8,24,11
2009-12-05,CHA,106,7,11,PHI,105,5,14,12,25
2009-12-05,CHI,78,7,10,TOR,110,8,13,15,23
2009-12-05,MIN,108,2,17,UTA,101,11,7,13,24
2009-12-05,SAS,99,9,7,DEN,106,14,5,23,12
2009-12-05,DAL,75,14,6,ATL,80,13,6,27,12
2009-12-05,PHX,115,14,5,SAC,107,9,8,23,13
2009-12-05,POR,90,12,8,HOU,89,11,8,23,16
2009-12-05,GSW,118,6,12,ORL,126,15,4,21,16
2009-12-05,LAC,88,8,11,IND,72,6,11,14,22
2009-12-06,NYK,106,5,15,NJN,97,1,18,6,33
2009-12-06,MIL,86,9,9,CLE,101,14,5,23,14
2009-12-06,DET,98,7,12,WAS,94,7,11,14,23
2009-12-06,SAC,102,9,9,MIA,115,10,9,19,18
2009-12-06,LAL,108,15,3,PHX,88,15,5,30,8
2009-12-07,PHI,83,5,15,DEN,93,15,5,20,20
2009-12-07,NYK,93,6,15,POR,84,13,8,19,23
2009-12-07,OKC,104,10,9,GSW,88,6,13,16,22
2009-12-07,UTA,104,11,8,SAS,101,9,8,20,16
2009-12-08,CHA,107,8,11,DEN,95,16,5,24,16
2009-12-08,TOR,94,9,13,MIN,88,3,17,12,30
2009-12-08,BOS,98,16,4,MIL,89,9,10,25,14
2009-12-08,CHI,101,7,11,NJN,103,1,19,8,30
2009-12-08,MEM,111,8,12,CLE,109,15,5,23,17
2009-12-08,NOH,96,8,11,SAC,94,9,10,17,21
2009-12-08,DAL,102,14,7,PHX,101,15,6,29,13
2009-12-08,LAC,86,9,11,ORL,97,16,4,25,15
2009-12-09,ATL,118,14,6,CHI,83,7,12,21,18
2009-12-09,IND,91,6,12,POR,102,13,9,19,21
2009-12-09,PHI,86,5,16,DET,90,8,12,13,28
2009-12-09,NJN,89,2,19,GSW,105,6,14,8,33
2009-12-09,MIL,117,9,11,TOR,95,10,13,19,24
2009-12-09,MIN,96,3,18,NOH,97,9,11,12,29
2009-12-09,HOU,95,11,9,CLE,85,15,6,26,15
2009-12-09,SAS,118,9,9,SAC,106,9,11,18,20
2009-12-09,LAL,101,16,3,UTA,77,12,8,28,11
2009-12-10,DET,101,9,12,DEN,99,16,6,25,18
2009-12-10,WAS,102,7,12,BOS,104,17,4,24,16
2009-12-10,UTA,120,12,9,ORL,111,17,4,29,13
2009-12-11,IND,107,6,13,NJN,91,2,20,8,33
2009-12-11,PHI,91,5,17,HOU,96,12,9,17,26
2009-12-11,TOR,89,10,14,ATL,111,15,6,25,20
2009-12-11,MIA,93,11,9,DAL,106,15,7,26,16
2009-12-11,CHI,96,7,13,GSW,91,7,14,14,27
2009-12-11,CLE,104,15,7,POR,99,14,9,29,16
2009-12-11,MEM,94,9,12,OKC,102,11,9,20,21
2009-12-11,NOH,96,10,11,NYK,113,7,15,17,26
2009-12-11,SAS,104,10,9,CHA,85,9,11,19,20
2009-12-11,LAL,104,17,3,MIN,92,3,19,20,22
2009-12-11,PHX,106,15,7,ORL,103,17,5,32,12
2009-12-12,WAS,113,7,13,IND,114,7,13,14,26
2009-12-12,DET,104,10,12,GSW,95,7,15,17,27
2009-12-12,CHI,80,8,13,BOS,106,18,4,26,17
2009-12-12,DAL,98,16,7,CHA,97,9,12,25,19
2009-12-12,MIL,108,10,11,POR,101,14,10,24,21
2009-12-12,DEN,105,16,7,PHX,99,16,7,32,14
2009-12-12,UTA,102,13,9,LAL,94,18,3,31,12
2009-12-12,SAC,120,9,12,MIN,100,3,20,12,32
2009-12-13,TOR,101,10,15,HOU,88,13,9,23,24
2009-12-13,ATL,130,16,6,NJN,107,2,21,18,27
2009-12-13,MIA,90,11,10,MEM,118,9,13,20,23
2009-12-13,OKC,89,12,9,CLE,102,16,7,28,16
2009-12-13,LAC,90,9,12,SAS,115,11,9,20,21
2009-12-14,ORL,106,17,6,IND,98,8,13,25,19
2009-12-14,PHI,117,5,18,GSW,101,7,16,12,34
2009-12-14,MEM,105,10,13,BOS,110,19,4,29,17
2009-12-14,DAL,94,17,7,NOH,90,10,12,27,19
2009-12-14,DEN,102,17,7,OKC,93,12,10,29,17
2009-12-14,UTA,108,14,9,MIN,110,3,21,17,30
2009-12-14,LAC,97,9,13,WAS,95,7,14,16,27
2009-12-15,CHA,94,9,13,NYK,87,8,15,17,28
2009-12-15,CLE,99,17,7,NJN,89,2,22,19,29
2009-12-15,MIA,115,11,11,TOR,95,11,15,22,26
2009-12-15,CHI,87,8,14,LAL,96,18,4,26,18
2009-12-15,HOU,107,13,10,DET,96,11,12,24,22
2009-12-15,PHX,116,16,8,SAS,104,12,9,28,17
2009-12-15,POR,95,14,11,SAC,88,10,12,24,23
2009-12-16,ATL,110,17,6,MEM,97,10,14,27,20
2009-12-16,IND,101,8,14,CHA,98,10,13,18,27
2009-12-16,ORL,118,18,6,TOR,99,11,16,29,22
2009-12-16,PHI,101,6,18,CLE,108,18,7,24,25
2009-12-16,NJN,92,2,23,UTA,108,14,10,16,33
2009-12-16,MIL,106,11,11,LAL,107,19,4,30,15
2009-12-16,MIN,95,4,21,LAC,120,10,13,14,34
2009-12-16,NOH,95,10,13,DET,87,11,13,21,26
2009-12-16,OKC,86,12,11,DAL,100,18,7,30,18
2009-12-16,DEN,111,18,7,HOU,101,14,10,32,17
2009-12-16,SAC,112,10,13,WAS,109,7,15,17,28
2009-12-16,GSW,91,7,17,SAS,103,12,10,19,27
2009-12-17,CHI,98,8,15,NYK,89,8,16,16,31
2009-12-17,MIA,104,12,11,ORL,86,19,6,31,17
2009-12-17,POR,105,15,11,PHX,102,17,8,32,19
2009-12-18,TOR,118,11,17,NJN,95,2,24,13,41
2009-12-18,ATL,96,18,6,UTA,83,15,10,33,16
2009-12-18,BOS,97,20,4,PHI,98,6,19,26,23
2009-12-18,CLE,85,19,7,MIL,82,11,12,30,19
2009-12-18,MEM,107,10,15,IND,94,9,14,19,29
2009-12-18,MIN,112,4,22,SAC,96,11,13,15,35
2009-12-18,NOH,98,11,13,DEN,92,19,7,30,20
2009-12-18,NYK,95,8,17,LAC,91,11,13,19,30
2009-12-18,OKC,109,12,12,DET,98,11,14,23,26
2009-12-18,DAL,108,19,7,HOU,116,14,11,33,18
2009-12-18,GSW,109,7,18,WAS,118,7,16,14,34
2009-12-19,CHA,102,10,14,UTA,110,15,11,25,25
2009-12-19,ORL,92,19,7,POR,83,16,11,35,18
2009-12-19,PHI,107,7,19,LAC,112,11,14,18,33
2009-12-19,CHI,101,9,15,ATL,98,19,6,28,21
2009-12-19,NJN,84,2,25,LAL,103,20,4,22,29
2009-12-19,HOU,95,15,11,OKC,90,13,12,28,23
2009-12-19,MIL,95,11,13,SAC,96,11,14,22,27
2009-12-19,SAS,100,13,10,IND,99,9,15,22,25
2009-12-19,PHX,121,17,9,WAS,95,8,16,25,25
2009-12-20,TOR,98,12,17,NOH,92,12,13,24,30
2009-12-20,MEM,102,11,15,DEN,96,19,8,30,23
2009-12-20,BOS,122,20,5,MIN,104,5,22,25,27
2009-12-20,DET,81,11,15,LAL,93,21,4,32,19
2009-12-20,MIA,95,13,11,POR,102,16,12,29,23
2009-12-20,DAL,102,19,8,CLE,95,20,7,39,15
2009-12-20,NYK,98,9,17,CHA,94,10,15,19,32
2009-12-21,IND,81,9,16,MIL,84,11,14,20,30
2009-12-21,ORL,104,20,7,UTA,99,16,11,36,18
2009-12-21,CHI,98,10,15,SAC,102,12,14,22,29
2009-12-21,SAS,103,14,10,LAC,87,12,14,26,24
2009-12-21,PHX,91,18,9,CLE,109,20,8,38,17
2009-12-22,CHA,88,10,16,DET,76,11,16,21,32
2009-12-22,WAS,105,8,17,PHI,98,7,20,15,37
2009-12-22,BOS,103,21,5,IND,94,9,17,30,22
2009-12-22,NYK,88,10,17,CHI,81,10,16,20,33
2009-12-22,MEM,121,12,15,GSW,108,7,19,19,34
2009-12-22,MIN,87,5,23,ATL,112,19,7,24,30
2009-12-22,DAL,81,20,8,POR,85,17,12,37,20
2009-12-22,HOU,108,16,11,LAC,99,12,15,28,26
2009-12-22,LAL,111,22,4,OKC,108,13,13,35,17
2009-12-23,ORL,102,21,7,HOU,87,17,11,38,18
2009-12-23,DET,64,11,17,TOR,94,13,17,24,34
2009-12-23,MIA,80,13,12,UTA,70,16,12,29,24
2009-12-23,NJN,99,2,26,MIN,103,5,24,7,50
2009-12-23,MIL,97,12,14,WAS,109,9,17,21,31
2009-12-23,NOH,108,12,14,GSW,102,7,20,19,34
2009-12-23,SAS,94,15,10,POR,98,18,12,33,22
2009-12-23,DEN,124,19,9,ATL,104,20,7,39,16
2009-12-23,PHX,113,18,10,OKC,117,13,14,31,24
2009-12-23,SAC,104,13,14,CLE,117,21,8,34,22
2009-12-25,NYK,87,11,17,MIA,93,14,12,25,29
2009-12-25,ORL,77,22,7,BOS,86,22,5,44,12
2009-12-25,LAL,87,23,4,CLE,102,22,8,45,12
2009-12-25,PHX,124,18,11,LAC,93,12,16,30,27
2009-12-25,POR,107,19,12,DEN,96,20,9,39,21
2009-12-26,DAL,106,20,9,MEM,101,13,15,33,24
2009-12-26,IND,98,9,18,ATL,110,20,8,29,26
2009-12-26,NJN,93,2,27,HOU,98,17,12,19,39
2009-12-26,CHI,96,10,17,NOH,85,13,14,23,31
2009-12-26,MIN,101,6,24,WAS,89,10,17,16,41
2009-12-26,OKC,98,14,14,CHA,91,11,16,25,30
2009-12-26,MIL,97,12,15,SAS,112,15,11,27,26
2009-12-26,UTA,97,16,13,PHI,76,7,21,23,34
2009-12-26,SAC,103,13,15,LAL,112,23,5,36,20
2009-12-26,GSW,132,7,21,PHX,127,19,11,26,32
2009-12-27,TOR,102,14,17,DET,95,11,18,25,35
2009-12-27,CLE,108,23,8,HOU,83,18,12,41,20
2009-12-27,MIA,114,15,12,IND,80,9,19,24,31
2009-12-27,NYK,88,11,18,SAS,95,16,11,27,29
2009-12-27,DEN,96,20,10,DAL,104,21,9,41,19
2009-12-27,LAC,92,12,17,BOS,90,23,5,35,22
2009-12-28,CHA,94,11,17,MIL,84,12,16,23,33
2009-12-28,NJN,89,2,28,OKC,105,15,14,17,42
2009-12-28,MEM,116,13,16,WAS,111,10,18,23,34
2009-12-28,PHX,118,19,12,LAL,103,24,5,43,17
2009-12-28,POR,93,20,12,PHI,104,7,22,27,34
2009-12-28,SAC,106,13,16,DEN,101,20,11,33,27
2009-12-28,GSW,103,8,21,BOS,99,23,6,31,27
2009-12-29,ATL,84,21,8,CLE,95,24,8,45,16
2009-12-29,WAS,98,10,19,OKC,110,16,14,26,33
2009-12-29,DET,87,11,19,NYK,104,11,19,22,38
2009-12-29,CHI,104,11,17,IND,95,9,20,20,37
2009-12-29,HOU,108,18,13,NOH,100,13,15,31,28
2009-12-29,SAS,117,17,11,MIN,99,7,24,24,35
2009-12-29,LAL,124,24,6,GSW,118,9,21,33,27
2009-12-30,CLE,106,25,8,ATL,101,21,9,46,17
2009-12-30,IND,110,9,21,MEM,121,14,16,23,37
2009-12-30,ORL,117,22,8,MIL,92,12,17,34,25
2009-12-30,TOR,107,15,17,CHA,103,12,17,27,34
2009-12-30,NJN,104,2,29,NYK,95,12,19,14,48
2009-12-30,MIN,103,7,25,UTA,107,17,13,24,38
2009-12-30,NOH,95,13,16,MIA,91,16,12,29,28
2009-12-30,PHX,116,20,12,BOS,98,23,7,43,19
2009-12-30,POR,103,20,13,LAC,99,13,17,33,30
2009-12-30,SAC,106,14,16,PHI,116,8,22,22,38
2009-12-31,DET,87,11,20,CHI,98,12,17,23,37
2009-12-31,HOU,97,19,13,DAL,94,22,9,41,22
2009-12-31,SAS,108,18,11,MIA,78,16,13,34,24
2009-12-31,OKC,87,17,14,UTA,86,18,13,35,27
2009-12-31,LAC,104,13,18,PHI,88,9,22,22,40
2010-01-01,ATL,108,21,10,NYK,112,12,20,33,30
2010-01-01,MIN,94,7,26,ORL,106,23,8,30,34
2010-01-01,LAL,109,25,6,SAC,108,14,17,39,23
2010-01-02,NJN,86,3,29,CLE,94,26,8,29,37
2010-01-02,MIA,97,16,14,CHA,107,12,18,28,32
2010-01-02,IND,122,9,22,MIN,111,7,27,16,49
2010-01-02,WAS,86,10,20,SAS,97,19,11,29,31
2010-01-02,BOS,103,23,8,TOR,96,16,17,39,25
2010-01-02,CHI,101,13,17,ORL,93,24,8,37,25
2010-01-02,NOH,99,14,16,HOU,95,20,13,34,29
2010-01-02,MIL,103,12,18,OKC,97,18,14,30,32
2010-01-02,PHX,103,21,12,MEM,128,15,16,36,28
2010-01-02,UTA,95,18,14,DEN,105,20,12,38,26
2010-01-02,POR,105,21,13,GSW,89,9,22,30,35
2010-01-02,SAC,91,14,18,DAL,99,22,10,36,28
2010-01-03,CLE,88,27,8,CHA,91,13,18,40,26
2010-01-03,NYK,132,13,20,IND,89,10,22,23,42
2010-01-03,TOR,91,16,18,SAS,86,20,11,36,29
2010-01-03,DEN,105,21,12,PHI,108,9,23,30,35
2010-01-03,LAL,131,26,6,DAL,96,23,10,49,16
2010-01-04,MIA,92,16,15,ATL,75,21,11,37,26
2010-01-04,CHI,85,14,17,OKC,98,18,15,32,32
2010-01-04,UTA,87,18,15,NOH,91,15,16,33,31
2010-01-04,LAC,105,14,18,POR,95,22,13,36,31
2010-01-05,CHA,113,14,18,CHI,108,14,18,28,36
2010-01-05,IND,97,10,23,ORL,90,24,9,34,32
2010-01-05,PHI,97,10,23,WAS,104,10,21,20,44
2010-01-05,NJN,76,3,30,MIL,98,13,18,16,48
2010-01-05,DAL,98,23,11,DET,93,11,21,34,32
2010-01-05,DEN,123,21,13,GSW,122,9,23,30,36
2010-01-05,POR,105,22,14,MEM,109,16,16,38,30
2010-01-05,SAC,109,14,19,PHX,113,21,13,35,32
2010-01-05,LAL,88,27,6,HOU,79,20,14,47,20
2010-01-06,ATL,119,21,12,NJN,89,3,31,24,43
2010-01-06,CLE,121,27,9,WAS,98,11,21,38,30
2010-01-06,ORL,103,24,10,TOR,108,17,18,41,28
2010-01-06,MIA,106,17,15,BOS,112,24,8,41,23
2010-01-06,MIN,101,7,28,GSW,107,9,24,16,52
2010-01-06,OKC,92,19,15,NOH,97,16,16,35,31
2010-01-06,SAS,112,20,12,DET,92,11,22,31,34
2010-01-06,PHX,118,22,13,HOU,110,20,15,42,28
2010-01-06,UTA,117,18,16,MEM,94,17,16,35,32
2010-01-06,LAC,102,15,18,LAL,91,28,6,43,24
2010-01-07,NYK,97,14,20,CHA,93,15,18,29,38
2010-01-08,PHI,106,10,24,TOR,108,18,18,28,42
2010-01-08,WAS,104,11,22,ORL,97,24,11,35,33
2010-01-08,ATL,93,22,12,BOS,85,25,8,47,20
2010-01-08,MEM,91,17,17,UTA,89,19,16,36,33
2010-01-08,MIN,116,7,29,IND,109,11,23,18,52
2010-01-08,NOH,103,17,16,NJN,99,3,32,20,48
2010-01-08,MIL,96,14,18,CHI,93,14,19,28,37
2010-01-08,SAS,103,21,12,DAL,112,24,11,45,23
2010-01-08,PHX,105,23,13,MIA,109,17,16,40,29
2010-01-08,POR,107,22,15,LAL,98,28,7,50,22
2010-01-08,DEN,99,22,13,CLE,97,28,9,50,22
2010-01-08,GSW,108,10,24,SAC,101,14,20,24,44
2010-01-09,CHA,89,15,19,MEM,87,18,17,33,36
2010-01-09,ORL,113,24,12,ATL,81,23,12,47,24
2010-01-09,DET,94,11,23,PHI,104,10,25,21,48
2010-01-09,CHI,110,14,20,MIN,96,8,29,22,49
2010-01-09,OKC,108,19,16,IND,102,11,24,30,40
2010-01-09,DAL,93,25,11,UTA,111,19,17,44,28
2010-01-09,HOU,105,20,16,NYK,96,15,20,35,36
2010-01-09,SAC,102,14,21,DEN,100,23,13,37,34
2010-01-10,TOR,107,19,18,BOS,114,25,9,44,27
2010-01-10,WAS,110,12,22,NOH,115,18,16,30,38
2010-01-10,LAC,94,16,18,MIA,84,18,16,34,34
2010-01-10,SAS,97,21,13,NJN,85,3,33,24,46
2010-01-10,POR,94,23,15,CLE,106,28,10,51,25
2010-01-10,LAL,95,28,8,MIL,77,15,18,43,26
2010-01-11,IND,105,11,25,TOR,101,19,19,30,44
2010-01-11,PHI,96,11,25,NOH,92,19,16,30,41
2010-01-11,BOS,96,26,9,ATL,102,23,13,49,22
2010-01-11,CHI,120,15,20,DET,87,11,24,26,44
2010-01-11,OKC,106,20,16,NYK,88,15,21,35,37
2010-01-11,DEN,105,23,14,MIN,94,8,30,31,44
2010-01-11,PHX,105,23,14,MIL,101,15,19,38,33
2010-01-11,UTA,118,20,17,MIA,89,18,17,38,34
2010-01-11,GSW,114,11,24,CLE,117,29,10,40,34
2010-01-12,CHA,102,16,19,HOU,94,21,16,37,35
2010-01-12,WAS,90,12,23,DET,99,11,25,23,48
2010-01-12,MEM,104,18,18,LAC,102,17,18,35,36
2010-01-12,SAS,105,22,13,LAL,85,29,8,51,21
2010-01-12,SAC,88,15,21,ORL,109,25,12,40,33
2010-01-13,ATL,94,24,13,WAS,82,12,24,36,37
2010-01-13,IND,122,12,25,PHX,114,24,14,36,39
2010-01-13,PHI,92,12,25,NYK,93,15,22,27,47
2010-01-13,NJN,87,3,34,BOS,111,26,10,29,44
2010-01-13,NOH,108,19,17,LAC,94,17,19,36,36
2010-01-13,OKC,108,21,16,SAS,109,23,13,44,29
2010-01-13,DAL,95,25,12,LAL,100,29,9,54,21
2010-01-13,HOU,120,21,17,MIN,114,8,31,29,48
2010-01-13,DEN,115,24,14,ORL,97,26,12,50,26
2010-01-13,POR,120,23,16,MIL,108,15,20,38,36
2010-01-13,GSW,102,11,25,MIA,115,18,18,29,43
2010-01-14,BOS,83,27,10,CHI,96,16,20,43,30
2010-01-14,UTA,97,21,17,CLE,96,30,10,51,27
2010-01-15,CHA,92,17,19,SAS,76,24,13,41,32
2010-01-15,PHI,98,12,26,SAC,86,15,22,27,48
2010-01-15,ATL,102,25,13,PHX,101,24,15,49,28
2010-01-15,CHI,121,17,20,WAS,119,12,25,29,45
2010-01-15,DET,110,12,25,NOH,104,20,17,32,42
2010-01-15,MEM,135,19,18,MIN,110,8,32,27,50
2010-01-15,NJN,105,3,35,IND,121,13,25,16,60
2010-01-15,NYK,104,16,22,TOR,112,19,20,35,42
2010-01-15,DAL,99,25,13,OKC,98,21,17,46,30
2010-01-15,HOU,106,22,17,MIA,115,19,18,41,35
2010-01-15,GSW,104,11,26,MIL,113,15,21,26,47
2010-01-15,LAL,126,30,9,LAC,86,17,20,47,29
2010-01-15,POR,102,24,16,ORL,87,26,13,50,29
2010-01-16,CHA,125,18,19,PHX,99,24,16,42,35
2010-01-16,IND,96,14,25,NOH,101,20,18,34,43
2010-01-16,WAS,96,12,26,SAC,86,15,23,27,49
2010-01-16,DET,94,13,25,NYK,90,16,23,29,48
2010-01-16,MEM,92,20,18,SAS,86,24,14,44,32
2010-01-16,OKC,98,21,18,MIA,80,20,18,41,36
2010-01-16,UTA,112,22,17,MIL,95,16,21,38,38
2010-01-16,LAC,101,17,21,CLE,102,30,11,47,32
2010-01-17,TOR,110,20,20,DAL,88,26,13,46,33
2010-01-17,DEN,119,25,14,UTA,112,23,17,48,31
2010-01-18,NYK,99,16,24,DET,91,14,25,30,49
2010-01-18,WAS,97,13,26,POR,92,25,16,38,42
2010-01-18,ATL,91,26,13,OKC,94,22,18,48,31
2010-01-18,CHA,105,19,19,SAC,103,15,24,34,43
2010-01-18,HOU,101,22,18,MIL,98,16,22,38,40
2010-01-18,LAC,106,17,22,NJN,95,3,36,20,58
2010-01-18,MIN,108,8,33,PHI,103,13,26,21,59
2010-01-18,NOH,90,21,18,SAS,97,24,15,45,33
2010-01-18,GSW,114,11,27,CHI,97,18,20,29,47
2010-01-18,MEM,125,21,18,PHX,118,24,17,45,35
2010-01-18,BOS,90,27,11,DAL,99,26,14,53,25
2010-01-18,LAL,98,31,9,ORL,92,26,14,57,23
2010-01-19,CLE,108,31,11,TOR,100,21,20,52,31
2010-01-19,MIA,113,20,19,IND,83,14,26,34,45
2010-01-20,ATL,108,26,14,SAC,97,15,25,41,39
2010-01-20,CHA,104,20,19,MIA,65,21,19,41,38
2010-01-20,ORL,109,26,15,IND,98,14,27,40,42
2010-01-20,PHI,90,13,27,POR,98,25,17,38,44
2010-01-20,WAS,93,14,26,DAL,94,27,14,41,40
2010-01-20,DET,92,14,26,BOS,86,27,12,41,38
2010-01-20,MIL,113,16,23,TOR,107,21,21,37,44
2010-01-20,MIN,92,9,33,OKC,94,23,18,32,51
2010-01-20,NOH,113,21,19,MEM,111,22,18,43,37
2010-01-20,PHX,118,24,18,NJN,94,3,37,27,55
2010-01-20,SAS,98,25,15,UTA,105,23,18,48,33
2010-01-20,GSW,118,12,27,DEN,123,26,14,38,41
2010-01-20,LAC,104,18,22,CHI,97,18,21,36,43
2010-01-21,CLE,93,32,11,LAL,87,32,9,64,20
2010-01-21,DEN,105,27,14,LAC,85,19,22,46,36
2010-01-22,ORL,100,27,15,SAC,84,15,26,42,41
2010-01-22,PHI,92,13,28,DAL,81,28,14,41,42
2010-01-22,TOR,101,21,22,MIL,96,17,23,38,45
2010-01-22,WAS,88,14,27,MIA,112,21,20,35,47
2010-01-22,ATL,103,27,14,CHA,89,21,19,48,33
2010-01-22,BOS,98,27,13,POR,95,26,17,53,30
2010-01-22,DET,93,15,26,IND,105,14,28,29,54
2010-01-22,MEM,86,22,19,OKC,84,24,18,46,37
2010-01-22,MIN,94,9,34,NOH,96,22,19,31,53
2010-01-22,NYK,105,17,24,LAL,115,32,10,49,34
2010-01-22,SAS,109,25,16,HOU,116,23,18,48,34
2010-01-22,GSW,111,12,28,NJN,79,3,38,15,66
2010-01-22,PHX,104,25,18,CHI,115,18,22,43,40
2010-01-23,CHA,95,21,20,ORL,106,28,15,49,35
2010-01-23,IND,97,15,28,PHI,107,14,28,29,56
2010-01-23,CLE,100,33,11,OKC,99,24,19,57,30
2010-01-23,DET,93,15,27,POR,97,26,18,41,45
2010-01-23,MIA,115,22,20,SAC,84,15,27,37,47
2010-01-23,HOU,97,24,18,CHI,104,19,22,43,40
2010-01-23,MIL,127,17,24,MIN,94,9,35,26,59
2010-01-23,DEN,116,28,14,NOH,110,23,19,51,33
2010-01-23,PHX,112,25,19,GSW,103,13,28,38,47
2010-01-23,UTA,116,24,18,NJN,83,3,39,27,57
2010-01-24,NYK,78,17,25,DAL,128,28,15,45,40
2010-01-24,WAS,78,14,28,LAC,92,19,23,33,51
2010-01-24,TOR,106,22,22,LAL,105,33,10,55,32
2010-01-25,PHI,98,15,28,IND,109,15,29,30,57
2010-01-25,BOS,95,28,13,LAC,89,20,23,48,36
2010-01-25,MIA,91,23,20,CLE,92,34,11,57,31
2010-01-25,MEM,99,23,19,ORL,94,29,15,52,34
2010-01-25,HOU,95,24,19,ATL,102,28,14,52,33
2010-01-25,SAS,93,25,17,CHI,98,20,22,45,39
2010-01-25,DEN,104,29,14,CHA,93,21,21,50,35
2010-01-25,UTA,124,25,18,PHX,115,26,19,51,37
2010-01-25,POR,97,27,18,NOH,98,23,20,50,38
2010-01-26,WAS,103,14,29,LAL,115,33,11,47,40
2010-01-26,NYK,132,17,26,MIN,105,9,36,26,62
2010-01-26,DAL,108,29,15,MIL,107,18,24,47,39
2010-01-26,PHX,109,26,20,CHA,114,21,22,47,42
2010-01-26,SAC,99,15,28,GSW,96,13,29,28,57
2010-01-27,CLE,109,35,11,MIN,95,9,37,44,48
2010-01-27,IND,96,16,29,LAL,118,34,11,50,40
2010-01-27,TOR,111,23,22,MIA,103,23,21,46,43
2010-01-27,DET,93,15,28,MEM,99,24,19,39,47
2010-01-27,NJN,103,3,40,LAC,87,20,24,23,64
2010-01-27,MIL,91,18,25,PHI,88,15,29,33,54
2010-01-27,OKC,86,24,20,CHI,96,21,22,45,42
2010-01-27,HOU,92,24,20,DEN,97,30,14,54,34
2010-01-27,SAS,105,25,18,ATL,90,29,14,54,32
2010-01-27,POR,95,27,19,UTA,106,26,18,53,37
2010-01-27,GSW,110,13,30,NOH,123,24,20,37,50
2010-01-28,NYK,104,18,26,TOR,106,24,22,42,48
2010-01-28,ORL,96,29,16,BOS,94,29,13,58,29
2010-01-28,PHX,112,26,21,DAL,106,30,15,56,36
2010-01-29,IND,73,16,30,CLE,94,36,11,52,41
2010-01-29,PHI,91,15,30,LAL,99,35,11,50,41
2010-01-29,ATL,100,29,15,BOS,91,29,14,58,29
2010-01-29,DET,65,15,29,MIA,92,23,22,38,51
2010-01-29,MIN,111,9,38,LAC,97,20,25,29,63
2010-01-29,NJN,79,4,40,WAS,81,14,30,18,70
2010-01-29,NOH,106,25,20,CHI,108,22,22,47,42
2010-01-29,OKC,101,24,21,DEN,84,31,14,55,35
2010-01-29,HOU,104,24,21,POR,100,27,20,51,41
2010-01-29,SAS,104,26,18,MEM,97,25,19,51,37
2010-01-29,UTA,101,27,18,SAC,94,16,28,43,46
2010-01-29,GSW,110,13,31,CHA,121,22,22,35,53
2010-01-30,ORL,104,30,16,ATL,86,30,15,60,31
2010-01-30,MEM,102,25,20,NOH,109,25,21,50,41
2010-01-30,WAS,106,15,30,NYK,96,18,27,33,57
2010-01-30,DAL,112,30,16,POR,114,27,21,57,37
2010-01-30,MIL,95,19,25,MIA,84,24,22,43,47
2010-01-30,SAC,96,16,29,CHA,103,23,22,39,51
2010-01-31,SAS,89,27,18,DEN,103,31,15,58,33
2010-01-31,BOS,89,29,15,LAL,90,36,11,65,26
2010-01-31,CLE,114,37,11,LAC,89,20,26,57,37
2010-01-31,DET,86,15,30,ORL,91,31,16,46,46
2010-01-31,NJN,79,4,41,PHI,83,15,31,19,72
2010-01-31,TOR,117,25,22,IND,102,16,31,41,53
2010-01-31,HOU,111,25,21,PHX,115,27,21,52,42
2010-01-31,MIN,112,10,38,NYK,91,18,28,28,66
2010-01-31,OKC,112,25,21,GSW,104,13,32,38,53
2010-02-01,WAS,88,16,30,BOS,99,29,16,45,46
2010-02-01,MIA,81,24,23,MIL,97,20,25,44,48
2010-02-01,MEM,95,25,21,LAL,93,37,11,62,32
2010-02-01,NOH,100,26,21,PHX,109,28,21,54,42
2010-02-01,DEN,112,32,15,SAC,109,16,30,48,45
2010-02-01,UTA,104,28,18,DAL,92,30,17,58,35
2010-02-01,POR,98,28,21,CHA,79,24,22,52,43
2010-02-02,CLE,105,38,11,MEM,89,26,21,64,32
2010-02-02,IND,130,16,32,TOR,115,26,22,42,54
2010-02-02,ORL,99,32,16,MIL,82,21,25,53,41
2010-02-02,NJN,93,4,42,DET,97,15,31,19,73
2010-02-02,CHI,82,23,22,LAC,90,20,27,43,49
2010-02-02,OKC,106,26,21,ATL,99,30,16,56,37
2010-02-02,HOU,119,25,22,GSW,97,13,33,38,55
2010-02-03,ATL,103,30,17,LAC,97,21,27,51,44
2010-02-03,PHI,106,16,31,CHI,103,23,23,39,54
2010-02-03,TOR,108,26,23,NJN,99,4,43,30,66
2010-02-03,NYK,107,18,29,WAS,85,16,31,34,60
2010-02-03,BOS,107,30,16,MIA,102,24,24,54,40
2010-02-03,NOH,99,26,22,OKC,103,27,21,53,43
2010-02-03,DAL,110,30,18,GSW,101,13,34,43,52
2010-02-03,DEN,97,33,15,PHX,109,29,21,62,36
2010-02-03,SAC,113,16,31,SAS,115,27,19,43,50
2010-02-03,LAL,99,37,12,CHA,97,24,23,61,35
2010-02-03,UTA,118,29,18,POR,105,29,21,58,39
2010-02-04,CLE,102,39,11,MIA,86,24,25,63,36
2010-02-04,POR,96,29,22,SAS,93,28,19,57,41
2010-02-05,IND,107,17,32,DET,83,16,31,33,63
2010-02-05,ORL,91,33,16,WAS,92,16,32,49,48
2010-02-05,BOS,96,31,16,NJN,87,4,44,35,60
2010-02-05,NYK,107,19,29,MIL,114,21,26,40,55
2010-02-05,ATL,91,31,17,CHI,81,23,24,54,41
2010-02-05,MEM,83,26,22,HOU,101,26,22,52,44
2010-02-05,NOH,94,26,23,PHI,101,17,31,43,54
2010-02-05,DAL,108,31,18,MIN,117,11,38,42,56
2010-02-05,SAC,102,16,32,PHX,114,30,21,46,53
2010-02-05,LAL,113,38,12,DEN,126,33,16,71,28
2010-02-06,CHA,99,24,24,NOH,104,26,24,50,48
2010-02-06,CLE,113,40,11,NYK,106,19,30,59,41
2010-02-06,DET,99,16,32,NJN,92,4,45,20,77
2010-02-06,CHI,95,23,25,MIA,91,24,26,47,51
2010-02-06,MIN,109,12,38,MEM,102,26,23,38,61
2010-02-06,HOU,95,27,22,PHI,102,18,31,45,53
2010-02-06,MIL,93,22,26,IND,81,18,32,40,58
2010-02-06,UTA,116,30,18,DEN,106,34,16,64,34
2010-02-06,POR,82,30,22,LAL,99,38,13,68,35
2010-02-06,GSW,95,13,35,OKC,104,28,21,41,56
2010-02-06,LAC,81,21,28,SAS,98,28,20,49,48
2010-02-07,TOR,115,27,23,SAC,104,16,33,43,56
2010-02-07,BOS,89,32,16,ORL,96,33,17,65,33
2010-02-08,ORL,123,34,17,NOH,117,27,24,61,41
2010-02-08,GSW,117,13,36,DAL,127,31,19,44,55
2010-02-08,LAL,101,39,13,SAS,89,29,20,68,33
2010-02-09,CHA,94,24,25,WAS,92,17,33,41,58
2010-02-09,CLE,104,41,11,NJN,97,4,46,45,57
2010-02-09,IND,101,18,33,CHI,109,24,25,42,58
2010-02-09,PHI,119,19,31,MIN,97,13,38,32,69
2010-02-09,MIA,99,24,27,HOU,66,27,23,51,50
2010-02-09,NYK,114,19,31,SAC,118,16,34,35,65
2010-02-09,MEM,94,26,24,ATL,108,33,17,59,41
2010-02-09,MIL,81,23,26,DET,93,17,32,40,58
2010-02-09,DEN,127,34,17,DAL,91,32,19,66,36
2010-02-09,POR,77,30,23,OKC,89,29,21,59,44
2010-02-09,LAC,99,21,29,UTA,109,31,18,52,47
2010-02-10,ATL,76,34,17,MIA,94,25,27,59,44
2010-02-10,TOR,104,28,23,PHI,93,20,31,48,54
2010-02-10,DET,97,18,32,SAC,103,17,34,35,66
2010-02-10,NJN,77,4,47,MIL,97,23,27,27,74
2010-02-10,CHI,87,25,25,ORL,107,35,17,60,42
2010-02-10,MIN,92,13,39,CHA,93,25,25,38,64
2010-02-10,NOH,93,27,25,BOS,85,32,17,59,42
2010-02-10,PHX,101,31,21,POR,108,30,24,61,45
2010-02-10,UTA,81,32,18,LAL,96,40,13,72,31
2010-02-10,GSW,132,13,37,LAC,102,21,30,34,67
2010-02-11,CLE,115,42,11,ORL,106,36,17,78,28
2010-02-11,DEN,92,35,17,SAS,111,29,21,64,38
2010-02-16,CHA,94,26,25,NJN,103,4,48,30,73
2010-02-16,PHI,78,20,32,MIA,105,26,27,46,59
2010-02-16,DET,108,18,33,MIN,85,13,40,31,73
2010-02-16,CHI,118,25,26,NYK,85,19,32,44,58
2010-02-16,MEM,95,26,25,PHX,109,31,22,57,47
2010-02-16,OKC,99,30,21,DAL,86,32,20,62,41
2010-02-16,HOU,95,27,24,UTA,104,32,19,59,43
2010-02-16,POR,109,31,24,LAC,87,21,31,52,55
2010-02-16,SAC,92,18,34,BOS,95,32,18,50,52
2010-02-16,LAL,104,41,13,GSW,94,14,37,55,50
2010-02-17,IND,87,18,34,SAS,90,30,21,48,55
2010-02-17,ORL,116,36,18,DET,91,19,33,55,51
2010-02-17,TOR,102,29,23,MEM,109,26,26,55,49
2010-02-17,WAS,108,17,34,MIN,99,13,41,30,75
2010-02-17,NJN,84,5,48,MIA,87,27,27,32,75
2010-02-17,NYK,109,19,33,CHI,115,26,26,45,59
2010-02-17,MIL,99,24,27,HOU,127,27,25,51,52
2010-02-17,NOH,90,28,25,UTA,98,33,19,61,44
2010-02-17,DAL,107,32,21,PHX,97,32,22,64,43
2010-02-17,GSW,130,14,38,SAC,98,18,35,32,73
2010-02-17,LAC,92,21,32,ATL,110,34,18,55,50
2010-02-18,CLE,116,43,11,DEN,118,35,18,78,29
2010-02-18,LAL,86,42,13,BOS,87,33,18,75,31
2010-02-19,CHA,110,26,26,CLE,93,43,12,69,38
2010-02-19,PHI,106,20,33,SAS,94,31,21,51,54
2010-02-19,WAS,107,18,34,DEN,97,36,18,54,52
2010-02-19,DET,85,19,34,MIL,91,24,28,43,62
2010-02-19,MEM,87,27,26,MIA,100,28,27,55,53
2010-02-19,MIN,94,13,42,CHI,100,27,26,40,68
2010-02-19,NJN,89,5,49,TOR,106,29,24,34,73
2010-02-19,NOH,107,28,26,IND,101,18,35,46,61
2010-02-19,ORL,85,37,18,DAL,95,33,21,70,39
2010-02-19,PHX,88,32,23,ATL,80,35,18,67,41
2010-02-19,GSW,89,15,38,UTA,100,34,19,49,57
2010-02-19,POR,76,32,24,BOS,96,34,18,66,42
2010-02-20,TOR,109,30,24,WAS,104,19,34,49,58
2010-02-20,NYK,118,19,34,OKC,121,31,21,50,55
2010-02-20,CHI,122,28,26,PHI,90,21,33,49,59
2010-02-20,DAL,97,34,21,MIA,91,29,27,63,48
2010-02-20,HOU,115,28,25,IND,125,18,36,46,61
2010-02-20,MIL,93,25,28,CHA,88,27,26,52,54
2010-02-20,LAC,99,21,33,SAC,89,18,36,39,69
2010-02-21,ORL,101,37,19,CLE,95,43,13,80,32
2010-02-21,DEN,114,36,19,BOS,105,35,18,71,37
2010-02-21,DET,109,19,35,SAS,101,31,22,50,57
2010-02-21,NJN,94,5,50,MEM,104,27,27,32,77
2010-02-21,MIN,107,13,43,OKC,109,32,21,45,64
2010-02-21,NOH,102,29,26,HOU,94,28,26,57,52
2010-02-21,GSW,108,15,39,ATL,104,35,19,50,58
2010-02-21,PHX,104,33,23,SAC,88,18,37,51,60
2010-02-21,POR,89,32,25,UTA,93,35,19,67,44
2010-02-22,WAS,101,19,35,CHI,95,29,26,48,61
2010-02-22,NYK,67,19,35,MIL,83,26,28,45,63
2010-02-22,DAL,91,35,21,IND,82,19,36,54,57
2010-02-22,UTA,100,36,19,ATL,105,35,20,71,39
2010-02-22,LAC,98,22,33,CHA,94,27,27,49,60
2010-02-23,CLE,105,43,14,NOH,95,30,26,73,40
2010-02-23,BOS,110,35,19,NYK,106,19,36,54,55
2010-02-23,MIA,88,29,28,MIN,91,13,44,42,72
2010-02-23,NJN,93,5,51,POR,102,32,26,37,77
2010-02-23,MEM,98,28,27,LAL,99,42,14,70,41
2010-02-23,OKC,102,33,21,PHX,104,34,23,67,44
2010-02-23,SAC,89,18,38,DET,101,20,35,38,73
2010-02-23,GSW,102,16,39,PHI,110,21,34,37,73
2010-02-24,ATL,98,36,20,MIN,92,14,44,50,64
2010-02-24,TOR,87,31,24,POR,101,33,26,64,50
2010-02-24,WAS,94,20,35,MEM,99,28,28,48,63
2010-02-24,CHI,120,29,27,IND,110,19,37,48,64
2010-02-24,MIL,115,27,28,NOH,95,30,27,57,55
2010-02-24,HOU,92,28,27,ORL,110,38,19,66,46
2010-02-24,SAS,95,31,23,OKC,87,33,22,64,45
2010-02-24,DAL,101,36,21,LAL,96,43,14,79,35
2010-02-24,PHX,106,35,23,PHI,95,22,34,57,57
2010-02-24,UTA,102,36,20,CHA,93,27,28,63,48
2010-02-24,LAC,97,23,33,DET,91,21,35,44,68
2010-02-25,IND,110,19,38,MIL,112,28,28,47,66
2010-02-25,BOS,88,36,19,CLE,108,44,14,80,33
2010-02-25,GSW,112,16,40,DEN,127,37,19,53,59
2010-02-26,TOR,118,31,25,CLE,126,45,14,76,39
2010-02-26,WAS,116,20,36,NYK,118,19,37,39,73
2010-02-26,ATL,103,37,20,DAL,111,37,21,74,41
2010-02-26,CHI,115,30,27,POR,111,34,26,64,53
2010-02-26,MEM,89,29,28,CHA,93,27,29,56,57
2010-02-26,NOH,100,30,28,ORL,93,39,19,69,47
2010-02-26,OKC,109,33,23,MIN,92,14,45,47,68
2010-02-26,HOU,109,28,28,SAS,104,32,23,60,51
2010-02-26,DEN,107,38,19,DET,102,21,36,59,55
2010-02-26,SAC,103,18,39,UTA,99,37,20,55,59
2010-02-26,LAL,99,43,15,PHI,90,22,35,65,50
2010-02-26,PHX,125,36,23,LAC,112,24,33,60,56
2010-02-27,BOS,96,36,20,NJN,104,5,52,41,72
2010-02-27,MIA,71,29,29,MIL,94,29,28,58,57
2010-02-27,IND,100,19,39,CHI,90,31,27,50,66
2010-02-27,NYK,109,20,37,MEM,120,29,29,49,66
2010-02-27,MIN,91,14,46,POR,110,34,27,48,73
2010-02-27,UTA,133,37,21,HOU,110,29,28,66,49
2010-02-27,GSW,95,16,41,DET,88,21,37,37,78
2010-02-28,SAS,113,32,24,PHX,110,37,23,69,47
2010-02-28,LAL,95,44,15,DEN,89,39,19,83,34
2010-02-28,ATL,106,37,21,MIL,102,30,28,67,49
2010-02-28,NJN,85,6,52,WAS,89,20,37,26,89
2010-02-28,OKC,119,34,23,TOR,99,31,26,65,49
2010-02-28,ORL,96,39,20,MIA,80,29,30,68,50
2010-02-28,SAC,97,19,39,LAC,92,24,34,43,73
2010-02-28,DAL,108,38,21,NOH,100,31,28,69,49
2010-03-01,CHA,84,28,29,DAL,89,39,21,67,50
2010-03-01,CLE,124,46,14,NYK,93,20,38,66,52
2010-03-01,PHI,105,22,36,ORL,126,40,20,62,56
2010-03-01,CHI,92,31,28,ATL,116,38,21,69,49
2010-03-01,MEM,93,30,29,POR,103,35,27,65,56
2010-03-01,NOH,92,31,29,SAS,106,33,24,64,53
2010-03-01,HOU,116,29,29,TOR,92,31,27,60,56
2010-03-01,PHX,101,37,24,DEN,85,39,20,76,44
2010-03-01,LAC,108,24,35,UTA,104,38,21,62,56
2010-03-02,DET,100,21,38,BOS,105,36,21,57,59
2010-03-02,MIA,110,29,31,GSW,106,17,41,46,72
2010-03-02,OKC,113,35,23,SAC,107,20,39,55,62
2010-03-02,LAL,122,45,15,IND,99,20,39,65,54
2010-03-03,ATL,112,39,21,PHI,93,22,37,61,58
2010-03-03,ORL,117,41,20,GSW,90,17,42,58,62
2010-03-03,BOS,104,37,21,CHA,80,28,30,65,51
2010-03-03,NJN,92,6,53,CLE,111,47,14,53,67
2010-03-03,NYK,128,20,39,DET,104,21,39,41,78
2010-03-03,MIL,100,30,29,WAS,87,21,37,51,66
2010-03-03,NOH,100,31,30,MEM,104,30,30,61,60
2010-03-03,DAL,112,40,21,MIN,109,14,47,54,68
2010-03-03,HOU,81,30,29,SAC,84,20,40,50,69
2010-03-03,DEN,119,39,21,OKC,90,36,23,75,44
2010-03-03,POR,102,36,27,IND,79,20,40,56,67
2010-03-03,LAC,101,25,35,PHX,127,38,24,63,59
2010-03-04,CHI,96,31,29,MEM,105,31,30,62,59
2010-03-04,MIA,114,30,31,LAL,111,46,15,76,46
2010-03-04,PHX,108,39,24,UTA,116,38,22,77,46
2010-03-05,CHA,98,28,31,LAL,83,46,16,74,47
2010-03-05,CLE,99,48,14,DET,92,21,40,69,54
2010-03-05,PHI,86,22,38,BOS,96,38,21,60,59
2010-03-05,TOR,102,31,28,NYK,96,21,39,52,67
2010-03-05,WAS,74,21,38,MIL,102,31,29,52,67
2010-03-05,ATL,127,40,21,GSW,122,17,43,57,64
2010-03-05,NJN,87,6,54,ORL,97,42,20,48,74
2010-03-05,DAL,108,41,21,SAC,100,21,40,62,61
2010-03-05,DEN,122,40,21,IND,114,20,41,60,62
2010-03-05,SAS,102,34,24,NOH,91,31,31,65,55
2010-03-05,LAC,87,25,36,OKC,104,36,24,61,60
2010-03-06,CHA,101,29,31,GSW,90,17,44,46,75
2010-03-06,MIA,100,31,31,ATL,94,41,21,72,52
2010-03-06,NYK,93,21,40,NJN,113,6,55,27,95
2010-03-06,CHI,116,31,30,DAL,122,42,21,73,51
2010-03-06,MEM,92,32,30,SAS,102,35,24,67,54
2010-03-06,MIN,98,14,48,HOU,112,30,30,44,78
2010-03-06,MIL,92,32,29,CLE,85,49,14,81,43
2010-03-06,PHX,113,39,25,IND,105,20,42,59,67
2010-03-06,UTA,107,39,22,LAC,85,25,37,64,59
2010-03-07,TOR,101,32,28,PHI,114,22,39,54,67
2010-03-07,ORL,96,43,20,LAL,94,46,17,89,37
2010-03-07,DET,110,21,41,HOU,107,31,30,52,71
2010-03-07,BOS,86,39,21,WAS,83,21,39,60,60
2010-03-07,SAC,102,21,41,OKC,108,37,24,58,65
2010-03-07,DEN,118,41,21,POR,106,37,27,78,48
2010-03-08,CLE,97,49,15,SAS,95,36,24,85,39
2010-03-08,NYK,99,21,41,ATL,98,41,22,62,63
2010-03-08,MEM,107,32,31,NJN,101,7,55,39,86
2010-03-08,MIN,112,14,49,DAL,125,43,21,57,70
2010-03-08,NOH,135,31,32,GSW,131,17,45,48,77
2010-03-09,CHA,83,30,31,MIA,78,32,31,62,62
2010-03-09,IND,107,20,43,PHI,96,23,39,43,82
2010-03-09,ORL,113,44,20,LAC,87,25,38,69,58
2010-03-09,WAS,88,21,40,HOU,96,31,31,52,71
2010-03-09,CHI,108,31,31,UTA,132,40,22,71,53
2010-03-09,MIL,86,33,29,BOS,84,40,21,73,50
2010-03-09,POR,88,37,28,SAC,81,21,42,58,70
2010-03-09,LAL,109,46,18,TOR,107,32,29,78,47
2010-03-10,PHI,87,23,40,CHA,102,31,31,54,71
2010-03-10,BOS,91,40,22,MEM,111,33,31,73,53
2010-03-10,DET,104,22,41,UTA,115,41,22,63,63
2010-03-10,MIA,108,32,32,LAC,97,25,39,57,71
2010-03-10,MIN,102,14,50,DEN,110,42,21,56,71
2010-03-10,OKC,98,38,24,NOH,83,32,32,70,56
2010-03-10,DAL,96,44,21,NJN,87,7,56,51,77
2010-03-10,SAS,97,36,25,NYK,87,22,41,58,66
2010-03-10,SAC,113,21,43,TOR,90,32,30,53,73
2010-03-11,WAS,99,17,32,ATL,105,32,17,49,49
2010-03-11,ORL,111,45,20,CHI,82,31,32,76,52
2010-03-11,GSW,105,17,46,POR,110,38,28,55,74
2010-03-12,CHA,106,32,31,LAC,98,25,40,57,71
2010-03-12,PHI,95,23,41,CLE,100,50,15,73,56
2010-03-12,BOS,122,40,23,IND,103,21,43,61,66
2010-03-12,MIA,108,33,32,CHI,95,31,33,64,65
2010-03-12,DET,101,22,42,WAS,87,21,41,43,83
2010-03-12,MEM,119,34,31,NYK,112,22,42,56,73
2010-03-12,MIN,85,14,51,SAS,103,37,25,51,76
2010-03-12,NOH,95,32,33,DEN,102,43,21,75,54
2010-03-12,OKC,104,39,24,NJN,102,7,57,46,81
2010-03-12,MIL,95,34,29,UTA,87,42,22,76,51
2010-03-12,PHX,96,40,25,LAL,102,47,18,87,43
2010-03-12,SAC,94,22,43,POR,110,39,28,61,71
2010-03-13,ATL,112,41,23,DET,99,23,42,64,65
2010-03-13,WAS,95,21,42,ORL,109,46,20,67,62
2010-03-13,MEM,108,35,31,DEN,125,44,21,79,52
2010-03-13,DAL,94,45,21,NYK,128,22,43,67,64
2010-03-13,HOU,116,32,31,NJN,108,7,58,39,89
2010-03-13,SAS,118,38,25,LAC,88,25,41,63,66
2010-03-13,GSW,124,17,47,TOR,112,32,31,49,78
2010-03-14,MIL,98,35,29,IND,94,21,44,56,73
2010-03-14,CLE,104,51,15,BOS,93,41,23,92,38
2010-03-14,MIA,104,34,32,PHI,91,23,42,57,74
2010-03-14,ORL,89,47,20,CHA,96,33,31,80,51
2010-03-14,OKC,119,40,24,UTA,111,42,23,82,47
2010-03-14,PHX,120,40,26,NOH,106,32,34,72,60
2010-03-14,POR,109,40,28,TOR,98,32,32,72,60
2010-03-14,SAC,114,22,44,MIN,100,14,52,36,96
2010-03-15,PHI,84,23,43,NYK,94,23,43,46,86
2010-03-15,BOS,119,41,24,DET,93,23,43,64,67
2010-03-15,HOU,125,33,31,DEN,123,45,21,78,52
2010-03-15,UTA,112,42,24,WAS,89,21,43,63,67
2010-03-15,GSW,121,18,47,LAL,124,48,18,66,65
2010-03-15,LAC,100,25,42,NOH,108,32,35,57,77
2010-03-16,IND,99,21,45,CHA,94,34,31,55,76
2010-03-16,DET,101,23,44,CLE,113,52,15,75,59
2010-03-16,MIA,76,35,32,SAS,88,39,25,74,57
2010-03-16,NJN,84,7,59,ATL,108,42,23,49,82
2010-03-16,MEM,104,35,32,CHI,97,31,34,66,66
2010-03-16,DEN,97,45,22,WAS,87,21,44,66,66
2010-03-16,PHX,152,41,26,MIN,114,14,53,55,79
2010-03-16,SAC,99,23,44,LAL,106,49,18,72,62
2010-03-17,CHA,100,34,32,OKC,92,41,24,75,56
2010-03-17,CLE,99,53,15,IND,94,22,45,75,60
2010-03-17,PHI,108,23,44,NJN,97,7,60,30,104
2010-03-17,TOR,106,32,33,ATL,105,43,23,75,56
2010-03-17,BOS,109,42,24,NYK,97,24,43,66,67
2010-03-17,ORL,110,47,21,SAS,84,40,25,87,46
2010-03-17,DAL,113,45,22,CHI,106,31,35,76,57
2010-03-17,HOU,107,34,31,MEM,94,36,32,70,63
2010-03-17,UTA,122,43,24,MIN,100,14,54,57,78
2010-03-17,GSW,131,18,48,NOH,121,33,35,51,83
2010-03-17,LAC,101,25,43,MIL,93,36,29,61,72
2010-03-18,MIA,102,35,33,ORL,108,48,21,83,54
2010-03-18,DEN,93,46,22,NOH,80,33,36,79,58
2010-03-19,IND,106,22,46,DET,102,23,45,45,91
2010-03-19,TOR,89,33,33,OKC,115,41,25,74,58
2010-03-19,ATL,93,43,24,CHA,92,35,32,78,56
2010-03-19,NYK,92,24,44,PHI,88,24,44,48,88
2010-03-19,CHI,85,31,36,CLE,92,54,15,85,51
2010-03-19,HOU,87,35,31,BOS,94,43,24,78,55
2010-03-19,SAS,147,40,26,GSW,116,19,48,59,74
2010-03-19,PHX,110,42,26,UTA,100,44,24,86,50
2010-03-19,POR,76,41,28,WAS,74,21,45,62,73
2010-03-19,SAC,108,23,45,MIL,114,36,30,59,75
2010-03-19,LAL,104,50,18,MIN,96,14,55,64,73
2010-03-20,PHI,84,24,45,CHI,98,31,37,55,82
2010-03-20,MIA,77,35,34,CHA,71,35,33,70,67
2010-03-20,NJN,90,7,61,TOR,100,33,34,40,95
2010-03-20,MEM,123,36,33,GSW,107,19,49,55,82
2010-03-20,DAL,93,46,22,BOS,102,44,24,90,46
2010-03-20,DEN,97,47,22,MIL,102,37,30,84,52
2010-03-20,UTA,106,44,25,NOH,86,33,37,77,62
2010-03-21,NYK,112,25,44,HOU,116,35,32,60,76
2010-03-21,IND,121,23,46,OKC,101,42,25,65,71
2010-03-21,ATL,119,44,24,SAS,114,41,26,85,50
2010-03-21,LAC,89,26,43,SAC,102,23,46,49,89
2010-03-21,CLE,104,55,15,DET,79,23,46,78,61
2010-03-21,LAL,99,51,18,WAS,92,21,46,72,64
2010-03-21,PHX,93,43,26,POR,87,42,28,85,54
2010-03-22,PHI,93,24,46,ORL,109,49,21,73,67
2010-03-22,NJN,89,7,62,MIA,99,36,34,43,96
2010-03-22,CHI,98,32,37,HOU,88,36,32,68,69
2010-03-22,MIL,98,38,30,ATL,95,45,24,83,54
2010-03-22,MIN,100,14,56,TOR,106,34,34,48,90
2010-03-22,NOH,115,33,38,DAL,99,46,23,79,61
2010-03-22,OKC,96,42,26,SAS,99,41,27,83,53
2010-03-22,UTA,110,45,25,BOS,97,45,24,90,49
2010-03-22,SAC,85,24,46,MEM,102,37,33,61,79
2010-03-22,GSW,131,19,50,PHX,133,44,26,63,76
2010-03-23,WAS,86,21,47,CHA,95,35,34,56,81
2010-03-23,DET,83,23,47,IND,98,24,46,47,93
2010-03-23,NYK,109,25,45,DEN,104,47,23,72,68
2010-03-23,DAL,106,46,24,LAC,96,26,44,72,68
2010-03-24,ATL,86,45,25,ORL,84,50,21,95,46
2010-03-24,BOS,113,45,25,DEN,99,47,24,92,49
2010-03-24,CHA,108,36,34,MIN,95,14,57,50,91
2010-03-24,IND,99,25,46,WAS,82,21,48,46,94
2010-03-24,TOR,87,35,34,UTA,113,46,25,81,59
2010-03-24,NJN,93,7,63,SAC,79,24,47,31,110
2010-03-24,MIL,86,39,30,PHI,101,24,47,63,77
2010-03-24,NOH,92,34,38,CLE,105,56,15,90,53
2010-03-24,OKC,122,42,27,HOU,104,36,33,78,60
2010-03-24,SAS,83,42,27,LAL,92,52,18,94,45
2010-03-24,GSW,128,19,51,MEM,110,38,33,57,84
2010-03-25,CHI,74,33,37,MIA,103,37,34,70,71
2010-03-25,HOU,93,36,34,LAC,99,26,45,62,79
2010-03-25,POR,101,42,29,DAL,89,47,24,89,53
2010-03-26,CHA,107,37,34,WAS,96,21,49,58,83
2010-03-26,IND,122,26,46,UTA,106,47,25,73,71
2010-03-26,ORL,106,50,22,MIN,97,14,58,64,80
2010-03-26,PHI,105,25,47,ATL,98,46,25,71,72
2010-03-26,TOR,96,35,35,DEN,97,47,25,82,60
2010-03-26,BOS,94,46,25,SAC,86,24,48,70,73
2010-03-26,NJN,118,8,63,DET,110,23,48,31,111
2010-03-26,OKC,91,43,27,LAL,75,53,18,96,45
2010-03-26,MIL,74,39,31,MIA,87,38,34,77,65
2010-03-26,SAS,102,42,28,CLE,97,57,15,99,43
2010-03-26,PHX,132,45,26,NYK,96,26,45,71,71
2010-03-27,WAS,87,21,50,UTA,103,47,26,68,76
2010-03-27,CHI,106,33,38,NJN,83,9,63,42,101
2010-03-27,NOH,101,34,39,POR,112,43,29,77,68
2010-03-27,HOU,101,36,35,LAL,109,53,19,89,54
2010-03-27,GSW,90,20,51,DAL,111,47,25,67,76
2010-03-28,CLE,97,57,16,SAC,90,24,49,81,65
2010-03-28,MIL,108,39,32,MEM,103,38,34,77,66
2010-03-28,ATL,94,46,26,IND,84,27,46,73,72
2010-03-28,DET,103,23,49,CHI,110,34,38,57,87
2010-03-28,MIA,97,39,34,TOR,94,35,36,74,70
2010-03-28,ORL,103,51,22,DEN,97,48,25,99,47
2010-03-28,MIN,105,14,59,PHX,111,46,26,60,85
2010-03-28,OKC,87,44,27,POR,92,44,29,88,56
2010-03-28,BOS,73,47,25,SAS,94,43,28,90,53
2010-03-28,LAC,103,27,45,GSW,121,20,52,47,97
2010-03-29,CHA,101,38,34,TOR,103,35,37,73,71
2010-03-29,NJN,90,9,64,SAS,84,44,28,53,92
2010-03-29,NOH,108,34,40,LAL,100,54,19,88,59
2010-03-29,DAL,109,48,25,DEN,93,48,26,96,51
2010-03-29,UTA,103,48,26,NYK,98,26,46,74,72
2010-03-30,IND,102,27,47,SAC,95,24,50,51,97
2010-03-30,PHI,93,26,47,OKC,111,44,28,70,75
2010-03-30,CHI,105,35,38,PHX,111,47,26,82,64
2010-03-30,MIL,107,40,32,LAC,89,27,46,67,78
2010-03-30,HOU,98,36,36,WAS,94,21,51,57,87
2010-03-31,ATL,109,47,26,LAL,92,54,20,101,46
2010-03-31,CHA,103,38,35,PHI,84,26,48,64,83
2010-03-31,CLE,101,58,16,MIL,98,41,32,99,48
2010-03-31,TOR,114,36,37,LAC,92,27,47,63,84
2010-03-31,BOS,104,47,26,OKC,109,45,28,92,54
2010-03-31,DET,81,23,50,MIA,98,40,34,63,84
2010-03-31,NJN,105,10,64,PHX,116,48,26,58,90
2010-03-31,MEM,102,38,35,DAL,106,49,25,87,60
2010-03-31,MIN,108,14,60,SAC,99,24,51,38,111
2010-03-31,NOH,91,35,40,WAS,96,21,52,56,92
2010-03-31,SAS,119,44,29,HOU,102,37,36,81,65
2010-03-31,POR,118,45,29,NYK,90,26,47,71,76
2010-03-31,UTA,128,49,26,GSW,104,21,52,70,78
2010-04-01,DAL,82,50,25,ORL,97,52,22,102,47
2010-04-01,DEN,109,48,27,POR,92,46,29,94,56
2010-04-02,CHA,87,39,35,MIL,86,41,33,80,68
2010-04-02,IND,96,28,47,MIA,105,41,34,69,81
2010-04-02,WAS,87,22,52,CHI,95,35,39,57,91
2010-04-02,BOS,114,47,27,HOU,119,37,37,84,64
2010-04-02,CLE,93,59,16,ATL,88,48,26,107,42
2010-04-02,DET,94,23,51,PHX,109,49,26,72,77
2010-04-02,MEM,107,38,36,NOH,96,35,41,73,77
2010-04-02,SAS,112,45,29,ORL,100,53,22,98,51
2010-04-02,GSW,128,21,53,NYK,117,26,48,47,101
2010-04-02,LAL,106,54,21,UTA,92,50,26,104,47
2010-04-03,PHI,123,26,49,TOR,128,37,37,63,86
2010-04-03,ATL,91,48,27,DET,85,23,52,71,79
2010-04-03,NJN,115,10,65,NOH,87,35,42,45,107
2010-04-03,CHI,96,36,39,CHA,88,40,35,76,74
2010-04-03,MIN,84,15,60,MIA,97,42,34,57,94
2010-04-03,DAL,116,50,26,OKC,121,46,28,96,54
2010-04-03,MIL,107,41,34,PHX,98,50,26,91,60
2010-04-03,DEN,98,49,27,LAC,90,27,48,76,75
2010-04-03,SAC,87,24,52,POR,98,46,30,70,82
2010-04-04,BOS,117,47,28,CLE,113,60,16,107,44
2010-04-04,LAL,81,55,21,SAS,100,46,29,101,50
2010-04-04,IND,133,28,48,HOU,102,38,37,66,85
2010-04-04,ORL,107,53,23,MEM,92,39,36,92,59
2010-04-04,TOR,112,38,37,GSW,113,22,53,60,90
2010-04-04,WAS,109,22,53,NJN,99,11,65,33,118
2010-04-04,OKC,116,47,28,MIN,108,15,61,62,89
2010-04-04,LAC,107,27,49,NYK,113,26,49,53,98
2010-04-06,CHA,109,40,36,ATL,100,49,27,89,63
2010-04-06,CLE,113,60,17,TOR,101,38,38,98,55
2010-04-06,PHI,103,26,50,DET,124,23,53,49,103
2010-04-06,WAS,112,23,53,GSW,94,23,53,46,106
2010-04-06,NYK,104,27,49,BOS,101,48,28,75,77
2010-04-06,CHI,74,37,39,MIL,79,42,34,79,73
2010-04-06,MEM,103,39,37,HOU,113,38,38,77,75
2010-04-06,UTA,140,50,27,OKC,139,48,28,98,55
2010-04-06,SAC,86,24,53,SAS,95,47,29,71,82
2010-04-07,IND,113,29,48,NYK,105,28,49,57,97
2010-04-07,TOR,104,38,39,BOS,115,48,29,86,68
2010-04-07,DET,90,24,53,ATL,88,49,28,73,81
2010-04-07,MIA,99,43,34,PHI,95,26,51,69,85
2010-04-07,MIL,108,43,34,NJN,89,11,66,54,100
2010-04-07,MIN,107,15,62,GSW,116,23,54,38,116
2010-04-07,NOH,103,35,43,CHA,104,41,36,76,79
2010-04-07,OKC,94,48,29,DEN,98,50,27,98,56
2010-04-07,ORL,121,54,23,WAS,94,24,53,78,76
2010-04-07,DAL,110,50,27,MEM,84,39,38,89,65
2010-04-07,HOU,113,39,38,UTA,96,51,27,90,65
2010-04-07,LAC,85,27,50,POR,93,47,30,74,80
2010-04-07,PHX,112,50,27,SAS,101,48,29,98,56
2010-04-08,CHI,109,37,40,CLE,108,61,17,98,57
2010-04-08,SAC,116,24,54,LAC,94,27,51,51,105
2010-04-08,DEN,98,51,27,LAL,96,55,22,106,49
2010-04-09,ORL,118,55,23,NYK,103,28,50,83,73
2010-04-09,PHI,90,26,52,MIL,95,44,34,70,86
2010-04-09,ATL,107,49,29,TOR,101,38,40,87,69
2010-04-09,BOS,96,49,29,WAS,106,24,54,73,83
2010-04-09,CLE,113,61,18,IND,116,30,48,91,66
2010-04-09,MIA,99,44,34,DET,106,25,53,69,87
2010-04-09,MIN,88,15,63,LAL,97,55,23,70,86
2010-04-09,NJN,127,11,67,CHI,116,38,40,49,107
2010-04-09,NOH,103,35,44,UTA,114,51,28,86,72
2010-04-09,OKC,96,48,30,PHX,91,51,27,99,57
2010-04-09,HOU,97,40,38,CHA,90,42,36,82,74
2010-04-09,SAS,99,48,30,MEM,107,39,39,87,69
2010-04-09,POR,77,48,30,DAL,83,51,27,99,57
2010-04-10,CHA,99,42,37,DET,95,26,53,68,90
2010-04-10,IND,115,31,48,NJN,102,12,67,43,115
2010-04-10,WAS,95,25,54,ATL,105,50,29,75,83
2010-04-10,MEM,101,40,39,PHI,120,26,53,66,92
2010-04-10,MIL,90,45,34,BOS,105,49,30,94,64
2010-04-10,DEN,85,52,27,SAS,104,48,31,100,58
2010-04-10,SAC,108,25,54,DAL,126,52,27,77,81
2010-04-10,LAC,107,27,52,GSW,104,24,54,51,106
2010-04-11,CLE,92,61,19,ORL,98,56,23,117,42
2010-04-11,LAL,88,56,23,POR,91,48,31,104,54
2010-04-11,TOR,88,38,41,CHI,104,38,41,76,82
2010-04-11,NOH,114,35,45,MIN,86,15,64,50,109
2010-04-11,NYK,98,28,51,MIA,111,44,35,72,86
2010-04-11,GSW,120,24,55,OKC,117,49,30,73,85
2010-04-11,PHX,116,51,28,HOU,106,41,38,92,66
2010-04-12,IND,98,32,48,ORL,118,57,23,89,71
2010-04-12,PHI,105,27,53,MIA,107,45,35,72,88
2010-04-12,DET,97,26,54,TOR,111,38,42,64,96
2010-04-12,NJN,95,12,68,CHA,105,43,37,55,105
2010-04-12,NYK,114,28,52,WAS,103,25,55,53,107
2010-04-12,MIL,96,45,35,ATL,104,51,29,96,64
2010-04-12,SAS,133,49,31,MIN,111,15,65,64,96
2010-04-12,DEN,123,52,28,MEM,101,40,40,92,68
2010-04-12,POR,103,49,31,OKC,95,49,31,98,62
2010-04-12,SAC,107,25,55,HOU,117,41,39,66,94
2010-04-12,LAC,94,28,52,DAL,117,53,27,81,79
2010-04-13,CHI,101,39,41,BOS,93,50,30,89,71
2010-04-13,GSW,94,25,55,UTA,103,52,28,77,83
2010-04-13,LAL,106,56,24,SAC,100,25,56,81,80
2010-04-13,PHX,123,52,28,DEN,101,53,28,105,56
2010-04-14,ATL,99,52,29,CLE,83,61,20,113,49
2010-04-14,BOS,95,50,31,MIL,106,45,36,95,67
2010-04-14,CHA,89,44,37,CHI,98,40,41,84,78
2010-04-14,DAL,96,54,27,SAS,89,50,31,104,58
2010-04-14,HOU,115,42,39,NOH,123,36,45,78,84
2010-04-14,MIA,94,46,35,NJN,86,12,69,58,104
2010-04-14,MIN,98,15,66,DET,103,26,55,41,121
2010-04-14,OKC,114,49,32,MEM,105,40,41,89,73
2010-04-14,ORL,125,58,23,PHI,111,27,54,85,77
2010-04-14,TOR,131,39,42,NYK,113,29,52,68,94
2010-04-14,WAS,98,25,56,IND,97,32,49,57,105
2010-04-14,LAC,107,28,53,LAL,91,57,24,85,77
2010-04-14,POR,116,50,31,GSW,122,25,56,75,87
2010-10-26,BOS,88,0,0,MIA,80,0,0,0,0
2010-10-26,POR,106,0,0,PHX,92,0,0,0,0
2010-10-26,LAL,112,0,0,HOU,110,0,0,0,0
2010-10-27,CLE,95,0,0,BOS,87,1,0,1,0
2010-10-27,NJN,101,0,0,DET,98,0,0,0,0
2010-10-27,PHI,87,0,0,MIA,97,0,1,0,1
2010-10-27,TOR,93,0,0,NYK,98,0,0,0,0
2010-10-27,MEM,104,0,0,ATL,119,0,0,0,0
2010-10-27,MIN,116,0,0,SAC,117,0,0,0,0
2010-10-27,NOH,95,0,0,MIL,91,0,0,0,0
2010-10-27,OKC,106,0,0,CHI,95,0,0,0,0
2010-10-27,DAL,101,0,0,CHA,86,0,0,0,0
2010-10-27,SAS,122,0,0,IND,109,0,0,0,0
2010-10-27,DEN,110,0,0,UTA,88,0,0,0,0
2010-10-27,GSW,132,0,0,HOU,128,0,1,0,1
2010-10-27,LAC,88,0,0,POR,98,1,0,1,0
2010-10-28,ORL,112,0,0,WAS,83,0,0,0,0
2010-10-28,UTA,94,0,1,PHX,110,0,1,0,2
2010-10-29,CHA,101,0,1,IND,104,0,1,0,2
2010-10-29,NJN,106,1,0,SAC,100,1,0,2,0
2010-10-29,PHI,101,0,1,ATL,104,1,0,1,1
2010-10-29,TOR,101,0,1,CLE,81,1,0,1,1
2010-10-29,BOS,105,1,1,NYK,101,1,0,2,1
2010-10-29,DET,104,0,1,OKC,105,1,0,1,1
2010-10-29,MIA,96,1,1,ORL,70,1,0,2,1
2010-10-29,MIN,96,0,1,MIL,85,0,1,0,2
2010-10-29,NOH,101,1,0,DEN,95,1,0,2,0
2010-10-29,DAL,90,1,0,MEM,91,0,1,1,1
2010-10-29,GSW,109,1,0,LAC,91,0,1,1,1
2010-10-29,PHX,106,1,1,LAL,114,1,0,2,1
2010-10-30,ATL,99,2,0,WAS,95,0,1,2,1
2010-10-30,CLE,104,1,1,SAC,107,1,1,2,2
2010-10-30,NYK,95,1,1,POR,100,2,0,3,1
2010-10-30,IND,99,1,1,PHI,86,0,2,1,3
2010-10-30,CHI,101,0,1,DET,91,0,2,0,3
2010-10-30,MEM,109,1,1,MIN,89,1,1,2,2
2010-10-30,HOU,94,0,2,DEN,107,1,1,1,3
2010-10-30,MIL,98,0,2,CHA,88,0,2,0,4
2010-10-30,SAS,90,1,0,NOH,99,2,0,3,0
2010-10-31,NJN,78,2,0,MIA,101,2,1,4,1
2010-10-31,LAC,83,0,2,DAL,99,1,1,1,3
2010-10-31,OKC,99,2,0,UTA,120,0,2,2,2
2010-10-31,LAL,107,2,0,GSW,83,2,0,4,0
2010-11-01,CHI,110,1,1,POR,98,3,0,4,1
2010-11-01,SAC,111,2,1,TOR,108,1,1,3,2
2010-11-01,LAC,88,0,3,SAS,97,1,1,1,4
2010-11-02,CLE,88,1,2,ATL,100,3,0,4,2
2010-11-02,WAS,116,0,2,PHI,115,0,3,0,5
2010-11-02,DET,86,0,3,BOS,109,2,1,2,4
2010-11-02,MIA,129,3,1,MIN,97,1,2,4,3
2010-11-02,MIL,76,1,2,POR,90,3,1,4,3
2010-11-02,LAL,124,3,0,MEM,105,2,1,5,1
2010-11-03,ATL,94,4,0,DET,85,0,4,4,4
2010-11-03,NJN,83,2,1,CHA,85,0,3,2,4
2010-11-03,ORL,128,1,2,MIN,86,1,3,2,5
2010-11-03,PHI,101,0,4,IND,75,2,1,2,5
2010-11-03,BOS,105,3,1,MIL,102,1,3,4,4
2010-11-03,HOU,99,0,3,NOH,107,3,0,3,3
2010-11-03,DEN,101,2,1,DAL,102,2,1,4,2
2010-11-03,UTA,125,1,2,TOR,108,1,2,2,4
2010-11-03,PHX,110,1,2,SAS,112,2,1,3,3
2010-11-03,GSW,115,2,1,MEM,109,2,2,4,3
2010-11-03,LAC,107,0,4,OKC,92,2,1,2,5
2010-11-03,SAC,100,3,1,LAL,112,4,0,7,1
2010-11-04,CHI,112,2,1,NYK,120,2,2,4,3
2010-11-04,POR,106,4,1,OKC,107,2,2,6,3
2010-11-05,IND,90,2,2,MIL,94,1,4,3,6
2010-11-05,ORL,105,2,2,NJN,90,2,2,4,4
2010-11-05,PHI,116,1,4,CLE,123,1,3,2,7
2010-11-05,DET,97,0,5,CHA,90,1,3,1,8
2010-11-05,NYK,112,3,2,WAS,91,1,2,4,4
2010-11-05,BOS,110,4,1,CHI,105,2,2,6,3
2010-11-05,MIN,103,1,4,ATL,113,5,0,6,4
2010-11-05,NOH,96,4,0,MIA,93,4,1,8,1
2010-11-05,PHX,123,1,3,MEM,118,2,3,3,6
2010-11-05,DEN,111,2,2,LAC,104,1,4,3,6
2010-11-05,GSW,85,3,1,UTA,78,2,2,5,3
2010-11-05,LAL,108,5,0,TOR,103,1,3,6,3
2010-11-06,CHA,88,1,4,ORL,91,3,2,4,6
2010-11-06,WAS,102,1,3,CLE,107,2,3,3,6
2010-11-06,MIA,101,4,2,NJN,89,2,3,6,5
2010-11-06,MIL,81,2,4,NOH,87,5,0,7,4
2010-11-06,SAS,124,3,1,HOU,121,0,4,3,5
2010-11-06,DAL,92,3,1,DEN,103,3,2,6,3
2010-11-06,UTA,109,2,3,LAC,107,1,5,3,8
2010-11-06,POR,97,4,2,TOR,84,1,4,5,6
2010-11-06,SAC,91,3,2,MEM,100,2,4,5,6
2010-11-07,NYK,96,4,2,PHI,106,1,5,5,7
2010-11-07,ATL,114,6,0,PHX,118,2,3,8,3
2010-11-07,DET,102,1,5,GSW,97,4,1,5,6
2010-11-07,HOU,120,0,5,MIN,94,1,5,1,10
2010-11-07,OKC,83,3,2,BOS,92,5,1,8,3
2010-11-07,LAL,121,6,0,POR,96,5,2,11,2
2010-11-08,CHA,91,1,5,SAS,95,4,1,5,6
2010-11-08,ORL,93,4,2,ATL,89,6,1,10,3
2010-11-08,TOR,102,1,5,GSW,109,4,2,5,7
2010-11-08,CHI,94,2,3,DEN,92,4,2,6,5
2010-11-08,MEM,109,3,4,PHX,99,3,3,6,7
2010-11-08,DAL,89,3,2,BOS,87,6,1,9,3
2010-11-09,IND,144,2,3,DEN,113,4,3,6,6
2010-11-09,NJN,91,2,4,CLE,93,3,3,5,7
2010-11-09,MIA,114,5,2,UTA,116,3,3,8,5
2010-11-09,MIL,107,2,5,NYK,80,4,3,6,8
2010-11-09,NOH,101,6,0,LAC,82,1,6,7,6
2010-11-09,POR,100,5,3,DET,78,2,5,7,8
2010-11-09,LAL,99,7,0,MIN,94,1,6,8,6
2010-11-10,ATL,91,6,2,MIL,108,3,5,9,7
2010-11-10,ORL,94,5,2,UTA,104,4,3,9,5
2010-11-10,TOR,96,1,6,CHA,101,1,6,2,12
2010-11-10,WAS,98,1,4,HOU,91,1,5,2,9
2010-11-10,CLE,87,4,3,NJN,95,2,5,6,8
2010-11-10,NYK,117,4,4,GSW,122,5,2,9,6
2010-11-10,MEM,91,4,4,DAL,106,4,2,8,6
2010-11-10,OKC,109,3,3,PHI,103,2,5,5,8
2010-11-10,SAS,107,5,1,LAC,95,1,7,6,8
2010-11-10,SAC,89,3,3,MIN,98,1,7,4,10
2010-11-11,MIA,107,5,3,BOS,112,6,2,11,5
2010-11-11,CHI,120,3,3,GSW,90,6,2,9,5
2010-11-11,DEN,118,4,4,LAL,112,8,0,12,4
2010-11-12,ATL,86,6,3,UTA,90,5,3,11,6
2010-11-12,IND,99,3,3,HOU,102,1,6,4,9
2010-11-12,ORL,106,5,3,TOR,110,1,7,6,10
2010-11-12,WAS,85,2,4,CHA,93,2,6,4,10
2010-11-12,MIN,112,2,7,NYK,103,4,5,6,12
2010-11-12,DAL,99,5,2,PHI,90,2,6,7,8
2010-11-12,PHX,103,3,4,SAC,89,3,4,6,8
2010-11-12,OKC,110,4,3,POR,108,6,3,10,6
2010-11-12,LAC,107,1,8,DET,113,2,6,3,14
2010-11-13,CHA,95,3,6,UTA,96,6,3,9,9
2010-11-13,NJN,90,3,5,ORL,91,5,4,8,9
2010-11-13,CLE,85,4,4,IND,99,3,4,7,8
2010-11-13,MIA,109,5,4,TOR,100,2,7,7,11
2010-11-13,CHI,103,4,3,WAS,96,2,5,6,8
2010-11-13,MEM,110,4,5,BOS,116,7,2,11,7
2010-11-13,NOH,107,7,0,POR,87,6,4,13,4
2010-11-13,MIL,79,4,5,GSW,72,6,3,10,8
2010-11-13,SAS,116,6,1,PHI,93,2,7,8,8
2010-11-14,ATL,111,6,4,MIN,105,3,7,9,11
2010-11-14,SAC,94,3,5,DET,100,3,6,6,11
2010-11-14,OKC,104,5,3,SAS,117,7,1,12,4
2010-11-14,NYK,96,4,6,HOU,104,2,6,6,12
2010-11-14,LAL,116,8,1,PHX,121,4,4,12,5
2010-11-15,CHA,113,3,7,MIN,110,3,8,6,15
2010-11-15,ORL,89,6,4,MEM,72,4,6,10,10
2010-11-15,DAL,98,6,2,NOH,95,8,0,14,2
2010-11-15,PHX,100,5,4,DEN,94,5,4,10,8
2010-11-15,UTA,108,7,3,OKC,115,5,4,12,7
2010-11-15,GSW,101,6,4,DET,97,4,6,10,10
2010-11-15,LAC,96,1,9,NJN,110,3,6,4,15
2010-11-16,CLE,101,4,5,PHI,93,2,8,6,13
2010-11-16,IND,92,4,4,ATL,102,7,4,11,8
2010-11-16,WAS,109,2,6,TOR,94,2,8,4,14
2010-11-16,MEM,99,4,7,POR,100,6,5,10,12
2010-11-16,MIL,107,5,5,LAL,118,8,2,13,7
2010-11-16,HOU,92,3,6,CHI,95,5,3,8,9
2010-11-16,DEN,120,5,5,NYK,118,4,7,9,12
2010-11-17,MIA,123,6,4,PHX,96,6,4,12,8
2010-11-17,PHI,86,2,9,TOR,94,2,9,4,18
2010-11-17,BOS,114,8,2,WAS,83,3,6,11,8
2010-11-17,DET,90,4,7,LAL,103,9,2,13,9
2010-11-17,MIN,113,3,9,LAC,111,1,10,4,19
2010-11-17,NOH,99,8,1,DAL,97,7,2,15,3
2010-11-17,OKC,116,6,4,HOU,99,3,7,9,11
2010-11-17,UTA,98,7,4,NJN,88,4,6,11,10
2010-11-17,SAS,103,8,1,CHI,94,6,3,14,4
2010-11-17,SAC,106,3,6,NYK,113,4,8,7,14
2010-11-18,IND,107,4,5,LAC,80,1,11,5,16
2010-11-18,ORL,105,7,4,PHX,89,6,5,13,9
2010-11-18,POR,86,7,5,DEN,83,6,5,13,10
2010-11-19,BOS,84,9,2,OKC,89,7,4,16,6
2010-11-19,PHI,90,2,10,MIL,79,5,6,7,16
2010-11-19,TOR,106,3,9,HOU,96,3,8,6,17
2010-11-19,WAS,89,3,7,MEM,86,4,8,7,15
2010-11-19,MIA,95,7,4,CHA,87,4,7,11,11
2010-11-19,MIN,95,4,9,LAL,112,10,2,14,11
2010-11-19,NOH,108,9,1,CLE,101,5,5,14,6
2010-11-19,UTA,82,8,4,SAS,94,9,1,17,5
2010-11-19,DAL,83,7,3,CHI,88,6,4,13,7
2010-11-19,SAC,86,3,7,NJN,81,4,7,7,14
2010-11-19,GSW,119,7,4,NYK,125,5,8,12,12
2010-11-20,CHA,123,4,8,PHX,105,6,6,10,14
2010-11-20,IND,86,5,5,ORL,90,8,4,13,9
2010-11-20,ATL,93,8,4,DAL,98,7,4,15,8
2010-11-20,MEM,97,4,9,MIA,95,8,4,12,13
2010-11-20,MIL,81,5,7,OKC,82,8,4,13,11
2010-11-20,SAS,116,10,1,CLE,92,5,6,15,7
2010-11-20,DEN,107,6,6,NJN,103,4,8,10,14
2010-11-20,POR,94,8,5,UTA,103,8,5,16,10
2010-11-20,LAC,115,1,12,NYK,124,6,8,7,20
2010-11-21,TOR,102,4,9,BOS,101,9,3,13,12
2010-11-21,DET,115,4,8,WAS,110,4,7,8,15
2010-11-21,SAC,71,4,7,NOH,75,10,1,14,8
2010-11-21,LAL,117,11,2,GSW,89,7,5,18,7
2010-11-22,ATL,76,8,5,BOS,99,9,4,17,9
2010-11-22,MIA,77,8,5,IND,93,5,6,13,11
2010-11-22,OKC,117,9,4,MIN,107,4,10,13,14
2010-11-22,HOU,116,3,9,PHX,123,6,7,9,16
2010-11-22,SAS,106,11,1,ORL,97,9,4,20,5
2010-11-22,UTA,94,9,5,SAC,83,4,8,13,13
2010-11-22,GSW,89,7,6,DEN,106,7,6,14,12
2010-11-22,LAC,99,1,13,NOH,95,11,1,12,14
2010-11-23,IND,100,6,6,CLE,89,5,7,11,13
2010-11-23,NJN,107,4,9,ATL,101,8,6,12,15
2010-11-23,WAS,116,4,8,PHI,114,3,10,7,18
2010-11-23,NYK,110,7,8,CHA,107,5,8,12,16
2010-11-23,DAL,88,8,4,DET,84,5,8,13,12
2010-11-23,LAL,98,12,2,CHI,91,7,4,19,6
2010-11-24,CHA,95,5,9,NYK,99,8,8,13,17
2010-11-24,CLE,83,5,8,MIL,81,5,8,10,16
2010-11-24,TOR,106,5,9,PHI,90,3,11,8,20
2010-11-24,BOS,89,10,4,NJN,83,5,9,15,13
2010-11-24,ORL,104,9,5,MIA,95,8,6,17,11
2010-11-24,MEM,105,5,9,DET,84,5,9,10,18
2010-11-24,MIN,109,4,11,SAS,113,12,1,16,12
2010-11-24,OKC,103,10,4,DAL,111,9,4,19,8
2010-11-24,HOU,111,3,10,GSW,101,7,7,10,17
2010-11-24,PHX,115,7,7,CHI,123,7,5,14,12
2010-11-24,UTA,105,10,5,NOH,87,11,2,21,7
2010-11-25,ATL,116,8,7,WAS,96,5,8,13,15
2010-11-25,LAC,100,2,13,SAC,82,4,9,6,22
2010-11-26,CHA,99,5,10,HOU,89,4,10,9,20
2010-11-26,ORL,111,10,5,CLE,100,6,8,16,13
2010-11-26,BOS,110,11,4,TOR,101,6,9,17,13
2010-11-26,DET,103,5,10,MIL,89,5,9,10,19
2010-11-26,MIA,99,8,7,PHI,90,3,12,11,19
2010-11-26,IND,106,7,6,OKC,110,10,5,17,11
2010-11-26,SAS,94,13,1,DAL,103,10,4,23,5
2010-11-26,DEN,98,8,6,CHI,97,8,5,16,11
2010-11-26,PHX,116,7,8,LAC,108,3,13,10,21
2010-11-26,UTA,102,11,5,LAL,96,13,2,24,7
2010-11-26,MEM,116,6,9,GSW,111,7,8,13,17
2010-11-26,POR,78,8,6,NOH,97,11,3,19,9
2010-11-27,NYK,90,9,8,ATL,99,9,7,18,15
2010-11-27,WAS,99,5,9,ORL,100,11,5,16,14
2010-11-27,CLE,92,6,9,MEM,86,7,9,13,18
2010-11-27,PHI,102,3,13,NJN,86,5,10,8,23
2010-11-27,MIN,94,4,12,GSW,104,7,9,11,21
2010-11-27,DAL,106,11,4,MIA,95,9,7,20,11
2010-11-27,MIL,104,5,10,CHA,101,6,10,11,20
2010-11-27,SAC,85,4,10,CHI,96,8,6,12,16
2010-11-28,TOR,78,6,10,ATL,96,10,7,16,17
2010-11-28,DET,116,6,10,NYK,125,9,9,15,19
2010-11-28,NOH,95,12,3,SAS,109,13,2,25,5
2010-11-28,LAC,97,3,14,UTA,109,12,5,15,19
2010-11-28,NJN,98,5,11,POR,96,8,7,13,18
2010-11-28,HOU,99,4,11,OKC,98,11,5,15,16
2010-11-28,DEN,138,9,6,PHX,133,8,8,17,14
2010-11-28,LAL,92,13,3,IND,95,7,7,20,10
2010-11-29,MIA,105,9,8,WAS,94,5,10,14,18
2010-11-29,OKC,95,11,6,NOH,89,12,4,23,10
2010-11-29,DAL,101,12,4,HOU,91,5,11,17,15
2010-11-29,UTA,109,13,5,MIL,88,6,10,19,15
2010-11-30,CLE,87,7,9,BOS,106,12,4,19,13
2010-11-30,ORL,90,12,5,DET,79,6,11,18,16
2010-11-30,PHI,88,4,13,POR,79,8,8,12,21
2010-11-30,NYK,111,10,9,NJN,100,6,11,16,20
2010-11-30,MEM,98,7,10,LAL,96,13,4,20,14
2010-11-30,SAC,98,4,11,IND,107,8,7,12,18
2010-11-30,GSW,98,8,9,SAS,118,14,2,22,11
2010-12-01,ATL,112,11,7,MEM,109,8,10,19,17
2010-12-01,NJN,120,6,12,OKC,123,12,6,18,18
2010-12-01,TOR,127,6,11,WAS,108,5,11,11,22
2010-12-01,BOS,99,13,4,POR,95,8,9,21,13
2010-12-01,MIA,97,10,8,DET,72,6,12,16,20
2010-12-01,CHI,78,9,6,ORL,107,13,5,22,11
2010-12-01,NOH,89,12,5,CHA,73,6,11,18,16
2010-12-01,DAL,100,13,4,MIN,86,4,13,17,17
2010-12-01,HOU,109,5,12,LAL,99,13,5,18,17
2010-12-01,DEN,105,10,6,MIL,94,6,11,16,17
2010-12-01,UTA,110,14,5,IND,88,9,7,23,12
2010-12-01,LAC,90,3,15,SAS,85,15,2,18,17
2010-12-02,CLE,90,7,10,MIA,118,11,8,18,18
2010-12-02,GSW,101,8,10,PHX,107,8,9,16,19
2010-12-03,CHA,91,6,12,NJN,84,6,13,12,25
2010-12-03,TOR,111,7,11,OKC,99,13,6,20,17
2010-12-03,WAS,83,5,12,POR,79,8,10,13,22
2010-12-03,ATL,93,12,7,PHI,88,5,13,17,20
2010-12-03,DET,91,6,13,ORL,104,14,5,20,18
2010-12-03,BOS,104,14,4,CHI,92,9,7,23,11
2010-12-03,MEM,111,8,11,HOU,127,6,12,14,23
2010-12-03,NOH,92,13,5,NYK,100,11,9,24,14
2010-12-03,SAS,107,15,3,MIN,101,4,14,19,17
2010-12-03,DEN,109,11,6,LAC,104,4,15,15,21
2010-12-03,PHX,105,9,9,IND,97,9,8,18,17
2010-12-03,UTA,81,15,5,DAL,93,14,4,29,9
2010-12-03,LAL,113,13,6,SAC,80,4,12,17,18
2010-12-04,MIA,89,12,8,ATL,77,13,7,25,15
2010-12-04,PHI,109,5,14,CHA,91,7,12,12,26
2010-12-04,CHI,119,9,8,HOU,116,7,12,16,20
2010-12-04,MIN,129,4,15,CLE,95,7,11,11,26
2010-12-04,MIL,96,6,12,ORL,85,15,5,21,17
2010-12-04,SAC,103,4,13,DAL,105,15,4,19,17
2010-12-05,NJN,75,6,14,BOS,100,15,4,21,18
2010-12-05,TOR,99,8,11,NYK,116,12,9,20,20
2010-12-05,DET,102,6,14,CLE,92,7,12,13,26
2010-12-05,OKC,114,13,7,GSW,109,8,11,21,18
2010-12-05,SAS,109,16,3,NOH,84,13,6,29,9
2010-12-05,DEN,108,12,6,MEM,107,8,12,20,18
2010-12-05,PHX,125,10,9,WAS,108,6,12,16,21
2010-12-05,POR,100,8,11,LAC,91,4,16,12,27
2010-12-06,IND,124,9,9,TOR,100,8,12,17,21
2010-12-06,ORL,74,15,6,ATL,80,13,8,28,14
2010-12-06,NYK,121,13,9,MIN,114,5,15,18,24
2010-12-06,CHI,99,10,8,OKC,90,14,7,24,15
2010-12-06,MIL,78,7,12,MIA,88,13,8,20,20
2010-12-06,UTA,94,15,6,MEM,85,8,13,23,19
2010-12-06,LAC,98,4,17,SAC,91,4,14,8,31
2010-12-07,ATL,116,14,8,NJN,101,6,15,20,23
2010-12-07,CHA,100,7,13,DEN,98,13,6,20,19
2010-12-07,PHI,117,6,14,CLE,97,7,13,13,27
2010-12-07,DAL,105,16,4,GSW,100,8,12,24,16
2010-12-07,HOU,97,7,13,DET,83,7,14,14,27
2010-12-07,POR,106,9,11,PHX,99,11,9,20,20
2010-12-07,LAL,115,14,6,WAS,108,6,13,20,19
2010-12-08,BOS,105,16,4,DEN,89,13,7,29,11
2010-12-08,CLE,83,7,14,CHI,88,11,8,18,22
2010-12-08,NYK,113,14,9,TOR,110,8,13,22,22
2010-12-08,MIL,97,7,13,IND,95,10,9,17,22
2010-12-08,MIN,103,5,16,OKC,111,14,8,19,24
2010-12-08,NOH,93,13,7,DET,74,7,15,20,22
2010-12-08,SAS,111,17,3,GSW,94,8,13,25,16
2010-12-08,PHX,98,11,10,MEM,104,8,14,19,24
2010-12-08,UTA,98,16,6,MIA,111,14,8,30,14
2010-12-08,SAC,116,4,15,WAS,91,6,14,10,29
2010-12-08,LAC,86,5,17,LAL,87,15,6,20,23
2010-12-09,PHI,101,7,14,BOS,102,17,4,24,18
2010-12-09,DAL,102,17,4,NJN,89,6,16,23,20
2010-12-09,POR,97,10,11,ORL,83,15,7,25,18
2010-12-10,IND,100,10,10,CHA,92,8,13,18,23
2010-12-10,TOR,116,8,14,DEN,123,13,8,21,22
2010-12-10,WAS,95,6,15,NYK,101,15,9,21,24
2010-12-10,CHI,88,12,8,LAL,84,16,6,28,14
2010-12-10,MIN,109,5,17,DET,99,7,16,12,33
2010-12-10,NOH,92,14,7,OKC,97,15,8,29,15
2010-12-10,MIL,97,8,13,HOU,91,8,13,16,26
2010-12-10,SAS,108,18,3,ATL,92,15,8,33,11
2010-12-10,PHX,94,11,11,POR,101,11,11,22,22
2010-12-10,UTA,117,16,7,ORL,105,15,8,31,15
2010-12-10,GSW,84,8,14,MIA,106,15,8,23,22
2010-12-11,LAC,83,5,18,MEM,84,9,14,14,32
2010-12-11,ATL,97,15,9,IND,83,11,10,26,19
2010-12-11,CHA,62,8,14,BOS,93,18,4,26,18
2010-12-11,DET,116,7,17,TOR,120,8,15,15,32
2010-12-11,CHI,113,13,8,MIN,82,6,17,19,25
2010-12-11,DAL,103,18,4,UTA,97,17,7,35,11
2010-12-11,HOU,110,8,14,CLE,95,7,15,15,29
2010-12-11,SAC,83,5,15,MIA,104,16,8,21,23
2010-12-12,NYK,129,16,9,DEN,125,14,8,30,17
2010-12-12,PHI,88,7,15,NOH,70,14,8,21,23
2010-12-12,NJN,92,6,17,LAL,99,16,7,22,24
2010-12-12,OKC,106,16,8,CLE,77,7,16,23,24
2010-12-12,SAS,95,19,3,POR,78,12,11,31,14
2010-12-12,LAC,85,5,19,ORL,94,15,9,20,28
2010-12-13,MIA,96,17,8,NOH,84,14,9,31,17
2010-12-13,CHI,92,14,8,IND,73,11,11,25,19
2010-12-13,MEM,86,10,14,POR,73,12,12,22,26
2010-12-13,DAL,99,19,4,MIL,103,9,13,28,17
2010-12-13,UTA,108,17,8,GSW,95,8,15,25,23
2010-12-14,CHA,97,8,15,TOR,91,9,15,17,30
2010-12-14,NJN,77,6,18,PHI,82,8,15,14,33
2010-12-14,WAS,89,6,16,LAL,103,17,7,23,23
2010-12-14,DET,103,7,18,ATL,80,16,9,23,27
2010-12-14,HOU,118,9,14,SAC,105,5,16,14,30
2010-12-14,DEN,111,14,9,ORL,94,16,9,30,18
2010-12-14,GSW,108,8,16,MIN,99,6,18,14,34
2010-12-15,IND,94,11,12,LAL,109,18,7,29,19
2010-12-15,NYK,116,17,9,BOS,118,19,4,36,13
2010-12-15,PHI,105,9,15,LAC,91,5,20,14,35
2010-12-15,TOR,93,9,16,CHI,110,15,8,24,24
2010-12-15,MIA,101,18,8,CLE,95,7,17,25,25
2010-12-15,MEM,113,11,14,CHA,80,9,15,20,29
2010-12-15,NOH,94,14,10,SAC,91,5,17,19,27
2010-12-15,OKC,117,17,8,HOU,105,10,14,27,22
2010-12-15,SAS,92,20,3,MIL,90,10,13,30,16
2010-12-15,PHX,128,11,12,MIN,122,6,19,17,31
2010-12-15,DAL,103,19,5,POR,98,12,13,31,18
2010-12-16,NJN,97,6,19,WAS,89,6,17,12,36
2010-12-16,BOS,102,20,4,ATL,90,16,10,36,14
2010-12-16,DEN,112,15,9,SAS,113,21,3,36,12
2010-12-17,IND,108,11,13,CLE,99,7,18,18,31
2010-12-17,NYK,91,17,10,MIA,113,19,8,36,18
2010-12-17,PHI,81,10,15,LAL,93,19,7,29,22
2010-12-17,TOR,98,9,17,NJN,92,7,19,16,36
2010-12-17,ATL,90,16,11,CHA,85,9,16,25,27
2010-12-17,DET,88,8,18,LAC,109,5,21,13,39
2010-12-17,NOH,100,15,10,UTA,71,18,8,33,18
2010-12-17,OKC,102,18,8,SAC,87,5,18,23,26
2010-12-17,HOU,103,10,15,MEM,87,12,14,22,29
2010-12-17,DAL,106,20,5,PHX,91,12,12,32,17
2010-12-17,POR,107,12,14,MIN,102,6,20,18,34
2010-12-18,ORL,89,16,10,PHI,97,10,16,26,26
2010-12-18,WAS,94,6,18,MIA,95,20,8,26,26
2010-12-18,CLE,109,7,19,NYK,102,17,11,24,30
2010-12-18,CHI,99,16,8,LAC,100,6,21,22,29
2010-12-18,MIL,86,10,14,UTA,95,18,9,28,23
2010-12-18,SAS,112,22,3,MEM,106,12,15,34,18
2010-12-18,DEN,115,15,10,MIN,113,6,21,21,31
2010-12-18,POR,96,13,14,GSW,95,9,16,22,30
2010-12-19,BOS,99,21,4,IND,88,12,13,33,17
2010-12-19,NJN,89,7,20,ATL,82,17,11,24,31
2010-12-19,TOR,110,10,17,LAL,120,20,7,30,24
2010-12-19,DET,111,8,19,NOH,108,16,10,24,29
2010-12-19,SAC,93,5,19,HOU,102,11,15,16,34
2010-12-19,OKC,110,19,8,PHX,113,12,13,31,21
2010-12-20,ATL,91,17,12,ORL,81,16,11,33,23
2010-12-20,CLE,90,8,19,UTA,101,19,9,27,28
2010-12-20,IND,94,12,14,NOH,93,16,11,28,25
2010-12-20,WAS,108,6,19,CHA,75,9,17,15,36
2010-12-20,MIA,96,21,8,DAL,98,21,5,42,13
2010-12-20,SAS,118,23,3,PHX,110,13,13,36,16
2010-12-20,POR,106,14,14,MIL,80,10,15,24,29
2010-12-20,GSW,112,9,17,HOU,121,12,15,21,32
2010-12-20,LAC,113,7,21,MIN,90,6,22,13,43
2010-12-21,CHA,81,9,18,OKC,99,19,9,28,27
2010-12-21,ORL,99,16,12,DAL,105,22,5,38,17
2010-12-21,CHI,121,16,9,PHI,76,11,16,27,25
2010-12-21,MEM,94,12,16,NJN,101,8,20,20,36
2010-12-21,SAC,109,5,20,GSW,117,9,18,14,38
2010-12-21,LAL,79,21,7,MIL,98,10,16,31,23
2010-12-22,ATL,98,18,12,CLE,84,8,20,26,32
2010-12-22,TOR,93,10,18,DET,115,9,19,19,37
2010-12-22,WAS,80,7,19,CHI,87,17,9,24,28
2010-12-22,BOS,84,22,4,PHI,80,11,17,33,21
2010-12-22,NYK,112,17,12,OKC,98,20,9,37,21
2010-12-22,MIN,107,6,23,UTA,112,20,9,26,32
2010-12-22,NOH,105,16,12,NJN,91,9,20,25,32
2010-12-22,SAS,109,24,3,DEN,103,16,10,40,13
2010-12-22,LAC,92,8,21,HOU,97,13,15,21,36
2010-12-23,ORL,123,16,13,SAS,101,25,3,41,16
2010-12-23,SAC,79,5,21,MIL,84,11,16,16,37
2010-12-23,PHX,83,13,14,MIA,95,21,9,34,23
2010-12-25,NYK,103,18,12,CHI,95,18,9,36,21
2010-12-25,ORL,86,17,13,BOS,78,23,4,40,17
2010-12-25,LAL,80,21,8,MIA,96,22,9,43,17
2010-12-25,OKC,114,20,10,DEN,106,16,11,36,21
2010-12-25,GSW,109,10,18,POR,102,15,14,25,32
2010-12-26,LAC,108,8,22,PHX,103,13,15,21,37
2010-12-26,CLE,97,8,21,MIN,98,6,24,14,45
2010-12-26,DET,92,10,19,CHI,95,18,10,28,29
2010-12-26,IND,90,13,14,MEM,104,12,17,25,31
2010-12-26,NOH,93,17,12,ATL,86,19,12,36,24
2010-12-26,SAS,94,25,4,WAS,80,7,20,32,24
2010-12-26,DEN,89,16,12,PHI,95,11,18,27,30
2010-12-27,CHA,105,9,19,DET,100,10,20,19,39
2010-12-27,NJN,88,9,21,ORL,104,18,13,27,34
2010-12-27,MEM,96,13,17,TOR,85,10,19,23,36
2010-12-27,MIL,80,12,16,ATL,95,19,13,31,29
2010-12-27,MIN,113,7,24,NOH,98,18,12,25,36
2010-12-27,OKC,93,21,10,DAL,103,23,5,44,15
2010-12-27,HOU,100,14,15,WAS,93,7,21,21,36
2010-12-27,UTA,91,21,9,POR,96,15,15,36,24
2010-12-27,SAC,99,5,22,LAC,100,9,22,14,44
2010-12-27,GSW,110,11,18,PHI,95,12,18,23,36
2010-12-28,CLE,95,8,22,ORL,110,19,13,27,35
2010-12-28,IND,83,13,15,BOS,95,23,5,36,20
2010-12-28,MIA,106,23,9,NYK,98,19,12,42,21
2010-12-28,CHI,90,19,10,MIL,77,12,17,31,27
2010-12-28,DAL,76,24,5,TOR,84,10,20,34,25
2010-12-28,SAS,97,26,4,LAL,82,21,9,47,13
2010-12-28,DEN,95,16,13,POR,77,16,15,32,28
2010-12-29,ATL,103,20,13,GSW,93,12,18,32,31
2010-12-29,CHA,101,10,19,CLE,92,8,23,18,42
2010-12-29,WAS,104,7,22,IND,90,13,16,20,38
2010-12-29,DET,104,10,21,BOS,92,24,5,34,26
2010-12-29,MIN,113,8,24,DEN,119,17,13,25,37
2010-12-29,NOH,88,18,13,LAL,103,21,10,39,23
2010-12-29,OKC,114,21,11,NJN,93,9,22,30,33
2010-12-29,HOU,119,15,15,MIA,125,24,9,39,24
2010-12-29,PHX,110,13,16,PHI,123,12,19,25,35
2010-12-29,SAC,100,5,23,MEM,98,14,17,19,40
2010-12-29,LAC,95,10,22,UTA,103,21,10,31,32
2010-12-30,ORL,112,20,13,NYK,103,19,13,39,26
2010-12-30,DAL,93,24,6,SAS,99,27,4,51,10
2010-12-30,POR,100,16,16,UTA,89,22,10,38,26
2010-12-31,BOS,81,24,6,NOH,83,18,14,42,20
2010-12-31,CHA,95,11,19,GSW,96,12,19,23,38
2010-12-31,IND,95,13,17,WAS,86,8,22,21,39
2010-12-31,CHI,90,20,10,NJN,81,9,23,29,33
2010-12-31,HOU,114,15,16,TOR,105,11,20,26,36
2010-12-31,OKC,103,22,11,ATL,94,21,13,43,24
2010-12-31,PHX,92,13,17,DET,75,11,21,24,38
2010-12-31,LAL,102,22,10,PHI,98,13,19,35,29
2011-01-01,WAS,81,8,23,NOH,92,19,14,27,37
2011-01-01,CHI,100,21,10,CLE,91,8,24,29,34
2011-01-01,MIA,114,25,9,GSW,107,13,19,38,28
2011-01-01,MIN,103,8,25,NJN,88,9,24,17,49
2011-01-01,SAS,101,28,4,OKC,74,23,11,51,15
2011-01-01,MIL,99,12,18,DAL,87,24,7,36,25
2011-01-01,DEN,104,18,13,SAC,86,6,23,24,36
2011-01-01,UTA,98,22,11,MEM,92,14,18,36,29
2011-01-02,NYK,98,19,14,IND,92,14,17,33,31
2011-01-02,LAC,98,10,23,ATL,107,21,14,31,37
2011-01-02,TOR,79,11,21,BOS,93,24,7,35,28
2011-01-02,CLE,95,8,25,DAL,104,24,8,32,33
2011-01-02,POR,100,17,16,HOU,85,16,16,33,32
2011-01-02,SAC,94,6,24,PHX,89,14,17,20,41
2011-01-02,LAL,85,23,10,MEM,104,14,19,37,29
2011-01-03,CHA,82,11,20,MIA,96,26,9,37,29
2011-01-03,ORL,110,21,13,GSW,90,13,20,34,33
2011-01-03,BOS,96,25,7,MIN,93,9,25,34,32
2011-01-03,NOH,84,20,14,PHI,77,13,20,33,34
2011-01-03,DEN,113,19,13,HOU,106,16,17,35,30
2011-01-03,UTA,102,23,11,DET,97,11,22,34,33
2011-01-04,MIA,101,27,9,MIL,89,13,18,40,27
2011-01-04,NYK,128,20,14,SAS,115,29,4,49,18
2011-01-04,CHI,111,22,10,TOR,91,11,22,33,32
2011-01-04,MEM,110,15,19,OKC,105,23,12,38,31
2011-01-04,DAL,84,25,8,POR,81,18,16,43,24
2011-01-04,SAC,102,7,24,ATL,108,22,14,29,38
2011-01-04,LAL,108,23,11,DET,83,11,23,34,34
2011-01-05,CLE,105,8,26,TOR,120,11,23,19,49
2011-01-05,NJN,96,9,25,CHI,94,23,10,32,35
2011-01-05,ORL,97,22,13,MIL,87,13,19,35,32
2011-01-05,PHI,109,13,21,WAS,97,8,24,21,45
2011-01-05,BOS,105,26,7,SAS,103,29,5,55,12
2011-01-05,MIN,105,9,26,CHA,108,11,21,20,47
2011-01-05,NOH,103,21,14,GSW,110,13,21,34,35
2011-01-05,HOU,100,16,18,POR,103,18,17,34,35
2011-01-05,UTA,87,24,11,ATL,110,23,14,47,25
2011-01-05,PHX,95,14,18,LAL,99,24,11,38,29
2011-01-05,LAC,106,10,24,DEN,93,20,13,30,37
2011-01-06,DAL,95,26,8,OKC,99,23,13,49,21
2011-01-06,SAC,122,7,25,DEN,102,20,14,27,39
2011-01-07,IND,87,14,18,SAS,90,29,6,43,24
2011-01-07,PHI,105,14,21,CHI,99,23,11,37,32
2011-01-07,WAS,97,8,25,NJN,77,10,25,18,50
2011-01-07,BOS,122,27,7,TOR,102,12,23,39,30
2011-01-07,ORL,110,23,13,HOU,95,16,19,39,32
2011-01-07,MEM,110,16,19,UTA,99,24,12,40,31
2011-01-07,MIN,98,9,27,POR,108,19,17,28,44
2011-01-07,MIL,95,13,20,MIA,101,28,9,41,29
2011-01-07,PHX,96,14,19,NYK,121,21,14,35,33
2011-01-07,GSW,116,14,21,CLE,98,8,27,22,48
2011-01-07,LAL,101,25,11,NOH,97,21,15,46,26
2011-01-08,ATL,108,24,14,IND,93,14,19,38,33
2011-01-08,CHA,104,12,21,WAS,89,9,25,21,46
2011-01-08,NJN,92,10,26,MIL,115,13,21,23,47
2011-01-08,DET,112,11,24,PHI,109,15,21,26,45
2011-01-08,CHI,90,23,12,BOS,79,28,7,51,19
2011-01-08,OKC,109,24,13,MEM,100,17,19,41,32
2011-01-08,DAL,107,26,9,ORL,117,24,13,50,22
2011-01-08,HOU,99,16,20,UTA,103,24,13,40,33
2011-01-09,TOR,118,12,24,SAC,112,8,25,20,49
2011-01-09,LAC,105,11,24,GSW,91,15,21,26,45
2011-01-09,SAS,94,30,6,MIN,91,9,28,39,34
2011-01-09,PHX,108,14,20,CLE,100,8,28,22,48
2011-01-09,DEN,87,20,15,NOH,96,21,16,41,31
2011-01-09,POR,100,20,17,MIA,107,29,9,49,26
2011-01-09,LAL,109,26,11,NYK,87,22,14,48,25
2011-01-10,CHA,96,13,21,MEM,82,17,20,30,41
2011-01-10,BOS,102,28,8,HOU,108,16,21,44,29
2011-01-10,CHI,95,24,12,DET,82,12,24,36,36
2011-01-11,PHI,103,15,22,IND,111,14,20,29,42
2011-01-11,WAS,136,9,26,SAC,133,8,26,17,52
2011-01-11,MIN,96,9,29,SAS,107,31,6,40,35
2011-01-11,DEN,132,20,16,PHX,98,15,20,35,36
2011-01-11,POR,86,20,18,NYK,100,22,15,42,33
2011-01-11,LAL,112,27,11,CLE,57,8,29,35,40
2011-01-12,CHA,96,14,21,CHI,91,25,12,39,33
2011-01-12,IND,102,15,20,DAL,89,26,10,41,30
2011-01-12,TOR,101,13,24,ATL,104,26,14,39,38
2011-01-12,BOS,119,28,9,SAC,95,8,27,36,36
2011-01-12,DET,99,12,25,MEM,107,17,21,29,46
2011-01-12,MIL,84,14,22,SAS,91,32,6,46,28
2011-01-12,NOH,92,22,16,ORL,89,25,13,47,29
2011-01-12,HOU,112,17,21,OKC,118,25,13,42,34
2011-01-12,PHX,118,15,21,NJN,109,10,27,25,48
2011-01-12,UTA,131,25,13,NYK,125,23,15,48,28
2011-01-12,GSW,110,15,22,LAL,115,28,11,43,33
2011-01-12,LAC,111,12,24,MIA,105,30,9,42,33
2011-01-13,MIN,109,9,30,WAS,97,10,26,19,56
2011-01-13,OKC,125,26,13,ORL,124,25,14,51,27
2011-01-13,DEN,130,21,16,MIA,102,30,10,51,26
2011-01-14,IND,86,16,20,CHI,99,25,13,41,33
2011-01-14,PHI,95,15,23,MIL,94,14,23,29,46
2011-01-14,TOR,95,13,25,DET,101,12,26,25,51
2011-01-14,BOS,99,29,9,CHA,94,15,21,44,30
2011-01-14,NYK,83,23,16,SAC,93,8,28,31,44
2011-01-14,SAS,101,33,6,DAL,89,26,11,59,17
2011-01-14,HOU,105,17,22,NOH,110,23,16,40,38
2011-01-14,UTA,121,26,13,CLE,99,8,30,34,43
2011-01-14,PHX,115,16,21,POR,111,20,19,36,40
2011-01-14,GSW,122,15,23,LAC,112,13,24,28,47
2011-01-14,LAL,100,29,11,NJN,88,10,28,39,39
2011-01-15,ATL,106,27,14,HOU,112,17,23,44,37
2011-01-15,CHA,81,15,22,NOH,88,24,16,39,38
2011-01-15,WAS,98,10,27,TOR,95,13,26,23,53
2011-01-15,DET,110,13,26,SAC,106,9,28,22,54
2011-01-15,CHI,99,26,13,MIA,96,30,11,56,24
2011-01-15,MEM,89,18,21,DAL,70,26,12,44,33
2011-01-15,MIN,99,10,30,ORL,108,25,15,35,45
2011-01-15,DEN,127,22,16,CLE,99,8,31,30,47
2011-01-15,POR,96,20,20,NJN,89,10,29,30,49
2011-01-16,LAC,99,13,25,LAL,92,30,11,43,36
2011-01-16,SAS,110,34,6,DEN,97,23,16,57,22
2011-01-17,NYK,121,23,17,PHX,129,17,21,40,38
2011-01-17,WAS,108,11,27,UTA,101,27,13,38,40
2011-01-17,MEM,84,19,21,CHI,96,27,13,46,34
2011-01-17,PHI,96,16,23,CHA,92,15,23,31,46
2011-01-17,HOU,93,18,23,MIL,84,14,24,32,47
2011-01-17,NOH,85,25,16,TOR,81,13,27,38,43
2011-01-17,DET,103,14,26,DAL,89,26,13,40,39
2011-01-17,LAC,114,14,25,IND,107,16,21,30,46
2011-01-17,ATL,100,27,15,SAC,98,9,29,36,44
2011-01-17,GSW,109,16,23,NJN,100,10,30,26,53
2011-01-17,BOS,109,30,9,ORL,106,26,15,56,24
2011-01-17,POR,113,21,20,MIN,102,10,31,31,51
2011-01-17,LAL,101,30,12,OKC,94,27,13,57,25
2011-01-18,MIA,89,30,12,ATL,93,28,15,58,27
2011-01-18,CHI,82,28,13,CHA,83,15,24,43,37
2011-01-19,CLE,98,8,32,PHX,106,18,21,26,53
2011-01-19,NJN,103,10,31,UTA,95,27,14,37,45
2011-01-19,ORL,99,26,16,PHI,98,17,23,43,39
2011-01-19,BOS,86,31,9,DET,82,15,26,46,35
2011-01-19,MIL,100,14,25,WAS,87,12,27,26,52
2011-01-19,NOH,103,26,16,MEM,102,19,22,45,38
2011-01-19,HOU,104,19,23,NYK,89,23,18,42,41
2011-01-19,SAS,104,35,6,TOR,95,13,28,48,34
2011-01-19,DAL,109,26,14,LAL,100,31,12,57,26
2011-01-19,DEN,112,23,17,OKC,107,27,14,50,31
2011-01-19,SAC,90,9,30,POR,94,22,20,31,50
2011-01-19,GSW,110,17,23,IND,108,16,22,33,45
2011-01-19,LAC,126,15,25,MIN,111,10,32,25,57
2011-01-20,CHA,100,16,24,PHI,97,17,24,33,48
2011-01-20,CHI,82,28,14,DAL,77,27,14,55,28
2011-01-20,POR,108,23,20,LAC,93,16,25,39,45
2011-01-21,NJN,89,11,31,DET,74,15,27,26,58
2011-01-21,ORL,112,27,16,TOR,72,13,29,40,45
2011-01-21,ATL,59,29,15,NOH,100,27,16,56,31
2011-01-21,BOS,110,32,9,UTA,86,27,15,59,24
2011-01-21,CLE,88,8,33,MIL,102,15,25,23,58
2011-01-21,WAS,91,12,28,PHX,109,19,21,31,49
2011-01-21,MEM,115,19,23,HOU,110,20,23,39,46
2011-01-21,SAS,101,36,6,NYK,92,23,19,59,25
2011-01-21,DEN,97,24,17,LAL,107,31,13,55,30
2011-01-21,GSW,119,18,23,SAC,112,9,31,27,54
2011-01-22,CHA,87,17,24,ATL,103,29,16,46,40
2011-01-22,NJN,86,12,31,DAL,87,27,15,39,46
2011-01-22,WAS,85,12,29,BOS,83,33,9,45,38
2011-01-22,DET,75,15,28,PHX,74,20,21,35,49
2011-01-22,MIA,120,30,13,TOR,103,13,30,43,43
2011-01-22,PHI,96,17,25,UTA,85,27,16,44,41
2011-01-22,CHI,92,29,14,CLE,79,8,34,37,48
2011-01-22,NOH,96,28,16,SAS,72,37,6,65,22
2011-01-22,OKC,101,27,15,NYK,98,23,20,50,35
2011-01-22,HOU,104,20,24,ORL,118,28,16,48,40
2011-01-22,MIL,81,16,25,MEM,94,20,23,36,48
2011-01-22,POR,97,24,20,IND,92,16,23,40,43
2011-01-22,LAC,113,16,26,GSW,109,19,23,35,49
2011-01-23,DEN,121,24,18,IND,107,16,24,40,42
2011-01-24,NJN,103,12,32,CLE,101,8,35,20,67
2011-01-24,ORL,96,29,16,DET,103,16,28,45,44
2011-01-24,PHI,105,18,25,PHX,95,20,22,38,47
2011-01-24,TOR,98,13,31,MEM,100,21,23,34,54
2011-01-24,NYK,115,23,21,WAS,106,13,29,36,50
2011-01-24,CHI,92,30,14,MIL,83,16,26,46,40
2011-01-24,MIN,125,10,33,HOU,129,20,25,30,58
2011-01-24,NOH,91,29,16,OKC,89,28,15,57,31
2011-01-24,POR,81,25,20,SAC,96,9,32,34,52
2011-01-24,GSW,102,19,24,SAS,113,37,7,56,31
2011-01-25,WAS,109,13,30,DEN,120,25,18,38,48
2011-01-25,BOS,112,33,10,CLE,95,8,36,41,46
2011-01-25,DAL,112,28,15,LAC,105,17,26,45,41
2011-01-25,SAC,89,10,32,CHA,94,17,25,27,57
2011-01-25,LAL,120,32,13,UTA,91,27,17,59,30
2011-01-26,IND,96,16,25,ORL,111,29,17,45,42
2011-01-26,NJN,93,13,32,MEM,88,22,23,35,55
2011-01-26,TOR,94,13,32,PHI,107,19,25,32,57
2011-01-26,DET,100,17,28,DEN,109,26,18,43,46
2011-01-26,MIL,98,16,27,ATL,90,30,16,46,43
2011-01-26,MIN,117,10,34,OKC,118,28,16,38,50
2011-01-26,HOU,96,21,25,LAC,83,17,27,38,52
2011-01-26,PHX,107,20,23,CHA,114,18,25,38,48
2011-01-26,UTA,105,27,18,SAS,112,38,7,65,25
2011-01-26,GSW,103,19,25,NOH,112,30,16,49,41
2011-01-27,NYK,93,24,21,MIA,88,31,13,55,34
2011-01-27,DAL,111,29,15,HOU,106,22,25,51,40
2011-01-27,POR,78,25,21,BOS,88,34,10,59,31
2011-01-28,IND,124,16,26,NJN,92,14,32,30,58
2011-01-28,PHI,94,20,25,MEM,99,22,24,42,49
2011-01-28,TOR,110,13,33,MIL,116,17,27,30,60
2011-01-28,ATL,111,30,17,NYK,102,25,21,55,38
2011-01-28,CLE,103,8,37,DEN,117,27,18,35,55
2011-01-28,MIA,88,31,14,DET,87,17,29,48,43
2011-01-28,CHI,99,31,14,ORL,90,30,17,61,31
2011-01-28,OKC,124,29,16,WAS,117,13,31,42,47
2011-01-28,UTA,108,27,19,MIN,100,10,35,37,54
2011-01-28,PHX,88,20,24,BOS,71,35,10,55,34
2011-01-28,GSW,113,19,26,CHA,121,19,25,38,51
2011-01-28,LAL,95,33,13,SAC,100,10,33,43,46
2011-01-29,CHI,110,32,14,IND,89,17,26,49,40
2011-01-29,MEM,107,23,24,WAS,93,13,32,36,56
2011-01-29,MIN,103,10,36,TOR,87,13,34,23,70
2011-01-29,DAL,102,30,15,ATL,91,31,17,61,32
2011-01-29,MIL,91,18,27,NJN,81,14,33,32,60
2011-01-29,SAS,108,39,7,HOU,95,22,26,61,33
2011-01-29,SAC,102,11,33,NOH,96,31,16,42,49
2011-01-29,LAC,103,17,28,CHA,88,20,25,37,53
2011-01-30,OKC,103,30,16,MIA,108,32,14,62,30
2011-01-30,LAL,96,33,14,BOS,109,35,11,68,25
2011-01-30,ORL,103,30,18,CLE,87,8,38,38,56
2011-01-30,PHI,110,20,26,DEN,99,28,18,48,44
2011-01-30,NYK,124,25,22,DET,106,17,30,42,52
2011-01-30,PHX,104,21,24,NOH,102,31,17,52,41
2011-01-30,GSW,96,19,27,UTA,81,28,19,47,46
2011-01-31,IND,104,17,27,TOR,93,13,35,30,62
2011-01-31,NJN,115,14,34,DEN,99,28,19,42,53
2011-01-31,MIA,117,33,14,CLE,90,8,39,41,53
2011-01-31,MEM,100,24,24,ORL,97,31,18,55,42
2011-01-31,DAL,102,31,15,WAS,92,13,33,44,48
2011-01-31,UTA,83,28,20,CHA,78,20,26,48,46
2011-01-31,LAC,105,18,28,MIL,98,19,27,37,55
2011-02-01,NOH,97,31,18,WAS,89,13,34,44,52
2011-02-01,POR,99,25,22,SAS,86,40,7,65,29
2011-02-01,SAC,90,12,33,BOS,95,36,11,48,44
2011-02-01,LAL,114,33,15,HOU,106,22,27,55,42
2011-02-02,ATL,100,31,18,TOR,87,13,36,44,54
2011-02-02,CLE,112,8,40,IND,117,18,27,26,67
2011-02-02,NJN,92,15,34,PHI,106,21,26,36,60
2011-02-02,DET,87,17,31,CHA,97,20,27,37,58
2011-02-02,NYK,97,26,22,DAL,113,32,15,58,37
2011-02-02,MIN,84,11,36,MEM,102,25,24,36,60
2011-02-02,OKC,104,30,17,NOH,93,32,18,62,35
2011-02-02,DEN,109,28,20,POR,90,26,22,54,42
2011-02-02,PHX,92,22,24,MIL,77,19,28,41,52
2011-02-02,UTA,96,29,20,HOU,97,22,28,51,48
2011-02-02,LAC,88,19,28,CHI,106,33,14,52,42
2011-02-03,ORL,100,31,19,MIA,104,34,14,65,33
2011-02-03,GSW,100,20,27,MIL,94,19,29,39,56
2011-02-03,LAL,88,34,15,SAS,89,40,8,74,23
2011-02-04,CHA,97,21,27,MIA,109,35,14,56,41
2011-02-04,IND,100,19,27,POR,87,26,23,45,50
2011-02-04,PHI,100,22,26,NYK,98,26,23,48,49
2011-02-04,TOR,111,13,37,MIN,100,11,37,24,74
2011-02-04,WAS,92,13,35,ORL,110,31,20,44,55
2011-02-04,ATL,101,32,18,LAC,100,19,29,51,47
2011-02-04,DET,92,17,32,NJN,82,15,35,32,67
2011-02-04,BOS,97,37,11,DAL,101,33,15,70,26
2011-02-04,MEM,112,26,24,CLE,105,8,41,34,65
2011-02-04,PHX,107,23,24,OKC,111,31,17,54,41
2011-02-04,SAC,100,12,34,SAS,113,41,8,53,42
2011-02-04,DEN,106,29,20,UTA,113,29,21,58,41
2011-02-05,CHA,92,21,28,DAL,101,34,15,55,43
2011-02-05,WAS,92,13,36,ATL,99,33,18,46,54
2011-02-05,CLE,105,8,42,POR,111,26,24,34,66
2011-02-05,NOH,95,32,19,LAL,101,34,16,66,35
2011-02-05,HOU,95,23,28,MEM,93,27,24,50,52
2011-02-05,MIL,78,19,30,DET,89,18,32,37,62
2011-02-05,MIN,100,11,38,DEN,113,29,21,40,59
2011-02-05,UTA,105,30,21,OKC,121,32,17,62,38
2011-02-05,GSW,101,21,27,CHI,90,34,14,55,41
2011-02-06,MIA,97,36,14,LAC,79,19,30,55,44
2011-02-06,NJN,86,15,36,IND,105,20,27,35,63
2011-02-06,NYK,117,26,24,PHI,103,23,26,49,50
2011-02-06,BOS,91,37,12,ORL,80,32,20,69,32
2011-02-07,CHA,94,21,29,BOS,89,38,12,59,41
2011-02-07,MEM,84,27,25,LAL,93,35,16,62,41
2011-02-07,NOH,92,32,20,MIN,104,11,39,43,59
2011-02-07,DAL,99,35,15,CLE,96,8,43,43,58
2011-02-07,DEN,103,30,21,HOU,108,24,28,54,49
2011-02-07,POR,109,27,24,CHI,103,34,15,61,39
2011-02-07,SAC,104,12,35,UTA,107,30,22,42,57
2011-02-07,GSW,92,22,27,PHX,104,23,25,45,52
2011-02-08,ATL,83,34,18,PHI,117,23,27,57,45
2011-02-08,ORL,101,32,21,LAC,85,19,31,51,52
2011-02-08,DET,89,19,32,SAS,100,42,8,61,40
2011-02-08,MIA,117,37,14,IND,112,21,27,58,41
2011-02-08,MIL,92,19,31,TOR,74,14,37,33,68
2011-02-08,OKC,101,33,17,MEM,105,27,26,60,43
2011-02-08,HOU,108,25,28,MIN,112,12,39,37,67
2011-02-09,CLE,94,8,44,DET,103,19,33,27,77
2011-02-09,IND,104,21,28,CHA,103,22,29,43,57
2011-02-09,NJN,103,15,37,NOH,101,32,21,47,58
2011-02-09,PHI,95,24,27,ORL,99,33,21,57,48
2011-02-09,TOR,100,14,38,SAS,111,43,8,57,46
2011-02-09,WAS,100,13,37,MIL,85,20,31,33,68
2011-02-09,NYK,108,27,24,LAC,116,19,32,46,56
2011-02-09,UTA,86,31,22,CHI,91,34,16,65,38
2011-02-09,SAC,100,12,36,DAL,102,36,15,48,51
2011-02-09,GSW,116,22,28,DEN,114,30,22,52,50
2011-02-10,BOS,86,38,13,LAL,92,36,16,74,29
2011-02-10,PHX,112,24,25,GSW,88,23,28,47,53
2011-02-10,DEN,121,30,23,DAL,120,37,15,67,38
2011-02-11,CHA,89,22,30,NJN,94,16,37,38,67
2011-02-11,IND,116,22,28,MIN,105,13,39,35,67
2011-02-11,ORL,93,34,21,NOH,99,32,22,66,43
2011-02-11,PHI,77,24,28,SAS,71,44,8,68,36
2011-02-11,TOR,96,14,39,POR,102,28,24,42,63
2011-02-11,CLE,126,8,45,LAC,119,20,32,28,77
2011-02-11,DET,92,20,33,MIA,106,38,14,58,47
2011-02-11,NYK,96,27,25,LAL,113,37,16,64,41
2011-02-11,MEM,89,28,26,MIL,86,20,32,48,58
2011-02-11,UTA,83,31,23,PHX,95,25,25,56,48
2011-02-12,ATL,86,34,19,CHA,88,22,31,56,50
2011-02-12,NJN,95,17,37,NYK,105,27,26,44,63
2011-02-12,WAS,94,14,37,SAS,118,44,9,58,46
2011-02-12,MIN,87,13,40,PHI,107,25,28,38,68
2011-02-12,NOH,88,33,22,CHI,97,35,16,68,38
2011-02-12,HOU,102,25,29,DAL,106,37,16,62,45
2011-02-12,MIL,97,20,33,IND,103,23,28,43,61
2011-02-12,SAC,97,12,37,OKC,99,33,18,45,55
2011-02-13,BOS,85,38,14,MIA,82,39,14,77,28
2011-02-13,ORL,89,34,22,LAL,75,38,16,72,38
2011-02-13,CLE,100,9,45,WAS,115,14,38,23,83
2011-02-13,DET,100,20,34,POR,105,29,24,49,58
2011-02-13,TOR,98,14,40,LAC,93,20,33,34,73
2011-02-13,MEM,116,29,26,DEN,108,31,23,60,49
2011-02-13,PHX,108,26,25,SAC,113,12,38,38,63
2011-02-13,GSW,100,23,29,OKC,94,34,18,57,47
2011-02-14,CHA,109,23,31,LAL,89,38,17,61,48
2011-02-14,NJN,85,17,38,SAS,102,45,9,62,47
2011-02-14,DET,79,20,35,ATL,94,34,20,54,55
2011-02-14,MIL,102,20,34,LAC,78,20,34,40,68
2011-02-14,MIN,81,13,41,POR,95,30,24,43,65
2011-02-14,HOU,121,25,30,DEN,102,31,24,56,54
2011-02-15,IND,103,24,28,MIA,110,39,15,63,43
2011-02-15,CHI,106,36,16,CHA,94,24,31,60,47
2011-02-15,MEM,102,30,26,PHI,91,26,28,56,54
2011-02-15,OKC,126,34,19,SAC,96,13,38,47,57
2011-02-15,PHX,102,26,26,UTA,101,31,24,57,50
2011-02-15,GSW,102,24,29,NOH,89,33,23,57,52
2011-02-16,ORL,101,35,22,WAS,76,15,38,50,60
2011-02-16,TOR,95,15,40,MIA,103,40,15,55,55
2011-02-16,BOS,94,39,14,NJN,80,17,39,56,53
2011-02-16,CLE,104,9,46,LAL,99,38,18,47,64
2011-02-16,DET,115,20,36,IND,109,24,29,44,65
2011-02-16,NYK,102,28,26,ATL,90,35,20,63,46
2011-02-16,MIN,90,13,42,LAC,98,20,35,33,77
2011-02-16,DAL,116,38,16,SAC,100,13,39,51,55
2011-02-16,HOU,105,26,30,PHI,114,26,29,52,59
2011-02-16,MIL,87,21,34,DEN,94,31,25,52,59
2011-02-16,UTA,100,31,25,GSW,107,25,29,56,54
2011-02-16,POR,103,31,24,NOH,96,33,24,64,48
2011-02-17,CHI,109,37,16,SAS,99,46,9,83,25
2011-02-17,PHX,106,27,26,DAL,112,39,16,66,42
2011-02-22,CHA,114,24,32,TOR,101,15,41,39,73
2011-02-22,WAS,96,15,39,IND,113,24,30,39,69
2011-02-22,DET,100,21,36,HOU,108,26,31,47,67
2011-02-22,MIA,117,41,15,SAC,97,13,40,54,55
2011-02-22,MIL,94,21,35,MIN,88,13,43,34,78
2011-02-22,OKC,111,35,19,LAC,88,21,35,56,54
2011-02-22,DEN,120,32,25,MEM,107,31,26,63,51
2011-02-22,GSW,93,26,29,BOS,115,40,14,66,43
2011-02-22,LAL,104,38,19,ATL,80,35,21,73,40
2011-02-23,CLE,119,10,46,HOU,124,27,31,37,77
2011-02-23,IND,102,25,30,DET,101,21,37,46,67
2011-02-23,ORL,105,36,22,SAC,111,13,41,49,63
2011-02-23,PHI,117,27,29,WAS,94,15,40,42,69
2011-02-23,TOR,118,15,42,CHI,113,38,16,53,58
2011-02-23,NYK,114,29,26,MIL,108,22,35,51,61
2011-02-23,MIN,95,13,44,MEM,104,31,27,44,71
2011-02-23,NOH,98,33,25,LAC,87,21,36,54,61
2011-02-23,SAS,109,46,10,OKC,105,36,19,82,29
2011-02-23,DAL,118,40,16,UTA,99,31,26,71,42
2011-02-23,PHX,105,27,27,ATL,97,35,22,62,49
2011-02-23,POR,101,32,24,LAL,106,39,19,71,43
2011-02-24,CHI,93,38,17,MIA,89,42,15,80,32
2011-02-24,DEN,89,33,25,BOS,75,41,14,74,39
2011-02-25,CHA,110,25,32,SAC,98,14,41,39,73
2011-02-25,IND,84,26,30,UTA,95,31,27,57,57
2011-02-25,PHI,110,28,29,DET,94,21,38,49,67
2011-02-25,TOR,92,16,42,PHX,110,28,27,44,69
2011-02-25,CLE,115,10,47,NYK,109,30,26,40,73
2011-02-25,MIA,121,42,16,WAS,113,15,41,57,57
2011-02-25,ORL,111,36,23,OKC,88,36,20,72,43
2011-02-25,MIN,81,13,45,NOH,95,34,25,47,70
2011-02-25,SAS,106,47,10,NJN,96,17,40,64,50
2011-02-25,GSW,79,26,30,ATL,95,35,23,61,53
2011-02-25,LAL,108,40,19,LAC,95,21,37,61,56
2011-02-25,POR,107,32,25,DEN,106,34,25,66,50
2011-02-26,WAS,99,15,42,DAL,105,41,16,56,58
2011-02-26,DET,120,21,39,UTA,116,32,27,53,66
2011-02-26,MEM,120,32,27,SAC,92,14,42,46,69
2011-02-26,HOU,123,28,31,NJN,108,17,41,45,72
2011-02-26,MIL,75,22,36,CHI,83,39,17,61,53
2011-02-26,LAC,92,21,38,BOS,99,41,15,62,53
2011-02-27,IND,108,26,31,PHX,110,29,27,55,58
2011-02-27,OKC,87,36,21,LAL,90,41,19,77,40
2011-02-27,CLE,91,11,47,PHI,95,29,29,40,76
2011-02-27,MIN,126,13,46,GSW,123,26,31,39,77
2011-02-27,ORL,100,37,23,CHA,86,26,32,63,55
2011-02-27,TOR,96,16,43,DAL,114,42,16,58,59
2011-02-27,NOH,89,35,25,HOU,91,29,31,64,56
2011-02-27,SAS,95,48,10,MEM,88,33,27,81,37
2011-02-27,MIA,86,43,16,NYK,91,30,27,73,43
2011-02-27,POR,83,33,25,ATL,90,36,23,69,48
2011-02-28,NJN,103,17,42,PHX,104,30,27,47,69
2011-02-28,WAS,77,15,43,CHI,105,40,17,55,60
2011-02-28,DEN,100,34,26,ATL,90,37,23,71,49
2011-02-28,UTA,102,32,28,BOS,107,42,15,74,43
2011-02-28,SAC,105,14,43,LAC,99,21,39,35,82
2011-03-01,IND,109,26,32,GSW,100,26,32,52,64
2011-03-01,ORL,116,38,23,NYK,110,31,27,69,50
2011-03-01,PHI,93,30,29,DAL,101,43,16,73,45
2011-03-01,TOR,96,16,44,NOH,90,35,26,51,70
2011-03-01,MEM,109,33,28,SAS,93,49,10,82,38
2011-03-01,MIL,92,22,37,DET,90,22,39,44,76
2011-03-01,MIN,79,14,46,LAL,90,42,19,56,65
2011-03-01,POR,87,33,26,HOU,103,30,31,63,57
2011-03-02,ATL,83,37,24,CHI,80,41,17,78,41
2011-03-02,CLE,99,11,48,SAS,109,49,11,60,59
2011-03-02,WAS,102,15,44,GSW,106,26,33,41,77
2011-03-02,BOS,115,43,15,PHX,103,31,27,74,42
2011-03-02,DET,105,22,40,MIN,116,14,47,36,87
2011-03-02,NYK,107,31,28,NOH,88,35,27,66,55
2011-03-02,OKC,113,36,22,IND,89,27,32,63,54
2011-03-02,DEN,120,35,26,CHA,80,26,33,61,59
2011-03-02,SAC,102,15,43,POR,107,33,27,48,70
2011-03-02,LAC,106,21,40,HOU,103,31,31,52,71
2011-03-03,MIA,96,43,17,ORL,99,39,23,82,40
2011-03-03,UTA,101,32,29,DEN,103,36,26,68,55
2011-03-04,NJN,116,17,43,TOR,103,17,44,34,87
2011-03-04,ORL,81,40,23,CHI,89,41,18,81,41
2011-03-04,PHI,111,30,30,MIN,100,15,47,45,77
2011-03-04,ATL,104,38,24,OKC,111,37,22,75,46
2011-03-04,BOS,107,44,15,GSW,103,27,33,71,48
2011-03-04,NYK,115,32,28,CLE,119,11,49,43,77
2011-03-04,MEM,91,34,28,NOH,98,35,28,69,56
2011-03-04,DAL,116,44,16,IND,108,27,33,71,49
2011-03-04,MIL,88,23,37,PHX,102,31,28,54,65
2011-03-04,SAS,125,50,11,MIA,95,43,18,93,29
2011-03-04,LAL,92,43,19,CHA,84,26,34,69,53
2011-03-05,NJN,137,18,43,TOR,136,17,45,35,88
2011-03-05,WAS,103,15,45,MIN,96,15,48,30,93
2011-03-05,HOU,112,31,32,IND,95,27,34,58,66
2011-03-05,UTA,109,32,30,SAC,102,15,44,47,74
2011-03-05,POR,93,34,27,CHA,69,26,35,60,62
2011-03-05,LAC,100,22,40,DEN,94,37,26,59,66
2011-03-06,MIA,86,43,19,CHI,87,42,18,85,37
2011-03-06,SAS,83,51,11,LAL,99,44,19,95,30
2011-03-06,ATL,79,38,25,NYK,92,32,29,70,54
2011-03-06,DET,113,22,41,WAS,102,16,45,38,86
2011-03-06,PHI,125,31,30,GSW,117,27,34,58,64
2011-03-06,CLE,81,12,49,NOH,96,36,28,48,77
2011-03-06,OKC,122,38,22,PHX,118,32,28,70,50
2011-03-06,DAL,103,45,16,MEM,104,34,29,79,45
2011-03-06,MIL,83,23,38,BOS,89,45,15,68,53
2011-03-07,CHA,87,26,36,LAC,92,23,40,49,76
2011-03-07,ORL,85,40,24,POR,89,35,27,75,51
2011-03-07,NYK,131,33,29,UTA,109,33,30,66,59
2011-03-07,CHI,85,43,18,NOH,77,37,28,80,46
2011-03-07,MEM,107,35,29,OKC,101,39,22,74,51
2011-03-07,MIN,105,15,49,DAL,108,45,17,60,66
2011-03-07,SAC,101,15,45,HOU,123,32,32,47,77
2011-03-08,ATL,87,38,26,LAL,101,45,19,83,45
2011-03-08,CLE,85,12,50,GSW,95,27,35,39,85
2011-03-08,IND,100,27,35,PHI,110,32,30,59,65
2011-03-08,WAS,76,16,46,MIL,95,23,39,39,85
2011-03-08,MIA,96,43,20,POR,105,36,27,79,47
2011-03-08,PHX,113,32,29,HOU,110,33,32,65,61
2011-03-09,CHA,84,26,37,CHI,101,44,18,70,55
2011-03-09,NJN,94,19,43,GSW,90,28,35,47,78
2011-03-09,PHI,105,33,30,OKC,110,39,23,72,53
2011-03-09,TOR,94,17,46,UTA,96,33,31,50,77
2011-03-09,BOS,103,46,15,LAC,108,24,40,70,55
2011-03-09,MEM,108,36,29,NYK,110,34,29,70,58
2011-03-09,MIL,110,24,39,CLE,90,12,51,36,90
2011-03-09,MIN,101,15,50,IND,75,27,36,42,86
2011-03-09,NOH,93,37,29,DAL,92,46,17,83,46
2011-03-09,SAS,111,51,12,DET,104,23,41,74,53
2011-03-09,SAC,102,15,46,ORL,106,40,25,55,71
2011-03-10,MIA,94,43,21,LAL,88,46,19,89,40
2011-03-10,DAL,127,46,18,NYK,109,35,29,81,47
2011-03-10,PHX,97,33,29,DEN,116,37,27,70,56
2011-03-11,CHA,97,26,38,POR,92,37,27,63,65
2011-03-11,NJN,102,20,43,LAC,98,25,40,45,83
2011-03-11,PHI,89,33,31,BOS,86,46,16,79,47
2011-03-11,TOR,108,17,47,IND,98,27,37,44,84
2011-03-11,CHI,94,45,18,ATL,76,38,27,83,45
2011-03-11,MIN,122,16,50,UTA,101,34,31,50,81
2011-03-11,OKC,104,40,23,DET,94,23,42,63,65
2011-03-11,SAS,108,52,12,SAC,103,15,47,67,59
2011-03-11,GSW,123,28,36,ORL,120,41,25,69,61
2011-03-12,MIA,118,44,21,MEM,85,36,30,80,51
2011-03-12,ATL,91,38,28,POR,82,37,28,75,56
2011-03-12,WAS,101,16,47,LAC,122,25,41,41,88
2011-03-12,CHI,118,46,18,UTA,100,34,32,80,50
2011-03-12,MIL,102,25,39,PHI,74,34,31,59,70
2011-03-12,NOH,115,38,29,SAC,103,15,48,53,77
2011-03-12,DAL,91,47,18,LAL,96,46,20,93,38
2011-03-12,HOU,107,33,33,SAS,115,53,12,86,45
2011-03-12,DEN,131,38,27,DET,101,23,43,61,70
2011-03-13,CLE,75,12,52,OKC,95,41,23,53,75
2011-03-13,TOR,90,18,47,CHA,95,27,38,45,85
2011-03-13,PHX,88,33,30,ORL,111,41,26,74,56
2011-03-13,BOS,87,46,17,MIL,56,26,39,72,56
2011-03-13,NYK,93,35,30,IND,106,27,38,62,68
2011-03-13,GSW,100,29,36,MIN,77,17,50,46,86
2011-03-14,NJN,88,21,43,BOS,79,47,17,68,60
2011-03-14,WAS,89,16,48,OKC,116,42,23,58,71
2011-03-14,MIA,110,45,21,SAS,80,54,12,99,33
2011-03-14,MEM,105,36,31,LAC,82,26,41,62,72
2011-03-14,NOH,103,39,29,DEN,114,39,27,78,56
2011-03-14,HOU,95,33,34,PHX,93,33,31,66,65
2011-03-14,UTA,112,34,33,PHI,107,34,32,68,65
2011-03-14,SAC,129,15,49,GSW,119,30,36,45,85
2011-03-14,LAL,97,47,20,ORL,84,42,26,89,46
2011-03-15,ATL,110,25,14,MIL,85,14,21,39,35
2011-03-15,IND,119,28,38,NYK,117,35,31,63,69
2011-03-15,CHI,98,47,18,WAS,79,16,49,63,67
2011-03-15,POR,104,37,29,DAL,101,47,19,84,48
2011-03-16,ATL,87,39,28,DEN,102,40,27,79,55
2011-03-16,BOS,92,47,18,IND,80,29,38,76,56
2011-03-16,DET,107,23,44,TOR,93,18,48,41,92
2011-03-16,MIA,85,46,21,OKC,96,43,23,89,44
2011-03-16,MIL,89,26,40,ORL,93,42,27,68,67
2011-03-16,NOH,100,39,30,PHX,95,33,32,72,62
2011-03-16,HOU,94,34,34,CHA,78,28,38,62,72
2011-03-16,UTA,119,35,33,MIN,104,17,51,52,84
2011-03-16,SAC,93,16,49,CLE,97,12,53,28,102
2011-03-16,GSW,106,30,37,DAL,112,47,20,77,57
2011-03-16,LAC,94,26,42,PHI,104,34,33,60,75
2011-03-17,NJN,73,22,43,CHI,84,48,18,70,61
2011-03-17,NYK,120,35,32,MEM,99,37,31,72,63
2011-03-17,POR,111,38,29,CLE,70,13,53,51,82
2011-03-18,IND,115,29,39,CHI,108,49,18,78,57
2011-03-18,ORL,85,43,27,DEN,82,41,27,84,54
2011-03-18,TOR,116,18,49,WAS,107,16,50,34,99
2011-03-18,ATL,85,39,29,MIA,106,46,22,85,51
2011-03-18,DET,99,24,44,NYK,95,36,32,60,76
2011-03-18,OKC,99,44,23,CHA,82,28,39,72,62
2011-03-18,DAL,91,48,20,SAS,97,54,13,102,33
2011-03-18,HOU,93,35,34,BOS,77,48,18,83,52
2011-03-18,MIL,110,26,41,NJN,95,22,44,48,85
2011-03-18,PHX,108,33,33,GSW,97,30,38,63,71
2011-03-18,SAC,80,16,50,PHI,102,35,33,51,83
2011-03-18,LAL,106,48,20,MIN,98,17,52,65,72
2011-03-19,LAC,100,26,43,CLE,92,13,54,39,97
2011-03-19,MIA,103,47,22,DEN,98,41,28,88,50
2011-03-19,MEM,99,37,32,IND,78,30,39,67,71
2011-03-19,NOH,85,40,30,BOS,89,48,19,88,49
2011-03-19,SAS,109,55,13,CHA,98,28,40,83,53
2011-03-19,POR,110,39,29,PHI,101,36,33,75,62
2011-03-20,WAS,98,16,51,NJN,92,22,45,38,96
2011-03-20,ATL,104,39,30,DET,96,25,44,64,74
2011-03-20,MIL,100,27,41,NYK,95,36,33,63,74
2011-03-20,MIN,95,17,53,SAC,127,16,51,33,104
2011-03-20,LAC,99,27,43,PHX,108,34,33,61,76
2011-03-20,HOU,110,36,34,UTA,108,36,33,72,67
2011-03-20,OKC,93,45,23,TOR,95,19,49,64,72
2011-03-20,DAL,101,48,21,GSW,73,30,39,78,60
2011-03-20,LAL,84,49,20,POR,80,40,29,89,49
2011-03-21,CLE,86,13,55,ORL,97,44,27,57,82
2011-03-21,NJN,98,22,46,IND,102,30,40,52,86
2011-03-21,NYK,86,36,34,BOS,96,49,19,85,53
2011-03-21,CHI,132,49,19,SAC,92,17,51,66,70
2011-03-21,MEM,103,38,32,UTA,85,36,34,74,66
2011-03-21,SAS,111,56,13,GSW,96,30,40,86,53
2011-03-21,DEN,123,41,29,TOR,90,20,49,61,78
2011-03-22,ATL,81,40,30,CHI,114,50,19,90,49
2011-03-22,POR,111,40,30,WAS,76,17,51,57,81
2011-03-22,LAL,139,50,20,PHX,137,35,33,85,53
2011-03-23,CHA,88,28,41,IND,111,31,40,59,81
2011-03-23,CLE,94,13,56,NJN,98,22,47,35,103
2011-03-23,PHI,105,36,34,ATL,100,40,31,76,65
2011-03-23,BOS,87,50,19,MEM,90,39,32,89,51
2011-03-23,DET,94,25,45,MIA,100,48,22,73,67
2011-03-23,NYK,99,36,35,ORL,111,45,27,81,62
2011-03-23,MIL,90,28,41,SAC,97,17,52,45,93
2011-03-23,OKC,106,45,24,UTA,94,36,35,81,59
2011-03-23,HOU,131,37,34,GSW,112,30,41,67,75
2011-03-23,PHX,114,35,34,TOR,106,20,50,55,84
2011-03-23,DEN,115,42,29,SAS,112,57,13,99,42
2011-03-23,LAC,127,27,44,WAS,119,17,52,44,96
2011-03-24,DAL,104,49,21,MIN,96,17,54,66,75
2011-03-24,UTA,117,36,36,NOH,121,40,31,76,67
2011-03-25,IND,93,32,40,SAC,110,18,52,50,92
2011-03-25,ORL,95,46,27,NJN,85,23,47,69,74
2011-03-25,BOS,81,50,20,CHA,83,28,42,78,62
2011-03-25,CLE,97,13,57,DET,91,25,46,38,103
2011-03-25,MIA,111,49,22,PHI,99,37,34,86,56
2011-03-25,NYK,96,36,36,MIL,102,28,42,64,78
2011-03-25,CHI,99,51,19,MEM,96,40,32,91,51
2011-03-25,OKC,111,46,24,MIN,103,17,55,63,79
2011-03-25,DEN,114,43,29,WAS,94,17,53,60,82
2011-03-25,PHX,100,36,34,NOH,106,41,31,77,65
2011-03-25,POR,98,41,30,SAS,96,57,14,98,44
2011-03-25,GSW,138,30,42,TOR,100,20,51,50,93
2011-03-25,LAL,112,51,20,LAC,104,28,44,79,64
2011-03-26,ATL,98,40,32,NJN,87,23,48,63,80
2011-03-26,CHA,114,29,42,NYK,106,36,37,65,79
2011-03-26,DET,100,25,47,IND,88,32,41,57,88
2011-03-26,MIL,87,29,42,CHI,95,52,19,81,61
2011-03-26,UTA,77,36,37,DAL,94,50,21,86,58
2011-03-26,LAC,94,28,45,TOR,90,20,52,48,97
2011-03-27,PHI,111,37,35,SAC,114,19,52,56,87
2011-03-27,CLE,83,14,57,ATL,99,41,32,55,89
2011-03-27,MIA,125,50,22,HOU,119,38,34,88,56
2011-03-27,MEM,111,40,33,SAS,104,57,15,97,48
2011-03-27,MIN,82,17,56,BOS,85,50,21,67,77
2011-03-27,OKC,99,47,24,POR,90,42,30,89,54
2011-03-27,GSW,114,31,42,WAS,104,17,54,48,96
2011-03-27,LAL,102,52,20,NOH,84,42,31,94,51
2011-03-27,PHX,83,36,35,DAL,91,51,21,87,56
2011-03-28,NYK,113,1,2,ORL,106,1,1,2,3
2011-03-28,CHA,87,30,42,MIL,86,29,43,59,85
2011-03-28,IND,107,32,42,BOS,100,51,21,83,63
2011-03-28,CHI,85,53,19,PHI,97,37,36,90,55
2011-03-28,SAS,92,57,16,POR,100,42,31,99,47
2011-03-28,UTA,95,36,38,WAS,100,17,55,53,93
2011-03-29,CLE,102,14,58,MIA,90,51,22,65,80
2011-03-29,NJN,87,23,49,HOU,112,38,35,61,84
2011-03-29,OKC,115,48,24,GSW,114,32,42,80,66
2011-03-29,SAC,116,20,52,PHX,113,36,36,56,88
2011-03-30,ATL,85,42,32,ORL,82,47,27,89,59
2011-03-30,CHA,98,31,42,CLE,97,15,58,46,100
2011-03-30,IND,111,33,42,DET,101,26,47,59,89
2011-03-30,PHI,108,38,36,HOU,97,39,35,77,71
2011-03-30,TOR,98,20,53,MIL,104,29,44,49,97
2011-03-30,WAS,107,18,55,MIA,123,51,23,69,78
2011-03-30,NYK,120,36,38,NJN,116,23,50,59,88
2011-03-30,MEM,110,41,33,GSW,91,32,43,73,76
2011-03-30,MIN,91,17,57,CHI,108,53,20,70,77
2011-03-30,NOH,95,42,32,POR,91,43,31,85,63
2011-03-30,DEN,104,44,29,SAC,90,21,52,65,81
2011-03-30,PHX,98,36,37,OKC,116,49,24,85,61
2011-03-30,LAC,100,29,45,DAL,106,52,21,81,66
2011-03-31,SAS,97,57,17,BOS,107,51,22,108,39
2011-03-31,LAL,110,53,20,DAL,82,53,21,106,41
2011-04-01,IND,89,34,42,MIL,88,30,44,64,86
2011-04-01,ORL,89,47,28,CHA,77,32,42,79,70
2011-04-01,PHI,115,39,36,NJN,90,23,51,62,87
2011-04-01,WAS,115,18,56,CLE,107,15,59,33,115
2011-04-01,DET,96,26,48,CHI,101,54,20,80,68
2011-04-01,ATL,88,43,32,BOS,83,52,22,95,54
2011-04-01,MIN,92,17,58,MIA,111,52,23,69,81
2011-04-01,NOH,81,43,32,MEM,93,42,33,85,65
2011-04-01,HOU,119,39,36,SAS,114,57,18,96,54
2011-04-01,PHX,111,36,38,LAC,98,29,46,65,84
2011-04-01,POR,98,43,32,OKC,91,50,24,93,56
2011-04-01,SAC,90,21,53,DEN,99,45,29,66,82
2011-04-01,UTA,85,36,39,LAL,96,54,20,90,59
2011-04-02,CHI,113,55,20,TOR,106,20,54,75,74
2011-04-02,MEM,106,43,33,MIN,89,17,59,60,92
2011-04-02,MIL,93,30,45,PHI,87,40,36,70,81
2011-04-02,GSW,99,32,44,DAL,92,53,22,85,66
2011-04-02,LAC,98,29,47,OKC,92,50,25,79,72
2011-04-03,SAS,114,57,19,PHX,97,37,38,94,57
2011-04-03,LAL,90,55,20,DEN,95,46,29,101,49
2011-04-03,BOS,101,52,23,DET,90,26,49,78,72
2011-04-03,CHA,91,32,43,WAS,97,19,56,51,99
2011-04-03,NJN,94,23,52,MIA,108,53,23,76,75
2011-04-03,NYK,123,37,38,CLE,107,15,60,52,98
2011-04-03,TOR,102,20,55,ORL,98,48,28,68,83
2011-04-03,SAC,106,21,54,UTA,97,36,40,57,94
2011-04-03,HOU,114,40,36,ATL,109,44,32,84,68
2011-04-03,NOH,108,43,33,IND,96,35,42,78,75
2011-04-03,POR,104,44,32,DAL,96,53,23,97,55
2011-04-05,ATL,90,44,33,SAS,97,58,19,102,52
2011-04-05,CLE,99,15,61,CHA,89,32,44,47,105
2011-04-05,NJN,107,23,53,MIN,105,17,60,40,113
2011-04-05,ORL,78,48,29,MIL,72,31,45,79,74
2011-04-05,WAS,107,20,56,DET,105,26,50,46,106
2011-04-05,BOS,99,53,23,PHI,82,40,37,93,60
2011-04-05,NYK,131,38,38,TOR,118,21,55,59,93
2011-04-05,CHI,97,56,20,PHX,94,37,39,93,59
2011-04-05,MEM,81,44,33,LAC,82,30,47,74,80
2011-04-05,HOU,101,41,36,SAC,104,22,54,63,90
2011-04-05,DEN,94,47,29,OKC,101,50,26,97,55
2011-04-05,POR,87,45,32,GSW,108,33,44,78,76
2011-04-05,LAL,85,55,21,UTA,86,36,41,91,62
2011-04-06,CHA,102,32,45,ORL,111,49,29,81,74
2011-04-06,IND,136,35,43,WAS,112,21,56,56,99
2011-04-06,MIA,85,54,23,MIL,90,31,46,85,69
2011-04-06,PHI,92,40,38,NYK,97,39,38,79,76
2011-04-06,TOR,96,21,56,CLE,104,16,61,37,117
2011-04-06,DET,116,26,51,NJN,109,24,53,50,104
2011-04-06,MIN,98,17,61,PHX,108,37,40,54,101
2011-04-06,NOH,101,44,33,HOU,93,41,37,85,70
2011-04-06,OKC,112,51,26,LAC,108,31,47,82,73
2011-04-06,SAS,124,59,19,SAC,92,23,54,82,73
2011-04-06,DAL,96,53,24,DEN,104,47,30,100,54
2011-04-06,GSW,95,34,44,LAL,87,55,22,89,66
2011-04-07,CHI,97,57,20,BOS,81,54,23,111,43
2011-04-07,UTA,87,37,41,POR,98,45,33,82,74
2011-04-08,IND,114,36,43,ATL,102,44,34,80,77
2011-04-08,NJN,93,24,54,NYK,116,40,38,64,92
2011-04-08,PHI,98,40,39,TOR,93,21,57,61,96
2011-04-08,BOS,104,54,24,WAS,88,21,57,75,81
2011-04-08,CLE,82,17,61,CHI,93,58,20,75,81
2011-04-08,DET,110,27,51,MIL,100,32,46,59,97
2011-04-08,MIA,112,54,24,CHA,103,32,46,86,70
2011-04-08,MEM,101,44,34,SAC,96,23,55,67,89
2011-04-08,NOH,109,45,33,PHX,97,38,40,83,73
2011-04-08,OKC,104,52,26,DEN,89,48,30,100,56
2011-04-08,DAL,107,53,25,LAC,96,31,48,84,73
2011-04-08,POR,93,46,33,LAL,86,55,23,101,56
2011-04-09,WAS,115,21,58,ATL,83,44,35,65,93
2011-04-09,HOU,99,41,38,LAC,78,31,49,72,87
2011-04-09,MIL,108,32,47,CLE,101,17,62,49,109
2011-04-09,SAS,111,60,19,UTA,102,37,42,97,61
2011-04-09,DEN,130,48,31,MIN,106,17,62,65,93
2011-04-10,ORL,99,50,29,CHI,102,59,20,109,49
2011-04-10,MIA,100,55,24,BOS,77,55,24,110,48
2011-04-10,CHA,101,32,47,DET,112,28,51,60,98
2011-04-10,TOR,99,21,58,NJN,92,24,55,45,113
2011-04-10,MEM,111,45,34,NOH,89,46,33,91,67
2011-04-10,IND,109,37,43,NYK,110,41,38,78,81
2011-04-10,DAL,115,54,25,PHX,90,38,41,92,66
2011-04-10,GSW,103,35,44,SAC,104,23,56,58,100
2011-04-10,LAL,106,55,24,OKC,120,53,26,108,50
2011-04-11,ATL,90,44,36,MIA,98,56,24,100,60
2011-04-11,NJN,103,24,56,CHA,105,32,48,56,104
2011-04-11,PHI,85,41,39,ORL,95,50,30,91,69
2011-04-11,WAS,95,22,58,BOS,94,55,25,77,83
2011-04-11,DET,101,29,51,CLE,110,17,63,46,114
2011-04-11,MIL,93,33,47,TOR,86,22,58,55,105
2011-04-11,NOH,78,46,34,UTA,90,37,43,83,77
2011-04-11,HOU,91,42,38,DAL,98,55,25,97,63
2011-04-11,DEN,134,49,31,GSW,111,35,45,84,76
2011-04-11,PHX,135,38,42,MIN,127,17,63,55,105
2011-04-11,SAC,112,24,56,OKC,120,54,26,78,82
2011-04-12,NYK,90,42,38,CHI,103,60,20,102,58
2011-04-12,POR,102,47,33,MEM,89,46,34,93,67
2011-04-12,LAL,102,55,25,SAS,93,61,19,116,44
2011-04-13,BOS,112,55,26,NYK,102,42,39,97,65
2011-04-13,CHA,96,33,48,ATL,85,44,37,77,85
2011-04-13,CLE,100,18,63,WAS,93,23,58,41,121
2011-04-13,ORL,92,51,30,IND,74,37,44,88,74
2011-04-13,PHI,100,41,40,DET,104,29,52,70,92
2011-04-13,TOR,79,22,59,MIA,97,57,24,79,83
2011-04-13,CHI,97,61,20,NJN,92,24,57,85,77
2011-04-13,DAL,121,56,25,NOH,89,46,35,102,60
2011-04-13,MIN,102,17,64,HOU,121,42,39,59,103
2011-04-13,OKC,106,55,26,MIL,110,34,47,89,73
2011-04-13,UTA,107,38,43,DEN,103,50,31,88,74
2011-04-13,GSW,110,35,46,POR,86,48,33,83,79
2011-04-13,LAC,110,31,50,MEM,103,46,35,77,85
2011-04-13,PHX,106,39,42,SAS,103,61,20,100,62
2011-12-25,NYK,106,0,0,BOS,104,0,0,0,0
2011-12-25,DAL,94,0,0,MIA,105,0,0,0,0
2011-12-25,LAL,87,0,0,CHI,88,0,0,0,0
2011-12-25,OKC,97,0,0,ORL,89,0,0,0,0
2011-12-25,GSW,86,0,0,LAC,105,0,0,0,0
2011-12-26,WAS,84,0,0,NJN,90,0,0,0,0
2011-12-26,CHA,96,0,0,MIL,95,0,0,0,0
2011-12-26,ORL,104,0,1,HOU,95,0,0,0,1
2011-12-26,CLE,96,0,0,TOR,104,0,0,0,0
2011-12-26,IND,91,0,0,DET,79,0,0,0,0
2011-12-26,MIN,100,0,0,OKC,104,1,0,1,0
2011-12-26,DAL,93,0,1,DEN,115,0,0,0,1
2011-12-26,SAS,95,0,0,MEM,82,0,0,0,0
2011-12-26,PHX,84,0,0,NOH,85,0,0,0,0
2011-12-26,SAC,100,0,0,LAL,91,0,1,0,1
2011-12-26,POR,107,0,0,PHI,103,0,0,0,0
2011-12-26,GSW,99,0,1,CHI,91,1,0,1,1
2011-12-27,NJN,70,1,0,ATL,106,0,0,1,0
2011-12-27,MIA,115,1,0,BOS,107,0,1,1,1
2011-12-27,MIL,98,0,1,MIN,95,0,1,0,2
2011-12-27,POR,101,1,0,SAC,79,1,0,2,0
2011-12-27,LAL,96,0,2,UTA,71,0,0,0,2
2011-12-28,TOR,85,1,0,IND,90,1,0,2,0
2011-12-28,CHA,95,1,0,MIA,96,2,0,3,0
2011-12-28,ATL,101,1,0,WAS,83,0,1,1,1
2011-12-28,DET,89,0,1,CLE,105,0,1,0,2
2011-12-28,MEM,95,0,1,OKC,98,2,0,2,1
2011-12-28,NOH,97,1,0,BOS,78,0,2,1,2
2011-12-28,SAS,115,1,0,LAC,90,1,0,2,0
2011-12-28,DEN,117,1,0,UTA,100,0,1,1,1
2011-12-28,PHX,83,0,1,PHI,103,0,1,0,2
2011-12-28,GSW,92,1,1,NYK,78,1,0,2,1
2011-12-29,ORL,94,1,1,NJN,78,1,1,2,2
2011-12-29,HOU,105,0,1,SAS,85,2,0,2,1
2011-12-29,OKC,104,3,0,DAL,102,0,2,3,2
2011-12-29,SAC,98,1,1,CHI,108,1,1,2,2
2011-12-29,POR,111,2,0,DEN,102,2,0,4,0
2011-12-29,LAL,99,1,2,NYK,82,1,1,2,3
2011-12-30,CHA,79,1,1,ORL,100,2,1,3,2
2011-12-30,IND,98,2,0,CLE,91,1,1,3,1
2011-12-30,BOS,96,0,3,DET,85,0,2,0,5
2011-12-30,ATL,105,2,0,NJN,98,1,2,3,2
2011-12-30,MEM,113,0,2,HOU,93,1,1,1,3
2011-12-30,NOH,78,2,0,PHX,93,0,2,2,2
2011-12-30,MIN,101,0,2,MIA,103,3,0,3,2
2011-12-30,MIL,102,1,1,WAS,81,0,2,1,3
2011-12-30,DAL,99,0,3,TOR,86,1,1,1,4
2011-12-30,UTA,102,0,2,PHI,99,1,1,1,3
2011-12-30,LAC,101,1,1,CHI,114,2,1,3,2
2011-12-31,LAL,92,2,2,DEN,89,2,1,4,3
2011-12-31,DET,96,0,3,IND,88,3,0,3,3
2011-12-31,HOU,95,1,2,ATL,84,3,0,4,2
2011-12-31,OKC,107,4,0,PHX,97,1,2,5,2
2011-12-31,SAC,92,1,2,NYK,114,1,2,2,4
2011-12-31,SAS,104,2,1,UTA,89,1,2,3,3
2011-12-31,GSW,79,2,1,PHI,107,1,2,3,3
2012-01-01,WAS,86,0,3,BOS,94,1,3,1,6
2012-01-01,ORL,102,3,1,TOR,96,1,2,4,3
2012-01-01,MIA,129,4,0,CHA,90,1,2,5,2
2012-01-01,CLE,98,1,2,NJN,82,1,3,2,5
2012-01-01,MIN,99,0,3,DAL,82,1,3,1,6
2012-01-01,CHI,104,3,1,MEM,64,1,2,4,3
2012-01-01,DEN,99,2,2,LAL,90,3,2,5,4
2012-01-01,SAC,96,1,3,NOH,80,2,1,3,4
2012-01-01,LAC,93,1,2,POR,88,3,0,4,2
2012-01-02,PHX,102,1,3,GSW,91,2,2,3,5
2012-01-02,BOS,100,2,3,WAS,92,0,4,2,7
2012-01-02,NJN,94,1,4,IND,108,3,1,4,5
2012-01-02,NYK,85,2,2,TOR,90,1,3,3,5
2012-01-02,MIA,92,5,0,ATL,100,3,1,8,1
2012-01-02,DET,89,1,3,ORL,78,4,1,5,4
2012-01-02,MIN,106,1,3,SAS,96,3,1,4,4
2012-01-02,DAL,100,1,4,OKC,87,5,0,6,4
2012-01-02,DEN,91,3,2,MIL,86,2,1,5,3
2012-01-02,UTA,94,1,3,NOH,90,2,2,3,5
2012-01-03,CLE,115,2,2,CHA,101,1,3,3,5
2012-01-03,CHI,76,4,1,ATL,74,4,1,8,2
2012-01-03,MEM,113,1,3,SAC,96,2,3,3,6
2012-01-03,OKC,93,5,1,POR,103,3,1,8,2
2012-01-03,UTA,85,2,3,MIL,73,2,2,4,5
2012-01-03,LAL,108,3,3,HOU,99,2,2,5,5
2012-01-04,TOR,92,2,3,CLE,77,3,2,5,5
2012-01-04,ORL,103,4,2,WAS,85,0,5,4,7
2012-01-04,BOS,89,3,3,NJN,70,1,5,4,8
2012-01-04,NYK,110,2,3,CHA,118,1,4,3,7
2012-01-04,MIA,118,5,1,IND,83,4,1,9,2
2012-01-04,DET,83,2,3,CHI,99,5,1,7,4
2012-01-04,NOH,93,2,3,PHI,101,2,2,4,5
2012-01-04,MIN,86,2,3,MEM,90,2,3,4,6
2012-01-04,DAL,98,2,4,PHX,89,2,3,4,7
2012-01-04,SAS,101,3,2,GSW,95,2,3,5,5
2012-01-04,DEN,110,4,2,SAC,83,2,4,6,6
2012-01-04,LAC,117,2,2,HOU,89,2,3,4,5
2012-01-05,ATL,109,4,2,MIA,116,6,1,10,3
2012-01-05,SAS,93,4,2,DAL,71,3,4,7,6
2012-01-05,SAC,103,2,5,MIL,100,2,3,4,8
2012-01-05,POR,107,4,1,LAL,96,4,3,8,4
2012-01-06,TOR,85,3,3,NJN,97,1,6,4,9
2012-01-06,PHI,96,3,2,DET,73,2,4,5,6
2012-01-06,WAS,96,0,6,NYK,99,2,4,2,10
2012-01-06,CHA,96,2,4,ATL,102,4,3,6,7
2012-01-06,BOS,74,4,3,IND,87,4,2,8,5
2012-01-06,ORL,83,5,2,CHI,97,6,1,11,3
2012-01-06,NOH,88,2,4,DEN,96,5,2,7,6
2012-01-06,OKC,109,5,2,HOU,94,2,4,7,6
2012-01-06,MIN,87,2,4,CLE,98,3,3,5,7
2012-01-06,UTA,94,3,3,MEM,85,3,3,6,6
2012-01-06,PHX,102,2,4,POR,77,5,1,7,5
2012-01-06,LAL,97,4,4,GSW,90,2,4,6,8
2012-01-07,ATL,109,5,3,CHI,94,7,1,12,4
2012-01-07,IND,99,5,2,CHA,77,2,5,7,7
2012-01-07,NJN,90,2,6,MIA,101,7,1,9,7
2012-01-07,DET,80,2,5,NYK,103,3,4,5,9
2012-01-07,PHI,97,4,2,TOR,62,3,4,7,6
2012-01-07,HOU,95,2,5,OKC,98,6,2,8,7
2012-01-07,SAS,121,5,2,DEN,117,6,2,11,4
2012-01-07,DAL,96,3,5,NOH,81,2,5,5,10
2012-01-07,LAC,92,3,2,MIL,86,2,4,5,6
2012-01-07,GSW,87,2,5,UTA,88,4,3,6,8
2012-01-08,WAS,72,0,7,MIN,93,2,5,2,12
2012-01-08,SAC,97,3,5,ORL,104,5,3,8,8
2012-01-08,OKC,108,7,2,SAS,96,6,2,13,4
2012-01-08,PHX,109,3,4,MIL,93,2,5,5,9
2012-01-08,POR,98,5,2,CLE,78,4,3,9,5
2012-01-08,LAL,90,5,4,MEM,82,3,4,8,8
2012-01-09,TOR,97,3,5,MIN,87,3,5,6,10
2012-01-09,PHI,96,5,2,IND,86,6,2,11,4
2012-01-09,NJN,101,2,7,ATL,106,6,3,8,10
2012-01-09,NYK,91,4,4,CHA,87,2,6,6,10
2012-01-09,CHI,92,7,2,DET,68,2,6,9,8
2012-01-09,DEN,81,6,3,NOH,94,2,6,8,9
2012-01-10,PHI,112,6,2,SAC,85,3,6,9,8
2012-01-10,WAS,93,0,8,TOR,78,4,5,4,13
2012-01-10,CHA,70,2,7,HOU,82,2,6,4,13
2012-01-10,DET,86,2,7,DAL,100,4,5,6,12
2012-01-10,MIL,106,2,6,SAS,103,6,3,8,9
2012-01-10,MEM,95,3,5,OKC,100,8,2,11,7
2012-01-10,MIN,100,3,6,CHI,111,8,2,11,8
2012-01-10,UTA,113,5,3,CLE,105,4,4,9,7
2012-01-10,POR,105,6,2,LAC,97,4,2,10,4
2012-01-10,LAL,99,6,4,PHX,83,4,4,10,8
2012-01-10,GSW,111,2,6,MIA,106,8,1,10,7
2012-01-11,TOR,91,4,6,SAC,98,3,7,7,13
2012-01-11,IND,96,6,3,ATL,84,7,3,13,6
2012-01-11,NYK,85,5,4,PHI,79,7,2,12,6
2012-01-11,BOS,85,4,4,DAL,90,5,5,9,9
2012-01-11,CHI,78,9,2,WAS,64,1,8,10,10
2012-01-11,NOH,85,3,6,OKC,95,9,2,12,8
2012-01-11,SAS,101,6,4,HOU,95,3,6,9,10
2012-01-11,DEN,123,6,4,NJN,115,2,8,8,12
2012-01-11,UTA,87,6,3,LAL,90,7,4,13,7
2012-01-11,POR,104,7,2,ORL,107,6,3,13,5
2012-01-11,LAC,95,4,3,MIA,89,8,2,12,5
2012-01-12,ATL,111,7,4,CHA,81,2,8,9,12
2012-01-12,MIL,102,3,6,DET,93,2,8,5,14
2012-01-12,MEM,94,3,6,NYK,83,6,4,9,10
2012-01-12,PHX,90,4,5,CLE,101,4,5,8,10
2012-01-12,GSW,109,3,6,ORL,117,7,3,10,9
2012-01-13,TOR,90,4,7,IND,95,7,3,11,10
2012-01-13,PHI,120,7,3,WAS,89,1,9,8,12
2012-01-13,CHA,81,2,9,DET,98,2,9,4,18
2012-01-13,BOS,79,4,5,CHI,88,10,2,14,7
2012-01-13,NOH,80,3,7,MIN,87,3,7,6,14
2012-01-13,HOU,103,3,7,SAC,89,4,7,7,14
2012-01-13,DAL,102,6,5,MIL,76,4,6,10,11
2012-01-13,SAS,99,7,4,POR,83,7,3,14,7
2012-01-13,PHX,103,4,6,NJN,110,2,9,6,15
2012-01-13,DEN,117,7,4,MIA,104,8,3,15,7
2012-01-13,LAL,97,8,4,CLE,92,5,5,13,9
2012-01-14,WAS,90,1,10,PHI,103,8,3,9,13
2012-01-14,CHA,112,2,10,GSW,100,3,7,5,17
2012-01-14,ATL,93,8,4,MIN,91,4,7,12,11
2012-01-14,IND,97,8,3,BOS,83,4,6,12,9
2012-01-14,CHI,77,11,2,TOR,64,4,8,15,10
2012-01-14,MEM,108,4,6,NOH,99,3,8,7,14
2012-01-14,HOU,107,4,7,POR,105,7,4,11,11
2012-01-14,OKC,104,10,2,NYK,92,6,5,16,7
2012-01-14,DAL,99,7,5,SAC,60,4,8,11,13
2012-01-14,UTA,107,6,4,NJN,94,3,9,9,13
2012-01-14,LAC,102,5,3,LAL,94,9,4,14,7
2012-01-15,DET,91,3,9,GSW,99,3,8,6,17
2012-01-15,DEN,96,8,4,UTA,106,7,4,15,8
2012-01-15,SAS,102,8,4,PHX,91,4,7,12,11
2012-01-16,NYK,93,6,6,ORL,102,8,3,14,9
2012-01-16,MEM,102,5,6,CHI,86,12,2,17,8
2012-01-16,PHI,94,9,3,MIL,82,4,7,13,10
2012-01-16,WAS,106,1,11,HOU,114,5,7,6,18
2012-01-16,CHA,94,3,10,CLE,102,5,6,8,16
2012-01-16,ATL,93,9,4,TOR,84,4,9,13,13
2012-01-16,NOH,77,3,9,POR,84,7,5,10,14
2012-01-16,LAC,101,6,3,NJN,91,3,10,9,13
2012-01-16,BOS,88,4,7,OKC,97,11,2,15,9
2012-01-16,MIN,99,4,8,SAC,86,4,9,8,17
2012-01-16,LAL,73,9,5,DAL,70,8,5,17,10
2012-01-17,ORL,96,9,3,CHA,89,3,11,12,14
2012-01-17,CLE,95,6,6,GSW,105,4,8,10,14
2012-01-17,MIA,120,8,4,SAS,98,9,4,17,8
2012-01-17,CHI,118,12,3,PHX,97,4,8,16,11
2012-01-17,MIL,95,4,8,DEN,105,8,5,12,13
2012-01-17,HOU,97,6,7,DET,80,3,10,9,17
2012-01-17,UTA,108,8,4,LAC,79,7,3,15,7
2012-01-18,PHI,104,10,3,DEN,108,9,5,19,8
2012-01-18,WAS,105,1,12,OKC,102,12,2,13,14
2012-01-18,ORL,83,10,3,SAS,85,9,5,19,8
2012-01-18,BOS,96,4,8,TOR,73,4,10,8,18
2012-01-18,NJN,107,3,11,GSW,100,5,8,8,19
2012-01-18,NYK,88,6,7,PHX,91,4,9,10,16
2012-01-18,ATL,92,10,4,POR,89,8,5,18,9
2012-01-18,NOH,87,3,10,MEM,93,6,6,9,16
2012-01-18,MIN,93,5,8,DET,85,3,11,8,19
2012-01-18,SAC,92,4,10,IND,88,9,3,13,13
2012-01-18,LAC,91,7,4,DAL,89,8,6,15,10
2012-01-19,MIA,98,9,4,LAL,87,10,5,19,9
2012-01-19,HOU,90,7,7,NOH,88,3,11,10,18
2012-01-19,UTA,91,9,4,DAL,94,8,7,17,11
2012-01-20,TOR,84,4,11,POR,94,8,6,12,17
2012-01-20,PHI,90,10,4,ATL,76,11,4,21,8
2012-01-20,WAS,104,2,12,DEN,108,10,5,12,17
2012-01-20,BOS,71,5,8,PHX,79,5,9,10,17
2012-01-20,NYK,86,6,8,MIL,100,4,9,10,17
2012-01-20,DET,81,3,12,MEM,98,7,6,10,18
2012-01-20,CLE,75,6,7,CHI,114,13,3,19,10
2012-01-20,ORL,92,10,4,LAL,80,10,6,20,10
2012-01-20,SAS,86,10,5,SAC,88,5,10,15,15
2012-01-20,LAC,98,8,4,MIN,101,6,8,14,12
2012-01-20,GSW,91,5,9,IND,94,9,4,14,13
2012-01-21,ATL,121,11,5,CLE,94,6,8,17,13
2012-01-21,NYK,114,6,9,DEN,119,11,5,17,14
2012-01-21,MIA,113,10,4,PHI,92,11,4,21,8
2012-01-21,DET,94,3,13,POR,91,9,6,12,19
2012-01-21,NJN,74,4,11,OKC,84,12,3,16,14
2012-01-21,CHI,95,14,3,CHA,89,3,12,17,15
2012-01-21,MEM,128,8,6,SAC,95,6,10,14,16
2012-01-21,NOH,81,3,12,DAL,83,9,7,12,19
2012-01-21,HOU,105,8,7,SAS,102,10,6,18,13
2012-01-21,UTA,108,9,5,MIN,98,7,8,16,13
2012-01-22,WAS,94,2,13,BOS,100,5,9,7,22
2012-01-22,LAC,103,8,5,TOR,91,4,12,12,17
2012-01-22,NJN,97,4,12,CHA,87,3,13,7,25
2012-01-22,MIA,82,11,4,MIL,91,5,9,16,13
2012-01-22,LAL,96,10,7,IND,98,10,4,20,11
2012-01-23,PHI,103,11,5,WAS,83,2,14,13,19
2012-01-23,BOS,87,6,9,ORL,56,11,4,17,13
2012-01-23,CHI,110,15,3,NJN,95,5,12,20,15
2012-01-23,MIL,92,6,9,ATL,97,12,5,18,14
2012-01-23,NOH,102,3,13,SAS,104,10,7,13,20
2012-01-23,OKC,99,13,3,DET,79,4,13,17,16
2012-01-23,MIN,92,7,9,HOU,107,9,7,16,16
2012-01-23,DAL,93,10,7,PHX,87,6,9,16,16
2012-01-23,POR,101,9,7,SAC,89,6,11,15,18
2012-01-23,GSW,90,5,10,MEM,91,9,6,14,16
2012-01-24,CHA,78,3,14,NYK,111,6,10,9,24
2012-01-24,IND,83,11,4,ORL,102,11,5,22,9
2012-01-24,MIA,92,11,5,CLE,85,6,9,17,14
2012-01-24,PHX,96,6,10,TOR,99,4,13,10,23
2012-01-24,POR,97,10,7,MEM,84,10,6,20,13
2012-01-25,PHI,90,12,5,NJN,97,5,13,17,18
2012-01-25,WAS,92,2,15,CHA,75,3,15,5,30
2012-01-25,CLE,91,6,10,NYK,81,7,10,13,20
2012-01-25,DET,98,4,14,MIA,101,12,5,16,19
2012-01-25,CHI,90,16,3,IND,95,11,5,27,8
2012-01-25,HOU,99,10,7,MIL,105,6,10,16,17
2012-01-25,OKC,101,14,3,NOH,91,3,14,17,17
2012-01-25,DAL,90,11,7,MIN,105,7,10,18,17
2012-01-25,SAS,105,11,7,ATL,83,13,5,24,12
2012-01-25,UTA,106,10,5,TOR,111,5,13,15,18
2012-01-25,SAC,93,6,12,DEN,122,12,5,18,17
2012-01-25,LAL,96,10,8,LAC,91,9,5,19,13
2012-01-25,GSW,101,5,11,POR,93,11,7,16,18
2012-01-26,ORL,83,12,5,BOS,91,7,9,19,14
2012-01-26,LAC,98,9,6,MEM,91,10,7,19,13
2012-01-27,PHI,89,12,6,CHA,72,3,16,15,22
2012-01-27,BOS,94,8,9,IND,87,12,5,20,14
2012-01-27,DET,101,4,15,ATL,107,13,6,17,21
2012-01-27,CLE,96,7,10,NJN,99,6,13,13,23
2012-01-27,MIA,99,13,5,NYK,89,7,11,20,16
2012-01-27,CHI,107,16,4,MIL,100,7,10,23,14
2012-01-27,NOH,93,3,15,ORL,67,12,6,15,21
2012-01-27,HOU,103,10,8,WAS,76,3,15,13,23
2012-01-27,MIN,87,8,10,SAS,79,12,7,20,17
2012-01-27,DAL,116,11,8,UTA,101,10,6,21,14
2012-01-27,DEN,96,13,5,TOR,81,6,13,19,18
2012-01-27,POR,109,11,8,PHX,71,6,11,17,19
2012-01-27,GSW,109,6,11,OKC,120,15,3,21,14
2012-01-28,PHI,95,13,6,DET,74,4,16,17,22
2012-01-28,CHA,99,3,17,WAS,102,3,16,6,33
2012-01-28,HOU,97,11,8,NYK,84,7,12,18,20
2012-01-28,MIL,100,7,11,LAL,89,11,8,18,19
2012-01-28,UTA,96,10,7,SAC,93,6,13,16,20
2012-01-28,PHX,86,6,12,MEM,84,10,8,16,20
2012-01-29,MIA,97,14,5,CHI,93,17,4,31,9
2012-01-29,BOS,87,9,9,CLE,88,7,11,16,20
2012-01-29,NJN,73,7,13,TOR,94,6,14,13,27
2012-01-29,ORL,85,12,7,IND,106,12,6,24,13
2012-01-29,DAL,101,12,8,SAS,100,12,8,24,16
2012-01-29,NOH,72,4,15,ATL,94,14,6,18,21
2012-01-29,MIN,101,9,10,LAL,106,11,9,20,19
2012-01-29,DEN,105,14,5,LAC,109,10,6,24,11
2012-01-30,PHI,74,14,6,ORL,69,12,8,26,14
2012-01-30,WAS,88,4,16,CHI,98,17,5,21,21
2012-01-30,MIA,109,15,5,NOH,95,4,16,19,21
2012-01-30,MIL,103,8,11,DET,82,4,17,12,28
2012-01-30,MEM,73,10,9,SAS,83,12,9,22,18
2012-01-30,HOU,108,12,8,MIN,120,9,11,21,19
2012-01-30,UTA,93,11,7,POR,89,12,8,23,15
2012-01-30,PHX,99,7,12,DAL,122,13,8,20,20
2012-01-30,LAC,112,11,6,OKC,100,16,3,27,9
2012-01-31,TOR,77,7,14,ATL,100,15,6,22,20
2012-01-31,CLE,90,8,11,BOS,93,9,10,17,21
2012-01-31,IND,106,13,6,NJN,99,7,14,20,20
2012-01-31,NYK,113,7,13,DET,86,4,18,11,31
2012-01-31,MEM,100,10,10,DEN,97,14,6,24,16
2012-01-31,LAL,106,12,9,CHA,73,3,18,15,27
2012-01-31,GSW,93,6,12,SAC,90,6,14,12,26
2012-02-01,PHI,98,15,6,CHI,82,18,5,33,11
2012-02-01,ORL,109,12,9,WAS,103,4,17,16,26
2012-02-01,BOS,100,10,10,TOR,64,7,15,17,25
2012-02-01,NJN,99,7,15,DET,96,4,19,11,34
2012-02-01,MIL,105,9,11,MIA,97,16,5,25,16
2012-02-01,NOH,103,4,17,PHX,120,7,13,11,30
2012-02-01,DAL,86,14,8,OKC,95,16,4,30,12
2012-02-01,MIN,99,10,11,IND,109,14,6,24,17
2012-02-01,SAS,99,13,9,HOU,91,12,9,25,18
2012-02-01,POR,112,12,9,CHA,68,3,19,15,28
2012-02-01,UTA,105,12,7,LAC,107,12,6,24,13
2012-02-02,ATL,77,16,6,MEM,96,11,10,27,16
2012-02-02,NYK,102,8,13,CHI,105,18,6,26,19
2012-02-02,SAS,93,14,9,NOH,81,4,18,18,27
2012-02-02,SAC,95,6,15,POR,92,13,9,19,24
2012-02-02,LAC,91,13,6,DEN,112,14,7,27,13
2012-02-02,GSW,119,7,12,UTA,101,12,8,19,20
2012-02-03,TOR,106,7,16,WAS,89,4,18,11,34
2012-02-03,PHI,79,16,6,MIA,99,16,6,32,12
2012-02-03,ORL,102,13,9,CLE,94,8,12,21,21
2012-02-03,NJN,105,8,15,MIN,108,10,12,18,27
2012-02-03,DET,88,4,20,MIL,80,10,11,14,31
2012-02-03,BOS,91,11,10,NYK,89,8,14,19,24
2012-02-03,HOU,99,12,10,PHX,81,8,13,20,23
2012-02-03,OKC,101,17,4,MEM,94,12,10,29,14
2012-02-03,DAL,87,14,9,IND,98,15,6,29,15
2012-02-03,DEN,89,15,7,LAL,93,13,9,28,16
2012-02-04,WAS,81,4,19,LAC,107,13,7,17,26
2012-02-04,ATL,87,16,7,PHI,98,16,7,32,14
2012-02-04,IND,81,16,6,ORL,85,14,9,30,15
2012-02-04,NYK,99,8,15,NJN,92,8,16,16,31
2012-02-04,DET,89,5,20,NOH,87,4,19,9,39
2012-02-04,CLE,91,8,13,DAL,88,14,10,22,23
2012-02-04,MIN,100,11,12,HOU,91,13,10,24,22
2012-02-04,MIL,90,10,12,CHI,113,19,6,29,18
2012-02-04,SAS,107,15,9,OKC,96,18,4,33,13
2012-02-04,UTA,96,12,9,LAL,87,14,9,26,18
2012-02-04,PHX,95,8,14,CHA,89,3,20,11,34
2012-02-04,SAC,114,7,15,GSW,106,8,12,15,27
2012-02-04,POR,117,13,10,DEN,97,15,8,28,18
2012-02-05,BOS,98,12,10,MEM,80,12,11,24,21
2012-02-05,MIA,95,17,6,TOR,89,8,16,25,22
2012-02-06,PHI,95,17,7,LAL,90,14,10,31,17
2012-02-06,WAS,111,4,20,TOR,108,8,17,12,37
2012-02-06,ORL,102,15,9,LAC,107,14,7,29,16
2012-02-06,NJN,87,8,17,CHI,108,20,6,28,23
2012-02-06,NYK,99,9,15,UTA,88,13,9,22,24
2012-02-06,ATL,90,16,8,PHX,99,9,14,25,22
2012-02-06,MEM,84,12,12,SAS,89,16,9,28,21
2012-02-06,NOH,92,4,20,SAC,100,8,15,12,35
2012-02-06,DEN,90,15,9,HOU,99,13,11,28,20
2012-02-06,POR,107,14,10,OKC,111,18,5,32,15
2012-02-07,IND,104,16,7,UTA,99,13,10,29,17
2012-02-07,BOS,94,13,10,CHA,84,3,21,16,31
2012-02-07,MIA,107,18,6,CLE,91,9,13,27,19
2012-02-07,MIL,105,10,13,PHX,107,10,14,20,27
2012-02-07,MIN,86,12,12,SAC,84,9,15,21,27
2012-02-07,GSW,116,8,13,OKC,119,19,5,27,18
2012-02-08,TOR,99,8,18,MIL,105,10,14,18,32
2012-02-08,PHI,90,18,7,SAS,100,17,9,35,16
2012-02-08,WAS,93,5,20,NYK,107,10,15,15,35
2012-02-08,ORL,102,15,10,MIA,89,19,6,34,16
2012-02-08,CLE,99,9,14,LAC,92,15,7,24,21
2012-02-08,NJN,92,8,18,DET,99,6,20,14,38
2012-02-08,ATL,97,16,9,IND,87,17,7,33,16
2012-02-08,MEM,85,12,13,MIN,80,13,12,25,25
2012-02-08,NOH,67,4,21,CHI,90,21,6,25,27
2012-02-08,DEN,95,15,10,DAL,105,14,11,29,21
2012-02-08,POR,96,14,11,HOU,103,14,11,28,22
2012-02-09,BOS,87,14,10,LAL,88,14,11,28,21
2012-02-09,DEN,101,15,11,GSW,109,8,14,23,25
2012-02-09,PHX,89,11,14,HOU,96,15,11,26,25
2012-02-09,SAC,106,9,16,OKC,101,20,5,29,21
2012-02-10,TOR,86,8,19,BOS,74,14,11,22,30
2012-02-10,PHI,77,18,8,LAC,78,15,8,33,16
2012-02-10,WAS,89,5,21,MIA,106,19,7,24,28
2012-02-10,CHA,64,3,22,CHI,95,22,6,25,28
2012-02-10,ORL,87,16,10,ATL,89,17,9,33,19
2012-02-10,DET,109,7,20,NJN,92,8,19,15,39
2012-02-10,CLE,112,10,14,MIL,113,11,14,21,28
2012-02-10,NYK,92,11,15,LAL,85,15,11,26,26
2012-02-10,MEM,98,13,13,IND,92,17,8,30,21
2012-02-10,NOH,86,4,22,POR,94,14,12,18,34
2012-02-10,MIN,97,13,13,DAL,104,15,11,28,24
2012-02-10,UTA,87,13,11,OKC,101,20,6,33,17
2012-02-11,CHA,86,3,23,LAC,111,16,8,19,31
2012-02-11,IND,109,17,9,DEN,113,15,12,32,21
2012-02-11,CLE,84,10,15,PHI,99,18,9,28,24
2012-02-11,NJN,89,8,20,SAS,103,18,9,26,29
2012-02-11,MIN,98,13,14,NYK,100,12,15,25,29
2012-02-11,DAL,97,16,11,POR,94,15,12,31,23
2012-02-11,MIL,94,12,14,ORL,99,16,11,28,25
2012-02-11,SAC,84,10,16,PHX,98,11,15,21,31
2012-02-12,TOR,92,9,19,LAL,94,15,12,24,31
2012-02-12,BOS,95,14,12,CHI,91,23,6,37,18
2012-02-12,DET,77,8,20,WAS,98,5,22,13,42
2012-02-12,ATL,87,18,9,MIA,107,20,7,38,16
2012-02-12,GSW,106,9,14,HOU,97,16,11,25,25
2012-02-12,MEM,88,14,13,UTA,98,13,12,27,25
2012-02-13,CHA,89,3,24,PHI,98,19,9,22,33
2012-02-13,ORL,102,17,11,MIN,89,13,15,30,26
2012-02-13,MIL,96,12,15,MIA,114,21,7,33,22
2012-02-13,NOH,86,4,23,UTA,80,14,12,18,35
2012-02-13,DAL,96,17,11,LAC,92,17,8,34,19
2012-02-13,GSW,102,10,14,PHX,96,12,15,22,29
2012-02-14,TOR,87,9,20,NYK,90,13,15,22,35
2012-02-14,IND,90,17,10,MIA,105,22,7,39,17
2012-02-14,DET,95,8,21,SAS,99,19,9,27,30
2012-02-14,CHI,121,23,7,SAC,115,10,17,33,24
2012-02-14,MEM,93,14,14,HOU,83,16,12,30,26
2012-02-14,OKC,111,21,6,UTA,85,14,13,35,19
2012-02-14,DEN,109,16,12,PHX,92,12,16,28,28
2012-02-14,POR,109,15,13,WAS,124,6,22,21,35
2012-02-14,LAL,86,16,12,ATL,78,18,10,34,22
2012-02-15,TOR,106,9,21,SAS,113,20,9,29,30
2012-02-15,ORL,103,18,11,PHI,87,20,9,38,20
2012-02-15,BOS,88,15,12,DET,98,8,22,23,34
2012-02-15,NJN,100,8,21,MEM,105,15,14,23,35
2012-02-15,NYK,100,14,15,SAC,85,10,18,24,33
2012-02-15,CLE,98,10,16,IND,87,17,11,27,27
2012-02-15,MIL,89,12,16,NOH,92,5,23,17,39
2012-02-15,HOU,96,16,13,OKC,95,22,6,38,19
2012-02-15,MIN,102,13,16,CHA,90,3,25,16,41
2012-02-15,DAL,102,18,11,DEN,84,17,12,35,23
2012-02-15,PHX,99,12,17,ATL,101,18,11,30,28
2012-02-15,GSW,91,11,14,POR,93,15,14,26,28
2012-02-15,LAC,102,17,9,WAS,84,7,22,24,31
2012-02-16,IND,93,17,12,NJN,88,8,22,25,34
2012-02-16,CHI,89,24,7,BOS,80,15,13,39,20
2012-02-16,POR,71,16,14,LAC,74,18,9,34,23
2012-02-17,TOR,91,9,22,CHA,98,3,26,12,48
2012-02-17,PHI,75,20,10,DAL,82,19,11,39,21
2012-02-17,ORL,94,19,11,MIL,85,12,17,31,28
2012-02-17,DET,114,9,22,SAC,108,10,19,19,41
2012-02-17,CLE,87,11,16,MIA,111,23,7,34,23
2012-02-17,NYK,85,15,15,NOH,89,6,23,21,38
2012-02-17,MEM,103,16,14,DEN,102,17,13,33,27
2012-02-17,HOU,98,17,13,MIN,111,14,16,31,29
2012-02-17,OKC,110,22,7,GSW,87,11,15,33,22
2012-02-17,UTA,114,14,14,WAS,100,7,23,21,37
2012-02-17,LAL,111,17,12,PHX,99,12,18,29,30
2012-02-18,LAC,100,19,9,SAS,103,21,9,40,18
2012-02-18,CHI,85,25,7,NJN,97,8,23,33,30
2012-02-18,MEM,104,17,14,GSW,103,11,16,28,30
2012-02-18,POR,97,16,15,ATL,77,19,11,35,26
2012-02-19,NYK,104,15,16,DAL,97,20,11,35,27
2012-02-19,MIA,90,24,7,ORL,78,20,11,44,18
2012-02-19,DET,96,10,22,BOS,81,15,14,25,36
2012-02-19,CLE,93,11,17,SAC,92,10,20,21,37
2012-02-19,IND,108,18,12,CHA,73,4,26,22,38
2012-02-19,NJN,85,9,23,MIL,92,12,18,21,41
2012-02-19,HOU,101,17,14,UTA,85,15,14,32,28
2012-02-19,MIN,92,15,16,PHI,91,20,11,35,27
2012-02-19,OKC,124,23,7,DEN,118,17,14,40,21
2012-02-19,PHX,102,12,19,LAL,90,18,12,30,31
2012-02-20,CHI,90,25,8,ATL,79,19,12,44,20
2012-02-20,NYK,92,16,16,NJN,100,9,24,25,40
2012-02-20,MIL,90,13,18,ORL,93,20,12,33,30
2012-02-20,HOU,97,18,14,MEM,93,18,14,36,28
2012-02-20,DAL,89,20,12,BOS,73,15,15,35,27
2012-02-20,OKC,101,24,7,NOH,93,7,23,31,30
2012-02-20,DEN,103,17,15,MIN,101,16,16,33,31
2012-02-20,UTA,102,15,15,SAS,106,22,9,37,24
2012-02-20,PHX,104,13,19,WAS,88,7,24,20,43
2012-02-20,LAL,103,18,13,POR,92,17,15,35,28
2012-02-20,GSW,104,11,17,LAC,97,19,10,30,27
2012-02-21,CLE,101,12,17,DET,100,11,22,23,39
2012-02-21,IND,117,19,12,NOH,108,7,24,26,36
2012-02-21,MIA,120,25,7,SAC,108,10,21,35,28
2012-02-21,MEM,89,18,15,PHI,76,20,12,38,27
2012-02-21,POR,137,17,16,SAS,97,23,9,40,25
2012-02-22,TOR,103,9,23,DET,93,11,23,20,46
2012-02-22,WAS,107,7,25,SAC,115,10,22,17,47
2012-02-22,CHA,88,4,27,IND,102,20,12,24,39
2012-02-22,CLE,84,13,17,NOH,89,7,25,20,42
2012-02-22,OKC,119,25,7,BOS,104,15,16,40,23
2012-02-22,NJN,91,10,24,ORL,108,21,12,31,36
2012-02-22,NYK,99,16,17,ATL,82,19,13,35,30
2012-02-22,CHI,110,26,8,MIL,91,13,19,39,27
2012-02-22,HOU,93,19,14,PHI,87,20,13,39,27
2012-02-22,MIN,100,16,17,UTA,98,15,16,31,33
2012-02-22,PHX,104,14,19,GSW,106,12,17,26,36
2012-02-22,DAL,91,21,12,LAL,96,19,13,40,25
2012-02-22,LAC,103,19,11,DEN,95,18,15,37,26
2012-02-23,MIA,102,26,7,NYK,88,17,17,43,24
2012-02-23,ATL,83,19,14,ORL,78,22,12,41,26
2012-02-23,DEN,99,18,16,SAS,114,23,10,41,26
2012-02-23,OKC,100,26,7,LAL,85,20,13,46,20
2012-02-28,CLE,83,13,18,BOS,86,15,17,28,35
2012-02-28,IND,102,21,12,GSW,78,13,17,34,29
2012-02-28,DET,68,11,24,PHI,97,20,14,31,38
2012-02-28,CHI,99,27,8,NOH,95,8,25,35,33
2012-02-28,MIL,119,13,20,WAS,118,7,26,20,46
2012-02-28,HOU,88,20,14,TOR,85,10,23,30,37
2012-02-28,DAL,92,21,13,NJN,93,10,25,31,38
2012-02-28,SAC,103,11,22,UTA,96,15,17,26,39
2012-02-28,LAC,97,20,11,MIN,109,17,17,37,28
2012-02-29,PHI,88,21,14,OKC,92,27,7,48,21
2012-02-29,WAS,95,7,27,ORL,102,22,13,29,40
2012-02-29,BOS,102,16,17,MIL,96,14,20,30,37
2012-02-29,NYK,120,17,18,CLE,103,13,19,30,37
2012-02-29,ATL,82,20,14,GSW,85,13,18,33,32
2012-02-29,DET,109,11,25,CHA,94,4,28,15,53
2012-02-29,MEM,96,19,15,DAL,85,21,14,40,29
2012-02-29,NOH,84,8,26,TOR,95,10,24,18,50
2012-02-29,SAS,89,24,10,CHI,96,28,8,52,18
2012-02-29,DEN,104,18,17,POR,95,18,16,36,33
2012-02-29,UTA,104,15,18,HOU,83,21,14,36,32
2012-02-29,LAL,104,20,14,MIN,85,18,17,38,31
2012-03-01,ORL,102,23,13,OKC,105,28,7,51,20
2012-03-01,PHX,104,14,20,MIN,95,18,18,32,38
2012-03-01,SAC,100,12,22,LAC,108,20,12,32,34
2012-03-01,POR,93,18,17,MIA,107,27,7,45,24
2012-03-02,TOR,99,11,24,MEM,102,20,15,31,39
2012-03-02,BOS,107,17,17,NJN,94,11,25,28,42
2012-03-02,ATL,99,20,15,MIL,94,14,21,34,36
2012-03-02,CLE,91,13,20,CHI,112,29,8,42,28
2012-03-02,PHI,105,21,15,GSW,83,14,18,35,33
2012-03-02,NOH,97,8,27,DAL,92,21,15,29,42
2012-03-02,HOU,105,21,15,DEN,117,19,17,40,32
2012-03-02,SAS,102,24,11,CHA,72,4,29,28,40
2012-03-02,UTA,99,16,18,MIA,98,28,7,44,25
2012-03-02,PHX,81,15,20,LAC,78,21,12,36,32
2012-03-02,LAL,115,21,14,SAC,107,12,23,33,37
2012-03-03,WAS,101,7,28,CLE,98,13,21,20,49
2012-03-03,ATL,97,21,15,OKC,90,29,7,50,22
2012-03-03,ORL,114,23,14,MIL,98,14,22,37,36
2012-03-03,MEM,100,21,15,DET,83,12,25,33,40
2012-03-03,NOH,84,9,27,IND,102,22,12,31,39
2012-03-03,DAL,102,21,16,UTA,96,17,18,38,34
2012-03-03,POR,110,18,18,MIN,122,18,19,36,37
2012-03-04,BOS,115,18,17,NYK,111,18,18,36,35
2012-03-04,LAL,93,22,14,MIA,83,28,8,50,22
2012-03-04,TOR,83,11,25,GSW,75,14,19,25,44
2012-03-04,CHA,101,4,30,NJN,104,11,26,15,56
2012-03-04,PHI,91,22,15,CHI,96,30,8,52,23
2012-03-04,HOU,103,21,16,LAC,105,21,13,42,29
2012-03-04,PHX,96,16,20,SAC,88,12,24,28,44
2012-03-04,SAS,94,25,11,DEN,99,20,17,45,28
2012-03-05,TOR,88,12,25,ORL,92,24,14,36,39
2012-03-05,WAS,100,8,28,GSW,120,14,20,22,48
2012-03-05,CLE,100,13,22,UTA,109,17,19,30,41
2012-03-05,CHI,92,31,8,IND,72,23,12,54,20
2012-03-05,MIL,97,14,23,PHI,93,22,16,36,39
2012-03-05,OKC,95,29,8,DAL,91,22,16,51,24
2012-03-05,MIN,95,19,19,LAC,94,22,13,41,32
2012-03-05,DEN,119,21,17,SAC,116,12,25,33,42
2012-03-05,POR,86,18,19,NOH,74,9,28,27,47
2012-03-06,CHA,100,4,31,ORL,84,25,14,29,45
2012-03-06,IND,96,23,13,ATL,101,22,15,45,28
2012-03-06,BOS,97,19,17,HOU,92,21,17,40,34
2012-03-06,MIA,108,28,9,NJN,78,12,26,40,35
2012-03-06,DET,88,12,26,LAL,85,23,14,35,40
2012-03-06,DAL,95,22,17,NYK,85,18,19,40,36
2012-03-07,TOR,116,12,26,HOU,98,21,18,33,44
2012-03-07,PHI,103,22,17,BOS,71,20,17,42,34
2012-03-07,WAS,106,8,29,LAL,101,23,15,31,44
2012-03-07,CHA,93,5,31,UTA,99,18,19,23,50
2012-03-07,MIA,89,29,9,ATL,86,23,15,52,24
2012-03-07,NJN,101,12,27,LAC,100,22,14,34,41
2012-03-07,MIL,104,15,23,CHI,106,32,8,47,31
2012-03-07,OKC,115,30,8,PHX,104,17,20,47,28
2012-03-07,MIN,106,20,19,POR,94,19,19,39,38
2012-03-07,SAS,118,25,12,NYK,105,18,20,43,32
2012-03-07,DEN,99,22,17,CLE,100,13,23,35,40
2012-03-07,SAC,99,12,26,NOH,98,9,29,21,55
2012-03-07,GSW,92,15,20,MEM,110,22,15,37,35
2012-03-08,CHI,94,33,8,ORL,99,25,15,58,23
2012-03-08,PHX,96,17,21,DAL,94,23,17,40,38
2012-03-09,PHI,104,23,17,UTA,91,19,19,42,36
2012-03-09,CHA,74,5,32,NJN,83,13,27,18,59
2012-03-09,BOS,104,20,18,POR,86,19,20,39,38
2012-03-09,DET,86,13,26,ATL,85,23,16,36,42
2012-03-09,OKC,90,31,8,CLE,96,14,23,45,31
2012-03-09,MIN,102,21,19,LAL,105,23,16,44,35
2012-03-09,MIL,119,15,24,NYK,114,18,21,33,45
2012-03-09,SAS,108,26,12,LAC,120,22,15,48,27
2012-03-09,DEN,110,22,18,NOH,97,9,30,31,48
2012-03-09,SAC,110,13,26,DAL,97,23,18,36,44
2012-03-10,WAS,99,9,29,POR,110,19,21,28,50
2012-03-10,MIA,93,30,9,IND,91,23,14,53,23
2012-03-10,DET,105,14,26,TOR,86,13,26,27,52
2012-03-10,NJN,106,14,27,HOU,112,21,19,35,46
2012-03-10,CHI,111,33,9,UTA,97,19,20,52,29
2012-03-10,OKC,122,31,9,CHA,95,5,33,36,42
2012-03-10,MIN,89,21,20,NOH,95,9,31,30,51
2012-03-10,PHX,98,18,21,MEM,91,23,15,41,36
2012-03-10,GSW,111,15,21,DAL,87,23,19,38,40
2012-03-11,NYK,94,18,22,PHI,106,24,17,42,39
2012-03-11,LAL,97,24,16,BOS,94,21,18,45,34
2012-03-11,TOR,99,13,27,MIL,105,16,24,29,51
2012-03-11,ORL,107,26,15,IND,94,23,15,49,30
2012-03-11,CLE,118,15,23,HOU,107,22,19,37,42
2012-03-11,DEN,91,23,18,MEM,94,23,16,46,34
2012-03-11,SAC,99,14,26,ATL,106,23,17,37,43
2012-03-11,LAC,93,23,15,GSW,97,16,21,39,36
2012-03-12,NJN,99,14,28,MIL,105,17,24,31,52
2012-03-12,CHI,104,34,9,NYK,99,18,23,52,32
2012-03-12,NOH,71,10,31,CHA,73,5,34,15,65
2012-03-12,SAS,112,26,13,WAS,97,9,30,35,43
2012-03-12,UTA,105,19,21,DET,90,15,26,34,47
2012-03-12,PHX,124,19,21,MIN,127,21,21,40,42
2012-03-12,LAC,85,23,16,BOS,94,21,19,44,35
2012-03-13,ORL,104,27,15,MIA,98,31,9,58,24
2012-03-13,CLE,88,16,23,TOR,96,13,28,29,51
2012-03-13,IND,92,23,16,POR,75,20,21,43,37
2012-03-13,MEM,111,24,16,LAL,116,25,16,49,32
2012-03-13,OKC,103,32,9,HOU,104,22,20,54,29
2012-03-13,DAL,107,23,20,WAS,98,9,31,32,51
2012-03-13,DEN,118,23,19,ATL,117,24,17,47,36
2012-03-13,SAC,89,14,27,GSW,115,17,21,31,48
2012-03-14,IND,111,24,16,PHI,94,25,17,49,33
2012-03-14,NJN,98,14,29,TOR,84,14,28,28,57
2012-03-14,NYK,121,18,24,POR,79,20,22,38,46
2012-03-14,CHI,106,35,9,MIA,102,31,10,66,19
2012-03-14,MIL,115,18,24,CLE,105,16,24,34,48
2012-03-14,NOH,101,10,32,LAL,107,26,16,36,48
2012-03-14,HOU,107,23,20,CHA,87,6,34,29,54
2012-03-14,SAS,122,27,13,ORL,111,28,15,55,28
2012-03-14,SAC,112,14,28,DET,124,15,27,29,55
2012-03-14,PHX,120,19,22,UTA,111,20,21,39,43
2012-03-14,LAC,96,23,17,ATL,82,24,18,47,35
2012-03-14,GSW,103,18,21,BOS,105,22,19,40,40
2012-03-15,NOH,89,10,33,WAS,99,9,32,19,65
2012-03-15,DAL,101,24,20,CHA,96,6,35,30,55
2012-03-15,DEN,90,24,19,OKC,103,32,10,56,29
2012-03-15,UTA,111,20,22,MIN,105,22,21,42,43
2012-03-15,LAC,87,24,17,PHX,91,20,22,44,39
2012-03-16,PHI,78,25,18,MIA,84,31,11,56,29
2012-03-16,ORL,86,28,16,NJN,70,15,29,43,45
2012-03-16,NYK,115,19,24,IND,100,25,16,44,40
2012-03-16,ATL,102,24,19,WAS,88,10,32,34,51
2012-03-16,CHI,89,36,9,POR,100,20,23,56,32
2012-03-16,MEM,110,24,17,TOR,114,14,29,38,46
2012-03-16,OKC,105,33,10,SAS,114,28,13,61,23
2012-03-16,PHX,109,21,22,DET,101,16,27,37,49
2012-03-16,SAC,120,14,29,BOS,95,23,19,37,48
2012-03-16,LAL,97,27,16,MIN,92,22,22,49,38
2012-03-16,GSW,98,18,22,MIL,120,19,24,37,46
2012-03-17,LAC,95,24,18,HOU,91,24,20,48,38
2012-03-17,CHA,107,6,36,TOR,103,15,29,21,65
2012-03-17,IND,88,25,17,NYK,102,20,24,45,41
2012-03-17,NJN,94,15,30,NOH,102,10,34,25,64
2012-03-17,CHI,89,36,10,PHI,80,25,19,61,29
2012-03-17,DAL,106,25,20,SAS,99,29,13,54,33
2012-03-17,DEN,98,24,20,BOS,91,23,20,47,40
2012-03-17,UTA,99,21,22,GSW,92,18,23,39,45
2012-03-18,CLE,87,16,25,ATL,103,25,19,41,44
2012-03-18,LAC,87,25,18,DET,83,16,28,41,46
2012-03-18,MEM,97,24,18,WAS,92,10,33,34,51
2012-03-18,SAC,115,15,29,MIN,99,22,23,37,52
2012-03-18,MIA,91,32,11,ORL,81,29,16,61,27
2012-03-18,PHX,99,22,22,HOU,86,24,21,46,43
2012-03-18,OKC,111,33,11,POR,95,21,23,54,34
2012-03-18,LAL,99,28,16,UTA,103,22,22,50,38
2012-03-19,CHA,80,7,36,PHI,105,25,20,32,56
2012-03-19,NJN,100,15,31,CLE,105,16,26,31,57
2012-03-19,ATL,76,26,19,BOS,79,23,21,49,40
2012-03-19,ORL,59,29,17,CHI,85,37,10,66,27
2012-03-19,DEN,95,25,20,DAL,112,26,20,51,40
2012-03-19,GSW,93,18,24,MIN,97,22,24,40,48
2012-03-20,IND,102,25,18,LAC,89,26,18,51,36
2012-03-20,NYK,106,21,24,TOR,87,15,30,36,54
2012-03-20,MIA,99,33,11,PHX,95,23,22,56,33
2012-03-20,HOU,107,24,22,LAL,104,28,17,52,39
2012-03-20,UTA,97,23,22,OKC,90,34,11,57,33
2012-03-20,SAC,119,16,29,MEM,110,25,18,41,47
2012-03-20,POR,87,21,24,MIL,116,20,24,41,48
2012-03-21,TOR,82,15,31,CHI,94,38,10,53,41
2012-03-21,PHI,79,26,20,NYK,82,22,24,48,44
2012-03-21,ORL,103,29,18,PHX,93,23,23,52,41
2012-03-21,NJN,89,15,32,WAS,108,10,34,25,66
2012-03-21,ATL,103,26,20,CLE,102,17,26,43,46
2012-03-21,NOH,92,11,34,GSW,101,18,25,29,59
2012-03-21,OKC,114,34,12,LAC,91,26,19,60,31
2012-03-21,SAS,116,29,14,MIN,100,23,24,52,38
2012-03-21,DEN,116,25,21,DET,115,16,29,41,50
2012-03-21,DAL,93,27,20,LAL,109,28,18,55,38
2012-03-22,WAS,83,11,34,IND,85,26,18,37,52
2012-03-22,MIL,91,21,24,BOS,100,24,21,45,45
2012-03-22,NOH,97,11,35,LAC,90,26,20,37,55
2012-03-22,HOU,109,25,22,GSW,83,19,25,44,47
2012-03-22,SAC,102,17,29,UTA,103,24,22,41,51
2012-03-22,POR,97,21,25,MEM,93,25,19,46,44
2012-03-23,TOR,96,15,32,NYK,79,23,24,38,56
2012-03-23,CHA,92,7,37,MIL,112,21,25,28,62
2012-03-23,ORL,93,30,18,CLE,80,17,27,47,45
2012-03-23,IND,111,27,18,PHX,113,23,24,50,42
2012-03-23,ATL,93,27,20,NJN,84,15,33,42,53
2012-03-23,DET,73,16,30,MIA,88,34,11,50,41
2012-03-23,PHI,99,26,21,BOS,86,25,21,51,42
2012-03-23,OKC,149,35,12,MIN,140,23,25,58,37
2012-03-23,SAS,104,30,14,DAL,87,27,21,57,35
2012-03-23,UTA,121,25,22,DEN,102,26,21,51,43
2012-03-23,LAL,103,29,18,POR,96,22,25,51,43
2012-03-24,LAC,101,26,21,MEM,85,25,20,51,41
2012-03-24,WAS,92,11,35,ATL,95,28,20,39,55
2012-03-24,NJN,102,15,34,CHA,89,7,38,22,72
2012-03-24,NYK,101,23,25,DET,79,16,31,39,56
2012-03-24,CHI,102,39,10,TOR,101,16,32,55,42
2012-03-24,NOH,86,12,35,SAS,89,31,14,43,49
2012-03-24,HOU,99,26,22,DAL,101,27,22,53,44
2012-03-24,MIL,104,22,25,IND,125,27,19,49,44
2012-03-24,GSW,111,19,26,SAC,108,17,30,36,56
2012-03-25,CLE,83,17,28,PHX,108,24,24,41,52
2012-03-25,MIN,117,23,26,DEN,100,26,22,49,48
2012-03-25,BOS,88,25,22,WAS,76,11,36,36,58
2012-03-25,ATL,139,29,20,UTA,133,26,22,55,42
2012-03-25,SAS,93,32,14,PHI,76,27,21,59,35
2012-03-25,OKC,103,36,12,MIA,87,35,11,71,23
2012-03-25,POR,90,22,26,GSW,87,20,26,42,52
2012-03-25,LAL,96,30,18,MEM,102,25,21,55,39
2012-03-26,TOR,101,16,33,ORL,117,31,18,47,51
2012-03-26,WAS,77,11,37,DET,79,16,32,27,69
2012-03-26,CHA,95,7,39,BOS,102,26,22,33,61
2012-03-26,IND,105,28,19,MIA,90,35,12,63,31
2012-03-26,NJN,84,16,34,UTA,105,26,23,42,57
2012-03-26,NYK,89,24,25,MIL,80,22,26,46,51
2012-03-26,CHI,91,40,10,DEN,108,26,23,66,33
2012-03-26,HOU,113,26,23,SAC,106,17,31,43,54
2012-03-26,LAC,97,27,21,NOH,85,12,36,39,57
2012-03-27,PHI,103,27,22,CLE,85,17,29,44,51
2012-03-27,MIL,108,22,27,ATL,101,30,20,52,47
2012-03-27,MEM,93,26,21,MIN,86,24,26,50,47
2012-03-27,DAL,90,28,22,HOU,81,27,23,55,45
2012-03-27,PHX,100,25,24,SAS,107,33,14,58,38
2012-03-27,POR,95,23,26,OKC,109,37,12,60,38
2012-03-27,GSW,101,20,27,LAL,104,30,19,50,46
2012-03-28,TOR,105,16,34,DEN,96,27,23,43,57
2012-03-28,NYK,108,25,25,ORL,86,32,18,57,43
2012-03-28,CHA,83,7,40,MIN,88,24,27,31,67
2012-03-28,CLE,75,17,30,DET,87,17,32,34,62
2012-03-28,BOS,94,27,22,UTA,82,27,23,54,45
2012-03-28,NJN,100,16,35,IND,84,29,19,45,54
2012-03-28,ATL,77,30,21,CHI,98,40,11,70,32
2012-03-28,SAC,112,17,32,SAS,117,34,14,51,46
2012-03-28,LAC,103,28,21,PHX,86,25,25,53,46
2012-03-28,GSW,87,20,28,NOH,102,12,37,32,65
2012-03-29,IND,93,29,20,WAS,89,11,38,40,58
2012-03-29,MIA,106,35,13,DAL,85,29,22,64,35
2012-03-29,POR,99,23,27,NOH,93,13,37,36,64
2012-03-29,LAL,93,31,19,OKC,102,38,12,69,31
2012-03-30,TOR,101,17,34,MIA,113,36,13,53,47
2012-03-30,WAS,97,11,39,PHI,76,28,22,39,61
2012-03-30,CHA,88,7,41,DEN,99,27,24,34,65
2012-03-30,ATL,100,30,22,NYK,90,26,25,56,47
2012-03-30,CLE,84,17,31,MIL,121,23,27,40,58
2012-03-30,ORL,98,32,19,DAL,100,29,23,61,42
2012-03-30,CHI,83,41,11,DET,71,18,32,59,43
2012-03-30,HOU,98,27,24,MEM,89,27,21,54,45
2012-03-30,MIN,79,25,27,BOS,100,28,22,53,49
2012-03-30,UTA,103,27,24,SAC,104,17,33,44,57
2012-03-30,LAC,98,29,21,POR,97,24,27,53,48
2012-03-30,GSW,100,20,29,NJN,102,17,35,37,64
2012-03-31,LAL,88,31,20,NOH,85,13,38,44,58
2012-03-31,NYK,91,26,26,CLE,75,17,32,43,58
2012-03-31,PHI,95,28,23,ATL,90,31,22,59,45
2012-03-31,DET,110,18,33,CHA,107,7,42,25,75
2012-03-31,MIL,95,24,27,MEM,99,27,22,51,49
2012-03-31,SAS,112,35,14,IND,103,30,20,65,34
2012-03-31,SAC,99,18,33,NJN,111,18,35,36,68
2012-03-31,LAC,105,30,21,UTA,96,27,25,57,46
2012-04-01,OKC,92,39,12,CHI,78,42,11,81,23
2012-04-01,BOS,91,29,22,MIA,72,37,13,66,35
2012-04-01,TOR,99,17,35,WAS,92,12,39,29,74
2012-04-01,ORL,101,32,20,DEN,104,28,24,60,44
2012-04-01,HOU,102,28,24,IND,104,30,21,58,45
2012-04-01,PHX,92,25,26,NOH,75,13,39,38,65
2012-04-01,POR,119,24,28,MIN,106,25,28,49,56
2012-04-01,LAL,120,32,20,GSW,112,20,30,52,50
2012-04-02,WAS,98,12,40,MIL,112,24,28,36,68
2012-04-02,CHI,93,42,12,HOU,99,28,25,70,37
2012-04-02,OKC,88,40,12,MEM,94,28,22,68,34
2012-04-02,DAL,75,30,23,LAC,94,31,21,61,44
2012-04-02,SAC,116,18,34,MIN,108,25,29,43,63
2012-04-02,POR,97,25,28,UTA,102,27,26,52,54
2012-04-03,TOR,92,18,35,CHA,87,7,43,25,78
2012-04-03,CLE,90,17,33,SAS,125,36,14,53,47
2012-04-03,IND,112,31,21,NYK,104,27,26,58,47
2012-04-03,MIA,99,37,14,PHI,93,29,23,66,37
2012-04-03,DET,102,19,33,ORL,95,32,21,51,54
2012-04-03,MEM,98,29,22,GSW,94,20,31,49,53
2012-04-03,SAC,100,19,34,PHX,109,26,26,45,60
2012-04-03,LAL,91,33,20,NJN,87,19,35,52,55
2012-04-04,PHI,78,29,24,TOR,99,19,35,48,59
2012-04-04,WAS,96,12,41,IND,109,32,21,44,62
2012-04-04,BOS,86,30,22,SAS,87,37,14,67,36
2012-04-04,ATL,120,31,23,CHA,93,7,44,38,67
2012-04-04,MIA,98,38,14,OKC,93,40,13,78,27
2012-04-04,MIL,107,25,28,CLE,98,17,34,42,62
2012-04-04,NOH,94,13,40,DEN,92,29,24,42,64
2012-04-04,MIN,94,25,30,GSW,97,20,32,45,62
2012-04-04,DAL,95,30,24,MEM,85,30,22,60,46
2012-04-04,UTA,105,28,26,PHX,107,27,26,55,52
2012-04-04,POR,101,25,29,NJN,88,19,36,44,65
2012-04-04,LAC,108,32,21,LAL,113,34,20,66,41
2012-04-05,ORL,80,32,22,NYK,96,27,27,59,49
2012-04-05,DET,99,20,33,WAS,94,12,42,32,75
2012-04-05,CHI,93,42,13,BOS,86,30,23,72,36
2012-04-05,SAC,85,19,35,LAC,93,32,22,51,57
2012-04-06,IND,103,33,21,OKC,98,40,14,73,35
2012-04-06,TOR,80,20,35,CLE,84,17,35,37,70
2012-04-06,NJN,110,19,37,WAS,98,12,43,31,80
2012-04-06,ATL,101,32,23,DET,96,21,33,53,56
2012-04-06,MIA,82,39,14,MEM,97,30,23,69,37
2012-04-06,MIL,95,26,28,CHA,90,7,45,33,73
2012-04-06,DAL,97,31,24,POR,99,26,29,57,53
2012-04-06,SAS,128,38,14,NOH,103,14,40,52,54
2012-04-06,DEN,105,29,25,PHX,99,28,26,57,51
2012-04-06,UTA,104,28,27,GSW,98,21,32,49,59
2012-04-06,LAL,107,35,20,HOU,112,29,25,64,45
2012-04-07,CHA,96,7,46,ATL,116,33,23,40,69
2012-04-07,IND,72,34,21,BOS,86,30,24,64,45
2012-04-07,PHI,82,29,25,ORL,88,32,23,61,48
2012-04-07,MEM,94,31,23,DAL,89,31,25,62,48
2012-04-07,NOH,99,14,41,MIN,90,25,31,39,72
2012-04-07,MIL,116,27,28,POR,94,27,29,54,57
2012-04-07,PHX,125,28,27,LAL,105,35,21,63,48
2012-04-07,LAC,109,33,22,SAC,94,19,36,52,58
2012-04-07,GSW,112,21,33,DEN,97,30,25,51,58
2012-04-08,NYK,100,28,27,CHI,99,43,13,71,40
2012-04-08,BOS,103,31,24,PHI,79,29,26,60,50
2012-04-08,NJN,122,20,37,CLE,117,18,35,38,72
2012-04-08,MIA,98,39,15,DET,75,21,34,60,49
2012-04-08,SAS,114,39,14,UTA,104,29,27,68,41
2012-04-08,OKC,91,40,15,TOR,75,20,36,60,51
2012-04-08,SAC,87,19,37,HOU,104,30,25,49,62
2012-04-09,CHA,85,7,47,WAS,113,12,44,19,91
2012-04-09,ORL,119,33,23,DET,89,21,35,54,58
2012-04-09,IND,103,34,22,TOR,98,20,37,54,59
2012-04-09,MIL,89,28,28,OKC,109,41,15,69,43
2012-04-09,MEM,94,32,23,LAC,85,34,22,66,45
2012-04-09,NOH,91,15,41,LAL,93,35,22,50,63
2012-04-09,MIN,90,25,32,PHX,114,29,27,54,59
2012-04-09,DEN,123,30,26,GSW,84,22,33,52,59
2012-04-09,UTA,91,29,28,SAS,84,40,14,69,42
2012-04-09,POR,89,27,30,HOU,94,31,25,58,55
2012-04-10,WAS,93,13,44,ORL,85,34,23,47,67
2012-04-10,MIA,107,40,15,BOS,115,32,24,72,39
2012-04-10,CLE,103,18,36,CHA,90,7,48,25,84
2012-04-10,NJN,88,21,37,PHI,107,29,27,50,64
2012-04-10,DAL,110,31,26,SAC,100,19,38,50,64
2012-04-10,CHI,98,43,14,NYK,86,29,27,72,41
2012-04-11,TOR,75,20,38,PHI,93,30,27,50,65
2012-04-11,CLE,98,19,36,IND,104,35,22,54,58
2012-04-11,BOS,88,33,24,ATL,86,34,23,67,47
2012-04-11,MIL,107,28,29,NYK,111,29,28,57,57
2012-04-11,MEM,104,33,23,PHX,93,30,27,63,50
2012-04-11,NOH,105,15,42,SAC,96,19,39,34,81
2012-04-11,HOU,91,32,25,UTA,103,30,28,62,53
2012-04-11,OKC,98,42,15,LAC,100,34,23,76,38
2012-04-11,SAS,84,40,15,LAL,98,36,22,76,37
2012-04-11,DEN,113,31,26,MIN,107,25,33,56,59
2012-04-11,POR,118,27,31,GSW,110,22,34,49,65
2012-04-12,CHA,85,7,49,DET,109,21,36,28,85
2012-04-12,CHI,96,44,14,MIA,86,40,16,84,30
2012-04-12,MIN,82,25,34,LAC,95,35,23,60,57
2012-04-12,SAS,107,40,16,MEM,97,34,23,74,39
2012-04-12,GSW,103,22,35,DAL,112,32,26,54,61
2012-04-13,TOR,84,20,39,BOS,79,34,24,54,63
2012-04-13,PHI,89,31,27,NJN,95,21,38,52,65
2012-04-13,ORL,81,34,24,ATL,109,34,24,68,48
2012-04-13,IND,102,36,22,CLE,83,19,37,55,59
2012-04-13,NYK,103,30,28,WAS,65,14,44,44,72
2012-04-13,MIA,105,40,17,CHA,82,7,50,47,67
2012-04-13,DET,97,22,36,MIL,113,28,30,50,66
2012-04-13,NOH,96,16,42,UTA,85,31,28,47,70
2012-04-13,HOU,105,32,26,PHX,112,30,28,62,54
2012-04-13,OKC,115,42,16,SAC,89,19,40,61,56
2012-04-13,LAL,103,37,22,DEN,97,32,26,69,48
2012-04-13,POR,94,28,31,DAL,97,33,26,61,57
2012-04-14,LAC,112,36,23,GSW,104,22,36,58,59
2012-04-14,WAS,89,14,45,CLE,98,19,38,33,83
2012-04-14,NJN,82,22,38,BOS,94,34,25,56,63
2012-04-14,MEM,103,34,24,UTA,98,31,29,65,53
2012-04-14,MIN,110,25,35,OKC,115,43,16,68,51
2012-04-14,MIL,99,29,30,IND,105,37,22,66,52
2012-04-14,SAS,105,41,16,PHX,91,31,28,72,44
2012-04-15,NYK,85,31,28,MIA,93,41,17,72,45
2012-04-15,LAL,112,38,22,DAL,108,34,26,72,48
2012-04-15,CHA,82,7,51,BOS,94,35,25,42,76
2012-04-15,ATL,86,35,24,TOR,102,21,39,56,63
2012-04-15,DET,94,22,37,CHI,100,45,14,67,51
2012-04-15,CLE,84,20,38,ORL,100,34,25,54,63
2012-04-15,SAC,104,19,41,POR,103,28,32,47,73
2012-04-15,NOH,88,17,42,MEM,75,35,24,52,66
2012-04-15,DEN,101,32,27,HOU,86,32,27,64,54
2012-04-16,TOR,87,22,39,ATL,109,35,25,57,64
2012-04-16,CHA,67,7,52,NOH,75,18,42,25,94
2012-04-16,ORL,113,35,25,PHI,100,31,28,66,53
2012-04-16,IND,111,38,22,MIN,88,25,36,63,58
2012-04-16,NJN,98,22,39,MIA,101,42,17,64,56
2012-04-16,CHI,84,46,14,WAS,87,14,46,60,60
2012-04-16,HOU,102,32,28,DEN,105,33,27,65,55
2012-04-16,UTA,123,31,30,DAL,121,34,27,65,57
2012-04-16,PHX,125,31,29,POR,107,28,33,59,62
2012-04-16,LAC,92,37,23,OKC,77,44,16,81,39
2012-04-16,GSW,99,22,37,SAS,120,42,16,64,53
2012-04-17,PHI,97,31,29,IND,102,39,22,70,51
2012-04-17,DET,116,22,38,CLE,77,20,39,42,77
2012-04-17,NYK,118,31,29,BOS,110,36,25,67,54
2012-04-17,MIN,84,25,37,MEM,91,35,25,60,62
2012-04-17,LAL,91,39,22,SAS,112,43,16,82,38
2012-04-18,WAS,121,15,46,MIL,112,29,31,44,77
2012-04-18,CHA,68,7,53,CHI,100,46,15,53,68
2012-04-18,CLE,87,20,40,PHI,103,31,30,51,70
2012-04-18,NJN,95,22,40,NYK,104,32,29,54,69
2012-04-18,ATL,116,36,25,DET,84,23,38,59,63
2012-04-18,MIA,96,43,17,TOR,72,22,40,65,57
2012-04-18,BOS,102,36,26,ORL,98,36,25,72,51
2012-04-18,MEM,103,36,25,NOH,91,19,42,55,67
2012-04-18,DAL,117,34,28,HOU,110,32,29,66,57
2012-04-18,DEN,98,34,27,LAC,104,38,23,72,50
2012-04-18,PHX,97,32,29,OKC,109,44,17,76,46
2012-04-18,SAC,102,20,41,SAS,127,44,16,64,57
2012-04-18,POR,91,28,34,UTA,112,32,30,60,64
2012-04-18,GSW,87,22,38,LAL,99,39,23,61,61
2012-04-19,IND,118,40,22,MIL,109,29,32,69,54
2012-04-19,DET,80,23,39,MIN,91,25,38,48,77
2012-04-19,MIA,83,44,17,CHI,72,47,15,91,32
2012-04-19,NOH,105,19,43,HOU,99,32,30,51,73
2012-04-19,PHX,93,32,30,LAC,90,39,23,71,53
2012-04-20,CHA,80,7,54,MEM,85,37,25,44,79
2012-04-20,ATL,97,37,25,BOS,92,37,26,74,51
2012-04-20,CLE,98,20,41,NYK,90,33,29,53,70
2012-04-20,DAL,104,35,28,GSW,94,22,39,57,67
2012-04-20,SAS,121,45,16,LAL,97,40,23,85,39
2012-04-20,SAC,92,20,42,OKC,103,45,17,65,59
2012-04-21,PHX,107,33,30,DEN,118,34,28,67,58
2012-04-21,IND,106,41,22,PHI,109,32,30,73,52
2012-04-21,MIA,84,45,17,WAS,86,16,46,61,63
2012-04-21,CHI,93,47,16,DAL,83,36,28,83,44
2012-04-21,MEM,93,38,25,POR,89,28,35,66,60
2012-04-21,HOU,99,32,31,GSW,96,22,40,54,71
2012-04-21,MIL,106,29,33,NJN,95,22,41,51,74
2012-04-21,UTA,117,33,30,ORL,107,36,26,69,56
2012-04-22,ATL,112,38,25,NYK,113,33,30,71,55
2012-04-22,LAL,114,40,24,OKC,106,46,17,86,41
2012-04-22,CHA,88,7,55,SAC,114,20,43,27,98
2012-04-22,MIA,97,45,18,HOU,88,33,31,78,49
2012-04-22,DET,76,23,40,TOR,73,22,41,45,81
2012-04-22,SAS,114,46,16,CLE,98,21,41,67,57
2012-04-22,MIN,88,26,38,GSW,93,22,41,48,79
2012-04-22,DEN,101,35,28,ORL,74,36,27,71,55
2012-04-22,LAC,107,39,24,NOH,98,20,43,59,67
2012-04-23,WAS,101,17,46,CHA,73,7,56,24,102
2012-04-23,IND,103,41,23,DET,97,24,40,65,63
2012-04-23,NJN,87,22,42,PHI,105,33,30,55,72
2012-04-23,MIL,92,30,33,TOR,86,22,42,52,75
2012-04-23,MEM,109,39,25,CLE,101,21,42,60,67
2012-04-23,SAS,124,47,16,POR,89,28,36,75,52
2012-04-24,ATL,109,38,26,LAC,102,40,24,78,50
2012-04-24,BOS,78,37,27,MIA,66,46,18,83,45
2012-04-24,OKC,118,46,18,SAC,110,21,43,67,61
2012-04-24,UTA,100,34,30,PHX,88,33,31,67,61
2012-04-24,GSW,81,23,41,NOH,83,20,44,43,85
2012-04-25,ORL,102,36,28,CHA,95,7,57,43,85
2012-04-25,CLE,85,21,43,WAS,96,18,46,39,89
2012-04-25,IND,87,42,23,CHI,92,48,16,90,39
2012-04-25,NYK,99,34,30,LAC,93,40,25,74,55
2012-04-25,MIL,85,31,33,PHI,90,34,30,65,63
2012-04-25,OKC,101,47,18,DEN,106,36,28,83,46
2012-04-25,PHX,106,33,32,SAS,110,48,16,81,48
2012-04-26,DET,108,24,41,PHI,86,35,30,59,71
2012-04-26,BOS,87,38,27,MIL,74,31,34,69,61
2012-04-26,TOR,98,22,43,NJN,67,22,43,44,86
2012-04-26,WAS,104,19,46,MIA,70,46,19,65,65
2012-04-26,CHA,84,7,58,NYK,104,35,30,42,88
2012-04-26,ATL,106,39,26,DAL,89,36,29,75,55
2012-04-26,CHI,107,49,16,CLE,75,21,44,70,60
2012-04-26,MEM,88,40,25,ORL,76,37,28,77,53
2012-04-26,HOU,84,33,32,NOH,77,21,44,54,76
2012-04-26,MIN,102,26,39,DEN,131,37,28,63,67
2012-04-26,UTA,96,35,30,POR,94,28,37,63,67
2012-04-26,SAC,113,21,44,LAL,96,41,24,62,68
2012-04-26,GSW,101,23,42,SAS,107,49,16,72,58
2012-10-30,CLE,94,0,0,WAS,84,0,0,0,0
2012-10-30,MIA,120,0,0,BOS,107,0,0,0,0
2012-10-30,LAL,91,0,0,DAL,99,0,0,0,0
2012-10-31,TOR,88,0,0,IND,90,0,0,0,0
2012-10-31,PHI,84,0,0,DEN,75,0,0,0,0
2012-10-31,DET,96,0,0,HOU,105,0,0,0,0
2012-10-31,CHI,93,0,0,SAC,87,0,0,0,0
2012-10-31,NOH,95,0,0,SAS,99,0,0,0,0
2012-10-31,UTA,113,0,0,DAL,94,1,0,1,0
2012-10-31,PHX,85,0,0,GSW,87,0,0,0,0
2012-10-31,LAC,101,0,0,MEM,92,0,0,0,0
2012-10-31,POR,116,0,0,LAL,106,0,1,0,1
2012-11-01,SAS,86,1,0,OKC,84,0,0,1,0
2012-11-02,CHA,90,0,0,IND,89,1,0,1,0
2012-11-02,ORL,102,0,0,DEN,89,0,1,0,1
2012-11-02,BOS,88,0,1,MIL,99,0,0,0,1
2012-11-02,ATL,102,0,0,HOU,109,1,0,1,0
2012-11-02,CLE,86,1,0,CHI,115,1,0,2,0
2012-11-02,NYK,104,0,1,MIA,84,1,0,1,1
2012-11-02,NOH,88,0,1,UTA,86,1,0,1,1
2012-11-02,OKC,106,0,1,POR,92,1,0,1,1
2012-11-02,MIN,92,0,0,SAC,80,0,1,0,1
2012-11-02,PHX,92,0,1,DET,89,0,1,0,2
2012-11-02,LAL,95,0,2,LAC,105,1,0,1,2
2012-11-02,GSW,94,1,0,MEM,104,0,1,1,1
2012-11-03,WAS,86,0,1,BOS,89,0,2,0,3
2012-11-03,IND,106,1,1,SAC,98,0,2,1,3
2012-11-03,BKN,107,1,0,TOR,100,0,1,1,1
2012-11-03,MIA,119,1,1,DEN,116,0,2,1,3
2012-11-03,CHI,82,2,0,NOH,89,1,1,3,1
2012-11-03,HOU,85,2,0,POR,95,1,1,3,1
2012-11-03,MIL,105,1,0,CLE,102,1,1,2,1
2012-11-03,DAL,126,1,1,CHA,99,1,0,2,1
2012-11-03,SAS,110,2,0,UTA,100,1,1,3,1
2012-11-03,LAC,110,2,0,GSW,114,1,1,3,1
2012-11-04,NYK,100,1,1,PHI,84,1,0,2,1
2012-11-04,TOR,105,0,2,MIN,86,1,0,1,2
2012-11-04,ORL,115,1,0,PHX,94,1,1,2,1
2012-11-04,OKC,95,1,1,ATL,104,0,1,1,2
2012-11-04,LAL,108,0,3,DET,79,0,2,0,5
2012-11-05,PHI,88,1,1,NYK,110,2,1,3,2
2012-11-05,BKN,96,2,0,MIN,107,1,1,3,1
2012-11-05,MIA,124,2,1,PHX,99,1,2,3,3
2012-11-05,MEM,103,1,1,UTA,94,1,2,2,3
2012-11-05,DAL,114,2,1,POR,91,2,1,4,2
2012-11-05,SAS,101,3,0,IND,79,2,1,5,1
2012-11-05,SAC,94,0,3,GSW,92,2,1,2,4
2012-11-05,LAC,101,2,1,CLE,108,1,2,3,3
2012-11-06,CHI,99,2,1,ORL,93,2,0,4,1
2012-11-06,OKC,108,1,2,TOR,88,1,2,2,4
2012-11-06,DEN,109,0,3,DET,97,0,3,0,6
2012-11-07,CHA,110,1,1,PHX,117,1,3,2,4
2012-11-07,BOS,100,1,2,WAS,94,0,2,1,4
2012-11-07,ATL,89,1,1,IND,86,2,2,3,3
2012-11-07,MIA,103,3,1,BKN,73,2,1,5,2
2012-11-07,MIL,90,2,0,MEM,108,2,1,4,1
2012-11-07,NOH,62,2,1,PHI,77,1,2,3,3
2012-11-07,HOU,87,2,1,DEN,93,1,3,3,4
2012-11-07,MIN,90,2,1,ORL,75,2,1,4,2
2012-11-07,DAL,109,3,1,TOR,104,1,3,4,4
2012-11-07,UTA,95,1,3,LAL,86,1,3,2,6
2012-11-07,SAC,105,1,3,DET,103,0,4,1,7
2012-11-07,LAC,106,2,2,SAS,84,4,0,6,2
2012-11-07,GSW,106,2,2,CLE,96,2,2,4,4
2012-11-08,CHI,91,3,1,OKC,97,2,2,5,3
2012-11-08,POR,90,2,2,LAC,103,3,2,5,4
2012-11-09,WAS,91,0,3,MIL,101,2,1,2,4
2012-11-09,ORL,68,2,2,BKN,107,2,2,4,4
2012-11-09,BOS,100,2,2,PHI,106,2,2,4,4
2012-11-09,NYK,104,3,1,DAL,94,4,1,7,2
2012-11-09,ATL,89,2,1,MIA,95,4,1,6,2
2012-11-09,MEM,93,3,1,HOU,85,2,2,5,3
2012-11-09,NOH,107,2,2,CHA,99,1,2,3,4
2012-11-09,OKC,105,3,2,DET,94,0,5,3,7
2012-11-09,MIN,96,3,1,IND,94,2,3,5,4
2012-11-09,PHX,107,2,3,CLE,105,2,3,4,6
2012-11-09,SAC,86,2,3,SAS,97,4,1,6,4
2012-11-09,DEN,104,2,3,UTA,84,2,3,4,6
2012-11-09,LAL,101,1,4,GSW,77,3,2,4,6
2012-11-10,TOR,83,1,4,PHI,93,3,2,4,6
2012-11-10,IND,89,2,4,WAS,85,0,4,2,8
2012-11-10,CHA,101,1,3,DAL,97,4,2,5,5
2012-11-10,CHI,87,3,2,MIN,80,4,1,7,3
2012-11-10,HOU,96,2,3,DET,82,0,6,2,9
2012-11-10,MIL,92,3,1,BOS,96,2,3,5,4
2012-11-10,UTA,94,2,4,PHX,81,3,3,5,7
2012-11-10,POR,109,2,3,SAS,112,5,1,7,4
2012-11-10,GSW,101,3,3,DEN,107,3,3,6,6
2012-11-11,BKN,82,3,2,ORL,74,2,3,5,5
2012-11-11,LAC,89,4,2,ATL,76,2,2,6,4
2012-11-11,MEM,104,4,1,MIA,86,5,1,9,2
2012-11-11,OKC,106,4,2,CLE,91,2,4,6,6
2012-11-11,LAL,103,2,4,SAC,90,2,4,4,8
2012-11-12,TOR,133,1,5,UTA,140,3,4,4,9
2012-11-12,PHI,96,4,2,MIL,105,3,2,7,4
2012-11-12,DET,90,0,7,OKC,92,5,2,5,9
2012-11-12,CHI,95,4,2,BOS,101,3,3,7,5
2012-11-12,HOU,110,3,3,MIA,113,5,2,8,5
2012-11-12,DAL,82,4,3,MIN,90,4,2,8,5
2012-11-12,PHX,110,3,4,DEN,100,4,3,7,7
2012-11-12,POR,87,2,4,ATL,95,2,3,4,7
2012-11-13,CHA,92,2,3,WAS,76,0,5,2,8
2012-11-13,ORL,89,2,4,NYK,99,4,1,6,5
2012-11-13,IND,72,3,4,TOR,74,1,6,4,10
2012-11-13,BKN,114,4,2,CLE,101,2,5,6,7
2012-11-13,SAC,86,2,5,POR,103,2,5,4,10
2012-11-13,LAL,82,3,4,SAS,84,6,1,9,5
2012-11-14,PHI,76,4,3,DET,94,0,8,4,11
2012-11-14,BOS,98,4,3,UTA,93,4,4,8,7
2012-11-14,MIL,99,4,2,IND,85,3,5,7,7
2012-11-14,HOU,100,3,4,NOH,96,3,2,6,6
2012-11-14,OKC,97,6,2,MEM,107,5,1,11,3
2012-11-14,MIN,87,5,2,CHA,89,3,3,8,5
2012-11-14,DAL,107,4,4,WAS,101,0,6,4,10
2012-11-14,PHX,106,4,4,CHI,112,4,3,8,7
2012-11-14,LAC,107,5,2,MIA,100,6,2,11,4
2012-11-14,GSW,92,3,4,ATL,88,3,3,6,7
2012-11-15,BKN,102,5,2,BOS,97,5,3,10,5
2012-11-15,SAS,100,7,1,NYK,104,5,1,12,2
2012-11-15,DEN,93,4,4,MIA,98,6,3,10,7
2012-11-16,PHI,99,4,4,UTA,93,4,5,8,9
2012-11-16,DET,106,1,8,ORL,110,2,5,3,13
2012-11-16,IND,103,3,6,DAL,83,5,4,8,10
2012-11-16,NOH,95,3,3,OKC,110,6,3,9,6
2012-11-16,MIN,98,5,3,GSW,106,4,4,9,7
2012-11-16,MEM,105,6,1,NYK,95,6,1,12,2
2012-11-16,SAC,96,2,6,ATL,112,3,4,5,10
2012-11-16,POR,119,3,5,HOU,117,4,4,7,9
2012-11-16,LAL,114,3,5,PHX,102,4,5,7,10
2012-11-17,BOS,107,5,4,TOR,89,2,6,7,10
2012-11-17,LAC,101,6,2,CHI,80,5,3,11,5
2012-11-17,WAS,76,0,7,UTA,83,4,6,4,13
2012-11-17,CHA,87,4,3,MEM,94,7,1,11,4
2012-11-17,CLE,95,2,6,DAL,103,5,5,7,11
2012-11-17,MIL,117,5,2,NOH,113,3,4,8,6
2012-11-17,SAS,126,7,2,DEN,100,4,5,11,7
2012-11-17,PHX,88,4,6,MIA,97,7,3,11,9
2012-11-18,NYK,88,6,2,IND,76,4,6,10,8
2012-11-18,TOR,97,2,7,ORL,86,3,5,5,12
2012-11-18,PHI,86,5,4,CLE,79,2,7,7,11
2012-11-18,SAC,90,2,7,BKN,99,6,2,8,9
2012-11-18,OKC,119,7,3,GSW,109,5,4,12,7
2012-11-18,DET,103,1,9,BOS,83,6,4,7,13
2012-11-18,POR,102,4,5,CHI,94,5,4,9,9
2012-11-18,LAL,119,4,5,HOU,108,4,5,8,10
2012-11-19,WAS,89,0,8,IND,96,4,7,4,15
2012-11-19,CHA,102,4,4,MIL,98,6,2,10,6
2012-11-19,ATL,81,4,4,ORL,72,3,6,7,10
2012-11-19,MEM,92,8,1,DEN,97,4,6,12,7
2012-11-19,DAL,101,6,5,GSW,105,5,5,11,10
2012-11-19,SAS,87,8,2,LAC,92,7,2,15,4
2012-11-19,UTA,102,5,6,HOU,91,4,6,9,12
2012-11-20,PHI,106,6,4,TOR,98,3,7,9,11
2012-11-20,NOH,80,3,5,NYK,102,7,2,10,7
2012-11-20,LAL,95,5,5,BKN,90,7,2,12,7
2012-11-21,CHA,98,5,4,TOR,97,3,8,8,12
2012-11-21,ORL,90,3,7,DET,74,2,9,5,16
2012-11-21,CLE,92,2,8,PHI,83,7,4,9,12
2012-11-21,IND,115,5,7,NOH,107,3,6,8,13
2012-11-21,BOS,100,6,5,SAS,112,8,3,14,8
2012-11-21,ATL,101,5,4,WAS,100,0,9,5,13
2012-11-21,MIA,113,8,3,MIL,106,6,3,14,6
2012-11-21,OKC,117,8,3,LAC,111,8,2,16,5
2012-11-21,HOU,93,4,7,CHI,89,5,5,9,12
2012-11-21,MIN,94,5,4,DEN,101,5,6,10,10
2012-11-21,DAL,114,6,6,NYK,111,8,2,14,8
2012-11-21,PHX,114,4,7,POR,87,5,5,9,12
2012-11-21,SAC,113,2,8,LAL,97,6,5,8,13
2012-11-21,GSW,102,6,5,BKN,93,7,3,13,8
2012-11-23,CHA,91,6,4,ATL,101,6,4,12,8
2012-11-23,ORL,108,4,7,CLE,104,3,8,7,15
2012-11-23,BOS,108,6,6,OKC,100,9,3,15,9
2012-11-23,BKN,86,7,4,LAC,76,8,3,15,7
2012-11-23,DET,91,2,10,TOR,90,3,9,5,19
2012-11-23,IND,97,6,7,SAS,104,9,3,15,10
2012-11-23,MEM,106,8,2,LAL,98,6,6,14,8
2012-11-23,HOU,131,5,7,NYK,103,8,3,13,10
2012-11-23,DEN,102,6,6,GSW,91,7,5,13,11
2012-11-23,UTA,104,6,6,SAC,102,3,8,9,14
2012-11-23,PHX,111,5,7,NOH,108,3,7,8,14
2012-11-23,POR,103,5,6,MIN,95,5,5,10,11
2012-11-24,PHI,109,7,5,OKC,116,9,4,16,9
2012-11-24,WAS,106,0,10,CHA,108,6,5,6,15
2012-11-24,ATL,104,7,4,LAC,93,8,4,15,8
2012-11-24,MIA,110,9,3,CLE,108,3,9,12,12
2012-11-24,DAL,89,7,6,LAL,115,6,7,13,13
2012-11-24,MIL,86,6,4,CHI,93,5,6,11,10
2012-11-24,SAC,108,3,9,UTA,97,7,6,10,15
2012-11-24,GSW,96,7,6,MIN,85,5,6,12,12
2012-11-25,TOR,106,3,10,SAS,111,10,3,13,13
2012-11-25,NYK,121,8,4,DET,100,3,10,11,14
2012-11-25,BKN,98,8,4,POR,85,6,6,14,10
2012-11-25,PHI,104,7,6,PHX,101,6,7,13,13
2012-11-25,ORL,110,5,7,BOS,116,7,6,12,13
2012-11-25,DEN,102,7,6,NOH,84,3,8,10,14
2012-11-26,BKN,96,0,0,NYK,89,0,0,0,0
2012-11-26,WAS,92,0,11,SAS,118,11,3,11,14
2012-11-26,DET,108,3,11,POR,101,6,7,9,18
2012-11-26,CHI,92,6,6,MIL,93,6,5,12,11
2012-11-26,MEM,84,9,2,CLE,78,3,10,12,12
2012-11-26,OKC,114,10,4,CHA,69,7,5,17,9
2012-11-26,UTA,105,7,7,DEN,103,8,6,15,13
2012-11-26,LAC,98,8,5,NOH,105,3,9,11,14
2012-11-27,PHI,100,8,6,DAL,98,7,7,15,13
2012-11-27,CLE,78,3,11,PHX,91,6,8,9,19
2012-11-27,HOU,117,6,7,TOR,101,3,11,9,18
2012-11-27,SAC,89,4,9,MIN,97,5,7,9,16
2012-11-27,LAL,77,7,7,IND,79,6,8,13,15
2012-11-28,WAS,84,0,12,POR,82,6,8,6,20
2012-11-28,ORL,89,5,8,SAS,110,12,3,17,11
2012-11-28,BOS,83,8,6,BKN,95,9,4,17,10
2012-11-28,ATL,94,8,4,CHA,91,7,6,15,10
2012-11-28,DET,117,4,11,PHX,77,7,8,11,19
2012-11-28,CHI,101,6,7,DAL,78,7,8,13,15
2012-11-28,MIL,88,7,5,NYK,102,9,4,16,9
2012-11-28,MEM,103,10,2,TOR,82,3,12,13,14
2012-11-28,NOH,84,4,9,UTA,96,8,7,12,16
2012-11-28,OKC,120,11,4,HOU,98,7,7,18,11
2012-11-28,LAC,101,8,6,MIN,95,6,7,14,13
2012-11-29,MIA,105,10,3,SAS,100,13,3,23,6
2012-11-29,GSW,106,8,6,DEN,105,8,7,16,13
2012-11-30,TOR,101,3,13,PHX,97,7,9,10,22
2012-11-30,CHA,98,7,7,PHI,104,9,6,16,13
2012-11-30,ORL,86,5,9,BKN,98,10,4,15,13
2012-11-30,BOS,96,8,7,POR,78,6,9,14,16
2012-11-30,NYK,108,10,4,WAS,87,1,12,11,16
2012-11-30,ATL,111,9,4,CLE,113,3,12,12,16
2012-11-30,MEM,90,11,2,DET,78,5,11,16,13
2012-11-30,OKC,106,12,4,UTA,94,9,7,21,11
2012-11-30,MIN,95,6,8,MIL,85,7,6,13,14
2012-11-30,SAC,92,4,10,IND,97,7,8,11,18
2012-11-30,LAL,122,7,8,DEN,103,8,8,15,16
2012-12-01,MIA,102,11,3,BKN,89,11,4,22,7
2012-12-01,CLE,117,4,12,POR,118,6,10,10,22
2012-12-01,CHI,93,7,7,PHI,88,10,6,17,13
2012-12-01,NOH,79,4,10,OKC,100,13,4,17,14
2012-12-01,HOU,124,7,8,UTA,116,9,8,16,16
2012-12-01,MIL,91,7,7,BOS,88,9,7,16,14
2012-12-01,SAS,99,13,4,MEM,95,12,2,25,6
2012-12-01,DAL,92,7,9,DET,77,5,12,12,21
2012-12-01,LAC,116,9,6,SAC,81,4,11,13,17
2012-12-01,GSW,103,9,6,IND,92,8,8,17,14
2012-12-02,NYK,106,11,4,PHX,99,7,10,18,14
2012-12-02,LAL,103,8,8,ORL,113,5,10,13,18
2012-12-03,CHA,112,7,8,POR,118,7,10,14,18
2012-12-03,DET,89,5,13,CLE,79,4,13,9,26
2012-12-03,NOH,102,4,11,MIL,81,8,7,12,18
2012-12-03,DEN,113,8,9,TOR,110,4,13,12,22
2012-12-03,UTA,104,9,9,LAC,105,10,6,19,15
2012-12-03,GSW,94,10,6,ORL,102,6,10,16,16
2012-12-04,PHI,88,10,7,MIN,105,7,8,17,15
2012-12-04,WAS,105,1,13,MIA,101,12,3,13,16
2012-12-04,BKN,111,11,5,OKC,117,14,4,25,9
2012-12-04,CHI,76,8,7,IND,80,8,9,16,16
2012-12-04,MEM,108,12,3,PHX,98,7,11,19,14
2012-12-04,HOU,107,8,8,LAL,105,8,9,16,17
2012-12-05,CHA,98,7,9,NYK,100,12,4,19,13
2012-12-05,IND,99,9,9,POR,92,8,10,17,19
2012-12-05,BOS,104,9,8,MIN,94,8,8,17,16
2012-12-05,ATL,108,9,5,DEN,104,9,9,18,14
2012-12-05,DET,97,6,13,GSW,104,10,7,16,20
2012-12-05,CLE,85,4,14,CHI,95,8,8,12,22
2012-12-05,NOH,87,5,11,LAL,103,8,10,13,21
2012-12-05,SAS,110,14,4,MIL,99,8,8,22,12
2012-12-05,UTA,87,9,10,ORL,81,7,10,16,20
2012-12-05,SAC,107,4,12,TOR,100,4,14,8,26
2012-12-05,LAC,112,11,6,DAL,90,8,9,19,15
2012-12-06,MIA,92,12,4,NYK,112,13,4,25,8
2012-12-06,PHX,94,7,12,DAL,97,8,10,15,22
2012-12-07,PHI,95,10,8,BOS,94,10,8,20,16
2012-12-07,IND,89,10,9,DEN,92,9,10,19,19
2012-12-07,BKN,102,11,6,GSW,109,11,7,22,13
2012-12-07,ATL,104,10,5,WAS,95,2,13,12,18
2012-12-07,DET,104,6,14,CHI,108,9,8,15,22
2012-12-07,NOH,89,5,12,MEM,96,13,3,18,15
2012-12-07,MIN,91,8,9,CLE,73,4,15,12,24
2012-12-07,MIL,108,8,9,CHA,93,7,10,15,19
2012-12-07,SAS,114,15,4,HOU,92,9,8,24,12
2012-12-07,UTA,131,10,10,TOR,99,4,15,14,25
2012-12-07,OKC,114,15,4,LAL,108,9,10,24,14
2012-12-07,SAC,91,5,12,ORL,82,7,11,12,23
2012-12-08,LAC,117,12,6,PHX,99,7,13,19,19
2012-12-08,WAS,97,2,14,GSW,101,12,7,14,21
2012-12-08,CHA,102,7,11,SAS,132,16,4,23,15
2012-12-08,BOS,92,10,9,PHI,79,11,8,21,17
2012-12-08,MIA,106,12,5,NOH,90,5,13,17,18
2012-12-08,CLE,97,4,16,DET,104,6,15,10,31
2012-12-08,CHI,93,10,8,NYK,85,14,4,24,12
2012-12-08,MEM,83,14,3,ATL,93,11,5,25,8
2012-12-08,HOU,109,9,9,DAL,116,9,10,18,19
2012-12-08,POR,80,8,11,SAC,99,6,12,14,23
2012-12-09,LAC,102,13,6,TOR,83,4,16,17,22
2012-12-09,BKN,88,11,7,MIL,97,9,9,20,16
2012-12-09,OKC,104,16,4,IND,93,10,10,26,14
2012-12-09,NYK,112,14,5,DEN,106,10,10,24,15
2012-12-09,PHX,90,7,14,ORL,98,7,12,14,26
2012-12-09,LAL,110,9,11,UTA,117,11,10,20,21
2012-12-10,PHI,104,11,9,DET,97,7,15,18,24
2012-12-10,CHA,96,7,12,GSW,104,13,7,20,19
2012-12-10,MIA,101,13,5,ATL,92,12,5,25,10
2012-12-10,HOU,126,9,10,SAS,134,17,4,26,14
2012-12-10,DAL,119,10,10,SAC,96,7,12,17,22
2012-12-10,POR,92,8,12,TOR,74,4,17,12,29
2012-12-11,BKN,97,11,8,NYK,100,15,5,26,13
2012-12-11,CLE,100,4,17,LAL,94,9,12,13,29
2012-12-11,DET,94,7,16,DEN,101,10,11,17,27
2012-12-11,NOH,70,5,14,WAS,77,2,15,7,29
2012-12-11,CHI,89,11,8,LAC,94,14,6,25,14
2012-12-12,TOR,88,4,18,BKN,94,11,9,15,27
2012-12-12,ORL,80,8,12,ATL,86,12,6,20,18
2012-12-12,IND,96,10,11,CLE,81,5,17,15,28
2012-12-12,PHI,89,12,9,CHI,96,11,9,23,18
2012-12-12,CHA,94,7,13,LAC,100,15,6,22,19
2012-12-12,MIA,95,14,5,GSW,97,14,7,28,12
2012-12-12,BOS,117,11,9,DAL,115,11,10,22,19
2012-12-12,MIL,98,10,9,SAC,85,7,13,17,22
2012-12-12,HOU,99,9,11,WAS,93,3,15,12,26
2012-12-12,OKC,92,17,4,NOH,88,5,15,22,19
2012-12-12,MIN,108,9,9,DEN,105,11,11,20,20
2012-12-12,PHX,82,7,15,MEM,80,14,4,21,19
2012-12-12,UTA,99,12,10,SAS,96,18,4,30,14
2012-12-13,ATL,113,13,6,CHA,90,7,14,20,20
2012-12-13,NYK,116,16,5,LAL,107,9,13,25,18
2012-12-13,POR,98,9,12,SAS,90,18,5,27,17
2012-12-14,TOR,95,4,19,DAL,74,11,11,15,30
2012-12-14,WAS,96,3,16,LAL,102,9,14,12,30
2012-12-14,IND,95,11,11,PHI,85,12,10,23,21
2012-12-14,BKN,107,12,9,DET,105,7,17,19,26
2012-12-14,CLE,86,5,18,MIL,90,11,9,16,27
2012-12-14,ORL,99,8,13,GSW,85,15,7,23,20
2012-12-14,NOH,102,5,16,MIN,113,10,9,15,25
2012-12-14,HOU,101,10,11,BOS,89,12,9,22,20
2012-12-14,OKC,113,18,4,SAC,103,7,14,25,18
2012-12-14,PHX,99,8,15,UTA,84,13,10,21,25
2012-12-14,DEN,99,11,12,MEM,94,14,5,25,17
2012-12-15,CHA,98,7,15,ORL,107,9,13,16,28
2012-12-15,ATL,93,14,6,GSW,115,15,8,29,14
2012-12-15,NYK,103,17,5,CLE,102,5,19,22,24
2012-12-15,MIA,102,14,6,WAS,72,3,17,17,23
2012-12-15,DET,77,7,18,IND,88,12,11,19,29
2012-12-15,CHI,83,12,9,BKN,82,13,9,25,18
2012-12-15,MIN,114,11,9,DAL,106,11,12,22,21
2012-12-15,MIL,85,12,9,LAC,111,16,6,28,15
2012-12-15,SAS,103,18,6,BOS,88,12,10,30,16
2012-12-15,UTA,86,13,11,MEM,99,14,6,27,17
2012-12-16,TOR,103,5,19,HOU,96,11,11,16,30
2012-12-16,PHI,98,12,11,LAL,111,10,14,22,25
2012-12-16,SAC,97,7,15,DEN,122,12,12,19,27
2012-12-16,POR,95,10,12,NOH,94,5,17,15,29
2012-12-17,ORL,102,10,13,MIN,93,12,9,22,22
2012-12-17,NYK,96,18,5,HOU,109,11,12,29,17
2012-12-17,DET,76,7,19,LAC,88,17,6,24,25
2012-12-17,MEM,80,15,6,CHI,71,13,9,28,15
2012-12-17,OKC,107,19,4,SAS,93,19,6,38,10
2012-12-17,PHX,101,9,15,SAC,90,7,16,16,31
2012-12-18,WAS,95,3,18,ATL,100,14,7,17,25
2012-12-18,CLE,99,5,20,TOR,113,6,19,11,39
2012-12-18,BKN,90,13,10,UTA,92,13,12,26,22
2012-12-18,MIA,103,15,6,MIN,92,12,10,27,16
2012-12-18,CHI,100,13,10,BOS,89,12,11,25,21
2012-12-18,MIL,98,12,10,IND,93,13,11,25,21
2012-12-18,DAL,107,11,13,PHI,100,12,12,23,25
2012-12-18,DEN,112,13,12,SAS,106,19,7,32,19
2012-12-18,LAL,101,11,14,CHA,100,7,16,18,30
2012-12-18,GSW,103,16,8,NOH,96,5,18,21,26
2012-12-19,TOR,97,7,19,DET,91,7,20,14,39
2012-12-19,NYK,100,18,6,BKN,86,13,11,31,17
2012-12-19,ORL,90,11,13,WAS,83,3,19,14,32
2012-12-19,IND,104,13,12,UTA,84,14,12,27,24
2012-12-19,BOS,103,12,12,CLE,91,5,21,17,33
2012-12-19,ATL,92,15,7,OKC,100,20,4,35,11
2012-12-19,HOU,125,12,12,PHI,103,12,13,24,25
2012-12-19,PHX,121,10,15,CHA,104,7,17,17,32
2012-12-19,MEM,90,16,6,MIL,80,13,10,29,16
2012-12-19,SAC,131,7,17,GSW,127,17,8,24,25
2012-12-19,LAC,93,18,6,NOH,77,5,19,23,25
2012-12-20,MIN,99,12,11,OKC,93,21,4,33,15
2012-12-20,DAL,95,12,13,MIA,110,16,6,28,19
2012-12-20,POR,101,11,12,DEN,93,14,12,25,24
2012-12-21,TOR,93,8,19,ORL,90,12,13,20,32
2012-12-21,PHI,99,12,14,ATL,80,15,8,27,22
2012-12-21,BOS,94,13,12,MIL,99,13,11,26,23
2012-12-21,NYK,106,19,6,CHI,110,14,10,33,16
2012-12-21,DET,100,7,21,WAS,68,3,20,10,41
2012-12-21,CLE,89,5,22,IND,99,14,12,19,34
2012-12-21,MEM,92,17,6,DAL,82,12,14,29,20
2012-12-21,SAS,99,19,8,NOH,94,5,20,24,28
2012-12-21,LAC,97,19,6,SAC,85,8,17,27,23
2012-12-21,GSW,115,17,9,CHA,100,7,18,24,27
2012-12-22,WAS,87,3,21,DET,96,8,21,11,42
2012-12-22,ATL,92,15,9,CHI,75,15,10,30,19
2012-12-22,MIA,105,17,6,UTA,89,14,13,31,19
2012-12-22,NOH,75,5,21,IND,81,15,12,20,33
2012-12-22,HOU,121,13,12,MEM,96,18,6,31,18
2012-12-22,MIL,82,14,11,CLE,94,5,23,19,34
2012-12-22,DEN,110,14,13,CHA,88,7,19,21,32
2012-12-22,POR,96,12,12,PHX,93,11,15,23,27
2012-12-22,GSW,115,18,9,LAL,118,12,14,30,23
2012-12-23,BKN,95,13,12,PHI,92,13,14,26,26
2012-12-23,NYK,94,19,7,MIN,91,13,11,32,18
2012-12-23,ORL,93,12,14,UTA,97,14,14,26,28
2012-12-23,SAS,129,20,8,DAL,91,12,15,32,23
2012-12-23,PHX,77,11,16,LAC,103,20,6,31,22
2012-12-23,SAC,108,8,18,POR,96,13,12,21,30
2012-12-25,BKN,76,14,12,BOS,93,13,13,27,25
2012-12-25,LAL,100,13,14,NYK,94,20,7,33,21
2012-12-25,MIA,103,18,6,OKC,97,21,5,39,11
2012-12-25,CHI,97,15,11,HOU,120,14,12,29,23
2012-12-25,LAC,112,21,6,DEN,100,15,13,36,19
2012-12-26,WAS,84,3,22,CLE,87,6,23,9,45
2012-12-26,CHA,92,7,20,MIA,105,19,6,26,26
2012-12-26,ORL,94,12,15,NOH,97,5,22,17,37
2012-12-26,ATL,126,16,9,DET,119,9,21,25,30
2012-12-26,MIL,108,14,12,BKN,93,14,13,28,25
2012-12-26,MEM,89,18,7,PHI,99,13,15,31,22
2012-12-26,MIN,84,13,12,HOU,87,15,12,28,24
2012-12-26,SAS,100,21,8,TOR,80,9,19,30,27
2012-12-26,DEN,126,15,14,LAL,114,14,14,29,28
2012-12-26,UTA,83,15,14,GSW,94,18,10,33,24
2012-12-26,PHX,97,11,17,NYK,99,20,8,31,25
2012-12-26,POR,109,13,13,SAC,91,9,18,22,31
2012-12-27,OKC,111,21,6,DAL,105,12,16,33,22
2012-12-27,LAC,106,22,6,BOS,77,14,13,36,19
2012-12-28,WAS,105,3,23,ORL,97,12,16,15,39
2012-12-28,IND,97,17,12,PHX,91,11,18,28,30
2012-12-28,BKN,97,14,14,CHA,81,7,21,21,35
2012-12-28,DET,109,9,22,MIA,99,20,6,29,28
2012-12-28,CLE,94,7,23,ATL,102,17,9,24,32
2012-12-28,NOH,97,6,22,TOR,104,9,20,15,42
2012-12-28,DAL,85,12,17,DEN,106,16,14,28,31
2012-12-28,SAS,122,22,8,HOU,116,16,12,38,20
2012-12-28,UTA,114,15,15,LAC,116,23,6,38,21
2012-12-28,SAC,106,9,19,NYK,105,21,8,30,27
2012-12-28,LAL,104,14,15,POR,87,14,13,28,28
2012-12-28,GSW,96,19,10,PHI,89,14,15,33,25
2012-12-29,CHA,95,7,22,NOH,98,6,23,13,45
2012-12-29,ATL,109,18,9,IND,100,18,12,36,21
2012-12-29,ORL,88,12,17,TOR,123,10,20,22,37
2012-12-29,BKN,103,15,14,CLE,100,7,24,22,38
2012-12-29,CHI,87,15,13,WAS,77,4,23,19,36
2012-12-29,MEM,81,18,8,DEN,72,17,14,35,22
2012-12-29,HOU,94,16,13,OKC,124,22,6,38,19
2012-12-29,MIN,111,13,13,PHX,107,11,19,24,32
2012-12-29,MIL,104,15,12,MIA,85,20,7,35,19
2012-12-29,POR,89,14,14,PHI,85,14,16,28,30
2012-12-29,GSW,101,20,10,BOS,83,14,14,34,24
2012-12-30,DET,96,10,22,MIL,94,16,12,26,34
2012-12-30,DAL,86,12,18,SAS,111,23,8,35,26
2012-12-30,SAC,118,10,19,BOS,96,14,15,24,34
2012-12-30,LAC,107,24,6,UTA,96,15,16,39,22
2012-12-31,IND,88,18,13,MEM,83,19,8,37,21
2012-12-31,CHI,81,16,13,CHA,91,7,23,23,36
2012-12-31,ORL,110,12,18,MIA,112,20,8,32,26
2012-12-31,HOU,123,16,14,ATL,104,19,9,35,23
2012-12-31,OKC,114,23,6,PHX,96,11,20,34,26
2012-12-31,SAS,104,24,8,BKN,73,16,14,40,22
2013-01-01,WAS,94,4,24,DAL,103,12,19,16,43
2013-01-01,NYK,100,21,9,POR,105,15,14,36,23
2013-01-01,DET,103,11,22,SAC,97,11,19,22,41
2013-01-01,NOH,86,7,23,ATL,95,19,10,26,33
2013-01-01,DEN,92,17,15,LAC,78,25,6,42,21
2013-01-01,LAL,99,15,15,PHI,103,14,17,29,32
2013-01-02,TOR,102,11,20,POR,79,16,14,27,34
2013-01-02,ORL,94,12,19,CHI,96,16,14,28,33
2013-01-02,CLE,94,7,25,SAC,97,11,20,18,45
2013-01-02,IND,89,19,13,WAS,81,4,25,23,38
2013-01-02,BOS,83,14,16,MEM,93,19,9,33,25
2013-01-02,MIA,119,21,8,DAL,109,13,19,34,27
2013-01-02,MIL,110,16,13,SAS,117,25,8,41,21
2013-01-02,HOU,104,17,14,NOH,92,7,24,24,38
2013-01-02,OKC,93,24,6,BKN,110,16,15,40,21
2013-01-02,UTA,106,15,17,MIN,84,14,13,29,30
2013-01-02,PHX,95,11,21,PHI,89,15,17,26,38
2013-01-02,GSW,115,21,10,LAC,94,25,7,46,17
2013-01-03,NYK,100,21,10,SAS,83,26,8,47,18
2013-01-03,DEN,97,18,15,MIN,101,14,14,32,29
2013-01-04,TOR,96,12,20,SAC,105,12,20,24,40
2013-01-04,WAS,113,4,26,BKN,115,17,15,21,41
2013-01-04,CHA,104,8,23,CLE,106,7,26,15,49
2013-01-04,MIA,89,22,8,CHI,96,17,14,39,22
2013-01-04,DET,85,12,22,ATL,84,20,10,32,32
2013-01-04,BOS,94,14,17,IND,75,20,13,34,30
2013-01-04,MEM,84,20,9,POR,86,16,15,36,24
2013-01-04,OKC,109,24,7,PHI,85,15,18,39,25
2013-01-04,MIL,101,16,14,HOU,115,18,14,34,28
2013-01-04,PHX,80,12,21,UTA,87,16,17,28,38
2013-01-04,LAC,107,25,8,LAL,102,15,16,40,24
2013-01-05,ATL,81,20,11,BOS,89,15,17,35,28
2013-01-05,ORL,106,12,20,NYK,114,22,10,34,30
2013-01-05,IND,95,20,14,MIL,80,16,15,36,29
2013-01-05,BKN,113,18,15,SAC,93,13,20,31,35
2013-01-05,CLE,104,8,26,HOU,112,19,14,27,40
2013-01-05,MIN,97,15,14,POR,102,17,15,32,29
2013-01-05,DAL,96,13,20,NOH,99,7,25,20,45
2013-01-05,SAS,109,26,9,PHI,86,15,19,41,28
2013-01-05,DEN,110,18,16,UTA,91,17,17,35,33
2013-01-05,LAC,115,26,8,GSW,89,22,10,48,18
2013-01-06,TOR,92,12,21,OKC,104,25,7,37,28
2013-01-06,MIA,99,22,9,WAS,71,4,27,26,36
2013-01-06,DET,101,13,22,CHA,108,8,24,21,46
2013-01-06,PHX,81,12,22,MEM,92,20,10,32,32
2013-01-06,LAL,105,15,17,DEN,112,19,16,34,33
2013-01-07,WAS,101,4,28,OKC,99,26,7,30,35
2013-01-07,NYK,96,23,10,BOS,102,16,17,39,27
2013-01-07,CHI,118,18,14,CLE,92,8,27,26,41
2013-01-07,NOH,95,8,25,SAS,88,27,9,35,34
2013-01-07,UTA,100,17,18,DAL,94,13,21,30,39
2013-01-07,SAC,81,13,21,MEM,113,21,10,34,31
2013-01-07,POR,125,18,15,ORL,119,12,21,30,36
2013-01-08,PHI,89,15,20,BKN,109,19,15,34,35
2013-01-08,IND,87,21,14,MIA,77,23,9,44,23
2013-01-08,MIL,108,16,16,PHX,99,12,23,28,39
2013-01-08,HOU,125,20,14,LAL,112,15,18,35,32
2013-01-08,MIN,108,15,15,ATL,103,20,12,35,27
2013-01-09,TOR,90,12,22,PHI,72,15,21,27,43
2013-01-09,CHA,102,9,24,UTA,112,18,18,27,42
2013-01-09,CLE,99,8,28,ATL,83,20,13,28,41
2013-01-09,BOS,87,17,17,PHX,79,12,24,29,41
2013-01-09,CHI,96,19,14,MIL,104,17,16,36,30
2013-01-09,NOH,88,9,25,HOU,79,21,14,30,39
2013-01-09,SAS,108,27,10,LAL,105,15,19,42,29
2013-01-09,OKC,106,26,8,MIN,84,16,15,42,23
2013-01-09,DEN,108,20,16,ORL,105,12,22,32,38
2013-01-09,LAC,99,27,8,DAL,93,13,22,40,30
2013-01-09,GSW,87,22,11,MEM,94,22,10,44,21
2013-01-10,IND,81,22,14,NYK,76,23,11,45,25
2013-01-10,SAC,112,13,22,DAL,117,13,23,26,45
2013-01-10,POR,92,19,15,MIA,90,23,10,42,25
2013-01-11,TOR,99,13,22,CHA,78,9,25,22,47
2013-01-11,BOS,103,18,17,HOU,91,21,15,39,32
2013-01-11,BKN,99,20,15,PHX,79,12,25,32,40
2013-01-11,ATL,103,20,14,UTA,95,19,18,39,32
2013-01-11,NYK,101,23,12,CHI,108,19,15,42,27
2013-01-11,MEM,101,23,10,SAS,98,28,10,51,20
2013-01-11,NOH,104,10,25,MIN,92,16,16,26,41
2013-01-11,MIL,87,18,16,DET,103,13,23,31,39
2013-01-11,DEN,98,21,16,CLE,91,9,28,30,44
2013-01-11,LAL,101,15,20,OKC,116,27,8,42,28
2013-01-11,GSW,103,22,12,POR,97,20,15,42,27
2013-01-12,LAC,101,28,8,ORL,104,12,23,40,31
2013-01-12,WAS,93,5,28,ATL,83,21,14,26,42
2013-01-12,IND,96,23,14,CHA,88,9,26,32,40
2013-01-12,PHI,107,15,22,HOU,100,21,16,36,38
2013-01-12,DET,87,14,23,UTA,90,19,19,33,42
2013-01-12,CHI,81,20,15,PHX,97,12,26,32,41
2013-01-12,DAL,104,14,23,MEM,83,24,10,38,33
2013-01-12,SAC,99,13,23,MIA,128,23,11,36,34
2013-01-13,NYK,100,23,13,NOH,87,11,25,34,38
2013-01-13,TOR,96,14,22,MIL,107,18,17,32,39
2013-01-13,BKN,97,21,15,IND,86,24,14,45,29
2013-01-13,SAS,106,28,11,MIN,88,16,17,44,28
2013-01-13,DEN,116,22,16,GSW,105,23,12,45,28
2013-01-13,POR,83,20,16,OKC,87,28,8,48,24
2013-01-13,LAL,113,15,21,CLE,93,9,29,24,50
2013-01-14,WAS,120,6,28,ORL,91,13,23,19,51
2013-01-14,BOS,100,19,17,CHA,89,9,27,28,44
2013-01-14,CHI,97,20,16,ATL,58,21,15,41,31
2013-01-14,MEM,73,24,11,LAC,99,28,9,52,20
2013-01-14,DAL,113,15,23,MIN,98,16,18,31,41
2013-01-14,UTA,104,20,19,MIA,97,24,11,44,30
2013-01-14,PHX,90,13,26,OKC,102,29,8,42,34
2013-01-14,SAC,124,13,24,CLE,118,9,30,22,54
2013-01-15,PHI,99,16,22,NOH,111,11,26,27,48
2013-01-15,CHA,76,9,28,IND,103,24,15,33,43
2013-01-15,BKN,113,22,15,TOR,106,14,23,36,38
2013-01-15,HOU,109,21,17,LAC,117,29,9,50,26
2013-01-15,DEN,115,23,16,POR,111,20,17,43,33
2013-01-15,LAL,104,16,21,MIL,88,19,17,35,38
2013-01-16,TOR,105,14,24,CHI,107,21,16,35,40
2013-01-16,ORL,97,13,24,IND,86,25,15,38,39
2013-01-16,ATL,109,21,16,BKN,95,23,15,44,31
2013-01-16,BOS,78,20,17,NOH,90,12,26,32,43
2013-01-16,OKC,117,30,8,DEN,97,24,16,54,24
2013-01-16,DAL,105,16,23,HOU,100,21,18,37,41
2013-01-16,SAS,103,29,11,MEM,82,24,12,53,23
2013-01-16,SAC,95,14,24,WAS,94,7,28,21,52
2013-01-16,POR,88,20,18,CLE,93,9,31,29,49
2013-01-16,GSW,75,23,13,MIA,92,24,12,47,25
2013-01-17,DET,87,14,24,NYK,102,24,13,38,37
2013-01-17,MIN,77,16,19,LAC,90,30,9,46,28
2013-01-17,PHX,94,13,27,MIL,98,19,18,32,45
2013-01-17,LAL,90,17,21,MIA,99,25,12,42,33
2013-01-18,BOS,99,20,18,CHI,100,22,16,42,34
2013-01-18,PHI,108,16,23,TOR,101,14,25,30,48
2013-01-18,ORL,100,14,24,CHA,106,9,29,23,53
2013-01-18,IND,105,25,16,HOU,95,21,19,46,35
2013-01-18,BKN,94,23,16,ATL,89,22,16,45,32
2013-01-18,MEM,85,24,13,SAC,69,15,24,39,37
2013-01-18,SAS,95,30,11,GSW,88,23,14,53,25
2013-01-18,DEN,108,24,17,WAS,112,7,29,31,46
2013-01-18,DAL,114,17,23,OKC,117,31,8,48,31
2013-01-19,CHA,93,10,29,SAC,97,15,25,25,54
2013-01-19,ATL,93,22,17,SAS,98,31,11,53,28
2013-01-19,CHI,82,23,16,MEM,85,25,13,48,29
2013-01-19,NOH,112,13,26,GSW,116,23,15,36,41
2013-01-19,MIN,92,16,20,HOU,79,21,20,37,40
2013-01-19,UTA,109,21,19,CLE,98,10,31,31,50
2013-01-19,POR,104,20,19,MIL,110,20,18,40,37
2013-01-19,LAC,94,31,9,WAS,87,8,29,39,38
2013-01-20,TOR,108,14,26,LAL,103,17,22,31,48
2013-01-20,ORL,105,14,25,DAL,111,17,24,31,49
2013-01-20,DET,103,14,25,BOS,88,20,19,34,44
2013-01-20,DEN,121,24,18,OKC,118,32,8,56,26
2013-01-21,MEM,81,26,13,IND,82,26,16,52,29
2013-01-21,NOH,114,13,27,SAC,105,16,25,29,52
2013-01-21,CHA,94,10,30,HOU,100,21,21,31,51
2013-01-21,ATL,104,22,18,MIN,96,17,20,39,38
2013-01-21,NYK,85,25,13,BKN,88,24,16,49,29
2013-01-21,GSW,106,24,15,LAC,99,32,9,56,24
2013-01-21,PHI,85,17,23,SAS,90,32,11,49,34
2013-01-21,CHI,95,23,17,LAL,83,17,23,40,40
2013-01-21,POR,95,20,20,WAS,98,8,30,28,50
2013-01-22,CLE,95,10,32,BOS,90,20,20,30,52
2013-01-22,DET,105,15,25,ORL,90,14,26,29,51
2013-01-22,MIL,110,21,18,PHI,102,17,24,38,42
2013-01-22,LAC,97,32,10,OKC,109,32,9,64,19
2013-01-23,CHA,92,10,31,ATL,104,23,18,33,49
2013-01-23,MIA,123,26,12,TOR,116,15,26,41,38
2013-01-23,CHI,85,24,17,DET,82,16,25,40,42
2013-01-23,MEM,106,26,14,LAL,93,17,24,43,38
2013-01-23,HOU,95,22,21,DEN,105,25,18,47,39
2013-01-23,MIN,83,17,21,BKN,91,25,16,42,37
2013-01-23,SAS,106,33,11,NOH,102,14,27,47,38
2013-01-23,UTA,92,22,19,WAS,88,9,30,31,49
2013-01-23,SAC,96,16,26,PHX,106,13,28,29,54
2013-01-23,POR,100,20,21,IND,80,27,16,47,37
2013-01-23,GSW,104,25,15,OKC,99,33,9,58,24
2013-01-24,ORL,95,14,27,TOR,97,15,27,29,54
2013-01-24,BOS,86,20,21,NYK,89,25,14,45,35
2013-01-24,PHX,93,14,28,LAC,88,32,11,46,39
2013-01-25,WAS,114,9,31,MIN,101,17,22,26,53
2013-01-25,ATL,123,24,18,BOS,111,20,22,44,40
2013-01-25,MIA,110,27,12,DET,88,16,26,43,38
2013-01-25,CLE,113,11,32,MIL,108,22,18,33,50
2013-01-25,CHI,103,25,17,GSW,87,26,15,51,32
2013-01-25,MEM,101,27,14,BKN,77,26,16,53,30
2013-01-25,NOH,82,14,28,HOU,100,22,22,36,50
2013-01-25,DAL,107,18,24,SAS,113,34,11,52,35
2013-01-25,SAC,95,16,27,OKC,105,33,10,49,37
2013-01-25,LAL,102,17,25,UTA,84,23,19,40,44
2013-01-26,TOR,98,16,27,CLE,99,12,32,28,59
2013-01-26,PHI,97,17,25,NYK,80,26,14,43,39
2013-01-26,WAS,86,10,31,CHI,73,26,17,36,48
2013-01-26,CHA,102,10,32,MIN,101,17,23,27,55
2013-01-26,HOU,119,23,22,BKN,106,26,17,49,39
2013-01-26,MIL,109,22,19,GSW,102,26,16,48,35
2013-01-26,SAS,108,35,11,PHX,99,15,28,50,39
2013-01-26,DEN,121,26,18,SAC,93,16,28,42,46
2013-01-26,UTA,114,23,20,IND,110,27,17,50,37
2013-01-26,POR,101,21,21,LAC,100,32,12,53,33
2013-01-27,BOS,100,20,23,MIA,98,28,12,48,35
2013-01-27,LAL,105,18,25,OKC,96,34,10,52,35
2013-01-27,ORL,102,14,28,DET,104,16,27,30,55
2013-01-27,MEM,83,28,14,NOH,91,14,29,42,43
2013-01-27,NYK,106,26,15,ATL,104,25,18,51,33
2013-01-27,DAL,110,18,25,PHX,95,15,29,33,54
2013-01-27,LAC,96,32,13,POR,83,22,21,54,34
2013-01-28,TOR,102,16,28,GSW,114,26,17,42,45
2013-01-28,PHI,100,18,25,MEM,103,28,15,46,40
2013-01-28,WAS,94,11,31,SAC,96,16,29,27,60
2013-01-28,BKN,97,26,18,ORL,77,14,29,40,47
2013-01-28,CHI,93,26,18,CHA,85,11,32,37,50
2013-01-28,DEN,102,27,18,IND,101,27,18,54,36
2013-01-28,UTA,80,24,20,HOU,125,24,22,48,42
2013-01-29,CLE,95,13,32,GSW,108,27,17,40,49
2013-01-29,DET,90,17,27,MIL,117,23,19,40,46
2013-01-29,POR,106,22,22,DAL,104,19,25,41,47
2013-01-29,LAL,111,19,25,NOH,106,15,29,34,54
2013-01-30,PHI,92,18,26,WAS,84,11,32,29,58
2013-01-30,IND,98,27,19,DET,79,17,28,44,47
2013-01-30,BOS,99,21,23,SAC,81,17,29,38,52
2013-01-30,NYK,113,27,15,ORL,97,14,30,41,45
2013-01-30,ATL,93,25,19,TOR,92,16,29,41,48
2013-01-30,BKN,85,27,18,MIA,105,28,13,55,31
2013-01-30,MIL,88,24,19,CHI,104,27,18,51,37
2013-01-30,MIN,90,17,24,LAC,96,33,13,50,37
2013-01-30,SAS,102,36,11,CHA,78,11,33,47,44
2013-01-30,DEN,118,28,18,HOU,110,25,22,53,40
2013-01-30,UTA,104,24,21,NOH,99,15,30,39,51
2013-01-30,PHX,92,15,30,LAL,86,20,25,35,55
2013-01-31,OKC,106,34,11,MEM,89,29,15,63,26
2013-01-31,GSW,100,28,17,DAL,97,19,26,47,43
2013-02-01,TOR,98,16,30,LAC,73,34,13,50,43
2013-02-01,IND,102,28,19,MIA,89,29,13,57,32
2013-02-01,BOS,97,22,23,ORL,84,14,31,36,54
2013-02-01,BKN,93,27,19,CHI,89,28,18,55,37
2013-02-01,NYK,96,28,15,MIL,86,24,20,52,35
2013-02-01,PHI,89,19,26,SAC,80,17,30,36,56
2013-02-01,DET,117,17,29,CLE,99,13,33,30,62
2013-02-01,MEM,85,29,16,WAS,76,11,33,40,49
2013-02-01,DEN,113,29,18,NOH,98,15,31,44,49
2013-02-01,UTA,86,25,21,POR,77,23,22,48,43
2013-02-01,PHX,99,16,30,DAL,109,19,27,35,57
2013-02-01,MIN,100,17,25,LAL,111,20,26,37,51
2013-02-02,ATL,76,26,19,CHI,93,28,19,54,38
2013-02-02,NYK,120,29,15,SAC,81,17,31,46,46
2013-02-02,CLE,115,13,34,OKC,110,35,11,48,45
2013-02-02,HOU,109,25,23,CHA,95,11,34,36,57
2013-02-02,MIN,115,17,26,NOH,86,15,32,32,58
2013-02-02,MIL,107,24,21,ORL,98,14,32,38,53
2013-02-02,SAS,96,37,11,WAS,86,11,34,48,45
2013-02-02,POR,105,23,23,UTA,99,26,21,49,44
2013-02-02,GSW,113,29,17,PHX,93,16,31,45,48
2013-02-03,BOS,106,23,23,LAC,104,34,14,57,37
2013-02-03,DET,97,18,29,LAL,98,21,26,39,55
2013-02-03,TOR,85,17,30,MIA,100,29,14,46,44
2013-02-04,IND,111,16,12,CHI,101,15,12,31,24
2013-02-04,PHI,78,20,26,ORL,61,14,33,34,59
2013-02-04,WAS,98,11,35,LAC,90,34,15,45,50
2013-02-04,NYK,99,30,15,DET,85,18,30,48,45
2013-02-04,MIA,99,30,14,CHA,94,11,35,41,49
2013-02-04,OKC,112,35,12,DAL,91,20,27,55,39
2013-02-04,MIN,98,18,26,POR,100,24,23,42,49
2013-02-04,UTA,98,26,22,SAC,91,17,32,43,54
2013-02-05,IND,114,29,19,ATL,103,26,20,55,39
2013-02-05,BKN,83,28,19,LAL,92,22,26,50,45
2013-02-05,MEM,90,30,16,PHX,96,16,32,46,48
2013-02-05,HOU,140,26,23,GSW,109,30,17,56,40
2013-02-05,DEN,112,30,18,MIL,104,25,21,55,39
2013-02-06,TOR,95,17,31,BOS,99,24,23,41,54
2013-02-06,PHI,69,21,26,IND,88,30,19,51,45
2013-02-06,WAS,106,12,35,NYK,96,31,15,43,50
2013-02-06,ORL,76,14,34,LAC,86,34,16,48,50
2013-02-06,CLE,122,14,34,CHA,95,11,36,25,70
2013-02-06,ATL,103,26,21,MEM,92,30,17,56,38
2013-02-06,MIA,114,31,14,HOU,108,27,23,58,37
2013-02-06,DET,90,18,31,BKN,93,28,20,46,51
2013-02-06,NOH,93,15,33,PHX,84,17,32,32,65
2013-02-06,OKC,119,36,12,GSW,98,30,18,66,30
2013-02-06,DAL,105,20,28,POR,99,25,23,45,51
2013-02-06,MIN,94,18,27,SAS,104,38,11,56,38
2013-02-06,UTA,100,27,22,MIL,86,25,22,52,44
2013-02-07,BOS,116,25,23,LAL,95,23,26,48,49
2013-02-07,DEN,128,31,18,CHI,96,29,19,60,37
2013-02-08,WAS,89,13,35,BKN,74,29,20,42,55
2013-02-08,CHA,93,11,37,LAL,100,23,27,34,64
2013-02-08,IND,98,31,19,TOR,100,17,32,48,51
2013-02-08,ATL,100,27,21,NOH,111,16,33,43,54
2013-02-08,DET,119,18,32,SAS,109,39,11,57,43
2013-02-08,CLE,119,15,34,ORL,108,14,35,29,69
2013-02-08,MIA,111,32,14,LAC,89,35,16,67,30
2013-02-08,MEM,99,30,18,GSW,93,30,19,60,37
2013-02-08,HOU,118,27,24,POR,103,25,24,52,48
2013-02-08,OKC,127,37,12,PHX,96,17,33,54,45
2013-02-08,MIN,94,18,28,NYK,100,31,16,49,44
2013-02-08,UTA,89,28,22,CHI,93,29,20,57,42
2013-02-09,CLE,103,16,34,DEN,111,32,18,48,52
2013-02-09,PHI,87,21,27,CHA,76,11,38,32,65
2013-02-09,MIL,100,25,23,DET,105,19,32,44,55
2013-02-09,DAL,116,21,28,GSW,91,30,20,51,48
2013-02-09,SAC,120,17,33,UTA,109,28,23,45,56
2013-02-10,NYK,88,32,16,LAC,102,35,17,67,33
2013-02-10,MIA,107,33,14,LAL,97,24,27,57,41
2013-02-10,BOS,118,26,23,DEN,114,33,18,59,41
2013-02-10,TOR,102,18,32,NOH,89,17,33,35,65
2013-02-10,ORL,110,14,36,POR,104,25,25,39,61
2013-02-10,MEM,105,31,18,MIN,88,18,29,49,47
2013-02-10,BKN,86,29,21,SAS,111,39,12,68,33
2013-02-10,PHX,69,17,34,OKC,97,38,12,55,46
2013-02-10,SAC,117,18,33,HOU,111,28,24,46,57
2013-02-11,PHI,90,22,27,LAC,107,36,17,58,44
2013-02-11,CHA,94,11,39,BOS,91,27,23,38,62
2013-02-11,CLE,92,16,35,MIN,100,18,30,34,65
2013-02-11,IND,84,31,20,BKN,89,29,22,60,42
2013-02-11,DET,86,20,32,NOH,105,17,34,37,66
2013-02-11,CHI,89,30,20,SAS,103,40,12,70,32
2013-02-11,MIL,90,25,24,WAS,102,14,35,39,59
2013-02-11,DAL,101,22,28,ATL,105,27,22,49,50
2013-02-12,TOR,109,19,32,DEN,108,33,19,52,51
2013-02-12,MIA,117,34,14,POR,104,25,26,59,40
2013-02-12,MEM,108,32,18,SAC,101,19,33,51,51
2013-02-12,UTA,109,28,24,OKC,94,39,12,67,36
2013-02-12,LAL,91,24,28,PHX,85,17,35,41,63
2013-02-12,GSW,107,30,21,HOU,116,28,25,58,46
2013-02-13,ORL,76,15,36,ATL,108,28,22,43,58
2013-02-13,CLE,95,16,36,SAS,96,41,12,57,48
2013-02-13,IND,101,31,21,CHA,77,12,39,43,60
2013-02-13,BOS,71,27,24,CHI,69,30,21,57,45
2013-02-13,BKN,119,30,22,DEN,108,33,20,63,42
2013-02-13,NYK,88,32,17,TOR,92,20,32,52,49
2013-02-13,DET,96,20,33,WAS,85,15,35,35,68
2013-02-13,MIL,94,25,25,PHI,92,22,28,47,53
2013-02-13,NOH,99,18,34,POR,63,25,27,43,61
2013-02-13,MIN,93,19,30,UTA,97,29,24,48,54
2013-02-13,DAL,123,22,29,SAC,100,19,34,41,63
2013-02-13,LAC,106,37,17,HOU,96,29,25,66,42
2013-02-14,OKC,100,39,13,MIA,110,35,14,74,27
2013-02-14,LAL,101,25,28,LAC,125,38,17,63,45
2013-02-19,WAS,88,15,36,TOR,96,21,32,36,68
2013-02-19,ORL,92,15,37,CHA,105,12,40,27,77
2013-02-19,BKN,113,31,22,MIL,111,26,25,57,47
2013-02-19,DET,91,21,33,MEM,105,33,18,54,51
2013-02-19,NOH,87,19,34,CHI,96,30,22,49,56
2013-02-19,DEN,97,33,21,BOS,90,28,24,61,45
2013-02-19,UTA,115,30,24,GSW,101,30,22,60,46
2013-02-19,SAC,102,19,35,SAS,108,42,12,61,47
2013-02-19,POR,98,25,28,PHX,102,17,36,42,64
2013-02-20,TOR,82,22,32,MEM,88,34,18,56,50
2013-02-20,CHA,99,13,40,DET,105,21,34,34,74
2013-02-20,CLE,105,16,37,NOH,100,19,35,35,72
2013-02-20,IND,125,32,21,NYK,91,32,18,64,39
2013-02-20,ATL,90,29,22,MIA,103,36,14,65,36
2013-02-20,MIL,94,26,26,BKN,97,32,22,58,48
2013-02-20,HOU,122,29,26,OKC,119,39,14,68,40
2013-02-20,MIN,94,19,31,PHI,87,22,29,41,60
2013-02-20,DAL,111,23,29,ORL,96,15,38,38,67
2013-02-20,LAL,113,25,29,BOS,99,28,25,53,54
2013-02-20,GSW,108,30,23,PHX,98,18,36,48,59
2013-02-21,CHI,67,31,22,MIA,86,37,14,68,36
2013-02-21,LAC,90,39,17,SAS,116,43,12,82,29
2013-02-22,TOR,100,22,33,NYK,98,32,19,54,52
2013-02-22,WAS,119,15,37,DEN,113,34,21,49,58
2013-02-22,CHA,75,13,41,CHI,105,31,23,44,64
2013-02-22,IND,114,33,21,DET,82,22,34,55,55
2013-02-22,BKN,96,33,22,HOU,106,30,26,63,48
2013-02-22,ATL,122,29,23,SAC,108,19,36,48,59
2013-02-22,MEM,88,35,18,ORL,82,15,39,50,57
2013-02-22,NOH,100,19,36,DAL,104,24,29,43,65
2013-02-22,OKC,127,39,15,MIN,111,20,31,59,46
2013-02-22,PHX,88,18,37,BOS,113,28,26,46,63
2013-02-22,LAL,111,26,29,POR,107,25,29,51,58
2013-02-22,GSW,107,31,23,SAS,101,44,12,75,35
2013-02-23,WAS,105,16,37,HOU,103,31,26,47,63
2013-02-23,CHA,99,13,42,DEN,113,34,22,47,64
2013-02-23,ORL,94,15,40,CLE,118,17,37,32,77
2013-02-23,PHI,90,22,30,MIA,114,38,14,60,44
2013-02-23,DET,72,22,35,IND,90,34,21,56,56
2013-02-23,MIL,102,26,27,ATL,103,30,23,56,50
2013-02-23,LAC,107,39,18,UTA,94,31,24,70,42
2013-02-24,DAL,99,25,29,LAL,103,27,29,52,58
2013-02-24,BKN,72,33,23,MEM,76,36,18,69,41
2013-02-24,MIN,99,20,32,GSW,100,32,23,52,55
2013-02-24,MIA,109,39,14,CLE,105,18,37,57,51
2013-02-24,NOH,110,19,37,SAC,95,19,37,38,74
2013-02-24,NYK,99,32,20,PHI,93,22,31,54,51
2013-02-24,PHX,87,18,38,SAS,97,44,13,62,51
2013-02-24,POR,92,25,30,BOS,86,29,26,54,56
2013-02-24,OKC,102,40,15,CHI,72,32,23,72,38
2013-02-25,TOR,84,23,33,WAS,90,17,37,40,70
2013-02-25,DET,103,22,36,ATL,114,31,23,53,59
2013-02-25,DEN,119,35,22,LAL,108,28,29,63,51
2013-02-25,UTA,107,31,25,BOS,110,29,27,60,52
2013-02-26,PHI,84,22,32,ORL,98,15,41,37,73
2013-02-26,IND,108,35,21,GSW,97,33,23,68,44
2013-02-26,MIA,141,40,14,SAC,129,19,38,59,52
2013-02-26,CHI,98,32,24,CLE,101,18,38,50,62
2013-02-26,NOH,97,20,37,BKN,101,33,24,53,61
2013-02-26,DAL,90,25,30,MIL,95,26,28,51,58
2013-02-26,PHX,84,18,39,MIN,83,20,33,38,72
2013-02-26,LAC,106,40,18,CHA,84,13,43,53,61
2013-02-27,ORL,101,16,41,SAC,125,19,39,35,80
2013-02-27,CLE,103,19,38,TOR,92,23,34,42,72
2013-02-27,NYK,109,33,20,GSW,105,33,24,66,44
2013-02-27,WAS,95,18,37,DET,96,22,37,40,74
2013-02-27,MEM,90,37,18,DAL,84,25,31,62,49
2013-02-27,HOU,107,31,27,MIL,110,27,28,58,55
2013-02-27,OKC,119,41,15,NOH,74,20,38,61,53
2013-02-27,SAS,101,45,13,PHX,105,19,39,64,52
2013-02-27,UTA,91,31,26,ATL,102,32,23,63,49
2013-02-27,POR,109,26,30,DEN,111,36,22,62,52
2013-02-28,IND,91,36,21,LAC,99,41,18,77,39
2013-02-28,CHI,93,32,25,PHI,82,22,33,54,58
2013-02-28,LAL,116,28,30,MIN,94,20,34,48,64
2013-03-01,TOR,81,23,35,IND,93,36,22,59,57
2013-03-01,WAS,88,18,38,NYK,96,34,20,52,58
2013-03-01,ORL,110,16,42,HOU,118,31,28,47,70
2013-03-01,BOS,94,30,27,GSW,86,33,25,63,52
2013-03-01,MIA,98,41,14,MEM,91,38,18,79,32
2013-03-01,CLE,89,20,38,LAC,105,42,18,62,56
2013-03-01,BKN,90,34,24,DAL,98,25,32,59,56
2013-03-01,NOH,100,20,39,DET,95,23,37,43,76
2013-03-01,SAS,130,45,14,SAC,102,20,39,65,53
2013-03-01,UTA,98,31,27,CHA,68,13,44,44,71
2013-03-01,PHX,92,20,39,ATL,87,33,23,53,62
2013-03-01,DEN,105,37,22,OKC,103,42,15,79,37
2013-03-02,PHI,104,22,34,GSW,97,33,26,55,60
2013-03-02,CHI,96,33,25,BKN,85,34,25,67,50
2013-03-02,MIL,122,28,28,TOR,114,23,36,51,64
2013-03-02,POR,109,26,31,MIN,94,20,35,46,66
2013-03-03,NYK,93,35,20,MIA,99,42,14,77,34
2013-03-03,LAC,104,43,18,OKC,108,42,16,85,34
2013-03-03,WAS,90,18,39,PHI,87,23,34,41,73
2013-03-03,ORL,82,16,43,MEM,108,38,19,54,62
2013-03-03,SAC,119,20,40,CHA,83,13,45,33,85
2013-03-03,HOU,136,32,28,DAL,103,26,32,58,60
2013-03-03,SAS,114,46,14,DET,75,23,38,69,52
2013-03-03,IND,97,37,22,CHI,92,34,25,71,47
2013-03-03,LAL,99,29,30,ATL,98,33,24,62,54
2013-03-04,CLE,97,20,39,NYK,102,35,21,55,60
2013-03-04,MIL,109,29,28,UTA,108,32,27,61,55
2013-03-04,NOH,102,21,39,ORL,105,16,44,37,83
2013-03-04,MIN,81,20,36,MIA,97,43,14,63,50
2013-03-04,DEN,104,38,22,ATL,88,33,25,71,47
2013-03-04,POR,122,27,31,CHA,105,13,46,40,77
2013-03-04,GSW,125,33,27,TOR,118,23,37,56,64
2013-03-05,PHI,101,23,35,BOS,109,31,27,54,62
2013-03-05,OKC,122,43,16,LAL,105,30,30,73,46
2013-03-05,SAC,113,21,40,DEN,120,39,22,60,62
2013-03-06,CHA,78,13,47,BKN,99,34,26,47,73
2013-03-06,CLE,104,20,40,UTA,101,32,28,52,68
2013-03-06,IND,81,38,22,BOS,83,32,27,70,49
2013-03-06,ATL,107,33,26,PHI,96,23,36,56,62
2013-03-06,MIA,97,44,14,ORL,96,17,44,61,58
2013-03-06,DET,77,23,39,NYK,87,36,21,59,60
2013-03-06,MEM,91,39,19,POR,85,28,31,67,50
2013-03-06,NOH,102,21,40,LAL,108,30,31,51,71
2013-03-06,MIN,87,20,37,WAS,82,19,39,39,76
2013-03-06,DAL,112,26,33,HOU,108,33,28,59,61
2013-03-06,SAS,101,47,14,CHI,83,34,26,81,40
2013-03-06,PHX,71,21,39,TOR,98,23,38,44,77
2013-03-06,LAC,117,43,19,MIL,101,30,28,73,47
2013-03-06,GSW,87,34,27,SAC,83,21,41,55,68
2013-03-07,NYK,94,37,21,OKC,95,44,16,81,37
2013-03-07,DEN,107,40,22,LAC,92,44,19,84,41
2013-03-08,CHA,94,13,48,OKC,116,45,16,58,64
2013-03-08,ORL,86,17,45,IND,115,38,23,55,68
2013-03-08,BOS,107,33,27,ATL,102,34,26,67,53
2013-03-08,BKN,95,35,26,WAS,78,19,40,54,66
2013-03-08,DET,99,23,40,DAL,102,27,33,50,73
2013-03-08,CLE,92,21,40,MEM,103,40,19,61,59
2013-03-08,MIA,102,45,14,PHI,93,23,37,68,51
2013-03-08,CHI,89,34,27,UTA,88,32,29,66,56
2013-03-08,SAS,106,48,14,POR,136,28,32,76,46
2013-03-08,SAC,121,21,42,PHX,112,21,40,42,82
2013-03-08,LAL,118,31,31,TOR,116,24,38,55,69
2013-03-08,GSW,88,35,27,HOU,94,33,29,68,56
2013-03-09,ATL,80,34,27,BKN,93,36,26,70,53
2013-03-09,NYK,113,37,22,UTA,84,32,30,69,52
2013-03-09,WAS,104,19,41,CHA,87,13,49,32,90
2013-03-09,MEM,96,41,19,NOH,85,21,41,62,60
2013-03-09,DEN,111,41,22,MIN,88,21,37,62,59
2013-03-09,PHX,107,21,41,HOU,105,34,29,55,70
2013-03-09,GSW,93,35,28,MIL,103,30,29,65,57
2013-03-10,OKC,91,46,16,BOS,79,34,27,80,43
2013-03-10,LAL,90,32,31,CHI,81,35,27,67,58
2013-03-10,TOR,100,24,39,CLE,96,21,41,45,80
2013-03-10,ORL,99,17,46,PHI,91,23,38,40,84
2013-03-10,MIA,105,46,14,IND,91,39,23,85,37
2013-03-10,NOH,98,21,42,POR,96,29,32,50,74
2013-03-10,MIN,77,21,38,DAL,100,28,33,49,71
2013-03-10,SAC,113,22,42,MIL,115,31,29,53,71
2013-03-10,LAC,129,44,20,DET,97,23,41,67,61
2013-03-11,PHI,106,23,39,BKN,97,37,26,60,65
2013-03-11,SAS,105,48,15,OKC,93,47,16,95,31
2013-03-11,UTA,103,32,31,DET,90,23,42,55,73
2013-03-11,PHX,93,22,41,DEN,108,42,22,64,63
2013-03-11,GSW,92,35,29,NYK,63,38,22,73,51
2013-03-12,CHA,100,13,50,BOS,74,34,28,47,78
2013-03-12,ORL,97,18,46,LAL,106,33,31,51,77
2013-03-12,CLE,95,21,42,WAS,90,20,41,41,83
2013-03-12,BKN,108,37,27,NOH,98,22,42,59,69
2013-03-12,MIA,98,47,14,ATL,81,34,28,81,42
2013-03-12,MIL,108,32,29,DAL,115,29,33,61,62
2013-03-12,MIN,107,21,39,SAS,83,49,15,70,54
2013-03-12,POR,97,29,33,MEM,102,42,19,71,52
2013-03-13,PHI,94,24,39,MIA,98,48,14,72,53
2013-03-13,WAS,106,20,42,MIL,93,32,30,52,72
2013-03-13,IND,107,39,24,MIN,91,22,39,61,63
2013-03-13,BOS,112,34,29,TOR,88,25,39,59,68
2013-03-13,ATL,96,34,29,LAL,92,34,31,68,60
2013-03-13,HOU,111,34,30,PHX,81,22,42,56,72
2013-03-13,OKC,110,47,17,UTA,87,33,31,80,48
2013-03-13,SAC,121,22,43,CHI,79,35,28,57,71
2013-03-13,DEN,117,43,22,NYK,94,38,23,81,45
2013-03-13,LAC,85,45,20,MEM,96,43,19,88,39
2013-03-13,GSW,105,36,29,DET,97,23,43,59,72
2013-03-14,SAS,92,49,16,DAL,91,30,33,79,49
2013-03-14,POR,105,29,34,NYK,90,38,24,67,58
2013-03-15,TOR,92,25,40,CHA,78,14,50,39,90
2013-03-15,WAS,96,21,42,NOH,87,22,43,43,85
2013-03-15,IND,93,40,24,LAL,99,34,32,74,56
2013-03-15,ATL,107,35,29,PHX,94,22,43,57,72
2013-03-15,HOU,108,35,30,MIN,100,22,40,57,70
2013-03-15,OKC,117,48,17,ORL,104,18,47,66,64
2013-03-15,MIL,94,32,31,MIA,107,49,14,81,45
2013-03-15,DAL,96,30,34,CLE,86,22,42,52,76
2013-03-15,DEN,87,44,22,MEM,80,44,19,88,41
2013-03-15,GSW,95,37,29,CHI,113,35,29,72,58
2013-03-16,WAS,127,22,42,PHX,105,22,44,44,86
2013-03-16,BOS,105,35,29,CHA,88,14,51,49,80
2013-03-16,PHI,98,24,40,IND,91,40,25,64,65
2013-03-16,SAS,119,50,16,CLE,113,22,43,72,59
2013-03-16,UTA,90,33,32,MEM,84,44,20,77,52
2013-03-16,POR,112,30,34,DET,101,23,44,53,78
2013-03-17,TOR,91,26,40,MIA,108,50,14,76,54
2013-03-17,MIL,115,32,32,ORL,109,18,48,50,80
2013-03-17,LAC,93,45,21,NYK,80,38,25,83,46
2013-03-17,HOU,78,36,30,GSW,108,37,30,73,60
2013-03-17,MIN,97,22,41,NOH,95,22,44,44,85
2013-03-17,DAL,101,31,34,OKC,107,49,17,80,51
2013-03-17,BKN,93,38,27,ATL,105,36,29,74,56
2013-03-17,LAL,113,35,32,SAC,102,23,43,58,75
2013-03-18,PHI,101,25,40,POR,100,31,34,56,74
2013-03-18,CHA,119,14,52,WAS,114,23,42,37,94
2013-03-18,CLE,90,22,44,IND,111,40,26,62,70
2013-03-18,ATL,113,37,29,DAL,127,31,35,68,64
2013-03-18,DET,82,23,45,BKN,119,38,28,61,73
2013-03-18,BOS,103,36,29,MIA,105,51,14,87,43
2013-03-18,CHI,118,36,29,DEN,119,45,22,81,51
2013-03-18,MEM,92,44,21,MIN,77,23,41,67,62
2013-03-18,NOH,72,22,45,GSW,93,38,30,60,75
2013-03-18,PHX,99,22,45,LAL,76,36,32,58,77
2013-03-18,UTA,83,34,32,NYK,90,38,26,72,58
2013-03-19,IND,95,41,26,ORL,73,18,49,59,75
2013-03-19,MIL,102,33,32,POR,95,31,35,64,67
2013-03-19,OKC,104,50,17,DEN,114,46,22,96,39
2013-03-19,SAC,116,23,44,LAC,101,46,21,69,65
2013-03-20,CHA,107,15,52,TOR,101,26,41,41,93
2013-03-20,CLE,95,22,45,MIA,98,52,14,74,59
2013-03-20,NYK,106,39,26,ORL,94,18,50,57,76
2013-03-20,ATL,98,37,30,MIL,90,34,32,71,62
2013-03-20,MEM,90,45,21,OKC,89,50,18,95,39
2013-03-20,NOH,87,22,46,BOS,86,36,30,58,76
2013-03-20,HOU,100,36,31,UTA,93,34,33,70,64
2013-03-20,DAL,96,32,35,BKN,113,39,28,71,63
2013-03-20,SAS,104,51,16,GSW,93,39,30,90,46
2013-03-20,PHX,79,23,45,WAS,88,23,43,46,88
2013-03-20,LAC,101,46,22,PHI,72,26,40,72,62
2013-03-21,CHI,89,36,30,POR,99,31,36,67,66
2013-03-21,DEN,101,47,22,PHI,100,26,41,73,63
2013-03-21,SAC,101,24,44,MIN,98,23,42,47,86
2013-03-22,TOR,94,26,42,NYK,99,40,26,66,68
2013-03-22,ORL,89,18,51,OKC,97,50,19,68,70
2013-03-22,IND,102,42,26,MIL,78,34,33,76,59
2013-03-22,ATL,93,38,30,POR,104,32,36,70,66
2013-03-22,MIA,103,53,14,DET,89,23,46,76,60
2013-03-22,NOH,90,23,46,MEM,83,46,21,69,67
2013-03-22,HOU,116,37,31,CLE,78,22,46,59,77
2013-03-22,DAL,104,32,36,BOS,94,36,31,68,67
2013-03-22,SAS,104,52,16,UTA,97,34,34,86,50
2013-03-22,PHX,86,23,46,MIN,117,23,43,46,89
2013-03-22,LAL,100,36,33,WAS,103,24,43,60,76
2013-03-23,CHA,91,16,52,DET,92,23,47,39,99
2013-03-23,NYK,110,41,26,TOR,84,26,43,67,69
2013-03-23,CHI,87,36,31,IND,84,43,26,79,57
2013-03-23,MEM,110,46,22,BOS,106,36,32,82,54
2013-03-23,DEN,101,48,22,SAC,95,25,44,73,66
2013-03-23,LAC,101,47,22,BKN,95,40,28,87,50
2013-03-23,GSW,101,39,31,WAS,92,25,43,64,74
2013-03-24,MIL,99,34,34,ATL,104,38,31,72,65
2013-03-24,MIA,109,54,14,CHA,77,16,53,70,67
2013-03-24,HOU,96,38,31,SAS,95,53,16,91,47
2013-03-24,OKC,103,51,19,POR,83,33,36,84,55
2013-03-24,MIN,97,24,43,CHI,104,37,31,61,74
2013-03-24,DAL,113,33,36,UTA,108,34,35,67,71
2013-03-24,PHX,100,23,47,BKN,102,40,29,63,76
2013-03-24,SAC,103,25,45,PHI,117,26,42,51,87
2013-03-25,WAS,107,25,44,MEM,94,47,22,72,66
2013-03-25,ORL,94,18,52,MIA,108,55,14,73,66
2013-03-25,IND,100,43,27,ATL,94,39,31,82,58
2013-03-25,NOH,110,24,46,DEN,86,49,22,73,68
2013-03-25,UTA,107,34,36,PHI,91,27,42,61,78
2013-03-25,GSW,109,40,31,LAL,103,36,34,76,65
2013-03-26,BOS,85,36,33,NYK,100,42,26,78,59
2013-03-26,DET,82,24,47,MIN,105,24,44,48,91
2013-03-26,DAL,109,34,36,LAC,102,48,22,82,58
2013-03-27,TOR,88,26,44,ATL,107,39,32,65,76
2013-03-27,PHI,100,27,43,MIL,92,34,35,61,78
2013-03-27,CHA,114,16,54,ORL,108,18,53,34,107
2013-03-27,CLE,92,22,47,BOS,93,36,34,58,81
2013-03-27,NYK,108,43,26,MEM,101,47,23,90,49
2013-03-27,CHI,101,38,31,MIA,97,56,14,94,45
2013-03-27,NOH,91,25,46,LAC,105,48,23,73,69
2013-03-27,HOU,91,39,31,IND,100,44,27,83,58
2013-03-27,OKC,103,52,19,WAS,80,26,44,78,63
2013-03-27,MIN,117,25,44,LAL,120,36,35,61,79
2013-03-27,SAS,100,53,17,DEN,99,49,23,102,40
2013-03-27,UTA,103,35,36,PHX,88,23,48,58,84
2013-03-27,GSW,98,41,31,SAC,105,25,46,66,77
2013-03-27,POR,93,33,37,BKN,111,41,29,74,66
2013-03-28,MIL,113,34,36,LAL,103,37,35,71,71
2013-03-28,DAL,78,35,36,IND,103,45,27,80,63
2013-03-28,PHX,103,23,49,SAC,117,26,46,49,95
2013-03-29,ORL,97,18,54,WAS,92,26,45,44,99
2013-03-29,BOS,118,37,34,ATL,107,40,32,77,66
2013-03-29,NYK,111,44,26,CHA,102,17,54,61,80
2013-03-29,DET,82,24,48,TOR,99,26,45,50,93
2013-03-29,CLE,87,22,48,PHI,97,28,43,50,91
2013-03-29,MEM,103,47,24,HOU,94,39,32,86,56
2013-03-29,NOH,89,25,47,MIA,108,56,15,81,62
2013-03-29,MIN,101,25,45,OKC,93,53,19,78,64
2013-03-29,SAS,104,54,17,LAC,102,49,23,103,40
2013-03-29,DEN,109,49,24,BKN,87,42,29,91,53
2013-03-29,POR,95,33,38,UTA,105,36,36,69,74
2013-03-30,DAL,100,35,37,CHI,98,39,31,74,68
2013-03-30,ATL,97,40,33,ORL,88,19,54,59,87
2013-03-30,PHI,100,29,43,CHA,92,17,55,46,98
2013-03-30,HOU,98,39,33,LAC,81,49,24,88,57
2013-03-30,MIN,86,26,45,MEM,99,48,24,74,69
2013-03-30,MIL,99,35,36,OKC,109,53,20,88,56
2013-03-30,UTA,116,37,36,BKN,107,42,30,79,66
2013-03-30,PHX,104,23,50,IND,112,46,27,69,77
2013-03-30,SAC,98,27,46,LAL,103,37,36,64,82
2013-03-30,GSW,125,41,32,POR,98,33,39,74,71
2013-03-31,WAS,109,26,46,TOR,92,27,45,53,91
2013-03-31,NOH,112,25,48,CLE,92,22,49,47,97
2013-03-31,CHI,95,39,32,DET,94,24,49,63,81
2013-03-31,SAS,86,55,17,MIA,88,57,15,112,32
2013-03-31,NYK,108,45,26,BOS,89,38,34,83,60
2013-04-01,TOR,98,27,46,DET,108,24,50,51,96
2013-04-01,ATL,102,41,33,CLE,94,22,50,63,83
2013-04-01,MIL,131,35,37,CHA,102,17,56,52,93
2013-04-01,MEM,92,49,24,SAS,90,55,18,104,42
2013-04-01,HOU,111,40,33,ORL,103,19,55,59,88
2013-04-01,MIN,110,26,46,BOS,100,38,35,64,81
2013-04-01,UTA,112,38,36,POR,102,33,40,71,76
2013-04-01,LAC,106,49,25,IND,109,47,27,96,52
2013-04-02,WAS,90,27,46,CHI,86,40,32,67,78
2013-04-02,MIA,90,58,15,NYK,102,46,26,104,41
2013-04-02,LAL,101,38,36,DAL,81,36,37,74,73
2013-04-03,TOR,88,27,47,WAS,78,28,46,55,93
2013-04-03,CHA,88,17,57,PHI,83,30,43,47,100
2013-04-03,ATL,82,42,33,NYK,95,47,26,89,59
2013-04-03,CLE,95,22,51,BKN,113,42,31,64,82
2013-04-03,BOS,98,38,36,DET,93,25,50,63,86
2013-04-03,MIL,98,36,37,MIN,107,27,46,63,83
2013-04-03,SAS,98,55,19,ORL,84,19,56,74,75
2013-04-03,UTA,96,39,36,DEN,113,50,24,89,60
2013-04-03,SAC,102,27,47,HOU,112,41,33,68,80
2013-04-03,POR,76,33,41,MEM,94,50,24,83,65
2013-04-03,LAC,126,49,26,PHX,101,23,51,72,77
2013-04-03,GSW,98,42,32,NOH,88,26,48,68,80
2013-04-04,BKN,90,43,31,CHI,92,40,33,83,64
2013-04-04,DEN,95,51,24,DAL,94,36,38,87,62
2013-04-04,OKC,100,54,20,SAS,88,56,19,110,39
2013-04-05,CHA,79,18,57,MIA,89,58,16,76,73
2013-04-05,BOS,91,39,36,CLE,97,22,52,61,88
2013-04-05,NYK,101,48,26,MIL,83,36,38,84,64
2013-04-05,ATL,90,42,34,PHI,101,30,44,72,78
2013-04-05,IND,75,48,27,OKC,97,55,20,103,47
2013-04-05,CHI,87,41,33,ORL,86,19,57,60,90
2013-04-05,MIN,93,28,46,TOR,95,28,47,56,93
2013-04-05,UTA,95,39,37,NOH,83,26,49,65,86
2013-04-05,PHX,107,23,52,GSW,111,43,32,66,84
2013-04-05,SAC,108,27,48,DAL,117,36,39,63,87
2013-04-05,POR,98,33,42,HOU,116,42,33,75,75
2013-04-05,LAL,86,39,36,MEM,84,51,24,90,60
2013-04-06,WAS,104,28,47,IND,85,48,28,76,75
2013-04-06,BKN,105,43,32,CHA,96,18,58,61,90
2013-04-06,MIA,106,59,16,PHI,87,31,44,90,60
2013-04-06,MIN,107,28,47,DET,101,25,51,53,98
2013-04-06,MIL,100,36,39,TOR,83,29,47,65,86
2013-04-06,SAS,99,56,20,ATL,97,42,35,98,55
2013-04-06,DEN,132,52,24,HOU,114,43,33,95,57
2013-04-07,OKC,120,56,20,NYK,125,49,26,105,46
2013-04-07,LAC,109,50,26,LAL,95,40,36,90,62
2013-04-07,BOS,107,39,37,WAS,96,29,47,68,84
2013-04-07,CLE,91,23,52,ORL,85,19,58,42,110
2013-04-07,SAC,87,27,49,MEM,89,51,25,78,74
2013-04-07,DET,99,25,52,CHI,85,42,33,67,85
2013-04-07,GSW,90,44,32,UTA,97,40,37,84,69
2013-04-07,PHX,92,23,53,NOH,95,26,50,49,103
2013-04-07,POR,91,33,43,DAL,96,37,39,70,82
2013-04-09,IND,99,48,29,CLE,94,24,52,72,81
2013-04-09,BKN,104,44,32,PHI,83,31,45,75,77
2013-04-09,NYK,120,50,26,WAS,99,29,48,79,74
2013-04-09,MIA,94,60,16,MIL,83,37,39,97,55
2013-04-09,CHI,98,42,34,TOR,101,29,48,71,82
2013-04-09,MEM,94,52,25,CHA,75,18,59,70,84
2013-04-09,HOU,101,43,34,PHX,98,23,54,66,88
2013-04-09,UTA,80,41,37,OKC,90,56,21,97,58
2013-04-09,LAL,104,40,37,NOH,96,27,50,67,87
2013-04-09,GSW,105,44,33,MIN,89,29,47,73,80
2013-04-10,PHI,101,31,46,ATL,124,42,36,73,82
2013-04-10,WAS,98,29,49,MIA,103,61,16,90,65
2013-04-10,ORL,113,19,59,MIL,103,37,40,56,99
2013-04-10,CLE,104,24,53,DET,111,26,52,50,105
2013-04-10,BOS,93,40,37,BKN,101,45,32,85,69
2013-04-10,DAL,91,38,39,PHX,102,23,55,61,94
2013-04-10,SAC,121,27,50,NOH,110,27,51,54,101
2013-04-10,POR,106,33,44,LAL,113,41,37,74,81
2013-04-10,DEN,96,53,24,SAS,86,57,20,110,44
2013-04-10,LAC,111,51,26,MIN,95,29,48,80,74
2013-04-11,CHI,118,42,35,NYK,111,51,26,93,61
2013-04-11,GSW,97,45,33,OKC,116,57,21,102,54
2013-04-12,TOR,97,30,48,CHI,88,43,35,73,83
2013-04-12,WAS,86,29,50,PHI,97,31,47,60,97
2013-04-12,IND,109,49,29,BKN,117,46,32,95,61
2013-04-12,ATL,109,43,36,MIL,104,37,41,80,77
2013-04-12,MIA,109,62,16,BOS,101,40,38,102,54
2013-04-12,DET,113,27,52,CHA,93,18,60,45,112
2013-04-12,CLE,91,24,54,NYK,101,51,27,75,81
2013-04-12,NOH,93,27,52,LAC,96,52,26,79,78
2013-04-12,HOU,78,44,34,MEM,82,53,25,97,59
2013-04-12,DAL,108,38,40,DEN,105,54,24,92,64
2013-04-12,SAS,108,57,21,SAC,101,28,50,85,71
2013-04-12,UTA,107,41,38,MIN,100,29,49,70,87
2013-04-12,POR,90,33,45,OKC,106,58,21,91,66
2013-04-12,LAL,118,42,37,GSW,116,45,34,87,71
2013-04-13,CHA,95,18,61,MIL,85,37,42,55,103
2013-04-13,ORL,88,20,59,BOS,120,40,39,60,98
2013-04-13,MEM,87,54,25,LAC,91,53,26,107,51
2013-04-13,MIN,105,29,50,PHX,93,24,55,53,105
2013-04-14,MIA,105,63,16,CHI,93,43,36,106,52
2013-04-14,TOR,93,31,48,BKN,87,47,32,78,80
2013-04-14,NYK,90,52,27,IND,80,49,30,101,57
2013-04-14,PHI,91,32,47,CLE,77,24,55,56,102
2013-04-14,DEN,118,54,25,POR,109,33,46,87,71
2013-04-14,NOH,89,27,53,DAL,107,39,40,66,93
2013-04-14,HOU,121,44,35,SAC,100,28,51,72,86
2013-04-14,LAL,91,43,37,SAS,86,58,21,101,58
2013-04-15,CHA,106,19,61,NYK,95,53,27,72,88
2013-04-15,ORL,84,20,60,CHI,102,43,37,63,97
2013-04-15,CLE,95,24,56,MIA,96,64,16,88,72
2013-04-15,BKN,106,47,33,WAS,101,29,51,76,84
2013-04-15,DET,109,28,52,PHI,101,33,47,61,99
2013-04-15,MIL,111,37,43,DEN,112,55,25,92,68
2013-04-15,DAL,97,40,40,MEM,103,54,26,94,66
2013-04-15,OKC,104,59,21,SAC,95,28,52,87,73
2013-04-15,MIN,80,30,50,UTA,96,42,38,72,88
2013-04-15,PHX,119,24,56,HOU,112,45,35,69,91
2013-04-15,GSW,116,45,35,SAS,106,58,22,103,57
2013-04-16,ATL,96,44,36,TOR,113,32,48,76,84
2013-04-16,LAC,93,54,26,POR,77,33,47,87,73
2013-04-17,TOR,114,33,48,BOS,90,41,39,74,87
2013-04-17,BKN,103,48,33,DET,99,29,52,77,85
2013-04-17,NYK,98,53,28,ATL,92,44,37,97,65
2013-04-17,CHA,105,20,61,CLE,98,24,57,44,118
2013-04-17,MIA,105,65,16,ORL,93,20,61,85,77
2013-04-17,IND,95,49,31,PHI,105,33,48,82,79
2013-04-17,CHI,95,44,37,WAS,92,29,52,73,89
2013-04-17,MEM,86,55,26,UTA,70,43,38,98,64
2013-04-17,DAL,99,40,41,NOH,87,27,54,67,95
2013-04-17,SAS,95,58,23,MIN,108,30,51,88,74
2013-04-17,OKC,89,60,21,MIL,95,37,44,97,65
2013-04-17,DEN,118,56,25,PHX,98,25,56,81,81
2013-04-17,LAL,99,44,37,HOU,95,45,36,89,73
2013-04-17,SAC,108,28,53,LAC,112,55,26,83,79
2013-10-29,IND,97,0,0,ORL,87,0,0,0,0
2013-10-29,MIA,107,0,0,CHI,95,0,0,0,0
2013-10-29,LAL,116,0,0,LAC,103,0,0,0,0
2013-10-30,CLE,98,0,0,BKN,94,0,0,0,0
2013-10-30,PHI,114,0,0,MIA,110,1,0,1,0
2013-10-30,TOR,93,0,0,BOS,87,0,0,0,0
2013-10-30,DET,113,0,0,WAS,102,0,0,0,0
2013-10-30,NYK,90,0,0,MIL,83,0,0,0,0
2013-10-30,HOU,96,0,0,CHA,83,0,0,0,0
2013-10-30,MIN,120,0,0,ORL,115,0,1,0,1
2013-10-30,NOP,90,0,0,IND,95,1,0,1,0
2013-10-30,DAL,118,0,0,ATL,109,0,0,0,0
2013-10-30,SAS,101,0,0,MEM,94,0,0,0,0
2013-10-30,UTA,98,0,0,OKC,101,0,0,0,0
2013-10-30,PHX,104,0,0,POR,91,0,0,0,0
2013-10-30,SAC,90,0,0,DEN,88,0,0,0,0
2013-10-30,GSW,125,0,0,LAL,94,1,0,1,0
2013-10-31,CHI,82,0,1,NYK,81,1,0,1,1
2013-10-31,LAC,126,0,1,GSW,115,1,0,1,1
2013-11-01,CHA,90,0,1,CLE,84,1,0,1,1
2013-11-01,ORL,110,0,2,NOP,90,0,1,0,3
2013-11-01,WAS,102,0,1,PHI,109,1,0,1,1
2013-11-01,ATL,102,0,1,TOR,95,1,0,1,1
2013-11-01,BOS,98,0,1,MIL,105,0,1,0,2
2013-11-01,HOU,113,1,0,DAL,105,1,0,2,0
2013-11-01,MEM,111,0,1,DET,108,1,0,1,1
2013-11-01,MIN,100,1,0,OKC,81,1,0,2,0
2013-11-01,BKN,101,0,1,MIA,100,1,1,1,2
2013-11-01,DEN,98,0,1,POR,113,0,1,0,2
2013-11-01,PHX,87,1,0,UTA,84,0,1,1,1
2013-11-01,SAC,101,1,0,LAC,110,1,1,2,1
2013-11-01,LAL,85,1,1,SAS,91,1,0,2,1
2013-11-02,IND,89,2,0,CLE,74,1,1,3,1
2013-11-02,PHI,107,2,0,CHI,104,1,1,3,1
2013-11-02,NOP,105,0,2,CHA,84,1,1,1,3
2013-11-02,DAL,111,1,1,MEM,99,1,1,2,2
2013-11-02,MIL,90,1,1,TOR,97,1,1,2,2
2013-11-02,UTA,93,0,2,HOU,104,2,0,2,2
2013-11-02,POR,115,1,1,SAS,105,2,0,3,1
2013-11-02,GSW,98,1,1,SAC,87,1,1,2,2
2013-11-03,DET,87,1,1,BOS,77,0,2,1,3
2013-11-03,MIA,103,1,2,WAS,93,0,2,1,4
2013-11-03,ORL,107,1,2,BKN,86,1,1,2,3
2013-11-03,OKC,103,1,1,PHX,96,2,0,3,1
2013-11-03,NYK,100,1,1,MIN,109,2,0,3,1
2013-11-03,LAL,105,1,2,ATL,103,1,1,2,3
2013-11-04,CLE,93,1,2,MIN,92,3,0,4,2
2013-11-04,PHI,90,3,0,GSW,110,2,1,5,1
2013-11-04,MEM,95,1,2,BOS,88,0,3,1,5
2013-11-04,LAC,137,2,1,HOU,118,3,0,5,1
2013-11-05,TOR,95,2,1,MIA,104,2,2,4,3
2013-11-05,BKN,104,1,2,UTA,88,0,3,1,5
2013-11-05,DET,91,2,1,IND,99,3,0,5,1
2013-11-05,NYK,97,1,2,CHA,102,1,2,2,4
2013-11-05,NOP,98,1,2,PHX,104,2,1,3,3
2013-11-05,DAL,123,2,1,LAL,104,2,2,4,3
2013-11-05,DEN,94,0,2,SAS,102,2,1,2,3
2013-11-05,POR,101,2,1,HOU,116,3,1,5,2
2013-11-05,SAC,100,1,2,ATL,105,1,2,2,4
2013-11-06,CHA,92,2,2,TOR,90,2,2,4,4
2013-11-06,IND,97,4,0,CHI,80,1,2,5,2
2013-11-06,ORL,98,2,2,LAC,90,3,1,5,3
2013-11-06,PHI,102,3,1,WAS,116,0,3,3,4
2013-11-06,BOS,97,0,4,UTA,87,0,4,0,8
2013-11-06,MEM,84,2,2,NOP,99,1,3,3,5
2013-11-06,MIL,109,1,2,CLE,104,2,2,3,4
2013-11-06,MIN,93,3,1,GSW,106,3,1,6,2
2013-11-06,SAS,99,3,1,PHX,96,3,1,6,2
2013-11-06,OKC,107,2,1,DAL,93,3,1,5,2
2013-11-07,MIA,102,3,2,LAC,97,3,2,6,4
2013-11-07,DEN,109,0,3,ATL,107,2,2,2,5
2013-11-07,HOU,98,4,1,LAL,99,2,3,6,4
2013-11-08,CHA,91,3,2,NYK,101,1,3,4,5
2013-11-08,IND,91,5,0,TOR,84,2,3,7,3
2013-11-08,ORL,89,3,2,BOS,91,1,4,4,6
2013-11-08,PHI,94,3,2,CLE,79,2,3,5,5
2013-11-08,WAS,112,1,3,BKN,108,2,2,3,5
2013-11-08,DET,110,2,2,OKC,119,3,1,5,3
2013-11-08,CHI,97,1,3,UTA,73,0,5,1,8
2013-11-08,MIN,116,3,2,DAL,108,3,2,6,4
2013-11-08,NOP,96,2,3,LAL,85,3,3,5,6
2013-11-08,SAS,76,4,1,GSW,74,4,1,8,2
2013-11-08,PHX,114,3,2,DEN,103,1,3,4,5
2013-11-08,POR,104,2,2,SAC,91,1,3,3,5
2013-11-09,TOR,115,2,4,UTA,91,0,6,2,10
2013-11-09,ATL,104,2,3,ORL,94,3,3,5,6
2013-11-09,BKN,91,2,3,IND,96,6,0,8,3
2013-11-09,CLE,127,2,4,PHI,125,4,2,6,6
2013-11-09,MIA,110,4,2,BOS,111,2,4,6,6
2013-11-09,HOU,94,4,2,LAC,107,3,3,7,5
2013-11-09,MEM,108,2,3,GSW,90,4,2,6,5
2013-11-09,MIL,83,2,2,DAL,91,3,3,5,5
2013-11-09,SAC,85,1,4,POR,96,3,2,4,6
2013-11-10,NYK,89,2,3,SAS,120,5,1,7,4
2013-11-10,OKC,106,4,1,WAS,105,2,3,6,4
2013-11-10,PHX,101,4,2,NOP,94,3,3,7,5
2013-11-10,LAL,90,3,4,MIN,113,4,2,7,6
2013-11-11,CHA,94,3,3,ATL,103,3,3,6,6
2013-11-11,IND,95,7,0,MEM,79,3,3,10,3
2013-11-11,PHI,85,4,3,SAS,109,6,1,10,4
2013-11-11,BOS,120,3,4,ORL,105,3,4,6,8
2013-11-11,CHI,96,2,3,CLE,81,3,4,5,7
2013-11-11,HOU,110,4,3,TOR,104,3,4,7,7
2013-11-11,UTA,81,0,7,DEN,100,1,4,1,11
2013-11-11,POR,109,4,2,DET,103,2,3,6,5
2013-11-11,LAC,109,4,3,MIN,107,5,2,9,5
2013-11-12,MIA,118,4,3,MIL,95,2,3,6,6
2013-11-12,DAL,105,4,3,WAS,95,2,4,6,7
2013-11-12,GSW,113,4,3,DET,95,2,4,6,7
2013-11-12,LAL,116,3,5,NOP,95,3,4,6,9
2013-11-13,ORL,94,3,5,MIL,91,2,4,5,9
2013-11-13,PHI,123,4,4,HOU,117,5,3,9,7
2013-11-13,BOS,83,4,4,CHA,89,3,4,7,8
2013-11-13,MEM,87,3,4,TOR,103,3,5,6,9
2013-11-13,MIN,124,5,3,CLE,95,3,5,8,8
2013-11-13,ATL,91,4,3,NYK,95,2,4,6,7
2013-11-13,SAS,92,7,1,WAS,79,2,5,9,6
2013-11-13,DEN,111,2,4,LAL,99,4,5,6,9
2013-11-13,UTA,111,0,8,NOP,105,3,5,3,13
2013-11-13,POR,90,5,2,PHX,89,5,2,10,4
2013-11-13,SAC,107,1,5,BKN,86,2,4,3,9
2013-11-13,LAC,111,5,3,OKC,103,5,1,10,4
2013-11-14,NYK,106,3,4,HOU,109,5,4,8,8
2013-11-14,GSW,116,5,3,OKC,115,5,2,10,5
2013-11-15,IND,104,8,0,MIL,77,2,5,10,5
2013-11-15,TOR,80,4,5,CHI,96,3,3,7,8
2013-11-15,ATL,113,4,4,PHI,103,5,4,9,8
2013-11-15,BOS,96,4,5,POR,109,6,2,10,7
2013-11-15,CLE,80,3,6,CHA,86,4,4,7,10
2013-11-15,MIA,110,5,3,DAL,104,5,3,10,6
2013-11-15,DEN,117,3,4,MIN,113,6,3,9,7
2013-11-15,PHX,98,5,3,BKN,100,2,5,7,8
2013-11-15,UTA,82,1,8,SAS,91,8,1,9,9
2013-11-15,LAL,86,4,6,MEM,89,3,5,7,11
2013-11-15,SAC,90,2,5,DET,97,2,5,4,10
2013-11-16,CHA,81,5,4,MIA,97,6,3,11,7
2013-11-16,ORL,100,4,5,DAL,108,5,4,9,9
2013-11-16,WAS,96,2,6,CLE,103,3,7,5,13
2013-11-16,NYK,90,3,5,ATL,110,5,4,8,9
2013-11-16,CHI,110,4,3,IND,94,9,0,13,3
2013-11-16,HOU,122,6,4,DEN,111,4,4,10,8
2013-11-16,MIN,106,6,4,BOS,88,4,6,10,10
2013-11-16,NOP,135,3,6,PHI,98,5,5,8,11
2013-11-16,MIL,79,2,6,OKC,92,5,3,7,9
2013-11-16,GSW,102,6,3,UTA,88,1,9,7,12
2013-11-16,LAC,110,6,3,BKN,103,3,5,9,8
2013-11-17,TOR,110,4,6,POR,118,7,2,11,8
2013-11-17,SAC,86,2,6,MEM,97,4,5,6,11
2013-11-17,LAL,114,4,7,DET,99,3,5,7,12
2013-11-18,BKN,98,3,6,POR,108,8,2,11,8
2013-11-18,CHI,86,5,3,CHA,81,5,5,10,8
2013-11-18,OKC,115,6,3,DEN,113,4,5,10,8
2013-11-18,DAL,97,6,4,PHI,94,5,6,11,10
2013-11-18,UTA,87,1,10,GSW,98,7,3,8,13
2013-11-18,LAC,102,7,3,MEM,106,5,5,12,8
2013-11-19,WAS,104,2,7,MIN,100,7,4,9,11
2013-11-19,DET,92,3,6,NYK,86,3,6,6,12
2013-11-19,MIA,104,7,3,ATL,88,6,4,13,7
2013-11-19,HOU,109,7,4,BOS,85,4,7,11,11
2013-11-19,SAC,107,2,7,PHX,104,5,4,7,11
2013-11-20,CHA,95,5,6,BKN,91,3,7,8,13
2013-11-20,CLE,91,4,7,WAS,98,3,7,7,14
2013-11-20,NYK,96,3,7,IND,103,9,1,12,8
2013-11-20,ORL,92,4,6,MIA,120,8,3,12,9
2013-11-20,PHI,98,5,7,TOR,108,4,7,9,14
2013-11-20,ATL,93,6,5,DET,85,4,6,10,11
2013-11-20,MIL,82,2,7,POR,91,9,2,11,9
2013-11-20,MIN,98,7,5,LAC,102,7,4,14,9
2013-11-20,NOP,105,4,6,UTA,98,1,11,5,17
2013-11-20,SAS,104,9,1,BOS,93,4,8,13,9
2013-11-20,PHX,106,5,5,SAC,113,3,7,8,12
2013-11-20,DAL,123,7,4,HOU,120,8,4,15,8
2013-11-20,GSW,81,8,3,MEM,88,6,5,14,8
2013-11-21,OKC,105,7,3,LAC,91,8,4,15,7
2013-11-21,DEN,97,4,6,CHI,87,6,3,10,9
2013-11-22,CHA,91,6,6,PHX,98,5,6,11,12
2013-11-22,PHI,115,5,8,MIL,107,2,8,7,16
2013-11-22,TOR,96,5,7,WAS,88,4,7,9,14
2013-11-22,BOS,82,4,9,IND,97,10,1,14,10
2013-11-22,DET,89,4,7,ATL,96,7,5,11,12
2013-11-22,MEM,86,7,5,SAS,102,10,1,17,6
2013-11-22,MIN,111,7,6,BKN,81,3,8,10,14
2013-11-22,NOP,104,5,6,CLE,100,4,8,9,14
2013-11-22,DAL,103,8,4,UTA,93,1,12,9,16
2013-11-22,POR,98,10,2,CHI,95,6,4,16,6
2013-11-22,LAL,102,5,7,GSW,95,8,4,13,11
2013-11-23,LAC,103,8,5,SAC,102,4,7,12,12
2013-11-23,IND,106,11,1,PHI,98,6,8,17,9
2013-11-23,WAS,98,4,8,NYK,89,3,8,7,16
2013-11-23,ATL,87,8,5,BOS,94,4,10,12,15
2013-11-23,MIA,101,9,3,ORL,99,4,7,13,10
2013-11-23,HOU,112,8,5,MIN,101,8,6,16,11
2013-11-23,MIL,72,2,9,CHA,96,6,7,8,16
2013-11-23,SAS,126,11,1,CLE,96,4,9,15,10
2013-11-23,DEN,102,5,6,DAL,100,9,4,14,10
2013-11-23,GSW,101,8,5,POR,113,11,2,19,7
2013-11-24,BKN,97,3,9,DET,109,4,8,7,17
2013-11-24,LAC,121,9,5,CHI,82,6,5,15,10
2013-11-24,ORL,96,4,8,PHX,104,6,6,10,14
2013-11-24,OKC,95,8,3,UTA,73,1,13,9,16
2013-11-24,LAL,100,6,7,SAC,86,4,8,10,15
2013-11-25,CHA,86,7,7,BOS,96,5,10,12,17
2013-11-25,IND,98,12,1,MIN,84,8,7,20,8
2013-11-25,DET,113,5,8,MIL,94,2,10,7,18
2013-11-25,MIA,107,10,3,PHX,92,7,6,17,9
2013-11-25,MEM,86,7,6,HOU,93,9,5,16,11
2013-11-25,DAL,96,9,5,DEN,110,6,6,15,11
2013-11-25,SAS,112,12,1,NOP,93,6,6,18,7
2013-11-25,UTA,89,1,14,CHI,83,6,6,7,20
2013-11-25,POR,102,12,2,NYK,91,3,9,15,11
2013-11-26,TOR,100,6,7,BKN,102,3,10,9,17
2013-11-26,WAS,116,5,8,LAL,111,7,7,12,15
2013-11-26,ATL,92,8,6,ORL,109,4,9,12,15
2013-11-26,NOP,101,6,7,GSW,102,8,6,14,13
2013-11-27,CHA,74,7,8,IND,99,13,1,20,9
2013-11-27,ORL,105,5,9,PHI,94,6,9,11,18
2013-11-27,BOS,93,6,10,MEM,100,7,7,13,17
2013-11-27,BKN,94,4,10,LAL,99,7,8,11,18
2013-11-27,CLE,84,4,10,MIA,95,11,3,15,13
2013-11-27,DET,79,6,8,CHI,99,6,7,12,15
2013-11-27,HOU,113,10,5,ATL,84,8,7,18,12
2013-11-27,MIL,92,2,11,WAS,100,6,8,8,19
2013-11-27,MIN,110,8,8,DEN,117,7,6,15,14
2013-11-27,OKC,94,9,3,SAS,88,13,1,22,4
2013-11-27,DAL,103,9,6,GSW,99,9,6,18,12
2013-11-27,PHX,120,7,7,POR,106,13,2,20,9
2013-11-27,LAC,93,10,5,NYK,80,3,10,13,15
2013-11-29,CHA,92,7,9,MIL,76,2,12,9,21
2013-11-29,ORL,91,6,9,SAS,109,13,2,19,11
2013-11-29,TOR,83,6,8,MIA,90,12,3,18,11
2013-11-29,ATL,88,8,8,DAL,87,10,6,18,14
2013-11-29,BOS,103,6,11,CLE,86,4,11,10,22
2013-11-29,DET,102,6,9,LAL,106,8,8,14,17
2013-11-29,HOU,114,11,5,BKN,95,4,11,15,16
2013-11-29,OKC,113,10,3,GSW,112,9,7,19,10
2013-11-29,IND,93,14,1,WAS,73,7,8,21,9
2013-11-29,PHI,105,6,10,NOP,121,6,8,12,18
2013-11-29,DEN,97,8,6,NYK,95,3,11,11,17
2013-11-29,UTA,101,2,14,PHX,112,8,7,10,21
2013-11-29,SAC,98,4,9,LAC,104,11,5,15,14
2013-11-30,WAS,108,7,9,ATL,101,9,8,16,17
2013-11-30,CLE,97,4,12,CHI,93,7,7,11,19
2013-11-30,MEM,88,8,7,BKN,97,4,12,12,19
2013-11-30,DAL,106,10,7,MIN,112,8,9,18,16
2013-11-30,SAS,106,14,2,HOU,112,12,5,26,7
2013-11-30,PHX,104,9,7,UTA,112,2,15,11,22
2013-11-30,MIL,92,2,13,BOS,85,7,11,9,24
2013-12-01,TOR,98,6,9,DEN,112,9,6,15,15
2013-12-01,LAC,100,12,5,IND,105,15,1,27,6
2013-12-01,DET,115,6,10,PHI,100,6,11,12,21
2013-12-01,SAC,113,4,10,GSW,115,9,8,13,18
2013-12-01,MIA,99,13,3,CHA,98,8,9,21,12
2013-12-01,OKC,113,11,3,MIN,103,9,9,20,12
2013-12-01,NYK,99,3,12,NOP,103,7,8,10,20
2013-12-01,LAL,108,9,8,POR,114,13,3,22,11
2013-12-02,WAS,98,8,9,ORL,80,6,10,14,19
2013-12-02,CHI,128,7,8,NOP,131,8,8,15,16
2013-12-02,SAS,102,14,3,ATL,100,9,9,23,12
2013-12-02,UTA,109,3,15,HOU,103,13,5,16,20
2013-12-02,POR,106,14,3,IND,102,16,1,30,4
2013-12-03,PHI,126,6,12,ORL,125,6,11,12,23
2013-12-03,BOS,108,7,12,MIL,100,3,13,10,25
2013-12-03,BKN,87,5,12,DEN,111,10,6,15,18
2013-12-03,MIA,97,14,3,DET,107,7,10,21,13
2013-12-03,MEM,110,8,8,PHX,91,9,8,17,16
2013-12-03,DAL,89,10,8,CHA,82,8,10,18,18
2013-12-03,SAC,95,4,11,OKC,97,12,3,16,14
2013-12-03,GSW,112,10,8,TOR,103,6,10,16,18
2013-12-04,CLE,98,5,12,DEN,88,11,6,16,18
2013-12-04,ATL,107,9,10,LAC,97,12,6,21,16
2013-12-04,HOU,88,13,6,PHX,97,9,9,22,15
2013-12-04,MIL,98,3,14,DET,105,8,10,11,24
2013-12-04,NOP,97,9,8,DAL,100,11,8,20,16
2013-12-04,UTA,86,4,15,IND,95,16,2,20,17
2013-12-04,POR,111,15,3,OKC,104,13,3,28,6
2013-12-05,BKN,83,5,13,NYK,113,3,13,8,26
2013-12-05,MEM,81,9,8,LAC,101,12,7,21,15
2013-12-05,CHI,107,7,9,MIA,87,14,4,21,13
2013-12-06,CHA,105,8,11,PHI,88,7,12,15,23
2013-12-06,WAS,105,9,9,MIL,109,3,15,12,24
2013-12-06,ATL,108,10,10,CLE,89,6,12,16,22
2013-12-06,BOS,106,8,12,DEN,98,11,7,19,19
2013-12-06,NYK,121,4,13,ORL,83,6,12,10,25
2013-12-06,HOU,105,13,7,GSW,83,11,8,24,15
2013-12-06,NOP,95,9,9,OKC,109,13,4,22,13
2013-12-06,PHX,106,10,9,TOR,97,6,11,16,20
2013-12-06,POR,130,16,3,UTA,98,4,16,20,19
2013-12-06,SAC,100,4,12,LAL,106,9,9,13,21
2013-12-07,PHI,92,7,13,DEN,103,11,8,18,21
2013-12-07,CLE,88,6,13,LAC,82,13,7,19,20
2013-12-07,CHI,75,8,9,DET,92,9,10,17,19
2013-12-07,MEM,82,9,9,GSW,108,11,9,20,18
2013-12-07,MIN,82,10,10,MIA,103,14,5,24,15
2013-12-07,MIL,82,4,15,BKN,90,5,14,9,29
2013-12-07,SAS,100,15,4,IND,111,17,2,32,6
2013-12-07,UTA,102,4,17,SAC,112,4,13,8,30
2013-12-07,POR,106,17,3,DAL,108,12,8,29,11
2013-12-08,NYK,73,5,13,BOS,114,9,12,14,25
2013-12-08,DET,95,10,10,MIA,110,15,5,25,15
2013-12-08,HOU,98,14,7,ORL,88,6,13,20,20
2013-12-08,OKC,118,14,4,IND,94,18,2,32,6
2013-12-08,LAL,94,10,9,TOR,106,6,12,16,21
2013-12-09,CHA,115,9,11,GSW,111,12,9,21,20
2013-12-09,PHI,83,7,14,LAC,94,13,8,20,22
2013-12-09,WAS,74,9,10,DEN,75,12,8,21,18
2013-12-09,MEM,94,9,10,ORL,85,6,14,15,24
2013-12-09,UTA,94,4,18,POR,105,17,4,21,22
2013-12-09,SAC,112,5,13,DAL,97,13,8,18,21
2013-12-10,CLE,109,7,13,NYK,94,5,14,12,27
2013-12-10,IND,90,18,3,MIA,84,16,5,34,8
2013-12-10,TOR,103,7,12,SAS,116,15,5,22,17
2013-12-10,ATL,92,11,10,OKC,101,15,4,26,14
2013-12-10,BKN,104,6,14,BOS,96,10,12,16,26
2013-12-10,DET,94,10,11,MIN,121,10,11,20,22
2013-12-10,CHI,74,8,10,MIL,78,4,16,12,26
2013-12-10,LAL,108,10,10,PHX,114,11,9,21,19
2013-12-11,CHA,83,10,11,ORL,92,6,15,16,26
2013-12-11,BOS,88,10,13,LAC,96,14,8,24,21
2013-12-11,MEM,100,10,10,OKC,116,16,4,26,14
2013-12-11,MIL,77,5,16,SAS,109,16,5,21,21
2013-12-11,MIN,106,11,11,PHI,99,7,15,18,26
2013-12-11,NOP,111,9,10,DET,106,10,12,19,22
2013-12-11,NYK,83,5,15,CHI,78,8,11,13,26
2013-12-11,SAC,101,6,13,UTA,122,4,19,10,32
2013-12-11,GSW,95,12,10,DAL,93,13,9,25,19
2013-12-12,BKN,102,7,14,LAC,93,15,8,22,22
2013-12-12,POR,111,18,4,HOU,104,15,7,33,11
2013-12-13,IND,99,19,3,CHA,94,10,12,29,15
2013-12-13,ORL,100,7,15,CLE,109,8,13,15,28
2013-12-13,TOR,108,7,13,PHI,100,7,16,14,29
2013-12-13,ATL,101,11,11,WAS,99,9,11,20,22
2013-12-13,BOS,90,10,14,NYK,86,6,15,16,29
2013-12-13,DET,103,10,13,BKN,99,8,14,18,27
2013-12-13,NOP,104,10,10,MEM,98,10,11,20,21
2013-12-13,OKC,122,17,4,LAL,97,10,11,27,15
2013-12-13,MIL,90,5,17,CHI,91,8,12,13,29
2013-12-13,SAS,117,17,5,MIN,110,12,11,29,16
2013-12-13,DEN,93,13,8,UTA,103,5,19,18,27
2013-12-13,PHX,116,12,9,SAC,107,6,14,18,23
2013-12-13,GSW,112,13,10,HOU,116,15,8,28,18
2013-12-14,CHA,85,10,13,LAL,88,10,12,20,25
2013-12-14,WAS,97,9,12,LAC,113,15,9,24,21
2013-12-14,MIA,114,16,6,CLE,107,9,13,25,19
2013-12-14,NYK,111,6,16,ATL,106,12,11,18,27
2013-12-14,CHI,77,9,12,TOR,99,8,13,17,25
2013-12-14,PHI,105,7,17,POR,139,19,4,26,21
2013-12-14,DAL,106,13,10,MIL,93,5,18,18,28
2013-12-14,UTA,84,6,19,SAS,100,18,5,24,24
2013-12-15,SAC,106,6,15,HOU,91,16,8,22,23
2013-12-15,MEM,93,10,12,MIN,101,12,12,22,24
2013-12-15,DET,109,11,13,POR,111,20,4,31,17
2013-12-15,OKC,101,18,4,ORL,98,7,16,25,20
2013-12-15,DEN,102,13,9,NOP,93,11,10,24,19
2013-12-15,PHX,106,13,9,GSW,102,13,11,26,20
2013-12-16,IND,96,20,3,DET,101,11,14,31,17
2013-12-16,ATL,114,12,12,LAL,100,11,12,23,24
2013-12-16,BOS,101,11,14,MIN,97,13,12,24,26
2013-12-16,BKN,130,8,15,PHI,94,7,18,15,33
2013-12-16,MIA,117,17,6,UTA,94,6,20,23,26
2013-12-16,NYK,101,7,16,WAS,102,9,13,16,29
2013-12-16,CHI,82,9,13,ORL,83,7,17,16,30
2013-12-16,LAC,115,16,9,SAS,92,19,5,35,14
2013-12-17,CHA,95,10,14,SAC,87,7,15,17,29
2013-12-17,CLE,116,9,14,POR,119,21,4,30,18
2013-12-17,MEM,92,10,13,LAL,96,11,13,21,26
2013-12-17,DEN,93,14,9,OKC,105,19,4,33,13
2013-12-17,GSW,104,13,12,NOP,93,11,11,24,23
2013-12-18,MIA,97,18,6,IND,94,20,4,38,10
2013-12-18,ORL,82,8,17,UTA,86,6,21,14,38
2013-12-18,TOR,102,9,13,CHA,104,11,14,20,27
2013-12-18,ATL,124,13,12,SAC,107,7,16,20,28
2013-12-18,BOS,106,12,14,DET,107,12,14,24,28
2013-12-18,BKN,107,9,15,WAS,113,10,13,19,28
2013-12-18,MIL,101,5,19,NYK,107,7,17,12,36
2013-12-18,MIN,120,13,13,POR,109,22,4,35,17
2013-12-18,DAL,105,14,10,MEM,91,10,14,24,24
2013-12-18,PHX,101,14,9,SAS,108,19,6,33,15
2013-12-18,HOU,109,16,9,CHI,94,9,14,25,23
2013-12-18,LAC,108,17,9,NOP,95,11,12,28,21
2013-12-19,OKC,107,20,4,CHI,95,9,15,29,19
2013-12-19,GSW,102,14,12,SAS,104,20,6,34,18
2013-12-20,PHI,121,7,19,BKN,120,9,16,16,35
2013-12-20,ATL,118,14,12,UTA,85,7,21,21,33
2013-12-20,CLE,114,9,15,MIL,111,5,20,14,35
2013-12-20,DET,106,13,14,CHA,116,12,14,25,28
2013-12-20,MIA,122,19,6,SAC,103,7,17,26,23
2013-12-20,IND,114,20,5,HOU,81,17,9,37,14
2013-12-20,DAL,108,15,10,TOR,109,9,14,24,24
2013-12-20,DEN,99,14,10,PHX,103,14,10,28,20
2013-12-20,LAL,104,12,13,MIN,91,14,13,26,26
2013-12-21,NYK,87,8,17,MEM,95,10,15,18,32
2013-12-21,BOS,99,12,15,WAS,106,11,13,23,28
2013-12-21,CHA,85,13,14,UTA,88,7,22,20,36
2013-12-21,ORL,100,8,18,SAC,105,7,18,15,36
2013-12-21,DET,97,13,15,HOU,114,17,10,30,25
2013-12-21,CHI,100,9,16,CLE,84,10,15,19,31
2013-12-21,MIL,116,5,21,PHI,106,8,19,13,40
2013-12-21,SAS,100,21,6,OKC,113,21,4,42,10
2013-12-21,PHX,123,15,10,DAL,108,15,11,30,21
2013-12-21,POR,110,22,5,NOP,107,11,13,33,18
2013-12-21,GSW,102,14,13,LAL,83,13,13,27,26
2013-12-21,LAC,112,18,9,DEN,91,14,11,32,20
2013-12-22,IND,106,21,5,BOS,79,12,16,33,21
2013-12-22,OKC,98,22,4,TOR,104,10,14,32,18
2013-12-22,LAC,120,19,9,MIN,116,14,14,33,23
2013-12-23,CHA,111,13,15,MIL,110,6,21,19,36
2013-12-23,CLE,92,10,16,DET,115,13,16,23,32
2013-12-23,ORL,98,8,19,NYK,103,8,18,16,37
2013-12-23,BKN,86,9,17,IND,103,22,5,31,22
2013-12-23,MIA,121,20,6,ATL,119,15,12,35,18
2013-12-23,HOU,104,18,10,DAL,111,15,12,33,22
2013-12-23,MEM,104,11,15,UTA,94,8,22,19,37
2013-12-23,SAS,112,21,7,TOR,99,11,14,32,21
2013-12-23,DEN,81,14,12,GSW,89,15,13,29,25
2013-12-23,PHX,117,16,10,LAL,90,13,14,29,24
2013-12-23,SAC,100,8,18,NOP,113,11,14,19,32
2013-12-25,BKN,78,9,18,CHI,95,10,16,19,34
2013-12-25,NYK,94,9,18,OKC,123,22,5,31,23
2013-12-25,LAL,95,13,15,MIA,101,21,6,34,21
2013-12-25,SAS,98,22,7,HOU,111,18,11,40,18
2013-12-25,GSW,105,16,13,LAC,103,20,9,36,22
2013-12-26,CLE,125,10,17,ATL,127,15,13,25,30
2013-12-26,HOU,100,19,11,MEM,92,12,15,31,26
2013-12-26,DAL,107,16,12,SAS,116,22,8,38,20
2013-12-26,POR,116,23,5,LAC,112,20,10,43,15
2013-12-27,CHA,85,14,15,OKC,89,23,5,37,20
2013-12-27,ORL,109,8,20,DET,92,14,16,22,36
2013-12-27,BKN,104,9,19,MIL,93,6,22,15,41
2013-12-27,NYK,83,9,19,TOR,95,11,15,20,34
2013-12-27,MIN,120,14,15,WAS,98,12,13,26,28
2013-12-27,NOP,105,12,14,DEN,89,14,13,26,27
2013-12-27,UTA,105,8,23,LAL,103,13,16,21,39
2013-12-27,SAC,108,8,19,MIA,103,22,6,30,25
2013-12-27,GSW,115,17,13,PHX,86,17,10,34,23
2013-12-28,BOS,103,12,17,CLE,100,10,18,22,35
2013-12-28,IND,105,23,5,BKN,91,10,19,33,24
2013-12-28,TOR,115,12,15,NYK,100,9,20,21,35
2013-12-28,WAS,106,12,14,DET,82,14,17,26,31
2013-12-28,ATL,118,16,13,CHA,116,14,16,30,29
2013-12-28,CHI,83,11,16,DAL,105,16,13,27,29
2013-12-28,HOU,107,20,11,NOP,98,13,14,33,25
2013-12-28,MEM,120,12,16,DEN,99,14,14,26,30
2013-12-28,MIL,95,6,23,MIN,117,15,15,21,38
2013-12-28,PHX,115,17,11,PHI,101,8,20,25,31
2013-12-28,POR,107,24,5,MIA,108,22,7,46,12
2013-12-28,LAC,98,20,11,UTA,90,9,23,29,34
2013-12-29,CLE,104,10,19,GSW,108,18,13,28,32
2013-12-29,ORL,109,9,20,ATL,102,17,13,26,33
2013-12-29,OKC,117,24,5,HOU,86,21,11,45,16
2013-12-29,SAS,112,23,8,SAC,104,9,19,32,27
2013-12-29,LAL,104,13,17,PHI,111,8,21,21,38
2013-12-30,DET,99,14,18,WAS,106,13,14,27,32
2013-12-30,MEM,91,13,16,CHI,95,11,17,24,33
2013-12-30,MIN,98,16,15,DAL,100,17,13,33,28
2013-12-30,NOP,110,13,15,POR,108,24,6,37,21
2013-12-30,DEN,94,14,15,MIA,97,23,7,37,22
2013-12-30,UTA,83,9,24,CHA,80,14,17,23,41
2013-12-30,LAC,88,21,11,PHX,107,18,11,39,22
2013-12-31,BOS,91,13,17,ATL,92,17,14,30,31
2013-12-31,IND,91,24,5,CLE,76,10,20,34,25
2013-12-31,ORL,81,10,20,GSW,94,19,13,29,33
2013-12-31,CHI,79,12,17,TOR,85,13,15,25,32
2013-12-31,HOU,106,21,12,SAC,110,9,20,30,32
2013-12-31,SAS,113,24,8,BKN,92,10,20,34,28
2013-12-31,OKC,94,25,5,POR,98,24,7,49,12
2013-12-31,LAL,79,13,18,MIL,94,6,24,19,42
2014-01-01,WAS,78,14,14,DAL,87,18,13,32,27
2014-01-01,TOR,95,14,15,IND,82,25,5,39,20
2014-01-01,MIN,124,16,16,NOP,112,14,15,30,31
2014-01-01,DEN,102,14,16,PHI,114,9,21,23,37
2014-01-01,LAC,112,21,12,CHA,85,14,18,35,30
2014-01-02,CLE,87,10,21,ORL,81,10,21,20,42
2014-01-02,MIA,114,24,7,GSW,123,20,13,44,20
2014-01-02,CHI,94,12,18,BOS,82,13,18,25,36
2014-01-02,OKC,93,25,6,BKN,95,10,21,35,27
2014-01-02,SAS,101,25,8,NYK,105,9,21,34,29
2014-01-02,PHX,91,19,11,MEM,99,13,17,32,28
2014-01-02,UTA,96,10,24,MIL,87,7,24,17,48
2014-01-02,POR,134,25,7,CHA,104,14,19,39,26
2014-01-02,SAC,104,10,20,PHI,113,10,21,20,41
2014-01-03,WAS,88,14,15,TOR,101,15,15,29,30
2014-01-03,ATL,100,18,14,GSW,101,21,13,39,27
2014-01-03,BOS,92,13,19,NOP,95,14,16,27,35
2014-01-03,HOU,102,21,13,NYK,100,10,21,31,34
2014-01-03,DAL,112,19,13,LAC,119,22,12,41,25
2014-01-03,DEN,111,14,17,MEM,108,14,17,28,34
2014-01-03,LAL,110,13,19,UTA,99,11,24,24,43
2014-01-04,IND,99,25,6,NOP,82,15,16,40,22
2014-01-04,ORL,94,10,22,MIA,110,24,8,34,30
2014-01-04,BKN,89,11,21,CLE,82,11,21,22,42
2014-01-04,CHI,91,13,18,ATL,84,18,15,31,33
2014-01-04,MIN,111,17,16,OKC,115,25,7,42,23
2014-01-04,SAS,116,25,9,LAC,92,23,12,48,21
2014-01-04,PHX,116,19,12,MIL,100,7,25,26,37
2014-01-04,POR,99,26,7,PHI,101,11,21,37,28
2014-01-04,SAC,103,10,21,CHA,113,14,20,24,41
2014-01-05,DET,84,14,19,MEM,112,14,18,28,37
2014-01-05,CLE,78,11,22,IND,82,26,6,37,28
2014-01-05,MIA,102,25,8,TOR,97,16,15,41,23
2014-01-05,WAS,96,14,16,GSW,112,22,13,36,29
2014-01-05,OKC,119,26,7,BOS,96,13,20,39,27
2014-01-05,DAL,80,19,14,NYK,92,10,22,29,36
2014-01-05,LAL,115,14,19,DEN,137,15,17,29,36
2014-01-06,PHI,95,12,21,MIN,126,17,17,29,38
2014-01-06,BKN,91,12,21,ATL,86,18,16,30,37
2014-01-06,LAC,101,23,13,ORL,81,10,23,33,36
2014-01-07,CHA,83,15,20,WAS,97,14,17,29,37
2014-01-07,CLE,111,11,23,PHI,93,12,22,23,45
2014-01-07,IND,86,27,6,TOR,79,16,16,43,22
2014-01-07,MIA,107,26,8,NOP,88,15,17,41,25
2014-01-07,NYK,89,11,22,DET,85,14,20,25,42
2014-01-07,CHI,92,14,18,PHX,87,20,12,34,30
2014-01-07,MEM,108,15,18,SAS,110,26,9,41,27
2014-01-07,MIL,80,7,26,GSW,101,23,13,30,39
2014-01-07,DAL,110,19,15,LAL,97,14,20,33,35
2014-01-07,DEN,129,16,17,BOS,98,13,21,29,38
2014-01-07,UTA,112,11,25,OKC,101,27,7,38,32
2014-01-07,SAC,123,10,22,POR,119,26,8,36,30
2014-01-08,SAS,112,27,9,DAL,90,20,15,47,24
2014-01-08,TOR,112,16,17,DET,91,14,21,30,38
2014-01-08,ATL,97,18,17,IND,87,28,6,46,23
2014-01-08,BKN,102,13,21,GSW,98,24,13,37,34
2014-01-08,MIN,103,18,17,PHX,104,20,13,38,30
2014-01-08,NOP,96,15,18,WAS,102,15,17,30,35
2014-01-08,HOU,113,22,13,LAL,99,14,21,36,34
2014-01-08,POR,110,26,9,ORL,94,10,24,36,33
2014-01-08,LAC,111,24,13,BOS,105,13,22,37,35
2014-01-09,NYK,102,12,22,MIA,92,27,8,39,30
2014-01-09,DEN,101,17,17,OKC,88,27,8,44,25
2014-01-10,IND,93,28,7,WAS,66,16,17,44,24
2014-01-10,PHI,104,12,23,DET,114,14,22,26,45
2014-01-10,ATL,83,19,17,HOU,80,23,13,42,30
2014-01-10,MEM,104,15,19,PHX,99,21,13,36,32
2014-01-10,MIN,119,18,18,CHA,92,15,21,33,39
2014-01-10,NOP,90,15,19,DAL,107,20,16,35,35
2014-01-10,BKN,104,14,21,MIA,95,27,9,41,30
2014-01-10,MIL,72,7,27,CHI,81,15,18,22,45
2014-01-10,UTA,102,12,25,CLE,113,12,23,24,48
2014-01-10,SAC,103,11,22,ORL,83,10,25,21,47
2014-01-10,GSW,99,24,14,BOS,97,13,23,37,37
2014-01-10,LAC,123,25,13,LAL,87,14,22,39,35
2014-01-11,TOR,96,17,17,BKN,80,15,21,32,38
2014-01-11,WAS,107,16,18,HOU,114,23,14,39,32
2014-01-11,DET,110,15,22,PHX,108,21,14,36,36
2014-01-11,PHI,92,12,24,NYK,102,13,22,25,46
2014-01-11,CHI,103,16,18,CHA,97,15,22,31,40
2014-01-11,OKC,101,27,9,MIL,85,7,28,34,37
2014-01-11,DAL,110,21,16,NOP,107,15,20,36,36
2014-01-11,DEN,120,18,17,ORL,94,10,26,28,43
2014-01-11,POR,112,27,9,BOS,104,13,24,40,33
2014-01-12,SAC,124,12,22,CLE,80,13,23,25,45
2014-01-12,MEM,108,16,19,ATL,101,20,17,36,36
2014-01-12,SAS,104,28,9,MIN,86,19,18,47,27
2014-01-13,TOR,116,18,17,MIL,94,7,29,25,46
2014-01-13,BOS,92,13,25,HOU,104,24,14,37,39
2014-01-13,NYK,98,14,22,PHX,96,21,15,35,37
2014-01-13,CHI,88,17,18,WAS,102,16,19,33,37
2014-01-13,NOP,95,15,21,SAS,101,29,9,44,30
2014-01-13,DAL,107,22,16,ORL,88,10,27,32,43
2014-01-13,UTA,118,12,26,DEN,103,19,17,31,43
2014-01-14,CHA,108,15,23,NYK,98,15,22,30,45
2014-01-14,IND,116,29,7,SAC,92,13,22,42,29
2014-01-14,MEM,90,17,19,OKC,87,28,9,45,28
2014-01-14,LAL,118,14,23,CLE,120,13,24,27,47
2014-01-15,ORL,125,10,28,CHI,128,17,19,27,47
2014-01-15,PHI,95,12,25,CHA,92,16,23,28,48
2014-01-15,WAS,114,17,19,MIA,97,27,10,44,29
2014-01-15,BOS,88,13,26,TOR,83,19,17,32,43
2014-01-15,MIL,77,7,30,MEM,82,18,19,25,49
2014-01-15,MIN,108,19,19,SAC,111,13,23,32,42
2014-01-15,NOP,100,15,22,HOU,103,25,14,40,36
2014-01-15,SAS,109,30,9,UTA,105,13,26,43,35
2014-01-15,PHX,121,21,16,LAL,114,14,24,35,40
2014-01-15,POR,108,28,9,CLE,96,14,24,42,33
2014-01-15,GSW,116,25,14,DEN,123,19,18,44,32
2014-01-15,LAC,129,26,13,DAL,127,23,16,49,29
2014-01-16,IND,117,30,7,NYK,89,15,23,45,30
2014-01-16,ATL,110,20,18,BKN,127,15,22,35,40
2014-01-16,HOU,92,26,14,OKC,104,28,10,54,24
2014-01-17,NYK,95,15,24,LAC,109,27,13,42,37
2014-01-17,ORL,101,10,29,CHA,111,16,24,26,53
2014-01-17,PHI,86,13,25,MIA,101,27,11,40,36
2014-01-17,TOR,94,19,18,MIN,89,19,20,38,38
2014-01-17,WAS,96,18,19,CHI,93,18,19,36,38
2014-01-17,BOS,104,14,26,LAL,107,14,25,28,51
2014-01-17,DET,89,16,22,UTA,110,13,27,29,49
2014-01-17,MEM,91,19,19,SAC,90,14,23,33,42
2014-01-17,SAS,100,31,9,POR,109,29,9,60,18
2014-01-17,DEN,109,20,18,CLE,117,14,25,34,43
2014-01-17,PHX,107,22,16,DAL,110,23,17,45,33
2014-01-17,OKC,127,29,10,GSW,121,25,15,54,25
2014-01-18,CHA,96,17,24,MIA,104,28,11,45,35
2014-01-18,IND,106,31,7,LAC,92,28,13,59,20
2014-01-18,WAS,98,19,19,DET,104,16,23,35,42
2014-01-18,CHI,103,18,20,PHI,78,13,26,31,46
2014-01-18,HOU,114,26,15,MIL,104,7,31,33,46
2014-01-18,MIN,98,19,21,UTA,72,14,27,33,48
2014-01-18,NOP,87,15,23,GSW,97,25,16,40,39
2014-01-18,DAL,111,24,17,POR,127,30,9,54,26
2014-01-19,TOR,106,20,18,LAL,112,15,25,35,43
2014-01-19,ORL,93,10,30,BOS,91,14,27,24,57
2014-01-19,OKC,108,30,10,SAC,93,14,24,44,34
2014-01-19,SAS,110,31,10,MIL,82,7,32,38,42
2014-01-19,PHX,117,22,17,DEN,103,20,19,42,36
2014-01-20,CLE,97,15,25,DAL,102,24,18,39,43
2014-01-20,DET,103,17,23,LAC,112,28,14,45,37
2014-01-20,CHA,100,17,25,TOR,95,20,19,37,44
2014-01-20,WAS,107,19,20,PHI,99,13,27,32,47
2014-01-20,NYK,80,15,25,BKN,103,16,22,31,47
2014-01-20,MEM,92,20,19,NOP,95,15,24,35,43
2014-01-20,ATL,121,20,19,MIA,114,29,11,49,30
2014-01-20,CHI,102,19,20,LAL,100,16,25,35,45
2014-01-20,HOU,126,27,15,POR,113,31,9,58,24
2014-01-20,GSW,94,26,16,IND,102,32,7,58,23
2014-01-21,BKN,101,17,22,ORL,90,11,30,28,52
2014-01-21,MIA,93,29,12,BOS,86,14,28,43,40
2014-01-21,NOP,97,16,24,SAC,114,14,25,30,49
2014-01-21,OKC,105,31,10,POR,97,31,10,62,20
2014-01-21,UTA,97,14,28,MIN,112,20,21,34,49
2014-01-22,CHA,95,18,25,LAC,91,29,14,47,39
2014-01-22,CLE,87,15,26,CHI,98,20,20,35,46
2014-01-22,ORL,109,11,31,ATL,112,21,19,32,50
2014-01-22,TOR,93,20,20,DAL,85,25,18,45,38
2014-01-22,WAS,111,20,20,BOS,113,14,29,34,49
2014-01-22,NYK,106,15,26,PHI,110,13,28,28,54
2014-01-22,HOU,119,28,15,SAC,98,15,25,43,40
2014-01-22,MIL,104,7,33,DET,101,17,24,24,57
2014-01-22,PHX,124,23,17,IND,100,33,7,56,24
2014-01-22,SAS,105,32,10,OKC,111,32,10,64,20
2014-01-23,MIA,109,30,12,LAL,102,16,26,46,38
2014-01-23,POR,110,31,11,DEN,105,20,20,51,31
2014-01-24,ORL,114,11,32,LAL,105,16,27,27,59
2014-01-24,PHI,95,14,28,TOR,104,21,20,35,48
2014-01-24,ATL,79,22,19,SAS,105,32,11,54,30
2014-01-24,BOS,83,15,29,OKC,101,33,10,48,39
2014-01-24,BKN,107,18,22,DAL,106,25,19,43,41
2014-01-24,CLE,93,15,27,MIL,78,8,33,23,60
2014-01-24,DET,101,17,25,NOP,103,16,25,33,50
2014-01-24,NYK,125,15,27,CHA,96,19,25,34,52
2014-01-24,CHI,95,21,20,LAC,112,29,15,50,35
2014-01-24,HOU,87,29,15,MEM,88,20,20,49,35
2014-01-24,PHX,95,24,17,WAS,101,20,21,44,38
2014-01-24,SAC,111,15,26,IND,116,33,8,48,34
2014-01-24,GSW,120,26,17,MIN,121,21,21,47,38
2014-01-25,CHA,87,19,26,CHI,89,21,21,40,47
2014-01-25,TOR,118,22,20,LAC,126,30,15,52,35
2014-01-25,PHI,91,14,29,OKC,103,34,10,48,39
2014-01-25,MEM,99,21,20,HOU,81,29,16,50,36
2014-01-25,MIL,87,8,34,ATL,112,22,20,30,54
2014-01-25,DEN,109,20,21,IND,96,34,8,54,29
2014-01-25,UTA,104,14,29,WAS,101,21,21,35,50
2014-01-25,POR,115,32,11,MIN,104,22,21,54,32
2014-01-26,MIA,113,31,12,SAS,101,33,11,64,23
2014-01-26,NYK,110,16,27,LAL,103,16,28,32,55
2014-01-26,NOP,100,17,25,ORL,92,12,32,29,57
2014-01-26,CLE,90,16,27,PHX,99,24,18,40,45
2014-01-26,BOS,79,15,30,BKN,85,19,22,34,52
2014-01-26,DAL,116,25,20,DET,106,17,26,42,46
2014-01-26,GSW,103,26,18,POR,88,33,11,59,29
2014-01-26,SAC,117,15,27,DEN,125,21,21,36,48
2014-01-27,PHI,113,14,30,PHX,124,25,18,39,48
2014-01-27,BKN,103,20,22,TOR,104,22,21,42,43
2014-01-27,CHI,86,22,21,MIN,95,22,22,44,43
2014-01-27,MIL,86,8,35,LAC,114,31,15,39,50
2014-01-27,OKC,111,35,10,ATL,109,23,20,58,30
2014-01-27,UTA,106,15,29,SAC,99,15,28,30,57
2014-01-28,CLE,89,16,28,NOP,100,18,25,34,53
2014-01-28,DET,103,17,27,ORL,87,12,33,29,60
2014-01-28,NYK,114,17,27,BOS,88,15,31,32,58
2014-01-28,HOU,97,29,17,SAS,90,33,12,62,29
2014-01-28,POR,81,33,12,MEM,98,22,20,55,32
2014-01-28,GSW,85,27,18,WAS,88,21,22,48,40
2014-01-28,LAL,92,16,29,IND,104,34,9,50,38
2014-01-29,MIA,95,32,12,OKC,112,36,10,68,22
2014-01-29,TOR,98,23,21,ORL,83,12,34,35,55
2014-01-29,BOS,94,15,32,PHI,95,14,31,29,63
2014-01-29,MIL,117,8,36,PHX,126,26,18,34,54
2014-01-29,MIN,88,23,22,NOP,77,19,25,42,47
2014-01-29,DAL,115,26,20,HOU,117,30,17,56,37
2014-01-29,DEN,98,22,21,CHA,101,19,27,41,48
2014-01-29,SAS,86,33,13,CHI,96,22,22,55,35
2014-01-29,SAC,89,15,29,MEM,99,23,20,38,49
2014-01-29,LAC,110,32,15,WAS,103,22,22,54,37
2014-01-30,IND,94,35,9,PHX,102,27,18,62,27
2014-01-30,NYK,117,18,27,CLE,86,16,29,34,56
2014-01-30,GSW,111,27,19,LAC,92,33,15,60,34
2014-01-31,ORL,113,12,35,MIL,102,8,37,20,72
2014-01-31,PHI,99,15,31,ATL,125,23,22,38,53
2014-01-31,MIN,90,24,22,MEM,94,24,20,48,42
2014-01-31,BKN,95,20,23,OKC,120,37,10,57,33
2014-01-31,DAL,107,26,21,SAC,103,15,30,41,51
2014-01-31,DEN,90,22,22,TOR,100,24,21,46,43
2014-01-31,LAL,100,16,30,CHA,110,20,27,36,57
2014-01-31,UTA,90,16,29,GSW,95,28,19,44,48
2014-02-01,IND,97,35,10,BKN,96,20,24,55,34
2014-02-01,WAS,96,22,23,OKC,81,38,10,60,33
2014-02-01,ATL,120,24,22,MIN,113,24,23,48,45
2014-02-01,DET,113,19,27,PHI,96,15,32,34,59
2014-02-01,HOU,106,31,17,CLE,92,16,30,47,47
2014-02-01,MEM,99,25,20,MIL,90,8,38,33,58
2014-02-01,NOP,88,19,26,CHI,79,23,22,42,48
2014-02-01,SAS,95,33,14,SAC,93,15,31,48,45
2014-02-01,NYK,91,19,27,MIA,106,32,13,51,40
2014-02-01,PHX,105,28,18,CHA,95,21,27,49,45
2014-02-01,POR,106,33,13,TOR,103,25,21,58,34
2014-02-01,LAC,102,33,16,UTA,87,16,30,49,46
2014-02-02,BOS,96,15,33,ORL,89,13,35,28,68
2014-02-03,IND,98,36,10,ORL,79,13,36,49,46
2014-02-03,WAS,100,23,23,POR,90,34,13,57,36
2014-02-03,BKN,108,20,25,PHI,102,15,33,35,58
2014-02-03,MIA,102,33,13,DET,96,20,27,53,40
2014-02-03,MIL,101,8,39,NYK,98,19,28,27,67
2014-02-03,NOP,95,20,26,SAS,102,34,14,54,40
2014-02-03,OKC,86,38,11,MEM,77,26,20,64,31
2014-02-03,DAL,124,27,21,CLE,107,16,31,43,52
2014-02-03,DEN,116,22,23,LAC,115,34,16,56,39
2014-02-03,UTA,79,16,31,TOR,94,25,22,41,53
2014-02-03,SAC,99,15,32,CHI,70,23,23,38,55
2014-02-04,ATL,85,25,22,IND,89,37,10,62,32
2014-02-04,MIN,109,24,24,LAL,99,16,31,40,55
2014-02-04,PHX,92,29,18,CHI,101,23,24,52,42
2014-02-04,GSW,75,29,19,CHA,91,21,28,50,47
2014-02-05,CLE,108,16,32,LAL,119,16,32,32,64
2014-02-05,PHI,108,15,34,BOS,114,16,33,31,67
2014-02-05,WAS,118,24,23,SAS,125,35,14,59,37
2014-02-05,NYK,90,19,29,POR,94,34,14,53,43
2014-02-05,HOU,122,32,17,PHX,108,29,19,61,36
2014-02-05,MEM,96,26,21,DAL,110,28,21,54,42
2014-02-05,NOP,105,20,27,ATL,100,25,23,45,50
2014-02-05,OKC,106,39,11,MIN,97,25,24,64,35
2014-02-05,ORL,112,13,37,DET,98,20,28,33,65
2014-02-05,DEN,110,23,23,MIL,100,9,39,32,62
2014-02-05,SAC,109,16,32,TOR,101,26,22,42,54
2014-02-05,LAC,112,34,17,MIA,116,34,13,68,30
2014-02-06,BKN,103,21,25,SAS,89,36,14,57,39
2014-02-06,GSW,102,29,20,CHI,87,24,24,53,44
2014-02-07,IND,118,38,10,POR,113,35,14,73,24
2014-02-07,ORL,103,14,37,OKC,102,40,11,54,48
2014-02-07,PHI,98,15,35,LAL,112,17,32,32,67
2014-02-07,WAS,113,24,24,CLE,115,16,33,40,57
2014-02-07,BOS,99,17,33,SAC,89,17,32,34,65
2014-02-07,DET,111,20,29,BKN,95,22,25,42,54
2014-02-07,NYK,117,19,30,DEN,90,24,23,43,53
2014-02-07,DAL,103,29,21,UTA,81,16,32,45,53
2014-02-07,NOP,98,21,27,MIN,91,25,25,46,52
2014-02-07,LAC,118,34,18,TOR,105,26,23,60,41
2014-02-08,CHA,100,22,28,SAS,104,36,15,58,43
2014-02-08,ATL,76,25,24,MEM,79,26,22,51,46
2014-02-08,DET,126,21,29,DEN,109,24,24,45,53
2014-02-08,MIN,110,25,26,POR,117,35,15,60,41
2014-02-08,MIL,95,9,40,HOU,101,33,17,42,57
2014-02-08,PHX,122,29,20,GSW,109,30,20,59,40
2014-02-08,UTA,94,16,33,MIA,89,35,13,51,46
2014-02-09,OKC,112,40,12,NYK,100,20,30,60,42
2014-02-09,LAL,86,18,32,CHI,92,24,25,42,57
2014-02-09,BOS,91,18,33,DAL,102,30,21,48,54
2014-02-09,BKN,93,22,26,NOP,81,22,27,44,53
2014-02-09,CLE,91,17,33,MEM,83,27,22,44,55
2014-02-09,ORL,93,15,37,IND,92,39,10,54,47
2014-02-09,WAS,93,24,25,SAC,84,17,33,41,58
2014-02-09,LAC,123,35,18,PHI,78,15,36,50,54
2014-02-10,IND,119,39,11,DEN,80,24,25,63,36
2014-02-10,TOR,108,26,24,NOP,101,22,28,48,52
2014-02-10,DET,109,22,29,SAS,100,37,15,59,44
2014-02-10,MIL,86,9,41,BOS,102,18,34,27,75
2014-02-10,MIN,89,25,27,HOU,107,34,17,59,44
2014-02-10,GSW,123,30,21,PHI,80,15,37,45,58
2014-02-11,CHA,114,22,29,DAL,89,31,21,53,50
2014-02-11,CLE,109,18,33,SAC,99,17,34,35,67
2014-02-11,CHI,100,25,25,ATL,85,25,25,50,50
2014-02-11,MEM,92,27,23,WAS,89,25,25,52,48
2014-02-11,PHX,97,30,20,MIA,103,35,14,65,34
2014-02-11,POR,95,36,15,OKC,98,41,12,77,27
2014-02-11,LAL,79,18,33,UTA,96,17,33,35,66
2014-02-12,IND,73,40,11,DAL,81,31,22,71,33
2014-02-12,ORL,81,16,37,MEM,86,28,23,44,60
2014-02-12,TOR,104,27,24,ATL,83,25,26,52,50
2014-02-12,BOS,92,19,34,SAS,104,37,16,56,50
2014-02-12,BKN,105,23,26,CHA,89,23,29,46,55
2014-02-12,DET,89,23,29,CLE,93,19,33,42,62
2014-02-12,NYK,101,20,31,SAC,106,17,35,37,66
2014-02-12,HOU,113,35,17,WAS,112,25,26,60,43
2014-02-12,MIL,98,9,42,NOP,102,22,29,31,71
2014-02-12,MIN,117,25,28,DEN,90,24,26,49,54
2014-02-12,UTA,105,18,33,PHI,100,15,38,33,71
2014-02-12,GSW,110,31,21,MIA,111,36,14,67,35
2014-02-12,LAC,122,36,18,POR,117,36,16,72,34
2014-02-13,CHI,92,26,25,BKN,76,24,26,50,51
2014-02-13,LAL,103,18,34,OKC,107,42,12,60,46
2014-02-18,IND,108,40,12,ATL,98,25,27,65,39
2014-02-18,PHI,85,15,39,CLE,114,20,33,35,72
2014-02-18,WAS,93,25,27,TOR,103,28,24,53,51
2014-02-18,DET,96,23,30,CHA,108,23,30,46,60
2014-02-18,MEM,98,29,23,NYK,93,20,32,49,55
2014-02-18,MIL,104,9,43,ORL,100,16,38,25,81
2014-02-18,DAL,106,32,22,MIA,117,37,14,69,36
2014-02-18,DEN,107,24,27,PHX,112,30,21,54,48
2014-02-18,LAC,103,37,18,SAS,113,38,16,75,34
2014-02-19,CHA,116,24,30,DET,98,23,31,47,61
2014-02-19,CLE,101,21,33,ORL,93,16,39,37,72
2014-02-19,TOR,92,29,24,CHI,94,27,25,56,49
2014-02-19,ATL,97,25,28,WAS,114,25,28,50,56
2014-02-19,MIN,104,26,28,IND,91,41,12,67,40
2014-02-19,NOP,91,23,29,NYK,98,20,33,43,62
2014-02-19,PHX,100,31,21,BOS,94,19,35,50,56
2014-02-19,UTA,99,19,33,BKN,105,24,27,43,60
2014-02-19,POR,109,36,17,SAS,111,39,16,75,33
2014-02-19,SAC,92,18,35,GSW,101,31,22,49,57
2014-02-19,LAL,108,18,35,HOU,134,36,17,54,52
2014-02-20,MIL,90,10,43,DEN,101,24,28,34,71
2014-02-20,OKC,81,43,12,MIA,103,38,14,81,26
2014-02-20,GSW,102,32,22,HOU,99,37,17,69,39
2014-02-21,CHA,90,25,30,NOP,87,23,30,48,60
2014-02-21,ORL,129,16,40,NYK,121,21,33,37,73
2014-02-21,PHI,112,15,40,DAL,124,32,23,47,63
2014-02-21,TOR,98,29,25,CLE,91,22,33,51,58
2014-02-21,DET,115,23,32,ATL,107,25,29,48,61
2014-02-21,CHI,117,28,25,DEN,89,25,28,53,53
2014-02-21,MEM,102,30,23,LAC,96,37,19,67,42
2014-02-21,PHX,106,32,21,SAS,85,40,16,72,37
2014-02-21,POR,102,36,18,UTA,94,19,34,55,52
2014-02-21,LAL,101,18,36,BOS,92,19,36,37,72
2014-02-22,CHA,92,26,30,MEM,89,31,23,57,53
2014-02-22,WAS,94,26,28,NOP,93,23,31,49,59
2014-02-22,ATL,107,25,30,NYK,98,21,34,46,64
2014-02-22,DET,102,24,32,DAL,113,33,23,57,55
2014-02-22,MIL,100,10,44,IND,110,41,13,51,57
2014-02-22,UTA,104,19,35,MIN,121,27,28,46,63
2014-02-22,SAC,105,18,36,BOS,98,19,37,37,73
2014-02-22,GSW,93,33,22,BKN,86,25,27,58,49
2014-02-23,OKC,117,43,13,LAC,125,37,20,80,33
2014-02-23,MIA,93,39,14,CHI,79,29,25,68,39
2014-02-23,CLE,83,22,34,WAS,96,27,28,49,62
2014-02-23,TOR,105,30,25,ORL,90,17,40,47,65
2014-02-23,DEN,95,25,29,SAC,109,19,36,44,65
2014-02-23,PHX,112,33,21,HOU,115,37,18,70,39
2014-02-23,LAL,102,19,36,BKN,108,25,28,44,64
2014-02-23,POR,108,37,18,MIN,97,28,28,65,46
2014-02-24,PHI,110,15,41,MIL,130,10,45,25,86
2014-02-24,DET,96,24,33,GSW,104,34,22,58,55
2014-02-24,NYK,108,21,35,DAL,110,34,23,55,58
2014-02-24,NOP,110,23,32,LAC,123,38,20,61,52
2014-02-24,UTA,110,19,36,BOS,98,19,38,38,74
2014-02-25,CLE,93,22,35,TOR,99,31,25,53,60
2014-02-25,IND,118,42,13,LAL,98,19,37,61,50
2014-02-25,WAS,115,28,28,ORL,106,17,41,45,69
2014-02-25,ATL,103,26,30,CHI,107,29,26,55,56
2014-02-25,DEN,95,25,30,POR,100,38,18,63,48
2014-02-25,PHX,101,33,22,MIN,110,28,29,61,51
2014-02-25,SAC,103,20,36,HOU,129,38,18,58,54
2014-02-26,PHI,90,15,42,ORL,101,17,42,32,84
2014-02-26,BOS,115,19,39,ATL,104,26,31,45,70
2014-02-26,CHI,103,30,26,GSW,83,35,22,65,48
2014-02-26,DAL,108,35,23,NOP,89,23,33,58,56
2014-02-26,MEM,108,31,24,LAL,103,19,38,50,62
2014-02-26,OKC,104,43,14,CLE,114,22,36,65,50
2014-02-26,SAS,120,40,17,DET,110,24,34,64,51
2014-02-26,UTA,109,20,36,PHX,86,33,23,53,59
2014-02-26,POR,124,39,18,BKN,80,26,28,65,46
2014-02-26,LAC,101,39,20,HOU,93,39,18,78,38
2014-02-27,IND,101,43,13,MIL,96,11,45,54,58
2014-02-27,TOR,129,32,25,WAS,134,29,28,61,53
2014-02-27,MIA,108,40,14,NYK,82,21,36,61,50
2014-02-27,DEN,89,25,31,BKN,112,26,29,51,60
2014-02-28,CLE,99,23,36,UTA,79,21,36,44,72
2014-02-28,OKC,113,43,15,MEM,107,32,24,75,39
2014-02-28,NYK,103,21,37,GSW,126,35,23,56,60
2014-02-28,DAL,91,36,23,CHI,100,31,26,67,49
2014-02-28,SAS,92,41,17,CHA,82,27,30,68,47
2014-02-28,LAL,126,19,39,SAC,122,20,37,39,76
2014-02-28,PHX,116,33,24,NOP,104,23,34,56,58
2014-03-01,MIA,112,41,14,ORL,98,18,42,59,56
2014-03-01,PHI,103,15,43,WAS,122,30,28,45,71
2014-03-01,HOU,118,39,19,DET,110,24,35,63,54
2014-03-01,BOS,97,20,39,IND,102,44,13,64,52
2014-03-01,MIL,98,11,46,BKN,107,27,29,38,75
2014-03-01,MEM,110,32,25,CLE,96,24,36,56,61
2014-03-01,POR,102,40,18,DEN,96,25,32,65,50
2014-03-01,SAC,97,20,38,MIN,108,29,29,49,67
2014-03-01,LAC,108,40,20,NOP,76,23,35,63,55
2014-03-02,CHI,109,32,26,NYK,90,21,38,53,64
2014-03-02,TOR,104,32,26,GSW,98,36,23,68,49
2014-03-02,IND,94,45,13,UTA,91,21,37,66,50
2014-03-02,ORL,92,18,43,PHI,81,15,44,33,87
2014-03-02,OKC,116,44,15,CHA,99,27,31,71,46
2014-03-02,SAS,112,42,17,DAL,106,36,24,78,41
2014-03-02,PHX,129,34,24,ATL,120,26,32,60,56
2014-03-03,WAS,104,31,28,MEM,110,33,25,64,53
2014-03-03,BKN,96,28,29,CHI,80,33,26,61,55
2014-03-03,DET,96,24,36,NYK,85,21,39,45,75
2014-03-03,MIA,124,42,14,CHA,107,27,32,69,46
2014-03-03,MIL,114,11,47,UTA,88,21,38,32,85
2014-03-03,DEN,128,25,33,MIN,132,30,29,55,62
2014-03-03,POR,106,41,18,LAL,107,20,39,61,57
2014-03-03,SAC,96,20,39,NOP,89,23,36,43,75
2014-03-04,CLE,101,24,37,SAS,122,43,17,67,54
2014-03-04,IND,96,46,13,GSW,98,36,24,82,37
2014-03-04,HOU,106,40,19,MIA,103,43,14,83,33
2014-03-04,OKC,125,45,15,PHI,92,15,45,60,60
2014-03-04,PHX,96,35,24,LAC,104,41,20,76,44
2014-03-04,LAL,125,21,39,NOP,132,23,37,44,76
2014-03-05,CHA,109,27,33,IND,87,46,14,73,47
2014-03-05,ORL,89,19,43,HOU,101,41,19,60,62
2014-03-05,WAS,104,31,29,UTA,91,21,39,52,68
2014-03-05,BOS,88,20,40,GSW,108,37,24,57,64
2014-03-05,BKN,103,29,29,MEM,94,34,25,63,54
2014-03-05,DET,94,25,36,CHI,105,33,27,58,63
2014-03-05,MIL,102,12,47,SAC,116,21,39,33,86
2014-03-05,MIN,106,31,29,NYK,118,21,40,52,69
2014-03-05,DEN,115,25,34,DAL,110,36,25,61,59
2014-03-05,POR,102,41,19,ATL,78,26,33,67,52
2014-03-06,SAS,111,44,17,MIA,87,43,15,87,32
2014-03-06,PHX,128,35,25,OKC,122,46,15,81,40
2014-03-06,LAL,94,21,40,LAC,142,42,20,63,60
2014-03-07,CHI,77,34,27,MEM,85,34,26,68,53
2014-03-07,CHA,101,28,33,CLE,92,24,38,52,71
2014-03-07,TOR,99,33,26,SAC,87,22,39,55,65
2014-03-07,BOS,91,20,41,BKN,84,30,29,50,70
2014-03-07,NYK,108,22,40,UTA,81,21,40,43,80
2014-03-07,MIN,114,31,30,DET,101,25,37,56,67
2014-03-07,NOP,112,24,37,MIL,104,12,48,36,85
2014-03-07,DAL,103,36,26,POR,98,42,19,78,45
2014-03-07,DEN,134,26,34,LAL,126,21,41,47,75
2014-03-07,HOU,112,42,19,IND,86,46,15,88,34
2014-03-07,GSW,111,38,24,ATL,97,26,34,64,58
2014-03-08,CLE,97,24,39,NYK,107,23,40,47,79
2014-03-08,PHI,92,15,46,UTA,104,21,41,36,87
2014-03-08,MEM,111,35,26,CHA,89,29,33,64,59
2014-03-08,MIL,107,12,49,WAS,114,32,29,44,78
2014-03-08,SAS,121,45,17,ORL,112,19,44,64,61
2014-03-08,LAC,109,43,20,ATL,108,26,35,69,55
2014-03-09,CHI,95,34,28,MIA,88,43,16,77,44
2014-03-09,LAL,114,21,42,OKC,110,46,16,67,58
2014-03-09,NOP,111,25,37,DEN,107,27,34,52,71
2014-03-09,BOS,118,21,41,DET,111,25,38,46,79
2014-03-09,BKN,104,30,30,SAC,89,22,40,52,70
2014-03-09,HOU,118,43,19,POR,113,42,20,85,39
2014-03-09,MIN,104,32,30,TOR,111,34,26,66,56
2014-03-09,DAL,105,37,26,IND,94,46,16,83,42
2014-03-09,GSW,113,39,24,PHX,107,36,25,75,49
2014-03-10,CHA,105,29,34,DEN,98,27,35,56,69
2014-03-10,BKN,101,31,30,TOR,97,35,26,66,56
2014-03-10,MIA,99,43,17,WAS,90,33,29,76,46
2014-03-10,NYK,123,24,40,PHI,110,15,47,39,87
2014-03-10,MIL,105,12,50,ORL,98,19,45,31,95
2014-03-10,UTA,110,22,41,ATL,112,26,36,48,77
2014-03-10,LAC,112,44,20,PHX,105,36,26,80,46
2014-03-11,IND,94,46,17,BOS,83,22,41,68,58
2014-03-11,DET,99,25,39,SAC,89,22,41,47,80
2014-03-11,CHI,96,35,28,SAS,104,46,17,81,45
2014-03-11,MEM,109,36,26,POR,99,42,21,78,47
2014-03-11,MIN,112,32,31,MIL,101,13,50,45,81
2014-03-11,OKC,106,46,17,HOU,98,44,19,90,36
2014-03-11,GSW,108,40,24,DAL,85,38,26,78,50
2014-03-12,MIA,95,44,17,BKN,96,32,30,76,47
2014-03-12,ORL,112,19,46,DEN,120,27,36,46,82
2014-03-12,PHI,98,15,48,SAC,115,22,42,37,90
2014-03-12,TOR,101,35,27,DET,87,26,39,61,66
2014-03-12,WAS,85,33,30,CHA,98,30,34,63,64
2014-03-12,BOS,92,22,42,NYK,116,25,40,47,82
2014-03-12,NOP,88,26,37,MEM,90,37,26,63,63
2014-03-12,UTA,101,22,42,DAL,108,38,27,60,69
2014-03-12,SAS,103,47,17,POR,90,42,22,89,39
2014-03-12,PHX,101,36,27,CLE,110,24,40,60,67
2014-03-12,LAC,111,45,20,GSW,98,41,24,86,44
2014-03-13,CHI,111,35,29,HOU,87,44,20,79,49
2014-03-13,ATL,102,27,36,MIL,97,13,51,40,87
2014-03-13,OKC,131,47,17,LAL,102,22,42,69,59
2014-03-14,CHA,105,31,34,MIN,93,33,31,64,65
2014-03-14,ORL,101,19,47,WAS,105,33,31,52,78
2014-03-14,PHI,94,15,49,IND,101,47,17,62,66
2014-03-14,TOR,99,36,27,MEM,86,38,26,74,53
2014-03-14,BOS,80,22,43,PHX,87,36,28,58,71
2014-03-14,MIA,107,44,18,DEN,111,28,36,72,54
2014-03-14,NOP,103,26,38,POR,111,42,23,68,61
2014-03-14,SAS,119,48,17,LAL,85,22,43,70,60
2014-03-14,UTA,87,22,43,LAC,96,46,20,68,63
2014-03-14,GSW,94,41,25,CLE,103,25,40,66,65
2014-03-15,NYK,115,26,40,MIL,94,13,52,39,92
2014-03-15,WAS,101,34,31,BKN,94,33,30,67,61
2014-03-15,ATL,97,28,36,DEN,92,29,36,57,72
2014-03-15,DET,104,26,40,IND,112,48,17,74,57
2014-03-15,PHI,77,15,50,MEM,103,38,27,53,77
2014-03-15,CHI,94,36,29,SAC,87,23,42,59,71
2014-03-16,MIL,92,13,53,CHA,101,32,34,45,87
2014-03-16,TOR,113,37,27,PHX,121,37,28,74,55
2014-03-16,MIA,113,44,19,HOU,104,44,21,88,40
2014-03-16,NOP,121,26,39,BOS,120,22,44,48,83
2014-03-16,MIN,104,33,32,SAC,102,23,43,56,75
2014-03-16,OKC,86,48,17,DAL,109,39,27,87,44
2014-03-16,SAS,122,49,17,UTA,104,22,44,71,61
2014-03-16,POR,112,43,23,GSW,113,41,26,84,49
2014-03-16,LAC,102,47,20,CLE,80,26,40,73,60
2014-03-17,CHA,83,33,34,ATL,97,29,36,62,70
2014-03-17,IND,99,49,17,PHI,90,15,51,64,68
2014-03-17,BKN,108,33,31,PHX,95,38,28,71,59
2014-03-17,CHI,85,37,29,OKC,97,48,18,85,47
2014-03-17,HOU,124,44,22,UTA,86,22,45,66,67
2014-03-17,DAL,94,40,27,BOS,89,22,45,62,72
2014-03-17,DEN,110,29,37,LAC,100,48,20,77,57
2014-03-18,CLE,96,26,41,MIA,100,45,19,71,60
2014-03-18,ATL,118,30,36,TOR,113,37,28,67,64
2014-03-18,POR,120,43,24,MIL,115,13,54,56,78
2014-03-18,SAC,117,23,44,WAS,111,35,31,58,75
2014-03-18,GSW,103,42,26,ORL,89,19,48,61,74
2014-03-19,PHI,94,15,52,CHI,102,37,30,52,82
2014-03-19,BOS,101,22,46,MIA,96,46,19,68,65
2014-03-19,BKN,104,34,31,CHA,99,33,35,67,66
2014-03-19,MEM,96,39,27,UTA,86,22,46,61,73
2014-03-19,NOP,100,27,39,TOR,107,37,29,64,68
2014-03-19,NYK,92,27,40,IND,86,50,17,77,57
2014-03-19,DAL,122,41,27,MIN,123,34,32,75,59
2014-03-19,DEN,118,30,37,DET,109,26,41,56,78
2014-03-19,PHX,109,38,29,ORL,93,19,49,57,78
2014-03-19,LAL,109,22,44,SAS,125,50,17,72,61
2014-03-20,CLE,95,26,42,OKC,102,49,18,75,60
2014-03-20,HOU,129,45,22,MIN,106,35,32,80,54
2014-03-20,POR,116,44,24,WAS,103,35,32,79,56
2014-03-20,GSW,115,43,26,MIL,110,13,55,56,81
2014-03-21,IND,91,50,18,CHI,79,38,30,88,48
2014-03-21,PHI,92,15,53,NYK,93,28,40,43,93
2014-03-21,TOR,118,38,29,OKC,119,50,18,88,47
2014-03-21,ATL,105,31,36,NOP,111,27,40,58,76
2014-03-21,BKN,114,35,31,BOS,98,23,46,58,77
2014-03-21,MIA,91,46,20,MEM,86,40,27,86,47
2014-03-21,DAL,122,41,28,DEN,106,31,37,72,65
2014-03-21,PHX,98,39,29,DET,92,26,42,65,71
2014-03-21,SAC,79,24,44,SAS,99,51,17,75,61
2014-03-21,LAL,107,22,45,WAS,117,35,33,57,78
2014-03-22,CHA,124,33,36,POR,94,45,24,78,60
2014-03-22,CLE,111,26,43,HOU,118,46,22,72,65
2014-03-22,CHI,91,38,31,PHI,81,15,54,53,85
2014-03-22,MEM,82,40,28,IND,71,51,18,91,46
2014-03-22,NOP,105,28,40,MIA,95,47,20,75,60
2014-03-22,UTA,89,22,47,ORL,88,19,50,41,97
2014-03-22,GSW,90,44,26,SAS,99,52,17,96,43
2014-03-22,LAC,112,48,21,DET,103,26,43,74,64
2014-03-23,TOR,96,38,30,ATL,86,31,37,69,67
2014-03-23,MIN,120,35,33,PHX,127,40,29,75,62
2014-03-23,DEN,105,31,38,WAS,102,36,33,67,71
2014-03-23,SAC,124,24,45,MIL,107,13,56,37,101
2014-03-23,DAL,104,42,28,BKN,107,36,31,78,59
2014-03-23,NYK,100,29,40,CLE,106,26,44,55,84
2014-03-23,LAL,103,22,46,ORL,94,19,51,41,97
2014-03-24,CHA,89,34,36,HOU,100,47,22,81,58
2014-03-24,ATL,95,31,38,PHX,102,41,29,72,67
2014-03-24,MIA,93,47,21,POR,91,45,25,92,46
2014-03-24,CHI,89,39,31,IND,77,51,19,90,50
2014-03-24,MEM,109,41,28,MIN,92,35,34,76,62
2014-03-24,NOP,109,29,40,BKN,104,37,31,66,71
2014-03-24,OKC,117,51,18,DEN,96,32,38,83,56
2014-03-24,SAS,113,53,17,PHI,91,15,55,68,72
2014-03-24,UTA,94,23,47,DET,114,26,44,49,91
2014-03-24,LAC,106,49,21,MIL,98,13,57,62,78
2014-03-25,CLE,102,27,44,TOR,100,39,30,66,74
2014-03-25,ORL,95,19,52,POR,85,45,26,64,78
2014-03-25,DAL,128,42,29,OKC,119,52,18,94,47
2014-03-25,LAL,127,23,46,NYK,96,29,41,52,87
2014-03-26,CHA,116,34,37,BKN,111,37,32,71,69
2014-03-26,WAS,93,36,34,PHX,99,42,29,78,63
2014-03-26,BOS,90,23,47,TOR,99,39,31,62,78
2014-03-26,DET,96,27,44,CLE,97,28,44,55,88
2014-03-26,MIN,107,35,35,ATL,83,31,39,66,74
2014-03-26,NOP,98,30,40,LAC,96,50,21,80,61
2014-03-26,IND,84,51,20,MIA,83,48,21,99,41
2014-03-26,SAS,108,54,17,DEN,103,32,39,86,56
2014-03-26,SAC,99,25,45,NYK,107,29,42,54,87
2014-03-26,UTA,87,23,48,MEM,91,42,28,65,76
2014-03-27,ATL,85,31,40,POR,100,45,27,76,67
2014-03-27,HOU,120,48,22,PHI,98,15,56,63,78
2014-03-27,MIL,108,13,58,LAL,105,24,46,37,104
2014-03-27,DAL,103,43,29,LAC,109,50,22,93,51
2014-03-28,ORL,110,20,52,CHA,105,35,37,55,89
2014-03-28,TOR,105,40,31,BOS,103,23,48,63,79
2014-03-28,WAS,91,36,35,IND,78,52,20,88,55
2014-03-28,BKN,108,37,33,CLE,97,29,44,66,77
2014-03-28,DET,78,27,45,MIA,110,48,22,75,67
2014-03-28,CHI,74,40,31,POR,91,46,27,86,58
2014-03-28,MIN,143,36,35,LAL,107,24,47,60,82
2014-03-28,NOP,102,31,40,UTA,95,23,49,54,89
2014-03-28,OKC,94,52,19,SAC,81,25,46,77,65
2014-03-28,DEN,102,32,40,SAS,133,55,17,87,57
2014-03-28,PHX,112,43,29,NYK,88,30,42,73,71
2014-03-28,GSW,100,44,27,MEM,93,43,28,87,55
2014-03-29,PHI,123,15,57,DET,98,27,46,42,103
2014-03-29,HOU,107,49,22,LAC,118,51,22,100,44
2014-03-29,WAS,101,37,35,ATL,97,31,41,68,76
2014-03-29,DAL,103,43,30,SAC,100,25,47,68,77
2014-03-29,MIL,67,14,58,MIA,88,49,22,63,80
2014-03-29,SAS,96,56,17,NOP,80,32,40,88,57
2014-03-30,OKC,116,53,19,UTA,96,23,50,76,69
2014-03-30,CLE,90,29,45,IND,76,52,21,81,66
2014-03-30,BKN,114,38,33,MIN,99,37,35,75,68
2014-03-30,ORL,93,21,52,TOR,98,41,31,62,83
2014-03-30,BOS,102,23,49,CHI,107,40,32,63,81
2014-03-30,GSW,84,45,27,NYK,89,30,43,75,70
2014-03-30,POR,105,47,27,MEM,98,43,29,90,56
2014-03-30,LAL,115,24,48,PHX,99,44,29,68,77
2014-03-31,CHA,100,35,38,WAS,94,38,35,73,73
2014-03-31,IND,77,52,22,SAS,103,57,17,109,39
2014-03-31,ATL,103,31,42,PHI,95,16,57,47,99
2014-03-31,DET,116,27,47,MIL,111,14,59,41,106
2014-03-31,MIA,93,50,22,TOR,83,42,31,92,53
2014-03-31,CHI,94,41,32,BOS,80,23,50,64,82
2014-03-31,MIN,104,37,36,LAC,114,52,22,89,58
2014-03-31,NOP,97,32,41,SAC,102,25,48,57,89
2014-03-31,DEN,92,32,41,MEM,94,43,30,75,71
2014-03-31,UTA,83,23,51,NYK,92,31,43,54,94
2014-04-01,BKN,105,39,33,HOU,96,49,23,88,56
2014-04-01,DAL,120,44,30,GSW,122,45,28,89,58
2014-04-01,LAL,112,25,48,POR,124,48,27,73,75
2014-04-02,IND,101,52,23,DET,94,28,47,80,70
2014-04-02,NYK,110,32,43,BKN,81,40,33,72,76
2014-04-02,ORL,98,21,53,CLE,119,30,45,51,98
2014-04-02,PHI,93,16,58,CHA,123,36,38,52,96
2014-04-02,TOR,107,42,32,HOU,103,49,24,91,56
2014-04-02,WAS,118,38,36,BOS,92,23,51,61,87
2014-04-02,ATL,92,32,42,CHI,105,42,32,74,74
2014-04-02,MIA,96,51,22,MIL,77,14,60,65,82
2014-04-02,MIN,102,37,37,MEM,88,44,30,81,67
2014-04-02,SAS,111,58,17,GSW,90,46,28,104,45
2014-04-02,DEN,137,32,42,NOP,107,32,42,64,84
2014-04-02,PHX,108,44,30,LAC,112,53,22,97,52
2014-04-02,SAC,107,26,48,LAL,102,25,49,51,97
2014-04-03,OKC,106,54,19,SAS,94,59,17,113,36
2014-04-03,LAC,107,54,22,DAL,113,44,31,98,53
2014-04-04,MEM,100,44,31,DEN,92,33,42,77,73
2014-04-04,CHA,91,37,38,ORL,80,21,54,58,92
2014-04-04,TOR,102,43,32,IND,94,53,23,96,55
2014-04-04,ATL,117,32,43,CLE,98,31,45,63,88
2014-04-04,BOS,102,23,52,PHI,111,16,59,39,111
2014-04-04,BKN,116,40,34,DET,104,28,48,68,82
2014-04-04,MIA,121,52,22,MIN,122,38,37,90,59
2014-04-04,NYK,89,33,43,WAS,90,39,36,72,79
2014-04-04,CHI,102,43,32,MIL,90,14,61,57,93
2014-04-04,UTA,100,23,52,NOP,96,32,43,55,95
2014-04-04,HOU,111,49,25,OKC,107,55,19,104,44
2014-04-04,POR,93,49,27,PHX,109,44,31,93,58
2014-04-04,GSW,102,46,29,SAC,69,27,48,73,77
2014-04-04,LAL,95,25,50,DAL,107,45,31,70,81
2014-04-05,ORL,100,21,55,MIN,92,39,37,60,92
2014-04-05,WAS,78,40,36,CHI,96,44,32,84,68
2014-04-05,CLE,94,31,46,CHA,96,38,38,69,84
2014-04-05,DET,115,28,49,BOS,111,23,53,51,102
2014-04-05,PHI,101,17,59,BKN,105,41,34,58,93
2014-04-05,MIL,98,14,62,TOR,102,44,32,58,94
2014-04-06,MIA,102,52,23,NYK,91,33,44,85,67
2014-04-06,LAC,120,54,23,LAL,97,25,51,79,74
2014-04-06,SAC,91,27,49,DAL,93,46,31,73,80
2014-04-06,IND,88,53,24,ATL,107,33,43,86,67
2014-04-06,HOU,130,50,25,DEN,125,33,43,83,68
2014-04-06,SAS,112,59,18,MEM,92,45,31,104,49
2014-04-06,GSW,130,47,29,UTA,102,24,52,71,81
2014-04-06,PHX,122,45,31,OKC,115,55,20,100,51
2014-04-06,POR,100,49,28,NOP,94,32,44,81,72
2014-04-08,MIN,110,9,10,SAS,91,15,3,24,13
2014-04-08,ATL,95,23,21,DET,102,18,27,41,48
2014-04-08,MIA,87,53,23,BKN,88,42,34,95,57
2014-04-08,UTA,83,24,53,DAL,95,47,31,71,84
2014-04-08,SAC,92,27,50,OKC,107,55,21,82,71
2014-04-08,LAL,130,25,52,HOU,145,51,25,76,77
2014-04-09,CLE,122,31,47,DET,100,29,49,60,96
2014-04-09,ORL,115,22,55,BKN,111,43,34,65,89
2014-04-09,TOR,125,45,32,PHI,114,17,60,62,92
2014-04-09,WAS,88,40,37,CHA,94,39,38,79,75
2014-04-09,ATL,105,34,43,BOS,97,23,54,57,97
2014-04-09,MEM,107,45,32,MIA,102,53,24,98,56
2014-04-09,MIL,102,14,63,IND,104,53,25,67,88
2014-04-09,MIN,87,39,38,CHI,102,45,32,84,70
2014-04-09,NOP,88,32,45,PHX,94,46,31,78,76
2014-04-09,DEN,123,33,44,HOU,116,52,25,85,69
2014-04-09,POR,100,50,28,SAC,99,27,51,77,79
2014-04-09,LAC,101,55,23,OKC,107,56,21,111,44
2014-04-10,DAL,100,48,31,SAS,109,60,18,108,49
2014-04-10,GSW,99,48,29,DEN,100,34,44,82,73
2014-04-11,ORL,86,23,55,WAS,96,40,38,63,93
2014-04-11,TOR,100,46,32,NYK,108,33,45,79,77
2014-04-11,BOS,106,23,55,CHA,103,40,38,63,93
2014-04-11,BKN,88,43,35,ATL,93,35,43,78,78
2014-04-11,MIA,98,53,25,IND,86,54,25,107,50
2014-04-11,CHI,106,46,32,DET,98,29,50,75,82
2014-04-11,MEM,117,46,32,PHI,95,17,61,63,93
2014-04-11,MIN,112,39,39,HOU,110,52,26,91,65
2014-04-11,OKC,116,57,21,NOP,94,32,46,89,67
2014-04-11,MIL,119,14,64,CLE,116,32,47,46,111
2014-04-11,SAS,112,61,18,PHX,104,47,31,108,49
2014-04-11,UTA,99,24,54,POR,111,51,28,75,82
2014-04-11,LAL,95,25,53,GSW,112,48,30,73,83
2014-04-12,LAC,117,55,24,SAC,101,27,52,82,76
2014-04-12,CHA,111,40,39,PHI,105,17,62,57,101
2014-04-12,WAS,104,41,38,MIL,91,15,64,56,102
2014-04-12,ATL,98,36,43,MIA,85,54,25,90,68
2014-04-12,CLE,99,32,48,BOS,111,24,55,56,103
2014-04-12,HOU,111,52,27,NOP,104,32,47,84,74
2014-04-12,DAL,101,48,32,PHX,98,47,32,95,64
2014-04-12,DEN,101,35,44,UTA,94,24,55,59,99
2014-04-13,NYK,100,34,45,CHI,89,47,32,81,77
2014-04-13,DET,107,29,51,TOR,116,46,33,75,84
2014-04-13,BKN,97,43,36,ORL,88,23,56,66,92
2014-04-13,IND,102,54,26,OKC,97,58,21,112,47
2014-04-13,POR,119,52,28,GSW,117,49,30,101,58
2014-04-13,SAC,106,27,53,MIN,103,40,39,67,92
2014-04-13,LAL,90,25,54,MEM,102,47,32,72,86
2014-04-14,PHI,113,17,63,BOS,108,25,55,42,118
2014-04-14,TOR,110,47,33,MIL,100,15,65,62,98
2014-04-14,WAS,114,42,38,MIA,93,54,26,96,64
2014-04-14,ATL,93,37,43,CHA,95,41,39,78,82
2014-04-14,CHI,108,47,33,ORL,95,23,57,70,90
2014-04-14,HOU,104,53,27,SAS,98,62,18,115,45
2014-04-14,NOP,101,32,48,OKC,89,58,22,90,70
2014-04-14,UTA,104,24,56,LAL,119,25,55,49,111
2014-04-14,PHX,91,47,33,MEM,97,48,32,95,65
2014-04-14,GSW,130,49,31,MIN,120,40,40,89,71
2014-04-15,BKN,98,44,36,NYK,109,35,45,79,81
2014-04-15,LAC,117,56,24,DEN,105,36,44,92,68
2014-04-16,MEM,106,49,32,DAL,105,49,32,98,64
2014-04-16,MIL,103,15,66,ATL,111,37,44,52,110
2014-04-16,MIN,130,40,41,UTA,136,24,57,64,98
2014-04-16,NOP,105,33,48,HOU,100,54,27,87,75
2014-04-16,OKC,112,58,23,DET,111,29,52,87,75
2014-04-16,SAS,100,62,19,LAL,113,26,55,88,74
2014-04-16,BOS,102,25,56,WAS,118,43,38,68,94
2014-04-16,CHA,91,42,39,CHI,86,48,33,90,72
2014-04-16,CLE,114,32,49,BKN,85,44,37,76,86
2014-04-16,MIA,87,54,27,PHI,100,18,63,72,90
2014-04-16,NYK,95,36,45,TOR,92,48,33,84,78
2014-04-16,ORL,86,23,58,IND,101,55,26,78,84
2014-04-16,POR,110,53,28,LAC,104,57,24,110,52
2014-04-16,SAC,99,28,53,PHX,104,47,34,75,87
2014-10-28,NOP,101,0,0,ORL,84,0,0,0,0
2014-10-28,SAS,101,0,0,DAL,100,0,0,0,0
2014-10-28,LAL,90,0,0,HOU,108,0,0,0,0
2014-10-29,CHA,108,0,0,MIL,106,0,0,0,0
2014-10-29,IND,103,0,0,PHI,91,0,0,0,0
2014-10-29,BOS,121,0,0,BKN,105,0,0,0,0
2014-10-29,MIA,107,0,0,WAS,95,0,0,0,0
2014-10-29,TOR,109,0,0,ATL,102,0,0,0,0
2014-10-29,MEM,105,0,0,MIN,101,0,0,0,0
2014-10-29,NYK,80,0,0,CHI,104,0,0,0,0
2014-10-29,DEN,89,0,0,DET,79,0,0,0,0
2014-10-29,UTA,93,0,0,HOU,104,1,0,1,0
2014-10-29,PHX,119,0,0,LAL,99,0,1,0,1
2014-10-29,SAC,77,0,0,GSW,95,0,0,0,0
2014-10-29,POR,106,0,0,OKC,89,0,0,0,0
2014-10-30,ORL,98,0,1,WAS,105,0,1,0,2
2014-10-30,MIN,97,0,1,DET,91,0,1,0,2
2014-10-30,CLE,90,0,0,NYK,95,0,1,0,1
2014-10-30,DAL,120,0,1,UTA,102,0,1,0,2
2014-10-30,LAC,93,0,0,OKC,90,0,1,0,1
2014-10-31,IND,89,1,0,MEM,97,1,0,2,0
2014-10-31,CHI,108,1,0,CLE,114,0,1,1,1
2014-10-31,MIL,93,0,1,PHI,81,0,1,0,2
2014-10-31,PHX,94,1,0,SAS,89,1,0,2,0
2014-10-31,SAC,103,0,1,POR,94,1,0,1,1
2014-10-31,LAL,111,0,2,LAC,118,1,0,1,2
2014-11-01,NOP,104,1,0,DAL,109,1,1,2,1
2014-11-01,CHA,69,1,0,MEM,71,2,0,3,0
2014-11-01,ORL,95,0,2,TOR,108,1,0,1,2
2014-11-01,PHI,96,0,2,MIA,114,1,0,1,2
2014-11-01,WAS,108,1,1,MIL,97,1,1,2,2
2014-11-01,ATL,102,0,1,IND,92,1,1,1,2
2014-11-01,DET,90,0,2,BKN,102,0,1,0,3
2014-11-01,HOU,104,2,0,BOS,90,1,0,3,0
2014-11-01,MIN,105,1,1,CHI,106,1,1,2,2
2014-11-01,OKC,102,0,2,DEN,91,1,0,1,2
2014-11-01,UTA,118,0,2,PHX,91,2,0,2,2
2014-11-01,GSW,127,1,0,LAL,104,0,3,1,3
2014-11-02,LAC,92,2,0,SAC,98,1,1,3,1
2014-11-02,MIA,107,2,0,TOR,102,2,0,4,0
2014-11-02,NYK,96,1,1,CHA,93,1,1,2,2
2014-11-02,POR,90,1,1,GSW,95,2,0,3,1
2014-11-03,PHI,93,0,3,HOU,104,3,0,3,3
2014-11-03,BKN,116,1,1,OKC,85,1,2,2,3
2014-11-03,MEM,93,3,0,NOP,81,1,1,4,1
2014-11-03,DAL,118,2,1,BOS,113,1,1,3,2
2014-11-03,DEN,105,1,1,SAC,110,2,1,3,2
2014-11-03,LAC,107,2,1,UTA,101,1,2,3,3
2014-11-04,IND,81,1,2,MIL,87,1,2,2,4
2014-11-04,MIA,91,3,0,HOU,108,4,0,7,0
2014-11-04,NYK,83,2,1,WAS,98,2,1,4,2
2014-11-04,TOR,100,2,1,OKC,88,1,3,3,4
2014-11-04,CHI,98,2,1,ORL,90,0,3,2,4
2014-11-04,NOP,100,1,2,CHA,91,1,2,2,4
2014-11-04,POR,101,1,2,CLE,82,1,1,2,3
2014-11-04,LAL,106,0,4,PHX,112,2,1,2,5
2014-11-05,CHA,96,1,3,MIA,89,3,1,4,4
2014-11-05,PHI,89,0,4,ORL,91,0,4,0,8
2014-11-05,BOS,107,1,2,TOR,110,3,1,4,3
2014-11-05,BKN,91,2,1,MIN,98,1,2,3,3
2014-11-05,DET,98,0,3,NYK,95,2,2,2,5
2014-11-05,MIL,86,2,2,CHI,95,3,1,5,3
2014-11-05,WAS,96,3,1,IND,94,1,3,4,4
2014-11-05,SAS,94,1,1,ATL,92,1,1,2,2
2014-11-05,PHX,91,3,1,MEM,102,4,0,7,1
2014-11-05,UTA,102,1,3,CLE,100,1,2,2,5
2014-11-05,SAC,131,3,1,DEN,109,1,2,4,3
2014-11-05,GSW,121,3,0,LAC,104,3,1,6,1
2014-11-06,HOU,98,5,0,SAS,81,2,1,7,1
2014-11-06,POR,108,2,2,DAL,87,3,1,5,3
2014-11-07,CHA,122,2,3,ATL,119,1,2,3,5
2014-11-07,ORL,112,1,4,MIN,103,2,2,3,6
2014-11-07,PHI,115,0,5,CHI,118,4,1,4,6
2014-11-07,BOS,101,1,3,IND,98,1,4,2,7
2014-11-07,BKN,110,2,2,NYK,99,2,3,4,5
2014-11-07,DET,98,1,3,MIL,95,2,3,3,6
2014-11-07,TOR,103,4,1,WAS,84,4,1,8,2
2014-11-07,OKC,89,1,4,MEM,91,5,0,6,4
2014-11-07,PHX,112,3,2,SAC,114,4,1,7,3
2014-11-07,UTA,82,2,3,DAL,105,3,2,5,5
2014-11-07,DEN,101,1,3,CLE,110,1,3,2,6
2014-11-08,LAC,106,3,2,POR,102,3,2,6,4
2014-11-08,IND,90,1,5,WAS,97,4,2,5,7
2014-11-08,ATL,103,1,3,NYK,96,2,4,3,7
2014-11-08,MIA,102,3,2,MIN,92,2,3,5,5
2014-11-08,CHI,101,5,1,BOS,106,2,3,7,4
2014-11-08,HOU,87,6,0,GSW,98,4,0,10,0
2014-11-08,MIL,93,2,4,MEM,92,6,0,8,4
2014-11-08,SAS,99,2,2,NOP,100,2,2,4,4
2014-11-09,BKN,104,3,2,ORL,96,2,4,5,6
2014-11-09,DET,96,2,3,UTA,97,2,4,4,7
2014-11-09,OKC,101,1,5,SAC,93,5,1,6,6
2014-11-09,TOR,120,5,1,PHI,88,0,6,5,7
2014-11-09,DAL,96,4,2,MIA,105,4,2,8,4
2014-11-09,PHX,107,3,3,GSW,95,5,0,8,3
2014-11-09,POR,116,3,3,DEN,100,1,4,4,7
2014-11-09,LAL,107,0,5,CHA,92,3,3,3,8
2014-11-10,CLE,118,2,3,NOP,111,3,2,5,5
2014-11-10,IND,97,1,6,UTA,86,3,4,4,10
2014-11-10,NYK,85,2,5,ATL,91,2,3,4,8
2014-11-10,CHI,102,5,2,DET,91,2,4,7,6
2014-11-10,LAC,85,4,2,SAS,89,2,3,6,5
2014-11-11,TOR,104,6,1,ORL,100,2,5,8,6
2014-11-11,MEM,107,6,1,LAL,102,1,5,7,6
2014-11-11,MIL,85,3,4,OKC,78,2,5,5,9
2014-11-11,DAL,106,4,3,SAC,98,5,2,9,5
2014-11-11,POR,102,4,3,CHA,100,3,4,7,7
2014-11-11,GSW,100,5,1,SAS,113,3,3,8,4
2014-11-12,WAS,107,5,2,DET,103,2,5,7,7
2014-11-12,ATL,100,3,3,UTA,97,3,5,6,8
2014-11-12,BOS,94,3,3,OKC,109,2,6,5,9
2014-11-12,MIA,75,5,2,IND,81,2,6,7,8
2014-11-12,NYK,95,2,6,ORL,97,2,6,4,12
2014-11-12,NOP,109,3,3,LAL,102,1,6,4,9
2014-11-12,DEN,113,1,5,POR,130,5,3,6,8
2014-11-12,PHX,112,4,3,BKN,104,4,2,8,5
2014-11-12,MIN,101,2,4,HOU,113,6,1,8,5
2014-11-13,MEM,111,7,1,SAC,110,5,3,12,4
2014-11-13,TOR,93,7,1,CHI,100,6,2,13,3
2014-11-13,DAL,123,5,3,PHI,70,0,7,5,10
2014-11-13,GSW,107,5,2,BKN,99,4,3,9,5
2014-11-14,IND,87,3,6,DEN,108,1,6,4,12
2014-11-14,ORL,101,3,6,MIL,85,4,4,7,10
2014-11-14,ATL,114,4,3,MIA,103,5,3,9,6
2014-11-14,BOS,121,3,4,CLE,122,3,3,6,7
2014-11-14,NYK,100,2,7,UTA,102,3,6,5,13
2014-11-14,HOU,88,7,1,PHI,87,0,8,7,9
2014-11-14,NOP,139,4,3,MIN,91,2,5,6,8
2014-11-14,OKC,89,3,6,DET,96,2,6,5,12
2014-11-14,PHX,95,5,3,CHA,103,3,5,8,8
2014-11-14,LAL,80,1,7,SAS,93,4,3,5,10
2014-11-15,WAS,98,6,2,ORL,93,4,6,10,8
2014-11-15,CLE,127,4,3,ATL,94,5,3,9,6
2014-11-15,TOR,111,7,2,UTA,93,4,6,11,8
2014-11-15,CHI,90,7,2,IND,99,3,7,10,9
2014-11-15,MEM,95,8,1,DET,88,3,6,11,7
2014-11-15,DAL,131,6,3,MIN,117,2,6,8,9
2014-11-15,POR,97,6,3,BKN,87,4,4,10,7
2014-11-15,SAC,94,5,4,SAS,91,5,3,10,7
2014-11-15,GSW,112,6,2,CHA,87,4,5,10,7
2014-11-15,LAC,120,4,3,PHX,107,5,4,9,7
2014-11-16,NYK,109,2,8,DEN,93,2,6,4,14
2014-11-16,MIA,84,5,4,MIL,91,4,5,9,9
2014-11-16,OKC,65,3,7,HOU,69,8,1,11,8
2014-11-16,LAL,115,1,8,GSW,136,7,2,8,10
2014-11-17,CHA,80,4,6,DAL,107,7,3,11,9
2014-11-17,CLE,97,5,3,DEN,106,2,7,7,10
2014-11-17,BOS,114,3,5,PHX,118,5,5,8,10
2014-11-17,BKN,83,4,5,MIA,95,5,5,9,10
2014-11-17,DET,93,3,7,ORL,107,4,7,7,14
2014-11-17,MEM,119,9,1,HOU,93,9,1,18,2
2014-11-17,SAS,100,5,4,PHI,75,0,9,5,13
2014-11-17,POR,102,7,3,NOP,93,5,3,12,6
2014-11-17,LAC,89,5,3,CHI,105,7,3,12,6
2014-11-18,ATL,109,5,4,LAL,114,1,9,6,13
2014-11-18,MIL,117,5,5,NYK,113,3,8,8,13
2014-11-18,UTA,98,4,7,OKC,81,3,8,7,15
2014-11-18,SAC,100,6,4,NOP,106,5,4,11,8
2014-11-19,CLE,90,5,4,SAS,92,6,4,11,8
2014-11-19,IND,88,4,7,CHA,86,4,7,8,14
2014-11-19,ORL,90,5,7,LAC,114,5,4,10,11
2014-11-19,PHI,90,0,10,BOS,101,3,6,3,16
2014-11-19,WAS,102,7,2,DAL,105,8,3,15,5
2014-11-19,BKN,118,4,6,MIL,122,6,5,10,11
2014-11-19,DET,86,3,8,PHX,88,6,5,9,13
2014-11-19,TOR,96,8,2,MEM,92,10,1,18,3
2014-11-19,MIN,115,2,7,NYK,99,3,9,5,16
2014-11-19,DEN,107,3,7,OKC,100,3,9,6,16
2014-11-19,HOU,92,9,2,LAL,98,2,9,11,11
2014-11-20,MIA,93,6,5,LAC,110,6,4,12,9
2014-11-20,SAC,103,6,5,CHI,88,8,3,14,8
2014-11-21,CHA,100,4,8,ORL,105,5,8,9,16
2014-11-21,PHI,96,0,11,PHX,122,7,5,7,16
2014-11-21,ATL,99,5,5,DET,89,3,9,8,14
2014-11-21,TOR,124,9,2,MIL,82,7,5,16,7
2014-11-21,MEM,117,10,2,BOS,100,4,6,14,8
2014-11-21,MIN,92,3,7,SAS,121,7,4,10,11
2014-11-21,OKC,92,3,10,BKN,94,4,7,7,17
2014-11-21,WAS,91,7,3,CLE,78,5,5,12,8
2014-11-21,DAL,140,9,3,LAL,106,3,9,12,12
2014-11-21,DEN,117,4,7,NOP,97,6,4,10,11
2014-11-21,GSW,101,8,2,UTA,88,5,7,13,9
2014-11-21,POR,105,8,3,CHI,87,8,4,16,7
2014-11-22,IND,83,5,7,PHX,106,8,5,13,12
2014-11-22,ORL,92,6,8,MIA,99,6,6,12,14
2014-11-22,CLE,93,5,6,TOR,110,10,2,15,8
2014-11-22,NYK,91,3,10,PHI,83,0,12,3,22
2014-11-22,HOU,95,9,3,DAL,92,10,3,19,6
2014-11-22,MIN,101,3,8,SAC,113,7,5,10,13
2014-11-22,MIL,100,7,6,WAS,111,8,3,15,9
2014-11-22,SAS,99,8,4,BKN,87,5,7,13,11
2014-11-22,UTA,94,5,8,NOP,106,6,5,11,13
2014-11-23,MEM,107,11,2,LAC,91,7,4,18,6
2014-11-23,BOS,88,4,7,POR,94,9,3,13,10
2014-11-23,MIA,94,7,6,CHA,93,4,9,11,15
2014-11-23,OKC,86,3,11,GSW,91,9,2,12,13
2014-11-23,LAL,94,3,10,DEN,101,5,7,8,17
2014-11-24,CHA,92,4,10,LAC,113,7,5,11,15
2014-11-24,CLE,106,5,7,ORL,74,6,9,11,16
2014-11-24,PHI,104,0,13,POR,114,10,3,10,16
2014-11-24,TOR,104,11,2,PHX,100,9,5,20,7
2014-11-24,HOU,91,10,3,NYK,86,4,10,14,13
2014-11-24,DAL,100,10,4,IND,111,5,8,15,12
2014-11-24,UTA,95,5,9,CHI,97,8,5,13,14
2014-11-25,WAS,102,9,3,ATL,106,6,5,15,8
2014-11-25,MIA,97,8,6,GSW,114,10,2,18,8
2014-11-25,MIL,98,7,7,DET,86,3,10,10,17
2014-11-25,NOP,89,7,5,SAC,99,8,5,15,10
2014-11-25,DEN,114,6,7,CHI,109,9,5,15,12
2014-11-26,CHA,97,4,11,POR,105,11,3,15,14
2014-11-26,CLE,113,6,7,WAS,87,9,4,15,11
2014-11-26,ORL,96,6,10,GSW,111,11,2,17,12
2014-11-26,PHI,91,0,14,BKN,99,5,8,5,22
2014-11-26,DAL,109,10,5,NYK,102,4,11,14,16
2014-11-26,ATL,115,7,5,TOR,126,12,2,19,7
2014-11-26,DET,98,3,11,LAC,104,8,5,11,16
2014-11-26,HOU,102,11,3,SAC,89,9,5,20,8
2014-11-26,MIN,86,3,9,MIL,103,8,7,11,16
2014-11-26,OKC,97,3,12,UTA,82,5,10,8,22
2014-11-26,SAS,106,9,4,IND,100,6,8,15,12
2014-11-26,PHX,120,9,6,DEN,112,7,7,16,13
2014-11-26,LAL,93,3,11,MEM,99,12,2,15,13
2014-11-28,BOS,102,4,8,CHI,109,9,6,13,14
2014-11-28,CHA,101,4,12,GSW,106,12,2,16,14
2014-11-28,ATL,100,7,6,NOP,91,7,6,14,12
2014-11-28,DET,88,3,12,MIL,104,9,7,12,19
2014-11-28,TOR,102,13,2,DAL,106,11,5,24,7
2014-11-28,HOU,85,12,3,LAC,102,9,5,21,8
2014-11-28,OKC,105,4,12,NYK,78,4,12,8,24
2014-11-28,IND,98,6,9,ORL,83,6,11,12,20
2014-11-28,SAS,112,10,4,SAC,104,9,6,19,10
2014-11-28,DEN,122,7,8,PHX,97,10,6,17,14
2014-11-28,POR,99,12,3,MEM,112,13,2,25,5
2014-11-28,LAL,119,3,12,MIN,120,3,10,6,22
2014-11-29,PHI,103,0,15,DAL,110,12,5,12,20
2014-11-29,WAS,83,9,5,NOP,80,7,7,16,12
2014-11-29,ATL,105,8,6,CHA,75,4,13,12,19
2014-11-29,CLE,109,7,7,IND,97,7,9,14,16
2014-11-29,UTA,96,5,11,LAC,112,10,5,15,16
2014-11-29,MIL,103,10,7,HOU,117,12,4,22,11
2014-11-30,BOS,89,4,9,SAS,111,11,4,15,13
2014-11-30,BKN,84,6,8,CHI,102,10,6,16,14
2014-11-30,DET,93,3,13,GSW,104,13,2,16,15
2014-11-30,SAC,85,9,7,MEM,97,14,2,23,9
2014-11-30,NYK,79,4,13,MIA,86,8,7,12,20
2014-11-30,PHX,90,10,7,ORL,93,6,12,16,19
2014-11-30,POR,107,12,4,MIN,93,4,10,16,14
2014-11-30,LAL,129,3,13,TOR,122,13,3,16,16
2014-12-01,PHI,103,0,16,SAS,109,12,4,12,20
2014-12-01,WAS,107,10,5,MIA,86,9,7,19,12
2014-12-01,UTA,101,5,12,DEN,103,8,8,13,20
2014-12-01,LAC,127,11,5,MIN,101,4,11,15,16
2014-12-02,CLE,111,8,7,MIL,108,10,8,18,15
2014-12-02,ATL,109,9,6,BOS,105,4,10,13,16
2014-12-02,DET,96,3,14,LAL,106,4,13,7,27
2014-12-02,NYK,93,4,14,BKN,98,6,9,10,23
2014-12-02,CHI,129,11,6,DAL,132,13,5,24,11
2014-12-02,NOP,112,7,8,OKC,104,5,12,12,20
2014-12-02,DEN,103,9,8,POR,105,13,4,22,12
2014-12-02,PHX,116,10,8,IND,99,7,10,17,18
2014-12-02,SAC,109,9,8,TOR,117,13,4,22,12
2014-12-02,GSW,98,14,2,ORL,97,7,12,21,14
2014-12-03,CHA,95,4,14,CHI,102,11,7,15,21
2014-12-03,WAS,111,11,5,LAL,95,5,13,16,18
2014-12-03,BOS,109,4,11,DET,102,3,15,7,26
2014-12-03,BKN,95,7,9,SAS,93,13,4,20,13
2014-12-03,MIA,102,9,8,ATL,112,10,6,19,14
2014-12-03,HOU,105,13,4,MEM,96,15,2,28,6
2014-12-03,MIL,105,10,9,DAL,107,14,5,24,14
2014-12-03,MIN,77,4,12,PHI,85,0,17,4,29
2014-12-03,UTA,104,5,13,TOR,123,14,4,19,17
2014-12-03,LAC,114,12,5,ORL,86,7,13,19,18
2014-12-04,NYK,87,4,15,CLE,90,9,7,13,22
2014-12-04,POR,88,14,4,IND,82,7,11,21,15
2014-12-04,GSW,112,15,2,NOP,85,8,8,23,10
2014-12-05,CHA,103,4,15,NYK,102,4,16,8,31
2014-12-05,PHI,91,1,17,OKC,103,5,13,6,30
2014-12-05,WAS,119,12,5,DEN,89,9,9,21,14
2014-12-05,BOS,113,5,11,LAL,96,5,14,10,25
2014-12-05,BKN,75,8,9,ATL,98,11,6,19,15
2014-12-05,TOR,91,15,4,CLE,105,10,7,25,11
2014-12-05,MEM,101,15,3,SAS,107,13,5,28,8
2014-12-05,MIN,112,4,13,HOU,114,14,4,18,17
2014-12-05,DAL,106,15,5,PHX,118,11,8,26,13
2014-12-05,MIL,109,10,10,MIA,85,9,9,19,19
2014-12-05,UTA,93,5,14,ORL,98,7,14,12,28
2014-12-05,SAC,102,9,9,IND,101,7,12,16,21
2014-12-06,DET,101,3,16,PHI,108,1,18,4,34
2014-12-06,CHI,102,12,7,GSW,112,16,2,28,9
2014-12-06,HOU,100,15,4,PHX,95,12,8,27,12
2014-12-06,SAS,123,14,5,MIN,101,4,14,18,19
2014-12-06,SAC,96,10,9,ORL,105,8,14,18,23
2014-12-06,LAC,120,13,5,NOP,100,8,9,21,14
2014-12-07,BOS,101,6,11,WAS,93,13,5,19,16
2014-12-07,ATL,96,12,6,DEN,84,9,10,21,16
2014-12-07,MEM,103,15,4,MIA,87,9,10,24,14
2014-12-07,DET,94,3,17,OKC,96,6,13,9,30
2014-12-07,DAL,125,15,6,MIL,102,11,10,26,16
2014-12-07,NYK,99,4,17,POR,103,15,4,19,21
2014-12-07,LAL,87,5,15,NOP,104,8,10,13,25
2014-12-08,IND,92,7,13,ATL,108,13,6,20,19
2014-12-08,WAS,133,13,6,BOS,132,7,11,20,17
2014-12-08,BKN,88,8,10,CLE,110,11,7,19,17
2014-12-08,TOR,112,15,5,DEN,107,9,11,24,16
2014-12-08,MIN,86,4,15,GSW,102,17,2,21,17
2014-12-08,SAC,101,10,10,UTA,92,5,15,15,25
2014-12-08,LAC,121,14,5,PHX,120,12,9,26,14
2014-12-09,CLE,105,12,7,TOR,101,16,5,28,12
2014-12-09,DET,86,3,18,POR,98,16,4,19,22
2014-12-09,MEM,114,16,4,DAL,105,16,6,32,10
2014-12-09,NOP,104,9,10,NYK,93,4,18,13,28
2014-12-09,OKC,114,7,13,MIL,101,11,11,18,24
2014-12-09,PHX,97,12,10,MIA,103,9,11,21,21
2014-12-09,UTA,100,5,16,SAS,96,15,5,20,21
2014-12-09,LAL,98,5,16,SAC,95,11,10,16,26
2014-12-10,CHA,96,5,15,BOS,87,7,12,12,27
2014-12-10,IND,96,7,14,LAC,103,15,5,22,19
2014-12-10,ORL,89,9,14,WAS,91,14,6,23,20
2014-12-10,ATL,95,14,6,PHI,79,2,18,16,24
2014-12-10,CHI,105,12,8,BKN,80,8,11,20,19
2014-12-10,MIN,90,4,16,POR,82,17,4,21,20
2014-12-10,SAS,109,15,6,NYK,95,4,19,19,25
2014-12-10,DAL,112,16,7,NOP,107,10,10,26,17
2014-12-10,GSW,105,18,2,HOU,93,16,4,34,6
2014-12-10,DEN,102,9,12,MIA,82,10,11,19,23
2014-12-11,OKC,103,8,13,CLE,94,13,7,21,20
2014-12-11,SAC,109,11,11,HOU,113,16,5,27,16
2014-12-12,CHI,115,13,8,POR,106,17,5,30,13
2014-12-12,WAS,104,15,6,LAC,96,16,5,31,11
2014-12-12,ATL,87,15,6,ORL,81,9,15,24,21
2014-12-12,BOS,95,7,13,NYK,101,4,20,11,33
2014-12-12,BKN,88,8,12,PHI,70,2,19,10,31
2014-12-12,TOR,106,16,6,IND,94,7,15,23,21
2014-12-12,MEM,113,17,4,CHA,107,6,15,23,19
2014-12-12,MIN,92,5,16,OKC,111,9,13,14,29
2014-12-12,NOP,119,10,11,CLE,114,13,8,23,19
2014-12-12,PHX,103,12,11,DET,105,3,19,15,30
2014-12-12,UTA,95,6,16,MIA,100,10,12,16,28
2014-12-12,SAS,110,16,6,LAL,112,6,16,22,22
2014-12-13,DAL,98,17,7,GSW,105,19,2,36,9
2014-12-13,CHA,87,6,16,BKN,114,9,12,15,28
2014-12-13,IND,85,7,16,POR,95,17,6,24,22
2014-12-13,ORL,100,9,16,ATL,99,16,6,25,22
2014-12-13,MIL,111,11,12,LAC,106,16,6,27,18
2014-12-13,PHI,115,2,20,MEM,120,18,4,20,24
2014-12-13,HOU,108,17,5,DEN,96,10,12,27,17
2014-12-13,SAC,90,11,12,DET,95,4,19,15,31
2014-12-14,NOP,122,11,11,GSW,128,20,2,31,13
2014-12-14,MIA,75,11,12,CHI,93,14,8,25,20
2014-12-14,WAS,93,16,6,UTA,84,6,17,22,23
2014-12-14,MIN,94,5,17,LAL,100,7,16,12,33
2014-12-14,OKC,112,10,13,PHX,88,12,12,22,25
2014-12-14,NYK,90,5,20,TOR,95,17,6,22,26
2014-12-14,DEN,91,10,13,SAS,99,16,7,26,20
2014-12-15,CLE,97,13,9,CHA,88,6,17,19,26
2014-12-15,IND,110,7,17,LAL,91,8,16,15,33
2014-12-15,PHI,87,2,21,BOS,105,7,14,9,35
2014-12-15,ATL,93,16,7,CHI,86,15,8,31,15
2014-12-15,TOR,95,18,6,ORL,82,10,16,28,22
2014-12-15,PHX,94,12,13,MIL,96,12,12,24,25
2014-12-15,POR,108,18,6,SAS,95,17,7,35,13
2014-12-15,LAC,113,16,7,DET,91,5,19,21,26
2014-12-16,WAS,109,17,6,MIN,95,5,18,22,24
2014-12-16,BKN,91,10,12,MIA,95,11,13,21,25
2014-12-16,MEM,105,19,4,GSW,98,21,2,40,6
2014-12-16,NOP,119,11,12,UTA,111,6,18,17,30
2014-12-16,NYK,87,5,21,DAL,107,17,8,22,29
2014-12-16,SAC,92,11,13,OKC,104,11,13,22,26
2014-12-17,CHA,106,6,18,PHX,111,12,14,18,32
2014-12-17,CLE,98,14,9,ATL,127,17,7,31,16
2014-12-17,BOS,109,8,14,ORL,92,10,17,18,31
2014-12-17,DET,106,5,20,DAL,117,18,8,23,28
2014-12-17,MIA,87,12,13,UTA,105,6,19,18,32
2014-12-17,TOR,105,19,6,BKN,89,10,13,29,19
2014-12-17,SAS,116,17,8,MEM,117,20,4,37,12
2014-12-17,POR,104,19,6,MIL,97,13,12,32,18
2014-12-17,LAC,102,17,7,IND,100,8,17,25,24
2014-12-17,DEN,111,10,14,HOU,115,18,5,28,19
2014-12-18,CHI,103,15,9,NYK,97,5,22,20,31
2014-12-18,HOU,90,19,5,NOP,99,12,12,31,17
2014-12-18,SAC,107,11,14,MIL,108,13,13,24,27
2014-12-18,GSW,114,21,3,OKC,109,12,13,33,16
2014-12-19,ORL,94,10,18,UTA,101,7,19,17,37
2014-12-19,PHI,91,2,22,CHA,109,6,19,8,41
2014-12-19,BOS,114,9,14,MIN,98,5,19,14,33
2014-12-19,CLE,95,14,10,BKN,91,10,14,24,24
2014-12-19,DET,100,5,21,TOR,110,20,6,25,27
2014-12-19,MIA,103,12,14,WAS,105,18,6,30,20
2014-12-19,MEM,97,21,4,CHI,103,16,9,37,13
2014-12-19,SAS,119,17,9,POR,129,20,6,37,15
2014-12-19,DEN,109,10,15,LAC,106,18,7,28,22
2014-12-19,LAL,103,8,17,OKC,104,12,14,20,31
2014-12-20,NYK,90,5,23,PHX,99,13,14,18,37
2014-12-20,NOP,88,13,12,POR,114,21,6,34,18
2014-12-20,CHA,104,7,19,UTA,86,8,19,15,38
2014-12-20,HOU,97,19,6,ATL,104,18,7,37,13
2014-12-20,DAL,99,19,8,SAS,93,17,10,36,18
2014-12-20,DEN,76,11,15,IND,73,8,18,19,33
2014-12-20,LAC,106,18,8,MIL,102,14,13,32,21
2014-12-21,TOR,118,21,6,NYK,108,5,24,26,30
2014-12-21,CLE,105,15,10,MEM,91,21,5,36,15
2014-12-21,SAC,108,11,15,LAL,101,8,18,19,33
2014-12-21,BKN,110,10,15,DET,105,5,22,15,37
2014-12-21,MIA,100,12,15,BOS,84,10,14,22,29
2014-12-21,ORL,88,10,19,PHI,96,2,23,12,42
2014-12-21,WAS,92,19,6,PHX,104,14,14,33,20
2014-12-21,MIN,96,5,20,IND,100,8,19,13,39
2014-12-21,OKC,99,13,14,NOP,101,13,13,26,27
2014-12-22,CHA,110,8,19,DEN,82,12,15,20,34
2014-12-22,CHI,129,17,9,TOR,120,22,6,39,15
2014-12-22,HOU,110,19,7,POR,95,22,6,41,13
2014-12-22,MEM,91,21,6,UTA,97,8,20,29,26
2014-12-22,DAL,102,20,8,ATL,105,19,7,39,15
2014-12-22,SAS,125,17,11,LAC,118,19,8,36,19
2014-12-22,GSW,128,22,3,SAC,108,12,15,34,18
2014-12-23,CLE,125,16,10,MIN,104,5,21,21,31
2014-12-23,IND,96,9,19,NOP,84,14,13,23,32
2014-12-23,ORL,100,10,20,BOS,95,10,15,20,35
2014-12-23,WAS,91,19,7,CHI,99,18,9,37,16
2014-12-23,ATL,107,20,7,LAC,104,19,9,39,16
2014-12-23,BKN,102,11,15,DEN,96,12,16,23,31
2014-12-23,MIA,87,13,15,PHI,91,3,23,16,38
2014-12-23,MIL,101,14,14,CHA,108,9,19,23,33
2014-12-23,OKC,111,13,15,POR,115,22,7,35,22
2014-12-23,PHX,124,15,14,DAL,115,20,9,35,23
2014-12-23,LAL,115,8,19,GSW,105,23,3,31,22
2014-12-25,NYK,91,5,25,WAS,102,19,8,24,33
2014-12-25,SAS,106,18,11,OKC,114,13,16,31,27
2014-12-25,MIA,101,13,16,CLE,91,17,10,30,26
2014-12-25,CHI,113,19,9,LAL,93,9,19,28,28
2014-12-25,LAC,100,19,10,GSW,86,23,4,42,14
2014-12-26,BOS,107,10,16,BKN,109,12,15,22,31
2014-12-26,ORL,89,11,20,CLE,98,17,11,28,31
2014-12-26,ATL,77,21,7,MIL,107,14,15,35,22
2014-12-26,DET,119,5,23,IND,109,10,19,15,42
2014-12-26,MEM,111,21,7,HOU,117,20,7,41,14
2014-12-26,NOP,97,14,14,SAS,90,18,12,32,26
2014-12-26,OKC,98,14,16,CHA,75,10,19,24,35
2014-12-26,DAL,102,20,10,LAL,98,9,20,29,30
2014-12-26,DEN,106,12,17,MIN,102,5,22,17,39
2014-12-26,POR,114,23,7,PHI,93,4,23,27,30
2014-12-26,SAC,106,12,16,PHX,115,16,14,28,30
2014-12-27,LAC,98,20,10,TOR,110,22,7,42,17
2014-12-27,CHA,94,10,20,ORL,102,11,21,21,41
2014-12-27,WAS,101,20,8,BOS,88,10,17,30,25
2014-12-27,MIA,95,14,16,MEM,103,21,8,35,24
2014-12-27,CHI,107,20,9,NOP,100,15,14,35,23
2014-12-27,BKN,85,13,15,IND,110,10,20,23,35
2014-12-27,MIL,85,15,15,ATL,90,21,8,36,23
2014-12-27,UTA,88,9,20,PHI,71,4,24,13,44
2014-12-27,SAC,135,12,17,NYK,129,5,26,17,43
2014-12-27,GSW,110,23,5,MIN,97,5,23,28,28
2014-12-28,CLE,80,18,11,DET,103,6,23,24,34
2014-12-28,SAS,110,18,13,HOU,106,21,7,39,20
2014-12-28,DAL,112,21,10,OKC,107,15,16,36,26
2014-12-28,POR,101,24,7,NYK,79,5,27,29,34
2014-12-28,DEN,102,13,17,TOR,116,23,7,36,24
2014-12-28,LAL,107,9,21,PHX,116,17,14,26,35
2014-12-29,CHA,94,10,21,MIL,104,15,16,25,37
2014-12-29,IND,90,11,20,CHI,92,21,9,32,29
2014-12-29,BKN,107,13,16,SAC,99,13,17,26,33
2014-12-29,MIA,101,14,17,ORL,102,12,21,26,38
2014-12-29,HOU,103,21,8,WAS,104,21,8,42,16
2014-12-29,LAC,101,20,11,UTA,97,10,20,30,31
2014-12-30,ORL,86,13,21,DET,109,7,23,20,44
2014-12-30,ATL,109,22,8,CLE,101,18,12,40,20
2014-12-30,CHI,82,22,9,BKN,96,14,16,36,25
2014-12-30,MEM,95,22,8,SAS,87,19,13,41,21
2014-12-30,NOP,110,15,15,PHX,106,18,14,33,29
2014-12-30,DAL,114,22,10,WAS,87,22,8,44,18
2014-12-30,DEN,103,13,18,LAL,111,9,22,22,40
2014-12-30,UTA,100,10,21,MIN,94,5,24,15,45
2014-12-30,POR,102,25,7,TOR,97,24,7,49,14
2014-12-30,GSW,126,24,5,PHI,86,4,25,28,30
2014-12-31,BOS,106,10,18,SAC,84,13,18,23,36
2014-12-31,IND,106,11,21,MIA,95,14,18,25,39
2014-12-31,LAC,99,21,11,NYK,78,5,28,26,39
2014-12-31,HOU,102,21,9,CHA,83,10,22,31,31
2014-12-31,CLE,80,18,13,MIL,96,16,16,34,29
2014-12-31,OKC,137,15,17,PHX,134,18,15,33,32
2014-12-31,SAS,95,19,14,NOP,93,16,15,35,29
2015-01-01,CHI,106,22,10,DEN,101,13,19,35,29
2015-01-01,MIN,107,5,25,SAC,110,13,19,18,44
2015-01-02,CHA,87,10,23,CLE,91,18,14,28,37
2015-01-02,ORL,98,13,22,BKN,100,15,16,28,38
2015-01-02,BOS,101,11,18,DAL,119,23,10,34,28
2015-01-02,NYK,81,5,29,DET,97,8,23,13,52
2015-01-02,NOP,111,16,16,HOU,83,22,9,38,25
2015-01-02,OKC,109,16,17,WAS,102,22,9,38,26
2015-01-02,MIL,91,17,16,IND,94,12,21,29,37
2015-01-02,PHX,112,18,16,PHI,96,4,26,22,42
2015-01-02,UTA,92,11,21,ATL,98,23,8,34,29
2015-01-02,GSW,126,25,5,TOR,105,24,8,49,13
2015-01-02,LAL,106,10,22,MEM,109,23,8,33,30
2015-01-03,ORL,90,13,23,CHA,98,10,24,23,47
2015-01-03,CHI,109,23,10,BOS,104,11,19,34,29
2015-01-03,HOU,115,22,10,MIA,79,14,19,36,29
2015-01-03,MIN,89,5,26,UTA,101,11,22,16,48
2015-01-03,SAS,101,20,14,WAS,92,22,10,42,24
2015-01-03,DEN,114,13,20,MEM,85,24,8,37,28
2015-01-03,POR,107,26,7,ATL,115,24,8,50,15
2015-01-03,LAC,127,22,11,PHI,91,4,27,26,38
2015-01-04,CLE,90,19,14,DAL,109,24,10,43,24
2015-01-04,DET,114,9,23,SAC,95,14,19,23,42
2015-01-04,MIA,88,14,20,BKN,84,16,16,30,36
2015-01-04,NYK,82,5,30,MIL,95,17,17,22,47
2015-01-04,PHX,125,19,16,TOR,109,24,9,43,25
2015-01-04,LAL,88,10,23,IND,87,13,21,23,44
2015-01-05,PHI,95,4,28,CLE,92,19,15,23,43
2015-01-05,BOS,95,11,20,CHA,104,11,24,22,44
2015-01-05,BKN,88,16,17,DAL,96,25,10,41,27
2015-01-05,CHI,114,24,10,HOU,105,23,10,47,20
2015-01-05,MEM,105,24,9,NYK,83,5,31,29,40
2015-01-05,MIN,101,5,27,DEN,110,14,20,19,47
2015-01-05,NOP,85,17,16,WAS,92,22,11,39,27
2015-01-05,UTA,101,12,22,IND,105,13,22,25,44
2015-01-05,POR,98,26,8,LAL,94,11,23,37,31
2015-01-05,GSW,117,26,5,OKC,91,17,17,43,22
2015-01-05,LAC,98,23,11,ATL,107,25,8,48,19
2015-01-06,MIL,96,18,17,PHX,102,20,16,38,33
2015-01-06,SAS,104,21,14,DET,105,10,23,31,37
2015-01-07,CHA,98,12,24,NOP,94,17,17,29,41
2015-01-07,CLE,93,19,16,HOU,105,23,11,42,27
2015-01-07,PHI,77,5,28,MIL,97,18,18,23,46
2015-01-07,WAS,101,23,11,NYK,91,5,32,28,43
2015-01-07,ATL,96,26,8,MEM,86,25,9,51,17
2015-01-07,BKN,81,16,18,BOS,89,11,21,27,39
2015-01-07,CHI,77,25,10,UTA,97,12,23,37,33
2015-01-07,DAL,95,26,10,DET,108,11,23,37,33
2015-01-07,DEN,93,15,20,ORL,90,13,24,28,44
2015-01-07,MIN,111,5,28,PHX,113,21,16,26,44
2015-01-07,SAC,104,14,20,OKC,83,17,18,31,38
2015-01-07,GSW,117,27,5,IND,102,14,22,41,27
2015-01-07,LAC,114,23,12,LAL,89,11,24,34,36
2015-01-08,TOR,95,24,10,CHA,103,13,24,37,34
2015-01-08,NYK,96,5,33,HOU,120,24,11,29,44
2015-01-08,POR,99,27,8,MIA,83,15,20,42,28
2015-01-09,IND,107,14,23,BOS,103,12,21,26,44
2015-01-09,BKN,88,16,19,PHI,90,5,29,21,48
2015-01-09,DET,103,12,23,ATL,106,27,8,39,31
2015-01-09,NOP,106,17,18,MEM,95,25,10,42,28
2015-01-09,OKC,99,17,19,UTA,94,13,23,30,42
2015-01-09,WAS,102,24,11,CHI,86,25,11,49,22
2015-01-09,MIL,98,19,18,MIN,84,5,29,24,47
2015-01-09,SAS,100,21,15,PHX,95,22,16,43,31
2015-01-09,SAC,108,15,20,DEN,118,16,20,31,40
2015-01-09,GSW,112,28,5,CLE,94,19,17,47,22
2015-01-09,LAL,101,11,25,ORL,84,13,25,24,50
2015-01-10,NYK,82,5,34,CHA,110,14,24,19,58
2015-01-10,LAC,120,24,12,DAL,100,26,11,50,23
2015-01-10,DET,98,12,24,BKN,93,16,20,28,44
2015-01-10,PHI,93,6,29,IND,92,15,23,21,52
2015-01-10,TOR,109,24,11,BOS,96,12,22,36,33
2015-01-10,CHI,95,25,12,MIL,87,20,18,45,30
2015-01-10,HOU,97,25,11,UTA,82,13,24,38,35
2015-01-10,MIN,93,5,30,SAS,108,22,15,27,45
2015-01-10,POR,103,28,8,ORL,92,13,26,41,34
2015-01-11,ATL,120,28,8,WAS,89,25,11,53,19
2015-01-11,LAC,90,25,12,MIA,104,15,21,40,33
2015-01-11,MEM,122,25,11,PHX,110,22,17,47,28
2015-01-11,SAC,103,15,21,CLE,84,19,18,34,39
2015-01-11,LAL,94,12,25,POR,106,29,8,41,33
2015-01-12,BOS,108,12,23,NOP,100,18,18,30,41
2015-01-12,BKN,99,16,21,HOU,113,26,11,42,32
2015-01-12,TOR,111,25,11,DET,114,13,24,38,35
2015-01-12,CHI,114,26,12,ORL,121,13,27,39,39
2015-01-13,IND,101,15,24,MIN,110,5,31,20,55
2015-01-13,PHI,87,7,29,ATL,105,29,8,36,37
2015-01-13,WAS,101,25,12,SAS,93,23,15,48,27
2015-01-13,PHX,107,22,18,CLE,100,19,19,41,37
2015-01-13,UTA,105,13,25,GSW,116,29,5,42,30
2015-01-13,SAC,104,16,21,DAL,108,26,12,42,33
2015-01-13,LAL,75,12,26,MIA,78,16,21,28,47
2015-01-14,CHA,93,15,24,SAS,98,23,16,38,40
2015-01-14,ORL,120,14,27,HOU,113,27,11,41,38
2015-01-14,BKN,92,16,22,MEM,103,26,11,42,33
2015-01-14,DET,94,14,24,NOP,105,18,19,32,43
2015-01-14,TOR,100,25,12,PHI,84,7,30,32,42
2015-01-14,CHI,99,26,13,WAS,105,26,12,52,25
2015-01-14,BOS,91,13,23,ATL,105,30,8,43,31
2015-01-14,DEN,114,17,20,DAL,107,27,12,44,32
2015-01-14,GSW,104,30,5,MIA,89,17,21,47,26
2015-01-14,POR,94,30,8,LAC,100,25,13,55,21
2015-01-15,HOU,112,27,12,OKC,101,18,19,45,31
2015-01-15,MIL,95,20,19,NYK,79,5,35,25,54
2015-01-15,LAL,102,12,27,CLE,109,19,20,31,47
2015-01-16,IND,96,15,25,DET,98,14,25,29,50
2015-01-16,ORL,96,15,27,MEM,106,27,11,42,38
2015-01-16,PHI,96,7,31,NOP,81,19,19,26,50
2015-01-16,WAS,80,27,12,BKN,102,16,23,43,35
2015-01-16,BOS,103,13,24,CHI,119,26,14,39,38
2015-01-16,TOR,89,26,12,ATL,110,31,8,57,20
2015-01-16,OKC,127,18,20,GSW,115,31,5,49,25
2015-01-16,DAL,97,27,13,DEN,89,18,20,45,33
2015-01-16,SAS,110,24,16,POR,96,30,9,54,25
2015-01-16,PHX,110,23,18,MIN,99,6,31,29,49
2015-01-16,UTA,94,13,26,LAL,85,12,28,25,54
2015-01-16,SAC,83,16,22,MIA,95,17,22,33,44
2015-01-16,LAC,121,26,13,CLE,126,20,20,46,33
2015-01-17,CHA,80,15,25,IND,71,15,26,30,51
2015-01-17,DET,107,15,25,PHI,89,8,31,23,56
2015-01-17,CHI,99,27,14,ATL,107,32,8,59,22
2015-01-17,HOU,106,28,12,GSW,131,31,6,59,18
2015-01-17,MEM,102,28,11,POR,98,30,10,58,21
2015-01-17,BKN,90,17,23,WAS,99,27,13,44,36
2015-01-17,DEN,105,18,21,MIN,113,6,32,24,53
2015-01-17,SAC,108,16,23,LAC,117,26,14,42,37
2015-01-18,TOR,93,26,13,NOP,95,19,20,45,33
2015-01-18,ORL,99,15,28,OKC,127,19,20,34,48
2015-01-18,SAS,89,25,16,UTA,69,14,26,39,42
2015-01-19,CHA,105,16,25,MIN,80,7,32,23,57
2015-01-19,WAS,111,28,13,PHI,76,8,32,36,45
2015-01-19,ATL,93,33,8,DET,82,16,25,49,33
2015-01-19,LAC,102,27,14,BOS,93,13,25,40,39
2015-01-19,GSW,122,32,6,DEN,79,18,22,50,28
2015-01-19,MEM,95,29,11,DAL,103,28,13,57,24
2015-01-19,HOU,110,28,13,IND,98,15,27,43,40
2015-01-19,NYK,99,5,36,NOP,92,20,20,25,56
2015-01-19,MIL,89,21,19,TOR,92,26,14,47,33
2015-01-19,CLE,108,21,20,CHI,94,27,15,48,35
2015-01-19,POR,98,30,11,SAC,94,16,24,46,35
2015-01-19,PHX,115,24,18,LAL,100,12,29,36,47
2015-01-20,MIA,86,18,22,OKC,94,20,20,38,42
2015-01-20,DEN,99,18,23,SAS,109,26,16,44,39
2015-01-21,CHA,78,17,25,MIA,76,18,23,35,48
2015-01-21,CLE,106,22,20,UTA,92,14,27,36,47
2015-01-21,PHI,91,8,33,NYK,98,6,36,14,69
2015-01-21,ATL,110,34,8,IND,91,15,28,49,36
2015-01-21,DET,128,16,26,ORL,118,15,29,31,55
2015-01-21,MEM,92,29,12,TOR,86,27,14,56,26
2015-01-21,MIN,75,7,33,DAL,98,29,13,36,46
2015-01-21,NOP,96,20,21,LAL,80,12,30,32,51
2015-01-21,WAS,103,29,13,OKC,105,21,20,50,33
2015-01-21,PHX,118,25,18,POR,113,31,11,56,29
2015-01-21,SAC,100,16,25,BKN,103,17,24,33,49
2015-01-21,GSW,126,33,6,HOU,113,29,13,62,19
2015-01-22,CHI,104,27,16,SAS,81,27,16,54,32
2015-01-22,MIL,99,21,20,UTA,101,14,28,35,48
2015-01-22,POR,89,31,12,BOS,90,13,26,44,38
2015-01-22,LAC,123,28,14,BKN,84,18,24,46,38
2015-01-23,PHI,86,8,34,TOR,91,27,15,35,49
2015-01-23,ATL,103,35,8,OKC,93,22,20,57,28
2015-01-23,CLE,129,23,20,CHA,90,18,25,41,45
2015-01-23,MIA,89,18,24,IND,87,15,29,33,53
2015-01-23,NYK,113,7,36,ORL,106,15,30,22,66
2015-01-23,DAL,98,30,13,CHI,102,28,16,58,29
2015-01-23,MIN,84,7,34,NOP,92,21,21,28,55
2015-01-23,SAS,99,27,17,LAL,85,12,31,39,48
2015-01-23,DEN,99,18,24,BOS,100,14,26,32,50
2015-01-23,PHX,111,26,18,HOU,113,29,14,55,32
2015-01-23,GSW,126,34,6,SAC,101,16,26,50,32
2015-01-24,CHA,76,18,26,NYK,71,8,36,26,62
2015-01-24,MIL,101,21,21,DET,86,17,26,38,47
2015-01-24,MEM,101,30,12,PHI,83,8,35,38,47
2015-01-24,UTA,108,15,28,BKN,73,18,25,33,53
2015-01-24,POR,103,31,13,WAS,96,29,14,60,27
2015-01-25,CHI,84,29,16,MIA,96,19,24,48,40
2015-01-25,CLE,108,24,20,OKC,98,22,21,46,41
2015-01-25,PHX,100,26,19,LAC,120,29,14,55,33
2015-01-25,NOP,109,22,21,DAL,106,30,14,52,35
2015-01-25,ATL,112,36,8,MIN,100,7,35,43,43
2015-01-25,ORL,99,15,31,IND,106,15,30,30,61
2015-01-25,SAS,101,28,17,MIL,95,22,21,50,38
2015-01-25,TOR,114,28,15,DET,110,17,27,45,42
2015-01-25,GSW,114,35,6,BOS,111,15,26,50,32
2015-01-25,DEN,115,18,25,WAS,117,29,15,47,40
2015-01-25,LAL,87,12,32,HOU,99,30,14,42,46
2015-01-26,MEM,103,31,12,ORL,94,15,32,46,44
2015-01-26,NOP,99,23,21,PHI,74,8,36,31,57
2015-01-26,OKC,92,22,22,MIN,84,7,36,29,58
2015-01-26,UTA,90,16,28,BOS,99,15,27,31,55
2015-01-26,LAC,102,30,14,DEN,98,18,26,48,40
2015-01-27,IND,91,16,30,TOR,104,29,15,45,45
2015-01-27,DET,95,17,28,CLE,103,25,20,42,48
2015-01-27,MIA,102,20,24,MIL,109,22,22,42,46
2015-01-27,DAL,90,30,15,MEM,109,32,12,62,27
2015-01-27,GSW,111,36,6,CHI,113,29,17,65,23
2015-01-27,LAL,92,12,33,WAS,98,30,15,42,48
2015-01-28,CLE,99,26,20,POR,94,32,14,58,34
2015-01-28,PHI,89,8,37,DET,69,17,29,25,66
2015-01-28,ATL,113,37,8,BKN,102,19,26,56,34
2015-01-28,TOR,119,30,15,SAC,102,17,27,47,42
2015-01-28,HOU,99,31,14,DAL,94,30,16,61,30
2015-01-28,MIN,110,7,37,BOS,98,16,27,23,64
2015-01-28,NOP,85,24,21,DEN,93,18,27,42,48
2015-01-28,NYK,100,8,38,OKC,92,23,22,31,60
2015-01-28,SAS,95,29,17,CHA,86,19,26,48,43
2015-01-28,UTA,89,16,29,LAC,94,31,14,47,43
2015-01-28,PHX,106,26,20,WAS,98,31,15,57,35
2015-01-29,ORL,100,15,33,MIL,115,23,22,38,55
2015-01-29,MEM,99,33,12,DEN,69,19,27,52,39
2015-01-29,IND,103,16,31,NYK,82,9,38,25,69
2015-01-29,LAL,123,12,34,CHI,118,30,17,42,51
2015-01-30,PHI,103,9,37,MIN,94,8,37,17,74
2015-01-30,ATL,105,38,8,POR,99,32,15,70,23
2015-01-30,BOS,87,16,28,HOU,93,32,14,48,42
2015-01-30,BKN,122,19,27,TOR,127,31,15,50,42
2015-01-30,CLE,101,27,20,SAC,90,17,28,44,48
2015-01-30,NOP,108,24,22,LAC,103,32,14,56,36
2015-01-30,MIA,72,20,25,DAL,93,30,17,50,42
2015-01-30,UTA,110,16,30,GSW,100,36,7,52,37
2015-01-30,PHX,99,27,20,CHI,93,30,18,57,38
2015-01-31,IND,94,17,31,SAC,99,17,29,34,60
2015-01-31,ORL,93,15,34,DAL,108,31,17,46,51
2015-01-31,WAS,116,31,16,TOR,120,32,15,63,31
2015-01-31,ATL,91,39,8,PHI,85,10,37,49,45
2015-01-31,DET,114,17,30,HOU,101,33,14,50,44
2015-01-31,MEM,85,34,12,OKC,74,23,23,57,35
2015-01-31,MIN,90,8,38,CLE,106,28,20,36,58
2015-01-31,MIL,95,24,22,POR,88,32,16,56,38
2015-01-31,DEN,86,19,28,CHA,104,19,27,38,55
2015-01-31,SAS,85,30,17,LAC,105,32,15,62,32
2015-01-31,GSW,106,36,8,PHX,87,28,20,64,28
2015-02-01,BOS,75,16,29,MIA,83,20,26,36,55
2015-02-01,NYK,92,9,39,LAL,80,13,34,22,73
2015-02-02,CLE,97,29,20,PHI,84,10,38,39,58
2015-02-02,WAS,88,31,17,CHA,92,20,27,51,44
2015-02-02,BKN,102,19,28,LAC,100,33,15,52,43
2015-02-02,TOR,75,33,15,MIL,82,25,22,58,37
2015-02-02,NOP,115,25,22,ATL,100,40,8,65,30
2015-02-02,OKC,104,23,24,ORL,97,15,35,38,59
2015-02-02,DAL,100,32,17,MIN,94,8,39,40,56
2015-02-02,PHX,101,28,21,MEM,102,35,12,63,33
2015-02-03,PHI,105,10,39,DEN,98,19,29,29,68
2015-02-03,DET,108,18,30,MIA,91,21,26,39,56
2015-02-03,NYK,97,10,39,BOS,108,16,30,26,69
2015-02-03,POR,103,32,17,UTA,102,17,30,49,47
2015-02-03,SAC,96,18,29,GSW,121,37,8,55,37
2015-02-04,IND,114,17,32,DET,109,19,30,36,62
2015-02-04,ATL,105,40,9,WAS,96,31,18,71,27
2015-02-04,BOS,104,17,30,DEN,100,19,30,36,60
2015-02-04,TOR,93,33,16,BKN,109,20,28,53,44
2015-02-04,HOU,101,33,15,CHI,90,30,19,63,34
2015-02-04,MIL,113,26,22,LAL,105,13,35,39,57
2015-02-04,MIN,102,8,40,MIA,101,21,27,29,67
2015-02-04,NOP,91,26,22,OKC,102,24,24,50,46
2015-02-04,SAS,110,30,18,ORL,103,15,36,45,54
2015-02-04,UTA,90,17,31,MEM,100,36,12,53,43
2015-02-04,GSW,128,38,8,DAL,114,33,17,71,25
2015-02-05,CHA,94,21,27,WAS,87,31,19,52,46
2015-02-05,CLE,105,30,20,LAC,94,33,16,63,36
2015-02-05,SAC,78,18,30,DAL,101,33,18,51,48
2015-02-05,POR,108,33,17,PHX,87,28,22,61,39
2015-02-06,BKN,92,21,28,NYK,88,10,40,31,68
2015-02-06,IND,103,18,32,CLE,99,31,20,49,52
2015-02-06,ORL,103,15,37,LAL,97,13,36,28,73
2015-02-06,ATL,124,41,9,GSW,116,39,8,80,17
2015-02-06,BOS,107,18,30,PHI,96,11,39,29,69
2015-02-06,DET,98,19,31,DEN,88,19,31,38,62
2015-02-06,TOR,123,33,17,LAC,107,33,17,66,34
2015-02-06,HOU,117,34,15,MIL,111,27,22,61,37
2015-02-06,MIN,90,9,40,MEM,89,37,12,46,52
2015-02-06,OKC,113,25,24,NOP,116,26,23,51,47
2015-02-06,PHX,100,28,23,UTA,93,17,32,45,55
2015-02-06,SAS,98,31,18,MIA,85,21,28,52,46
2015-02-07,NOP,72,27,23,CHI,107,30,20,57,43
2015-02-07,WAS,114,31,20,BKN,77,22,28,53,48
2015-02-07,NYK,92,10,41,GSW,106,39,9,49,50
2015-02-07,PHI,89,11,40,CHA,81,22,27,33,67
2015-02-07,DAL,111,34,18,POR,101,34,17,68,35
2015-02-07,MIL,96,27,23,BOS,93,19,30,46,53
2015-02-07,UTA,102,17,33,SAC,90,18,31,35,64
2015-02-08,OKC,131,25,25,LAC,108,33,18,58,43
2015-02-08,CLE,120,31,21,LAL,105,13,37,44,58
2015-02-08,MEM,94,37,13,ATL,88,42,9,79,22
2015-02-08,CHA,102,22,28,IND,103,19,32,41,60
2015-02-08,DET,101,20,31,MIN,112,10,40,30,71
2015-02-08,ORL,97,16,37,CHI,98,31,20,47,57
2015-02-08,HOU,98,35,15,POR,109,34,18,69,33
2015-02-08,TOR,87,34,17,SAS,82,32,18,66,35
2015-02-08,SAC,85,18,32,PHX,83,29,23,47,55
2015-02-09,IND,93,20,32,SAS,95,32,19,52,51
2015-02-09,PHI,84,12,40,GSW,89,40,9,52,49
2015-02-09,WAS,96,32,20,ORL,80,16,38,48,58
2015-02-09,MIA,109,21,29,NYK,95,10,42,31,71
2015-02-09,MIL,103,28,23,BKN,97,22,29,50,52
2015-02-09,MIN,105,11,40,ATL,117,42,10,53,50
2015-02-09,NOP,96,27,24,UTA,100,18,33,45,57
2015-02-09,DAL,98,35,18,LAC,115,33,19,68,37
2015-02-09,DEN,114,19,32,OKC,124,26,25,45,57
2015-02-10,CHA,78,22,29,DET,106,20,32,42,61
2015-02-10,PHX,118,29,24,HOU,127,35,16,64,40
2015-02-10,CHI,104,32,20,SAC,86,19,32,51,52
2015-02-10,MEM,95,38,13,BKN,86,22,30,60,43
2015-02-10,LAL,96,13,38,DEN,106,19,33,32,71
2015-02-11,ORL,89,16,39,NYK,83,10,43,26,82
2015-02-11,BOS,89,19,31,ATL,88,43,10,62,41
2015-02-11,DET,87,21,32,SAS,104,33,19,54,51
2015-02-11,TOR,95,35,17,WAS,93,33,20,68,37
2015-02-11,MIL,111,29,23,SAC,103,19,33,48,56
2015-02-11,MIN,91,11,41,GSW,94,41,9,52,50
2015-02-11,NOP,93,27,25,IND,106,20,33,47,58
2015-02-11,OKC,105,27,25,MEM,89,39,13,66,38
2015-02-11,CLE,113,32,21,MIA,93,22,29,54,50
2015-02-11,DAL,87,35,19,UTA,82,19,33,54,52
2015-02-11,POR,102,35,18,LAL,86,13,39,48,57
2015-02-11,LAC,110,34,19,HOU,95,36,16,70,35
2015-02-12,CHI,113,33,20,CLE,98,33,21,66,41
2015-02-19,OKC,104,28,25,DAL,89,36,19,64,44
2015-02-19,LAC,119,35,19,SAS,115,34,19,69,38
2015-02-20,ORL,95,17,39,NOP,84,27,26,44,65
2015-02-20,PHI,95,12,41,IND,106,21,33,33,74
2015-02-20,ATL,80,43,11,TOR,105,36,17,79,28
2015-02-20,DET,100,21,33,CHI,91,34,20,55,53
2015-02-20,NYK,87,10,44,MIA,111,22,30,32,74
2015-02-20,MIN,111,11,42,PHX,109,29,25,40,67
2015-02-20,WAS,89,33,21,CLE,127,33,22,66,43
2015-02-20,DAL,111,36,20,HOU,100,36,17,72,37
2015-02-20,MIL,89,30,23,DEN,81,20,33,50,56
2015-02-20,UTA,92,19,34,POR,76,36,18,55,52
2015-02-20,SAC,109,19,34,BOS,101,20,31,39,65
2015-02-20,GSW,110,42,9,SAS,99,34,20,76,29
2015-02-20,LAL,105,13,40,BKN,114,22,31,35,71
2015-02-21,CHA,103,22,30,OKC,110,29,25,51,55
2015-02-21,MIA,91,23,30,NOP,105,27,27,50,57
2015-02-21,CHI,112,34,21,PHX,107,29,26,63,47
2015-02-21,HOU,98,36,18,TOR,76,37,17,73,35
2015-02-21,LAC,126,36,19,SAC,99,20,34,56,53
2015-02-22,NYK,83,10,45,CLE,101,34,22,44,67
2015-02-22,MIL,86,31,23,ATL,97,43,12,74,35
2015-02-22,DET,106,22,33,WAS,89,33,22,55,55
2015-02-22,IND,104,22,33,GSW,98,43,9,65,42
2015-02-22,ORL,103,18,39,PHI,98,12,42,30,81
2015-02-22,OKC,119,30,25,DEN,94,20,34,50,59
2015-02-22,DAL,92,37,20,CHA,81,22,31,59,51
2015-02-22,POR,92,36,19,MEM,98,39,14,75,33
2015-02-22,LAL,118,13,41,BOS,111,20,32,33,73
2015-02-23,MIA,119,23,31,PHI,108,12,43,35,74
2015-02-23,CHI,87,35,21,MIL,71,31,24,66,45
2015-02-23,HOU,113,37,18,MIN,102,12,42,49,60
2015-02-23,NOP,100,28,27,TOR,97,37,18,65,45
2015-02-23,DEN,82,20,35,BKN,110,23,31,43,66
2015-02-23,PHX,110,29,27,BOS,115,20,33,49,60
2015-02-23,UTA,90,20,34,SAS,81,34,21,54,55
2015-02-23,LAC,87,37,19,MEM,90,40,14,77,33
2015-02-24,WAS,107,33,23,GSW,114,43,10,76,33
2015-02-24,DET,93,23,33,CLE,102,35,22,58,55
2015-02-24,OKC,105,31,25,IND,92,23,33,54,58
2015-02-24,DAL,99,38,20,TOR,92,37,19,75,39
2015-02-25,ORL,90,19,39,MIA,93,24,31,43,70
2015-02-25,ATL,104,44,12,DAL,87,39,20,83,32
2015-02-25,BOS,115,21,33,NYK,94,10,46,31,79
2015-02-25,CHI,86,36,21,CHA,98,22,32,58,53
2015-02-25,HOU,110,38,18,LAC,105,37,20,75,38
2015-02-25,MIL,104,31,25,PHI,88,12,44,43,69
2015-02-25,MIN,97,12,43,WAS,77,33,24,45,67
2015-02-25,NOP,102,29,27,BKN,96,24,31,53,58
2015-02-25,DEN,96,20,36,PHX,110,29,28,49,64
2015-02-25,UTA,97,21,34,LAL,100,14,41,35,75
2015-02-25,SAC,102,20,35,MEM,90,41,14,61,49
2015-02-25,POR,111,36,20,SAS,95,34,22,70,42
2015-02-26,CLE,110,36,22,GSW,99,44,10,80,32
2015-02-26,PHX,117,30,28,OKC,113,32,25,62,53
2015-02-27,IND,93,23,34,CLE,86,37,22,60,56
2015-02-27,PHI,89,12,45,WAS,81,33,25,45,70
2015-02-27,ATL,95,45,12,ORL,88,19,40,64,52
2015-02-27,BOS,106,22,33,CHA,98,23,32,45,65
2015-02-27,DET,115,23,34,NYK,121,10,47,33,81
2015-02-27,TOR,89,37,20,GSW,113,44,11,81,31
2015-02-27,CHI,96,36,22,MIN,89,13,43,49,65
2015-02-27,HOU,102,39,18,BKN,98,24,32,63,50
2015-02-27,MEM,79,41,15,LAC,97,37,21,78,36
2015-02-27,NOP,104,30,27,MIA,102,25,31,55,58
2015-02-27,DEN,82,20,37,UTA,104,21,35,41,72
2015-02-27,SAC,96,21,35,SAS,107,34,23,55,58
2015-02-27,LAL,101,15,41,MIL,93,32,25,47,66
2015-02-27,POR,115,37,20,OKC,112,32,26,69,46
2015-02-28,WAS,99,33,26,DET,95,23,35,56,61
2015-02-28,MIA,91,25,32,ATL,93,46,12,71,44
2015-02-28,NYK,103,11,47,TOR,98,37,21,48,68
2015-02-28,MIN,97,13,44,MEM,101,41,16,54,60
2015-02-28,DAL,94,39,21,BKN,104,24,33,63,54
2015-02-28,PHX,74,31,28,SAS,101,35,23,66,51
2015-02-28,UTA,82,22,35,MIL,75,32,26,54,61
2015-03-01,CHI,86,37,22,LAC,96,38,21,75,43
2015-03-01,LAL,101,16,41,OKC,108,32,27,48,68
2015-03-01,SAC,99,21,36,POR,110,38,20,59,56
2015-03-01,BOS,101,23,33,GSW,106,45,11,68,44
2015-03-01,IND,94,24,34,PHI,74,13,45,37,79
2015-03-01,ORL,83,19,41,CHA,98,23,33,42,74
2015-03-01,HOU,105,40,18,CLE,103,37,23,77,41
2015-03-01,DEN,92,20,38,NOP,99,31,27,51,65
2015-03-02,PHI,103,13,46,TOR,114,37,22,50,68
2015-03-02,BKN,110,25,33,GSW,108,46,11,71,44
2015-03-02,MIA,115,25,33,PHX,98,31,29,56,62
2015-03-02,MIN,105,13,45,LAC,110,39,21,52,66
2015-03-02,DAL,102,39,22,NOP,93,32,27,71,49
2015-03-03,NYK,86,8,37,SAC,124,16,27,24,64
2015-03-03,CHA,104,24,33,LAL,103,16,42,40,75
2015-03-03,CLE,110,37,24,BOS,79,23,34,60,58
2015-03-03,ATL,104,47,12,HOU,96,41,18,88,30
2015-03-03,CHI,97,37,23,WAS,92,34,26,71,49
2015-03-03,MEM,82,42,16,UTA,93,23,35,65,51
2015-03-03,DEN,106,20,39,MIL,95,32,27,52,66
2015-03-04,IND,105,25,34,NYK,82,12,47,37,81
2015-03-04,ORL,100,19,42,PHX,105,31,30,50,72
2015-03-04,BOS,85,23,35,UTA,84,24,35,47,70
2015-03-04,BKN,91,26,33,CHA,115,25,33,51,66
2015-03-04,TOR,112,38,22,CLE,120,38,24,76,46
2015-03-04,HOU,100,41,19,MEM,102,42,17,83,36
2015-03-04,MIN,85,13,46,DEN,100,21,39,34,85
2015-03-04,NOP,88,32,28,DET,85,23,36,55,64
2015-03-04,OKC,123,33,27,PHI,118,13,47,46,74
2015-03-04,MIA,100,26,33,LAL,94,16,43,42,76
2015-03-04,SAS,112,36,23,SAC,85,21,37,57,60
2015-03-04,GSW,102,46,12,MIL,93,32,28,78,40
2015-03-04,LAC,93,40,21,POR,98,39,20,79,41
2015-03-05,CHI,108,38,23,OKC,105,34,27,72,50
2015-03-05,POR,94,40,20,DAL,75,40,22,80,42
2015-03-06,CHA,103,26,33,TOR,94,38,23,64,56
2015-03-06,IND,98,26,34,CHI,84,39,23,65,57
2015-03-06,ORL,119,19,43,SAC,114,21,38,40,81
2015-03-06,PHI,83,13,48,UTA,89,24,36,37,84
2015-03-06,ATL,106,48,12,CLE,97,39,24,87,36
2015-03-06,BKN,100,26,34,PHX,108,32,30,58,64
2015-03-06,HOU,103,41,20,DET,93,23,37,64,57
2015-03-06,MEM,97,43,17,LAL,90,16,44,59,61
2015-03-06,NOP,98,33,28,BOS,104,24,35,57,63
2015-03-06,WAS,99,34,27,MIA,97,27,33,61,60
2015-03-06,SAS,120,37,23,DEN,111,22,39,59,62
2015-03-06,GSW,104,47,12,DAL,89,40,23,87,35
2015-03-07,NOP,95,33,29,MEM,89,44,17,77,46
2015-03-07,CLE,89,39,25,PHX,79,33,30,72,55
2015-03-07,MIA,114,27,34,SAC,109,21,39,48,73
2015-03-07,NYK,86,12,48,IND,92,27,34,39,82
2015-03-07,PHI,92,13,49,ATL,84,49,12,62,61
2015-03-07,MIN,121,13,47,POR,113,41,20,54,67
2015-03-07,MIL,91,32,29,WAS,85,35,27,67,56
2015-03-07,DEN,100,22,40,HOU,114,42,20,64,60
2015-03-08,SAS,116,38,23,CHI,105,39,24,77,47
2015-03-08,GSW,106,48,12,LAC,98,40,22,88,34
2015-03-08,BKN,88,26,35,UTA,95,25,36,51,71
2015-03-08,DET,101,23,38,CHA,108,27,33,50,71
2015-03-08,ORL,103,20,43,BOS,98,25,35,45,78
2015-03-08,OKC,108,34,28,TOR,104,38,24,72,52
2015-03-08,LAL,93,16,45,DAL,100,40,24,56,69
2015-03-09,CHA,69,28,33,WAS,95,35,28,63,61
2015-03-09,ATL,130,49,13,SAC,105,21,40,70,53
2015-03-09,MIA,90,28,34,BOS,100,25,36,53,70
2015-03-09,CHI,91,39,25,MEM,101,44,18,83,43
2015-03-09,MIL,103,33,29,NOP,114,34,29,67,58
2015-03-09,DEN,106,22,41,NYK,78,12,49,34,90
2015-03-09,PHX,80,33,31,GSW,98,49,12,82,43
2015-03-09,LAC,89,40,23,MIN,76,14,47,54,70
2015-03-10,IND,118,28,34,ORL,86,21,43,49,77
2015-03-10,BKN,91,26,36,NOP,111,35,29,61,65
2015-03-10,DAL,94,41,24,CLE,127,40,25,81,49
2015-03-10,SAS,117,39,23,TOR,107,38,25,77,48
2015-03-10,UTA,87,26,36,NYK,82,12,50,38,86
2015-03-10,LAL,93,16,46,DET,85,23,39,39,85
2015-03-11,CHA,106,28,34,SAC,113,21,41,49,75
2015-03-11,PHI,95,14,49,CHI,104,39,26,53,75
2015-03-11,BOS,95,26,36,MEM,92,45,18,71,54
2015-03-11,MIA,104,28,35,BKN,98,26,37,54,72
2015-03-11,MIL,97,33,30,ORL,91,21,44,54,74
2015-03-11,OKC,108,35,28,LAC,120,41,23,76,51
2015-03-11,DEN,115,23,41,ATL,102,50,13,73,54
2015-03-11,PHX,106,33,32,MIN,97,14,48,47,80
2015-03-11,GSW,105,50,12,DET,98,23,40,73,52
2015-03-11,POR,105,41,21,HOU,100,43,20,84,41
2015-03-12,IND,109,29,34,MIL,103,34,30,63,64
2015-03-12,WAS,107,36,28,MEM,87,45,19,81,47
2015-03-12,SAS,125,40,23,CLE,128,41,25,81,48
2015-03-12,UTA,109,27,36,HOU,91,43,21,70,57
2015-03-12,LAL,94,17,46,NYK,101,12,51,29,97
2015-03-13,CHA,101,28,35,CHI,91,40,26,68,61
2015-03-13,PHI,114,14,50,SAC,107,22,41,36,91
2015-03-13,BOS,95,27,36,ORL,88,21,45,48,81
2015-03-13,TOR,102,38,26,MIA,92,29,35,67,61
2015-03-13,OKC,113,35,29,MIN,99,14,49,49,78
2015-03-13,DAL,129,41,25,LAC,99,42,23,83,48
2015-03-13,DEN,114,24,41,GSW,103,51,12,75,53
2015-03-13,PHX,87,34,32,ATL,96,50,14,84,46
2015-03-13,POR,118,42,21,DET,99,23,41,65,62
2015-03-14,IND,89,30,34,BOS,93,28,36,58,70
2015-03-14,WAS,113,37,28,SAC,97,22,42,59,70
2015-03-14,PHI,87,15,50,BKN,94,26,38,41,88
2015-03-14,MEM,96,45,20,MIL,83,34,31,79,51
2015-03-14,UTA,88,28,36,DET,85,23,42,51,78
2015-03-14,GSW,125,51,13,NYK,94,13,51,64,64
2015-03-15,OKC,109,36,29,CHI,100,40,27,76,56
2015-03-15,LAC,98,42,24,HOU,100,43,22,85,46
2015-03-15,NOP,111,36,29,DEN,118,25,41,61,70
2015-03-15,ORL,108,21,46,CLE,123,42,25,63,71
2015-03-15,SAS,123,40,24,MIN,97,14,50,54,74
2015-03-15,TOR,97,39,26,POR,113,43,21,82,47
2015-03-15,PHX,102,34,33,NYK,89,13,52,47,85
2015-03-15,LAL,86,17,47,ATL,91,51,14,68,61
2015-03-16,IND,98,30,35,TOR,117,39,27,69,62
2015-03-16,WAS,105,38,28,POR,97,44,21,82,49
2015-03-16,BOS,108,29,36,PHI,89,15,51,44,87
2015-03-16,MEM,92,46,20,DEN,81,26,41,72,61
2015-03-16,MIN,106,14,51,BKN,122,27,38,41,89
2015-03-16,MIA,106,29,36,CLE,92,43,25,72,61
2015-03-16,DAL,119,42,25,OKC,115,37,29,79,54
2015-03-16,UTA,94,29,36,CHA,66,29,35,58,71
2015-03-16,SAC,103,22,43,ATL,110,52,14,74,57
2015-03-16,GSW,108,52,13,LAL,105,17,48,69,61
2015-03-17,DET,105,23,43,MEM,95,47,20,70,63
2015-03-17,NYK,104,13,53,SAS,100,41,24,54,77
2015-03-17,HOU,107,44,22,ORL,94,21,47,65,69
2015-03-17,NOP,85,36,30,MIL,84,34,32,70,62
2015-03-17,LAC,99,42,25,CHA,92,29,36,71,61
2015-03-18,CLE,117,43,26,BKN,92,28,38,71,64
2015-03-18,PHI,94,15,52,DET,83,24,43,39,95
2015-03-18,MIA,108,30,36,POR,104,44,22,74,58
2015-03-18,TOR,105,40,27,MIN,100,14,52,54,79
2015-03-18,CHI,103,40,28,IND,86,30,36,70,64
2015-03-18,MIL,103,34,33,SAS,114,41,25,75,58
2015-03-18,OKC,122,37,30,BOS,118,30,36,67,66
2015-03-18,DAL,107,43,25,ORL,102,21,48,64,73
2015-03-18,SAC,105,22,44,LAC,116,43,25,65,69
2015-03-18,GSW,114,53,13,ATL,95,53,14,106,27
2015-03-18,UTA,84,30,36,WAS,88,39,28,69,64
2015-03-19,NYK,92,14,53,MIN,95,14,53,28,106
2015-03-19,HOU,118,45,22,DEN,108,26,42,71,64
2015-03-19,PHX,74,35,33,NOP,72,37,30,72,63
2015-03-19,LAL,73,17,49,UTA,80,30,37,47,86
2015-03-20,ORL,111,21,49,POR,104,44,23,65,72
2015-03-20,PHI,97,16,52,NYK,81,14,54,30,106
2015-03-20,BKN,129,28,39,MIL,127,34,34,62,73
2015-03-20,CLE,95,44,26,IND,92,30,37,74,63
2015-03-20,MIA,108,31,36,DEN,91,26,43,57,79
2015-03-20,CHI,108,41,28,TOR,92,41,27,82,55
2015-03-20,OKC,123,38,30,ATL,115,53,15,91,45
2015-03-20,DAL,101,44,25,MEM,112,47,21,91,46
2015-03-20,SAS,101,42,25,BOS,89,30,37,72,62
2015-03-20,SAC,101,22,45,CHA,91,29,37,51,82
2015-03-20,GSW,112,54,13,NOP,96,37,31,91,44
2015-03-20,LAC,113,44,25,WAS,99,40,28,84,53
2015-03-21,IND,111,30,38,BKN,123,29,39,59,77
2015-03-21,DET,107,24,44,CHI,91,42,28,66,72
2015-03-21,HOU,102,46,22,PHX,117,36,33,82,55
2015-03-21,MEM,97,48,21,POR,86,44,24,92,45
2015-03-21,GSW,106,55,13,UTA,91,31,37,86,50
2015-03-22,MIL,90,34,35,CLE,108,45,26,79,61
2015-03-22,OKC,93,39,30,MIA,75,32,36,71,66
2015-03-22,ATL,95,53,16,SAS,114,43,25,96,41
2015-03-22,LAC,107,45,25,NOP,100,37,32,82,57
2015-03-22,TOR,106,41,28,NYK,89,14,55,55,83
2015-03-22,SAC,109,23,45,WAS,86,40,29,63,74
2015-03-22,BOS,97,30,38,DET,105,25,44,55,82
2015-03-22,ORL,100,22,49,DEN,119,26,44,48,93
2015-03-22,MIN,98,15,53,CHA,109,29,38,44,91
2015-03-22,PHX,98,37,33,DAL,92,44,26,81,59
2015-03-22,LAL,101,17,50,PHI,87,17,52,34,102
2015-03-23,IND,100,30,39,HOU,110,46,23,76,62
2015-03-23,BKN,91,30,39,BOS,110,30,39,60,78
2015-03-23,NYK,82,14,56,MEM,103,49,21,63,77
2015-03-23,CHI,98,42,29,CHA,86,30,38,72,67
2015-03-23,UTA,104,31,38,MIN,106,15,54,46,92
2015-03-23,GSW,107,56,13,WAS,76,40,30,96,43
2015-03-24,DET,108,26,44,TOR,104,42,28,68,72
2015-03-24,MIL,89,34,36,MIA,88,32,37,66,73
2015-03-24,OKC,127,40,30,LAL,117,18,50,58,80
2015-03-24,DAL,101,44,27,SAS,94,44,25,88,52
2015-03-24,SAC,107,24,45,PHI,106,17,53,41,98
2015-03-24,POR,108,44,25,GSW,122,57,13,101,38
2015-03-25,CHA,88,30,39,BKN,91,30,40,60,79
2015-03-25,NYK,80,14,57,LAC,111,46,25,60,82
2015-03-25,ORL,83,22,50,ATL,95,53,17,75,67
2015-03-25,WAS,101,40,31,IND,103,30,40,70,71
2015-03-25,BOS,86,31,39,MIA,93,32,38,63,77
2015-03-25,TOR,103,42,29,CHI,116,43,29,85,58
2015-03-25,MEM,89,50,21,CLE,111,46,26,96,47
2015-03-25,MIN,99,16,54,LAL,101,18,51,34,105
2015-03-25,NOP,93,37,33,HOU,95,47,23,84,56
2015-03-25,DEN,85,27,44,PHI,99,17,54,44,98
2015-03-25,UTA,89,31,39,POR,92,44,26,75,65
2015-03-25,SAS,130,44,26,OKC,91,41,30,85,56
2015-03-25,PHX,99,38,33,SAC,108,25,45,63,78
2015-03-26,MIL,111,35,36,IND,107,31,40,66,76
2015-03-27,ORL,97,22,51,DET,111,27,44,49,95
2015-03-27,PHI,98,18,54,LAC,119,47,25,65,79
2015-03-27,WAS,110,40,32,CHA,107,30,40,70,72
2015-03-27,ATL,99,54,17,MIA,86,33,38,87,55
2015-03-27,BKN,106,31,40,CLE,98,47,26,78,66
2015-03-27,NYK,92,14,58,BOS,96,31,40,45,98
2015-03-27,TOR,94,42,30,LAL,83,19,51,61,81
2015-03-27,HOU,120,48,23,MIN,110,16,55,64,78
2015-03-27,MEM,84,50,22,GSW,107,58,13,108,35
2015-03-27,NOP,102,37,34,SAC,88,26,45,63,79
2015-03-27,SAS,94,45,26,DAL,76,45,27,90,53
2015-03-27,DEN,107,27,45,UTA,91,31,40,58,85
2015-03-27,PHX,81,38,34,POR,87,45,26,83,60
2015-03-28,CHA,115,30,41,ATL,100,55,17,85,58
2015-03-28,CHI,111,44,29,NYK,80,14,59,58,88
2015-03-28,MIL,95,36,36,GSW,108,59,13,95,49
2015-03-28,UTA,94,31,41,OKC,89,41,31,72,72
2015-03-28,POR,120,46,26,DEN,114,28,45,74,71
2015-03-29,CLE,87,47,27,PHI,86,18,55,65,82
2015-03-29,BKN,107,32,40,LAL,99,19,52,51,92
2015-03-29,NOP,110,38,34,MIN,88,16,56,54,90
2015-03-29,BOS,106,32,40,LAC,119,48,25,80,65
2015-03-29,MIA,109,33,39,DET,102,28,44,61,83
2015-03-29,WAS,91,41,32,HOU,99,49,23,90,55
2015-03-29,SAS,103,46,26,MEM,89,50,23,96,49
2015-03-29,IND,104,31,41,DAL,99,45,28,76,69
2015-03-29,PHX,97,38,35,OKC,109,41,32,79,67
2015-03-30,CHA,104,31,41,BOS,116,32,41,63,82
2015-03-30,PHI,111,18,56,LAL,113,19,53,37,109
2015-03-30,ATL,101,55,18,MIL,88,36,37,91,55
2015-03-30,TOR,99,43,30,HOU,96,50,23,93,53
2015-03-30,MEM,97,50,24,SAC,83,26,46,76,70
2015-03-30,MIN,84,16,57,UTA,104,32,41,48,98
2015-03-30,POR,109,47,26,PHX,86,38,36,85,62
2015-03-31,BKN,111,33,40,IND,106,32,41,65,81
2015-03-31,DET,105,28,45,ATL,95,56,18,84,63
2015-03-31,MIA,81,34,39,SAS,95,47,26,81,65
2015-03-31,LAC,106,49,25,GSW,110,60,13,109,38
2015-04-01,CHA,102,31,42,DET,78,29,45,60,87
2015-04-01,ORL,91,22,52,SAS,103,48,26,70,78
2015-04-01,WAS,106,41,33,PHI,93,18,57,59,90
2015-04-01,BOS,100,33,41,IND,87,32,42,65,83
2015-04-01,NYK,98,14,60,BKN,100,34,40,48,100
2015-04-01,HOU,115,50,24,SAC,111,26,47,76,71
2015-04-01,MIL,95,36,38,CHI,91,45,29,81,67
2015-04-01,MIN,99,16,58,TOR,113,44,30,60,88
2015-04-01,OKC,131,42,32,DAL,135,45,29,87,61
2015-04-01,UTA,98,33,41,DEN,84,28,46,61,87
2015-04-01,POR,122,48,26,LAC,126,49,26,97,52
2015-04-01,LAL,92,20,53,NOP,113,39,34,59,87
2015-04-02,CLE,114,48,27,MIA,88,34,40,82,67
2015-04-02,DAL,101,46,29,HOU,108,51,24,97,53
2015-04-02,GSW,107,61,13,PHX,106,38,37,99,50
2015-04-03,IND,93,32,43,CHA,74,32,42,64,85
2015-04-03,WAS,101,42,33,NYK,87,14,61,56,94
2015-04-03,BOS,101,34,41,MIL,110,37,38,71,79
2015-04-03,BKN,114,35,40,TOR,109,45,30,80,70
2015-04-03,CHI,88,45,30,DET,82,29,46,74,76
2015-04-03,MEM,100,51,24,OKC,92,42,33,93,57
2015-04-03,MIN,84,16,59,ORL,97,22,53,38,112
2015-04-03,SAS,123,49,26,DEN,93,28,47,77,73
2015-04-03,SAC,95,26,48,NOP,101,40,34,66,82
2015-04-03,LAL,77,20,54,POR,107,48,27,68,81
2015-04-04,CHA,92,32,43,PHI,91,18,58,50,101
2015-04-04,ATL,131,56,19,BKN,99,36,40,92,59
2015-04-04,DET,99,29,47,MIA,98,34,41,63,88
2015-04-04,TOR,116,45,31,BOS,117,34,42,79,73
2015-04-04,MEM,83,52,24,WAS,92,43,33,95,57
2015-04-04,DAL,110,46,30,GSW,123,62,13,108,43
2015-04-04,MIL,90,38,38,ORL,97,23,53,61,91
2015-04-04,DEN,92,28,48,LAC,107,50,26,78,74
2015-04-04,PHX,87,38,38,UTA,85,34,41,72,79
2015-04-04,POR,99,49,27,NOP,90,41,34,90,61
2015-04-05,OKC,112,42,34,HOU,115,52,24,94,58
2015-04-05,CLE,99,49,27,CHI,94,46,30,95,57
2015-04-05,IND,112,33,43,MIA,89,34,42,67,85
2015-04-05,SAS,107,50,26,GSW,92,63,13,113,39
2015-04-05,NYK,101,14,62,PHI,91,18,59,32,121
2015-04-05,SAC,95,26,49,UTA,101,34,42,60,91
2015-04-05,LAL,78,20,55,LAC,106,51,26,71,81
2015-04-06,BKN,106,18,26,POR,96,32,13,50,39
2015-04-07,ATL,96,57,19,PHX,69,39,38,96,57
2015-04-07,MIA,105,34,43,CHA,100,33,43,67,86
2015-04-07,NOP,103,41,35,GSW,100,63,14,104,49
2015-04-07,OKC,88,42,35,SAS,113,51,26,93,61
2015-04-07,SAC,116,26,50,MIN,111,16,60,42,110
2015-04-07,LAC,105,52,26,LAL,100,20,56,72,82
2015-04-08,CHA,74,33,44,TOR,92,45,32,78,76
2015-04-08,ORL,105,24,53,CHI,103,46,31,70,84
2015-04-08,PHI,90,18,60,WAS,119,44,33,62,93
2015-04-08,BKN,111,36,41,ATL,114,58,19,94,60
2015-04-08,DET,103,30,47,BOS,113,35,42,65,89
2015-04-08,NYK,86,15,62,IND,102,34,43,49,105
2015-04-08,MEM,110,52,25,NOP,74,42,35,94,60
2015-04-08,MIL,99,38,39,CLE,104,50,27,88,66
2015-04-08,SAS,110,52,26,HOU,98,53,24,105,50
2015-04-08,DEN,119,28,49,LAL,101,20,57,48,106
2015-04-08,UTA,103,35,42,SAC,91,27,50,62,92
2015-04-08,DAL,107,46,31,PHX,104,39,39,85,70
2015-04-08,POR,116,50,27,MIN,91,16,61,66,88
2015-04-09,MIA,78,35,43,CHI,89,46,32,81,75
2015-04-09,GSW,116,63,15,POR,105,51,27,114,42
2015-04-10,ORL,99,25,53,TOR,101,46,32,71,85
2015-04-10,ATL,104,59,19,CHA,80,33,45,92,64
2015-04-10,BKN,117,36,42,WAS,80,45,33,81,75
2015-04-10,CLE,90,51,27,BOS,99,36,42,87,69
2015-04-10,DET,103,30,48,IND,107,35,43,65,91
2015-04-10,NYK,91,15,63,MIL,99,38,40,53,103
2015-04-10,HOU,103,53,25,SAS,104,53,26,106,51
2015-04-10,NOP,90,42,36,PHX,75,39,40,81,76
2015-04-10,OKC,116,42,36,SAC,103,27,51,69,87
2015-04-10,DEN,143,29,49,DAL,144,47,31,76,80
2015-04-10,UTA,88,36,42,MEM,89,53,25,89,67
2015-04-10,LAL,106,20,58,MIN,98,16,62,36,120
2015-04-11,ORL,79,25,54,NYK,80,15,64,40,118
2015-04-11,MIA,104,35,44,TOR,107,47,32,82,76
2015-04-11,CHI,114,47,32,PHI,107,18,61,65,93
2015-04-11,LAC,94,53,26,MEM,86,54,25,107,51
2015-04-11,POR,105,51,28,UTA,111,36,43,87,71
2015-04-11,GSW,110,64,15,MIN,101,16,63,80,78
2015-04-12,MIL,96,39,40,BKN,73,37,42,76,82
2015-04-12,BOS,117,37,42,CLE,78,51,28,88,70
2015-04-12,DET,116,30,49,CHA,77,33,46,63,95
2015-04-12,DEN,122,29,50,SAC,111,27,52,56,102
2015-04-12,IND,116,36,43,OKC,104,43,36,79,79
2015-04-12,WAS,108,45,34,ATL,99,60,19,105,53
2015-04-12,HOU,121,53,26,NOP,114,43,36,96,62
2015-04-12,SAS,107,54,26,PHX,91,39,41,93,67
2015-04-12,LAL,106,21,58,DAL,120,48,31,69,89
2015-04-13,CHA,90,33,47,HOU,100,54,26,87,73
2015-04-13,CLE,109,51,29,DET,97,31,49,82,78
2015-04-13,PHI,97,18,62,MIL,107,40,40,58,102
2015-04-13,ATL,108,60,20,NYK,112,16,64,76,84
2015-04-13,BKN,86,37,43,CHI,113,48,32,85,75
2015-04-13,MIA,100,35,45,ORL,93,25,55,60,100
2015-04-13,MIN,88,16,64,NOP,100,43,37,59,101
2015-04-13,OKC,101,43,37,POR,90,51,29,94,66
2015-04-13,UTA,109,37,43,DAL,92,49,31,86,74
2015-04-13,SAC,102,27,53,LAL,92,21,59,48,112
2015-04-13,GSW,111,65,15,MEM,107,54,26,119,41
2015-04-13,LAC,110,54,26,DEN,103,30,50,84,76
2015-04-14,BOS,95,38,42,TOR,93,48,32,86,74
2015-04-14,IND,99,37,43,WAS,95,46,34,83,77
2015-04-14,PHX,101,39,42,LAC,112,55,26,94,68
2015-04-15,CHI,91,49,32,ATL,85,60,21,109,53
2015-04-15,DAL,114,49,32,POR,98,51,30,100,62
2015-04-15,HOU,117,55,26,UTA,91,38,43,93,69
2015-04-15,MEM,95,54,27,IND,83,38,43,92,70
2015-04-15,MIL,100,41,40,BOS,105,39,42,80,82
2015-04-15,MIN,113,16,65,OKC,138,44,37,60,102
2015-04-15,NOP,108,44,37,SAS,103,55,26,99,63
2015-04-15,BKN,101,37,44,ORL,88,25,56,62,100
2015-04-15,CLE,113,52,29,WAS,108,46,35,98,64
2015-04-15,NYK,90,17,64,DET,112,31,50,48,114
2015-04-15,PHI,101,18,63,MIA,105,36,45,54,108
2015-04-15,TOR,92,48,33,CHA,87,33,48,81,81
2015-04-15,GSW,133,66,15,DEN,126,30,51,96,66
2015-10-27,ATL,94,0,0,DET,106,0,0,0,0
2015-10-27,CHI,97,0,0,CLE,95,0,0,0,0
2015-10-27,GSW,111,0,0,NOP,95,0,0,0,0
2015-10-28,ORL,87,0,0,WAS,88,0,0,0,0
2015-10-28,BOS,112,0,0,PHI,95,0,0,0,0
2015-10-28,BKN,100,0,0,CHI,115,1,0,1,0
2015-10-28,DET,92,1,0,UTA,87,0,0,1,0
2015-10-28,MIA,104,0,0,CHA,94,0,0,0,0
2015-10-28,TOR,106,0,0,IND,99,0,0,0,0
2015-10-28,HOU,85,0,0,DEN,105,0,0,0,0
2015-10-28,MEM,76,0,0,CLE,106,0,1,0,1
2015-10-28,MIL,97,0,0,NYK,122,0,0,0,0
2015-10-28,OKC,112,0,0,SAS,106,0,0,0,0
2015-10-28,PHX,95,0,0,DAL,111,0,0,0,0
2015-10-28,POR,112,0,0,NOP,94,0,1,0,1
2015-10-28,SAC,104,0,0,LAC,111,0,0,0,0
2015-10-28,LAL,111,0,0,MIN,112,0,0,0,0
2015-10-29,IND,103,0,1,MEM,112,0,1,0,2
2015-10-29,NYK,101,1,0,ATL,112,0,1,1,1
2015-10-29,LAC,104,1,0,DAL,88,1,0,2,0
2015-10-30,CLE,102,1,1,MIA,92,1,0,2,1
2015-10-30,ORL,136,0,1,OKC,139,1,0,1,1
2015-10-30,PHI,71,0,1,UTA,99,0,1,0,2
2015-10-30,BOS,103,1,0,TOR,113,1,0,2,0
2015-10-30,DET,98,2,0,CHI,94,2,0,4,0
2015-10-30,ATL,97,1,1,CHA,94,0,1,1,2
2015-10-30,MIL,113,0,1,WAS,118,1,0,1,1
2015-10-30,SAS,102,0,1,BKN,75,0,1,0,2
2015-10-30,DEN,78,1,0,MIN,95,1,0,2,0
2015-10-30,HOU,92,0,1,GSW,112,1,0,1,1
2015-10-30,SAC,132,0,1,LAL,114,0,1,0,2
2015-10-30,PHX,110,0,1,POR,92,1,0,1,1
2015-10-31,IND,76,0,2,UTA,97,1,1,1,3
2015-10-31,WAS,110,2,0,NYK,117,1,1,3,1
2015-10-31,NOP,120,0,2,GSW,134,2,0,2,2
2015-10-31,MEM,101,1,1,BKN,91,0,2,1,3
2015-10-31,POR,90,1,1,PHX,101,1,1,2,2
2015-10-31,LAC,114,2,0,SAC,109,1,1,3,1
2015-11-01,CHA,92,0,2,ATL,94,2,1,2,3
2015-11-01,BOS,87,1,1,SAS,95,1,1,2,2
2015-11-01,MIA,109,1,1,HOU,89,0,2,1,3
2015-11-01,TOR,106,2,0,MIL,87,0,2,2,2
2015-11-01,CHI,92,2,1,ORL,87,0,2,2,3
2015-11-01,OKC,117,2,0,DEN,93,1,1,3,1
2015-11-01,LAL,93,0,2,DAL,103,1,1,1,3
2015-11-02,PHI,100,0,2,CLE,107,2,1,2,3
2015-11-02,BKN,96,0,3,MIL,103,0,3,0,6
2015-11-02,NYK,84,2,1,SAS,94,2,1,4,2
2015-11-02,HOU,110,0,3,OKC,105,3,0,3,3
2015-11-02,MIN,101,2,0,POR,106,1,2,3,2
2015-11-02,GSW,119,3,0,MEM,69,2,1,5,1
2015-11-02,LAC,102,3,0,PHX,96,2,1,5,1
2015-11-03,CHA,130,0,3,CHI,105,3,1,3,4
2015-11-03,DET,82,3,0,IND,94,0,3,3,3
2015-11-03,MIA,92,2,1,ATL,98,3,1,5,2
2015-11-03,NOP,94,0,3,ORL,103,0,3,0,6
2015-11-03,DAL,91,2,1,TOR,102,3,0,5,1
2015-11-03,SAC,89,1,2,MEM,103,2,2,3,4
2015-11-03,LAL,109,0,3,DEN,120,1,2,1,5
2015-11-04,IND,100,1,3,BOS,98,1,2,2,5
2015-11-04,WAS,102,2,1,SAS,99,3,1,5,2
2015-11-04,ATL,101,4,1,BKN,87,0,4,4,5
2015-11-04,CLE,96,3,1,NYK,86,2,2,5,3
2015-11-04,HOU,119,1,3,ORL,114,1,3,2,6
2015-11-04,MIL,91,1,3,PHI,87,0,3,1,6
2015-11-04,OKC,98,3,1,TOR,103,4,0,7,1
2015-11-04,PHX,118,2,2,SAC,97,1,3,3,5
2015-11-04,UTA,92,2,1,POR,108,2,2,4,3
2015-11-04,GSW,112,4,0,LAC,108,4,0,8,0
2015-11-05,CHI,104,3,2,OKC,98,3,2,6,4
2015-11-05,MIN,84,2,1,MIA,96,2,2,4,3
2015-11-05,DAL,94,2,2,CHA,108,1,3,3,5
2015-11-05,DEN,84,2,2,UTA,96,2,2,4,4
2015-11-05,POR,115,3,2,MEM,96,3,2,6,4
2015-11-06,ORL,92,1,4,TOR,87,5,0,6,4
2015-11-06,BOS,118,1,3,WAS,98,3,1,4,4
2015-11-06,BKN,98,0,5,LAL,104,0,4,0,9
2015-11-06,CLE,108,4,1,PHI,102,0,4,4,5
2015-11-06,NYK,92,2,3,MIL,99,2,3,4,6
2015-11-06,IND,90,2,3,MIA,87,3,2,5,5
2015-11-06,NOP,115,0,4,ATL,121,5,1,5,5
2015-11-06,PHX,92,3,2,DET,100,3,1,6,3
2015-11-06,GSW,119,5,0,DEN,104,2,3,7,3
2015-11-06,SAC,110,1,4,HOU,116,2,3,3,7
2015-11-07,CHI,93,4,2,MIN,102,2,2,6,4
2015-11-07,ATL,114,6,1,WAS,99,3,2,9,3
2015-11-07,PHI,97,0,5,ORL,105,2,4,2,9
2015-11-07,DAL,107,2,3,NOP,98,0,5,2,8
2015-11-07,MIL,94,3,3,BKN,86,0,6,3,9
2015-11-07,SAS,114,3,2,CHA,94,2,3,5,5
2015-11-07,UTA,89,3,2,MEM,79,3,3,6,5
2015-11-07,SAC,94,1,5,GSW,103,6,0,7,5
2015-11-07,LAC,105,4,1,HOU,109,3,3,7,4
2015-11-08,CLE,101,5,1,IND,97,3,3,8,4
2015-11-08,NYK,99,2,4,LAL,95,1,4,3,8
2015-11-08,MIA,96,3,3,TOR,76,5,1,8,4
2015-11-08,OKC,124,3,3,PHX,103,3,3,6,6
2015-11-08,POR,103,4,2,DET,120,4,1,8,3
2015-11-09,IND,97,3,4,ORL,84,3,4,6,8
2015-11-09,PHI,88,0,6,CHI,111,4,3,4,9
2015-11-09,ATL,107,7,1,MIN,117,3,2,10,3
2015-11-09,DEN,108,2,4,POR,104,4,3,6,7
2015-11-09,SAC,88,1,6,SAS,106,4,2,5,8
2015-11-09,GSW,109,7,0,DET,95,5,1,12,1
2015-11-09,LAC,94,4,2,MEM,92,3,4,7,6
2015-11-10,CLE,118,6,1,UTA,114,4,2,10,3
2015-11-10,WAS,101,3,3,OKC,125,4,3,7,6
2015-11-10,MIA,101,4,3,LAL,88,1,5,5,8
2015-11-10,TOR,109,5,2,NYK,111,3,4,8,6
2015-11-10,MIL,83,4,3,BOS,99,2,3,6,6
2015-11-10,MIN,95,4,2,CHA,104,2,4,6,6
2015-11-10,NOP,120,0,6,DAL,105,3,3,3,9
2015-11-11,CHA,95,3,4,NYK,93,4,4,7,8
2015-11-11,ORL,101,3,5,LAL,99,1,6,4,11
2015-11-11,PHI,103,0,7,TOR,119,5,3,5,10
2015-11-11,BOS,91,3,3,IND,102,4,4,7,7
2015-11-11,ATL,106,7,2,NOP,98,1,6,8,8
2015-11-11,DAL,118,3,4,LAC,108,5,2,8,6
2015-11-11,HOU,98,4,3,BKN,106,0,7,4,10
2015-11-11,MEM,84,3,5,GSW,100,8,0,11,5
2015-11-11,DEN,103,3,4,MIL,102,4,4,7,8
2015-11-11,SAC,101,1,7,DET,92,5,2,6,9
2015-11-11,POR,101,4,4,SAS,113,5,2,9,6
2015-11-12,MIA,92,5,3,UTA,91,4,3,9,6
2015-11-12,MIN,116,4,3,GSW,129,9,0,13,3
2015-11-12,PHX,118,3,4,LAC,104,5,3,8,7
2015-11-13,IND,107,5,4,MIN,103,4,4,9,8
2015-11-13,ORL,102,4,5,UTA,93,4,4,8,9
2015-11-13,BOS,106,3,4,ATL,93,8,2,11,6
2015-11-13,NYK,84,4,5,CLE,90,7,1,11,6
2015-11-13,TOR,100,6,3,NOP,81,1,7,7,10
2015-11-13,CHI,102,5,3,CHA,97,4,4,9,7
2015-11-13,MEM,101,3,6,POR,100,4,5,7,11
2015-11-13,OKC,102,5,3,PHI,85,0,8,5,11
2015-11-13,DAL,90,4,4,LAL,82,1,7,5,11
2015-11-13,DEN,107,4,4,HOU,98,4,4,8,8
2015-11-13,SAC,111,2,7,BKN,109,1,7,3,14
2015-11-14,LAC,101,5,4,DET,96,5,3,10,7
2015-11-14,WAS,108,3,4,ORL,99,5,5,8,9
2015-11-14,HOU,98,4,5,DAL,110,5,4,9,9
2015-11-14,MIL,108,4,5,CLE,105,8,1,12,6
2015-11-14,SAS,92,6,2,PHI,83,0,9,6,11
2015-11-14,PHX,105,4,4,DEN,81,5,4,9,8
2015-11-14,GSW,107,10,0,BKN,99,1,8,11,8
2015-11-15,NYK,95,4,6,NOP,87,1,8,5,14
2015-11-15,MIN,106,4,5,MEM,114,4,6,8,11
2015-11-15,CHA,106,4,5,POR,94,4,6,8,11
2015-11-15,ATL,96,8,3,UTA,97,4,5,12,8
2015-11-15,OKC,85,6,3,BOS,100,4,4,10,7
2015-11-15,SAC,107,3,7,TOR,101,7,3,10,10
2015-11-15,LAL,97,1,8,DET,85,5,4,6,12
2015-11-16,PHI,86,0,10,DAL,92,6,4,6,14
2015-11-16,CHI,96,6,3,IND,95,6,4,12,7
2015-11-16,HOU,95,4,6,BOS,111,5,4,9,10
2015-11-16,MEM,122,5,6,OKC,114,6,4,11,10
2015-11-16,SAS,93,7,2,POR,80,4,7,11,9
2015-11-16,PHX,120,5,4,LAL,101,2,8,7,12
2015-11-17,WAS,115,4,4,MIL,86,5,5,9,9
2015-11-17,BKN,90,1,9,ATL,88,8,4,9,13
2015-11-17,DET,104,5,5,CLE,99,8,2,13,7
2015-11-17,MIA,91,6,3,MIN,103,4,6,10,9
2015-11-17,NYK,102,5,6,CHA,94,5,5,10,11
2015-11-17,NOP,98,1,9,DEN,115,5,5,6,14
2015-11-17,GSW,115,11,0,TOR,110,7,4,18,4
2015-11-18,CHA,116,5,6,BKN,111,2,9,7,15
2015-11-18,ORL,104,5,6,MIN,101,5,6,10,12
2015-11-18,PHI,85,0,11,IND,112,6,5,6,16
2015-11-18,BOS,102,6,4,DAL,106,7,4,13,8
2015-11-18,ATL,103,8,5,SAC,97,4,7,12,12
2015-11-18,HOU,108,4,7,POR,103,4,8,8,15
2015-11-18,OKC,110,6,5,NOP,103,1,10,7,15
2015-11-18,SAS,109,8,2,DEN,98,6,5,14,7
2015-11-18,UTA,93,5,5,TOR,89,7,5,12,10
2015-11-18,PHX,97,6,4,CHI,103,7,3,13,7
2015-11-19,MIA,116,6,4,SAC,109,4,8,10,12
2015-11-19,CLE,115,8,3,MIL,100,5,6,13,9
2015-11-19,LAC,117,6,4,GSW,124,12,0,18,4
2015-11-20,CHA,113,6,6,PHI,88,0,12,6,18
2015-11-20,BOS,120,6,5,BKN,95,2,10,8,15
2015-11-20,MEM,96,6,6,HOU,84,5,7,11,13
2015-11-20,MIN,86,5,7,DET,96,6,5,11,12
2015-11-20,NOP,104,1,11,SAS,90,9,2,10,13
2015-11-20,OKC,90,7,5,NYK,93,6,6,13,11
2015-11-20,DAL,102,8,4,UTA,93,6,5,14,9
2015-11-20,DEN,107,6,6,PHX,114,6,5,12,11
2015-11-20,POR,102,4,9,LAC,91,6,5,10,14
2015-11-20,GSW,106,13,0,CHI,94,8,3,21,3
2015-11-20,LAL,91,2,9,TOR,102,7,6,9,15
2015-11-21,ORL,91,6,6,SAC,97,4,9,10,15
2015-11-21,IND,123,7,5,MIL,86,5,7,12,12
2015-11-21,CLE,109,9,3,ATL,97,9,5,18,8
2015-11-21,DET,95,7,5,WAS,97,5,4,12,9
2015-11-21,MIA,96,7,4,PHI,91,0,13,7,17
2015-11-21,HOU,102,5,8,NYK,107,7,6,12,14
2015-11-21,SAS,92,9,3,MEM,82,7,6,16,9
2015-11-22,LAC,80,6,6,TOR,91,8,6,14,12
2015-11-22,BKN,111,2,11,BOS,101,7,5,9,16
2015-11-22,NOP,122,2,11,PHX,116,7,5,9,16
2015-11-22,OKC,117,7,6,DAL,114,9,4,16,10
2015-11-22,DEN,105,6,7,GSW,118,14,0,20,7
2015-11-22,LAL,93,2,10,POR,107,5,9,7,19
2015-11-23,CHA,127,7,6,SAC,122,5,9,12,15
2015-11-23,CLE,117,10,3,ORL,103,6,7,16,10
2015-11-23,MIA,95,8,4,NYK,78,8,6,16,10
2015-11-23,MIL,109,5,8,DET,88,7,6,12,14
2015-11-23,MIN,100,5,8,PHI,95,0,14,5,22
2015-11-23,SAS,98,10,3,PHX,84,7,6,17,9
2015-11-23,UTA,89,6,6,OKC,111,8,6,14,12
2015-11-24,WAS,106,6,4,IND,123,8,5,14,9
2015-11-24,ATL,121,9,6,BOS,97,7,6,16,12
2015-11-24,MEM,110,7,7,DAL,96,9,5,16,12
2015-11-24,DEN,94,6,8,LAC,111,6,7,12,15
2015-11-24,POR,88,6,9,CHI,93,8,4,14,13
2015-11-24,GSW,111,15,0,LAL,77,2,11,17,11
2015-11-25,CHA,101,8,6,WAS,87,6,5,14,11
2015-11-25,ORL,100,6,8,NYK,91,8,7,14,15
2015-11-25,BOS,84,7,7,PHI,80,0,15,7,22
2015-11-25,DET,104,7,7,MIA,81,9,4,16,11
2015-11-25,TOR,103,9,6,CLE,99,11,3,20,9
2015-11-25,HOU,93,5,9,MEM,102,8,7,13,16
2015-11-25,MIL,118,6,8,SAC,129,5,10,11,18
2015-11-25,MIN,99,6,8,ATL,95,10,6,16,14
2015-11-25,OKC,110,9,6,BKN,99,3,11,12,17
2015-11-25,SAS,88,11,3,DAL,83,9,6,20,9
2015-11-25,PHX,114,7,7,NOP,120,3,11,10,18
2015-11-25,LAC,91,7,7,UTA,102,6,7,13,14
2015-11-27,CHA,90,9,6,CLE,95,11,4,20,10
2015-11-27,ORL,114,7,8,MIL,90,6,9,13,17
2015-11-27,BOS,111,8,7,WAS,78,6,6,14,13
2015-11-27,NYK,78,8,8,MIA,97,9,5,17,13
2015-11-27,IND,104,9,5,CHI,92,9,4,18,9
2015-11-27,HOU,116,5,10,PHI,114,0,16,5,26
2015-11-27,MEM,101,9,7,ATL,116,10,7,19,14
2015-11-27,OKC,103,10,6,DET,87,8,7,18,13
2015-11-27,DEN,80,6,9,SAS,91,12,3,18,12
2015-11-27,PHX,116,7,8,GSW,135,16,0,23,8
2015-11-27,SAC,91,6,10,MIN,101,7,8,13,18
2015-11-27,LAC,111,7,8,NOP,90,4,11,11,19
2015-11-28,WAS,82,6,7,TOR,84,10,6,16,13
2015-11-28,CLE,90,12,4,BKN,88,3,12,15,16
2015-11-28,DAL,92,9,7,DEN,81,6,10,15,17
2015-11-28,SAS,108,13,3,ATL,88,11,7,24,10
2015-11-28,UTA,101,7,7,NOP,87,4,12,11,19
2015-11-28,POR,108,6,10,LAL,96,2,12,8,22
2015-11-28,GSW,120,17,0,SAC,101,6,11,23,11
2015-11-29,CHA,87,9,7,MIL,82,6,10,15,17
2015-11-29,LAC,107,8,8,MIN,99,8,8,16,16
2015-11-29,BKN,87,3,13,DET,83,8,8,11,21
2015-11-29,ORL,110,8,8,BOS,91,9,7,17,15
2015-11-29,TOR,102,11,6,PHX,107,7,9,18,15
2015-11-29,MEM,92,9,8,PHI,84,0,17,9,25
2015-11-29,NYK,111,8,9,HOU,116,6,10,14,19
2015-11-29,LAL,103,2,13,IND,107,10,5,12,18
2015-11-30,DET,116,8,9,HOU,105,7,10,15,19
2015-11-30,MIA,95,10,5,BOS,105,9,8,19,13
2015-11-30,ATL,106,11,8,OKC,100,11,6,22,14
2015-11-30,CHI,92,9,5,SAS,89,14,3,23,8
2015-11-30,MIL,92,6,11,DEN,74,6,11,12,22
2015-11-30,UTA,103,8,7,GSW,106,18,0,26,7
2015-11-30,SAC,112,6,12,DAL,98,10,7,16,19
2015-11-30,LAC,102,9,8,POR,87,7,10,16,18
2015-12-01,CLE,85,13,4,WAS,97,6,8,19,12
2015-12-01,PHI,103,0,18,LAL,91,2,14,2,32
2015-12-01,BKN,94,4,13,PHX,91,8,9,12,22
2015-12-01,MIN,93,8,9,ORL,96,9,8,17,17
2015-12-01,NOP,104,4,13,MEM,113,10,8,14,21
2015-12-01,POR,112,7,11,DAL,115,10,8,17,19
2015-12-02,CHA,99,10,7,GSW,116,19,0,29,7
2015-12-02,WAS,104,7,8,LAL,108,2,15,9,23
2015-12-02,DET,127,9,9,PHX,122,8,10,17,19
2015-12-02,NYK,99,8,10,PHI,87,1,18,9,28
2015-12-02,ATL,86,12,8,TOR,96,11,7,23,15
2015-12-02,CHI,99,10,5,DEN,90,6,12,16,17
2015-12-02,HOU,108,7,11,NOP,101,4,14,11,25
2015-12-02,SAS,95,14,4,MIL,70,7,11,21,15
2015-12-02,LAC,91,10,8,IND,103,11,5,21,13
2015-12-03,MIA,97,10,6,OKC,95,11,7,21,13
2015-12-03,TOR,105,12,7,DEN,106,6,13,18,20
2015-12-03,UTA,94,8,8,ORL,103,10,8,18,16
2015-12-03,MEM,83,11,8,SAS,103,15,4,26,12
2015-12-03,POR,123,7,12,IND,111,12,5,19,17
2015-12-03,SAC,97,7,12,BOS,114,10,8,17,20
2015-12-04,NYK,108,9,10,BKN,91,5,13,14,23
2015-12-04,WAS,109,7,9,PHX,106,8,11,15,20
2015-12-04,DET,102,10,9,MIL,95,7,12,17,21
2015-12-04,ATL,100,12,9,LAL,87,3,15,15,24
2015-12-04,DAL,96,11,8,HOU,100,8,11,19,19
2015-12-04,NOP,114,4,15,CLE,108,13,5,17,20
2015-12-05,PHI,105,1,19,DEN,108,7,13,8,32
2015-12-05,TOR,109,12,8,GSW,112,20,0,32,8
2015-12-05,MIA,99,11,6,CLE,84,13,6,24,12
2015-12-05,CHI,96,11,5,CHA,102,10,8,21,13
2015-12-05,HOU,120,9,11,SAC,113,7,13,16,24
2015-12-05,MIN,103,8,10,POR,109,8,12,16,22
2015-12-05,MIL,106,7,13,NYK,91,10,10,17,23
2015-12-05,SAS,108,16,4,BOS,105,11,8,27,12
2015-12-05,UTA,122,8,9,IND,119,12,6,20,15
2015-12-05,LAC,103,10,9,ORL,101,11,8,21,17
2015-12-06,MEM,95,11,9,PHX,93,8,12,19,21
2015-12-06,BKN,98,5,14,GSW,114,21,0,26,14
2015-12-06,DET,111,11,9,LAL,91,3,16,14,25
2015-12-06,WAS,104,8,9,DAL,116,11,9,19,18
2015-12-06,OKC,98,11,8,SAC,95,7,14,18,22
2015-12-07,CHA,104,11,8,DET,84,12,9,23,17
2015-12-07,PHI,68,1,20,SAS,119,17,4,18,24
2015-12-07,MIA,103,12,6,WAS,114,8,10,20,16
2015-12-07,NYK,97,10,11,DAL,104,12,9,22,20
2015-12-07,TOR,102,12,9,LAL,93,3,17,15,26
2015-12-07,CHI,101,11,6,PHX,103,8,13,19,19
2015-12-07,MIL,90,8,13,POR,88,9,12,17,25
2015-12-07,MIN,106,8,11,LAC,110,11,9,19,20
2015-12-07,NOP,93,5,15,BOS,111,11,9,16,24
2015-12-08,CLE,105,13,7,POR,100,9,13,22,20
2015-12-08,IND,123,12,7,GSW,131,22,0,34,7
2015-12-08,BKN,110,5,15,HOU,105,10,11,15,26
2015-12-08,MEM,88,12,9,OKC,125,12,8,24,17
2015-12-08,DEN,74,8,13,ORL,85,11,9,19,22
2015-12-08,SAC,114,7,15,UTA,106,9,9,16,24
2015-12-09,BOS,105,12,9,CHI,100,11,7,23,16
2015-12-09,CHA,99,12,8,MIA,81,12,7,24,15
2015-12-09,WAS,103,9,10,HOU,109,10,12,19,22
2015-12-09,DET,92,12,10,MEM,93,12,10,24,20
2015-12-09,TOR,97,13,9,SAS,94,18,4,31,13
2015-12-09,MIL,95,9,13,LAC,109,12,9,21,22
2015-12-09,MIN,123,8,12,LAL,122,3,18,11,30
2015-12-09,PHX,107,9,13,ORL,104,12,9,21,22
2015-12-09,UTA,106,9,10,NYK,85,10,12,19,22
2015-12-09,DAL,95,13,9,ATL,98,13,9,26,18
2015-12-10,BKN,100,6,15,PHI,91,1,21,7,36
2015-12-10,CHI,83,11,8,LAC,80,13,9,24,17
2015-12-10,OKC,107,13,8,ATL,94,14,9,27,17
2015-12-10,SAC,99,8,15,NYK,97,10,13,18,28
2015-12-11,IND,96,12,8,MIA,83,12,8,24,16
2015-12-11,ORL,76,12,10,CLE,111,14,7,26,17
2015-12-11,PHI,95,1,22,DET,107,12,11,13,33
2015-12-11,BOS,119,13,9,GSW,124,23,0,36,9
2015-12-11,TOR,90,14,9,MIL,83,9,14,23,23
2015-12-11,MEM,99,13,10,CHA,123,13,8,26,18
2015-12-11,NOP,107,5,16,WAS,105,9,11,14,27
2015-12-11,DEN,111,8,14,MIN,108,9,12,17,26
2015-12-11,UTA,90,10,10,OKC,94,14,8,24,18
2015-12-11,SAS,109,18,5,LAL,87,3,19,21,24
2015-12-11,PHX,96,10,13,POR,106,9,14,19,27
2015-12-12,BKN,100,7,15,LAC,105,13,10,20,25
2015-12-12,CHA,93,14,8,BOS,98,13,10,27,18
2015-12-12,DET,118,13,11,IND,96,13,8,26,19
2015-12-12,ATL,78,14,10,SAS,103,19,5,33,15
2015-12-12,CHI,98,12,8,NOP,94,6,16,18,24
2015-12-12,HOU,126,11,12,LAL,97,3,20,14,32
2015-12-12,DAL,111,13,10,WAS,114,9,12,22,22
2015-12-12,MIL,108,9,15,GSW,95,24,0,33,15
2015-12-12,POR,110,10,14,NYK,112,10,14,20,28
2015-12-13,PHX,108,10,14,MIN,101,9,13,19,27
2015-12-13,MIA,100,12,9,MEM,97,13,11,25,20
2015-12-13,TOR,96,15,9,PHI,76,1,23,16,32
2015-12-13,OKC,104,15,8,UTA,98,10,11,25,19
2015-12-14,IND,106,13,9,TOR,90,16,9,29,18
2015-12-14,BKN,82,7,16,ORL,105,12,11,19,27
2015-12-14,DET,103,14,11,LAC,105,14,10,28,21
2015-12-14,ATL,88,14,11,MIA,100,13,9,27,20
2015-12-14,CHI,115,13,8,PHI,96,1,24,14,32
2015-12-14,MEM,112,13,12,WAS,95,10,12,23,24
2015-12-14,DAL,104,13,11,PHX,94,11,14,24,25
2015-12-14,SAS,118,20,5,UTA,81,10,12,30,17
2015-12-14,DEN,114,9,14,HOU,108,12,12,21,26
2015-12-14,POR,105,10,15,NOP,101,6,17,16,32
2015-12-15,BOS,77,14,10,CLE,89,15,7,29,17
2015-12-15,MIN,100,9,14,DEN,112,10,14,19,28
2015-12-15,SAC,107,9,15,HOU,97,12,13,21,28
2015-12-15,LAL,113,3,21,MIL,95,10,15,13,36
2015-12-16,IND,107,14,9,DAL,81,14,11,28,20
2015-12-16,ORL,113,13,11,CHA,98,14,9,27,20
2015-12-16,BKN,98,7,17,MIA,104,14,9,21,26
2015-12-16,DET,119,14,12,BOS,116,14,11,28,23
2015-12-16,NYK,107,11,14,MIN,102,9,15,20,29
2015-12-16,ATL,127,14,12,PHI,106,1,25,15,37
2015-12-16,CHI,98,14,8,MEM,85,14,12,28,20
2015-12-16,OKC,106,16,8,POR,90,11,15,27,23
2015-12-16,SAS,114,21,5,WAS,95,10,13,31,18
2015-12-16,UTA,94,10,13,NOP,104,6,18,16,31
2015-12-16,GSW,128,24,1,PHX,103,11,15,35,16
2015-12-16,LAC,103,15,10,MIL,90,10,16,25,26
2015-12-17,CHA,109,14,10,TOR,99,16,10,30,20
2015-12-17,CLE,104,16,7,OKC,100,17,8,33,15
2015-12-17,LAL,87,4,21,HOU,107,12,14,16,35
2015-12-18,IND,104,15,9,BKN,97,7,18,22,27
2015-12-18,ORL,102,14,11,POR,94,11,16,25,27
2015-12-18,PHI,97,1,26,NYK,107,12,14,13,40
2015-12-18,BOS,101,14,12,ATL,109,15,12,29,24
2015-12-18,MIA,94,15,9,TOR,108,16,11,31,20
2015-12-18,CHI,144,15,8,DET,147,15,12,30,20
2015-12-18,MIN,99,9,16,SAC,95,10,15,19,31
2015-12-18,SAS,115,22,5,LAC,107,16,10,38,15
2015-12-18,DAL,97,14,12,MEM,88,14,13,28,25
2015-12-18,UTA,97,10,14,DEN,88,11,14,21,28
2015-12-18,PHX,104,11,16,NOP,88,7,18,18,34
2015-12-18,GSW,121,25,1,MIL,112,10,17,35,18
2015-12-19,OKC,118,17,9,LAL,78,4,22,21,31
2015-12-19,WAS,109,10,14,CHA,101,15,10,25,24
2015-12-19,NYK,107,13,14,CHI,91,15,9,28,23
2015-12-19,HOU,107,13,14,LAC,97,16,11,29,25
2015-12-19,MEM,96,14,14,IND,84,16,9,30,23
2015-12-20,BKN,85,7,19,MIN,100,10,16,17,35
2015-12-20,MIA,116,15,10,POR,109,11,17,26,27
2015-12-20,CLE,108,17,7,PHI,86,1,27,18,34
2015-12-20,PHX,95,12,16,MIL,101,10,18,22,34
2015-12-20,ORL,100,15,11,ATL,103,16,12,31,23
2015-12-20,TOR,94,17,11,SAC,104,10,16,27,27
2015-12-20,DEN,125,11,15,NOP,130,7,19,18,34
2015-12-21,WAS,113,11,14,SAC,99,11,16,22,30
2015-12-21,BOS,113,14,13,MIN,99,11,16,25,29
2015-12-21,NYK,99,14,14,ORL,107,15,12,29,26
2015-12-21,ATL,106,17,12,POR,97,11,18,28,30
2015-12-21,CHI,102,15,10,BKN,105,7,20,22,30
2015-12-21,HOU,102,14,14,CHA,95,15,11,29,25
2015-12-21,SAS,106,23,5,IND,92,16,10,39,15
2015-12-21,UTA,110,11,14,PHX,89,12,17,23,31
2015-12-21,LAC,99,16,12,OKC,100,18,9,34,21
2015-12-22,PHI,90,1,28,MEM,104,15,14,16,42
2015-12-22,MIA,92,16,10,DET,93,16,12,32,22
2015-12-22,TOR,103,17,12,DAL,99,15,12,32,24
2015-12-22,DEN,107,11,16,LAL,111,4,23,15,39
2015-12-23,CHA,89,15,12,BOS,102,15,13,30,25
2015-12-23,CLE,91,18,7,NYK,84,14,15,32,22
2015-12-23,IND,106,16,11,SAC,108,11,17,27,28
2015-12-23,ORL,104,16,12,HOU,101,15,14,31,26
2015-12-23,WAS,100,12,14,MEM,91,16,14,28,28
2015-12-23,BKN,118,8,20,DAL,119,15,13,23,33
2015-12-23,ATL,107,18,12,DET,100,17,12,35,24
2015-12-23,MIL,113,11,18,PHI,100,1,29,12,47
2015-12-23,MIN,83,11,17,SAS,108,24,5,35,22
2015-12-23,NOP,115,8,19,POR,89,11,19,19,38
2015-12-23,PHX,96,12,18,DEN,104,11,17,23,35
2015-12-23,GSW,103,26,1,UTA,85,12,14,38,15
2015-12-23,LAL,85,5,23,OKC,120,19,9,24,32
2015-12-25,MIA,94,16,11,NOP,88,9,19,25,30
2015-12-25,OKC,96,20,9,CHI,105,15,11,35,20
2015-12-25,GSW,89,27,1,CLE,83,19,7,46,8
2015-12-25,HOU,88,15,15,SAS,84,25,5,40,20
2015-12-25,LAL,84,5,24,LAC,94,16,13,21,37
2015-12-26,MIL,90,12,18,TOR,111,18,12,30,30
2015-12-26,ATL,117,19,12,NYK,98,14,16,33,28
2015-12-26,CHA,98,15,13,MEM,92,16,15,31,28
2015-12-26,ORL,101,17,12,MIA,108,17,11,34,23
2015-12-26,NOP,110,9,20,HOU,108,16,15,25,35
2015-12-26,DET,93,17,13,BOS,99,16,13,33,26
2015-12-26,BKN,96,8,21,WAS,111,13,14,21,35
2015-12-26,MIN,88,11,18,IND,102,16,12,27,30
2015-12-26,DAL,118,16,13,CHI,111,16,11,32,24
2015-12-26,SAS,101,25,6,DEN,86,12,17,37,23
2015-12-26,PHX,104,12,19,PHI,111,1,30,13,49
2015-12-26,UTA,104,12,15,LAC,109,17,13,29,28
2015-12-26,POR,105,11,20,CLE,76,19,8,30,28
2015-12-27,BOS,100,17,13,NYK,91,14,17,31,30
2015-12-27,MEM,112,16,16,LAL,96,5,25,21,41
2015-12-27,OKC,122,20,10,DEN,112,12,18,32,28
2015-12-27,SAC,94,12,17,POR,98,12,20,24,37
2015-12-28,CHA,108,16,13,LAL,98,5,26,21,39
2015-12-28,IND,93,17,12,ATL,87,20,12,37,24
2015-12-28,ORL,104,17,13,NOP,89,10,20,27,33
2015-12-28,WAS,91,14,14,LAC,108,18,13,32,27
2015-12-28,MIA,105,18,11,BKN,111,8,22,26,33
2015-12-28,CHI,104,16,12,TOR,97,19,12,35,24
2015-12-28,DAL,103,17,13,MIL,93,12,19,29,32
2015-12-28,SAS,101,26,6,MIN,95,11,19,37,25
2015-12-28,PHX,97,12,20,CLE,101,19,9,31,29
2015-12-28,UTA,95,12,16,PHI,91,2,30,14,46
2015-12-28,GSW,122,28,1,SAC,103,12,18,40,19
2015-12-29,NYK,108,14,18,DET,96,17,14,31,32
2015-12-29,HOU,115,16,16,ATL,121,20,13,36,29
2015-12-29,MEM,99,17,16,MIA,90,18,12,35,28
2015-12-29,OKC,131,21,10,MIL,123,12,20,33,30
2015-12-29,DEN,87,12,19,CLE,93,20,9,32,28
2015-12-30,CHA,117,17,13,LAC,122,19,13,36,26
2015-12-30,ORL,100,18,13,BKN,93,9,22,27,35
2015-12-30,BOS,104,18,13,LAL,112,5,27,23,40
2015-12-30,TOR,94,19,13,WAS,91,14,15,33,28
2015-12-30,CHI,102,17,12,IND,100,18,12,35,24
2015-12-30,MIN,94,11,20,UTA,80,13,16,24,36
2015-12-30,DAL,114,18,13,GSW,91,29,1,47,14
2015-12-30,SAS,112,27,6,PHX,79,12,21,39,27
2015-12-30,POR,110,13,20,DEN,103,12,20,25,40
2015-12-30,SAC,105,12,19,PHI,110,2,31,14,50
2015-12-31,IND,116,18,13,MIL,120,12,21,30,34
2015-12-31,HOU,110,16,17,GSW,114,29,2,45,19
2015-12-31,DET,115,17,15,MIN,90,12,20,29,35
2015-12-31,NOP,89,10,21,LAC,95,20,13,30,34
2015-12-31,OKC,110,22,10,PHX,106,12,22,34,32
2015-12-31,UTA,109,13,17,POR,96,14,20,27,37
2016-01-01,WAS,103,14,16,ORL,91,19,13,33,29
2016-01-01,MIA,106,18,13,DAL,82,19,13,37,26
2016-01-01,TOR,104,20,13,CHA,94,17,14,37,27
2016-01-01,CHI,108,18,12,NYK,81,15,18,33,30
2016-01-01,LAL,93,6,27,PHI,84,3,31,9,58
2016-01-02,BOS,97,18,14,BKN,100,9,23,27,37
2016-01-02,SAC,142,12,20,PHX,119,12,23,24,43
2016-01-02,CHA,90,17,15,OKC,109,23,10,40,25
2016-01-02,IND,94,18,14,DET,82,18,15,36,29
2016-01-02,CLE,104,21,9,ORL,79,19,14,40,23
2016-01-02,MIN,85,12,21,MIL,95,13,21,25,42
2016-01-02,DAL,98,19,14,NOP,105,10,22,29,36
2016-01-02,SAS,121,28,6,HOU,103,16,18,44,24
2016-01-02,UTA,92,14,17,MEM,87,18,16,32,33
2016-01-02,GSW,111,30,2,DEN,108,12,21,42,23
2016-01-02,LAC,130,21,13,PHI,99,3,32,24,45
2016-01-03,NYK,111,15,19,ATL,97,21,13,36,32
2016-01-03,TOR,113,21,13,CHI,115,19,12,40,25
2016-01-03,WAS,75,15,16,MIA,97,19,13,34,29
2016-01-03,DEN,106,12,22,POR,112,14,21,26,43
2016-01-03,LAL,97,7,27,PHX,77,12,24,19,51
2016-01-04,CLE,122,22,9,TOR,100,21,14,43,23
2016-01-04,PHI,109,3,33,MIN,99,12,22,15,55
2016-01-04,BKN,94,10,23,BOS,103,18,15,28,38
2016-01-04,DET,115,18,16,ORL,89,19,15,37,31
2016-01-04,MIA,103,20,13,IND,100,19,14,39,27
2016-01-04,MIL,98,14,21,SAS,123,29,6,43,27
2016-01-04,OKC,104,24,10,SAC,116,13,20,37,30
2016-01-04,UTA,91,15,17,HOU,93,16,19,31,36
2016-01-04,POR,78,15,21,MEM,91,18,17,33,38
2016-01-04,GSW,111,31,2,CHA,101,17,16,48,18
2016-01-05,ATL,101,21,14,NYK,107,16,19,37,33
2016-01-05,CHI,117,20,12,MIL,106,14,22,34,34
2016-01-05,DAL,117,19,15,SAC,116,14,20,33,35
2016-01-05,LAL,88,8,27,GSW,109,32,2,40,29
2016-01-06,MIA,90,21,13,NYK,98,17,19,38,32
2016-01-06,ORL,86,19,16,IND,95,19,15,38,31
2016-01-06,WAS,115,15,17,CLE,121,23,9,38,26
2016-01-06,BOS,94,19,15,DET,99,19,16,38,31
2016-01-06,BKN,74,10,24,TOR,91,21,15,31,39
2016-01-06,MIN,74,12,23,DEN,78,12,23,24,46
2016-01-06,NOP,91,11,22,DAL,100,20,15,31,37
2016-01-06,SAS,123,30,6,UTA,98,15,18,45,24
2016-01-06,PHX,111,12,25,CHA,102,17,17,29,42
2016-01-06,OKC,112,24,11,MEM,94,19,17,43,28
2016-01-06,POR,98,15,22,LAC,109,22,13,37,35
2016-01-07,PHI,98,4,33,ATL,126,21,15,25,48
2016-01-07,CHI,101,21,12,BOS,92,19,16,40,28
2016-01-07,HOU,103,17,19,UTA,94,15,19,32,38
2016-01-07,SAC,118,14,21,LAL,115,8,28,22,49
2016-01-08,WAS,88,15,18,TOR,97,22,15,37,33
2016-01-08,BKN,77,10,25,ORL,83,19,17,29,42
2016-01-08,MEM,91,19,18,DEN,84,13,23,32,41
2016-01-08,MIN,99,12,24,CLE,125,24,9,36,33
2016-01-08,NOP,86,11,23,IND,91,20,15,31,38
2016-01-08,MIL,96,14,23,DAL,95,21,15,35,38
2016-01-08,SAS,100,31,6,NYK,99,18,19,49,25
2016-01-08,PHX,95,13,25,MIA,103,21,14,34,39
2016-01-08,POR,108,15,23,GSW,128,33,2,48,25
2016-01-08,LAL,113,8,29,OKC,117,25,11,33,40
2016-01-09,LAC,97,23,13,CHA,83,17,18,40,31
2016-01-09,ATL,120,22,15,CHI,105,22,12,44,27
2016-01-09,ORL,99,20,17,WAS,105,15,19,35,36
2016-01-09,DET,103,20,16,BKN,89,10,26,30,42
2016-01-09,PHI,95,4,34,TOR,108,23,15,27,49
2016-01-09,UTA,98,15,20,MIA,83,22,14,37,34
2016-01-09,SAC,116,15,21,GSW,128,34,2,49,23
2016-01-10,MIN,87,12,25,DAL,93,21,16,33,41
2016-01-10,LAC,114,24,13,NOP,111,11,24,35,37
2016-01-10,PHI,85,4,35,CLE,95,25,9,29,44
2016-01-10,MEM,101,20,18,BOS,98,19,17,39,35
2016-01-10,HOU,107,18,19,IND,103,21,15,39,34
2016-01-10,NYK,100,18,20,MIL,88,15,23,33,43
2016-01-10,DEN,95,13,24,CHA,92,17,19,30,43
2016-01-10,POR,115,15,24,OKC,110,26,11,41,35
2016-01-10,LAL,74,8,30,UTA,86,16,20,24,50
2016-01-11,BKN,79,10,27,SAS,106,32,6,42,33
2016-01-11,CHI,100,22,13,WAS,114,16,19,38,32
2016-01-11,GSW,111,35,2,MIA,103,22,15,57,17
2016-01-12,IND,116,21,16,PHX,97,13,26,34,42
2016-01-12,DET,99,21,16,SAS,109,33,6,54,22
2016-01-12,NYK,120,19,20,BOS,114,19,18,38,38
2016-01-12,MEM,91,21,18,HOU,107,19,19,40,37
2016-01-12,MIL,106,15,24,CHI,101,22,14,37,38
2016-01-12,MIN,96,12,26,OKC,101,26,12,38,38
2016-01-12,DAL,107,22,16,CLE,110,26,9,48,25
2016-01-12,LAL,95,8,31,NOP,91,11,25,19,56
2016-01-13,CHA,107,17,20,ATL,84,23,15,40,35
2016-01-13,WAS,106,17,19,MIL,101,16,24,33,43
2016-01-13,BKN,110,10,28,NYK,104,20,20,30,48
2016-01-13,BOS,103,19,19,IND,94,22,16,41,35
2016-01-13,HOU,107,20,19,MIN,104,12,27,32,46
2016-01-13,OKC,108,27,12,DAL,89,22,17,49,29
2016-01-13,DEN,112,14,24,GSW,110,36,2,50,26
2016-01-13,POR,99,16,24,UTA,85,17,20,33,44
2016-01-13,SAC,97,15,22,NOP,109,11,26,26,48
2016-01-13,LAC,104,25,13,MIA,90,22,16,47,29
2016-01-14,PHI,111,4,36,CHI,115,22,15,26,51
2016-01-14,ORL,103,20,18,TOR,106,24,15,44,33
2016-01-14,MEM,103,21,19,DET,101,21,17,42,36
2016-01-14,SAS,99,34,6,CLE,95,27,9,61,15
2016-01-14,UTA,101,17,21,SAC,103,15,23,32,44
2016-01-14,GSW,116,36,3,LAL,98,9,31,45,34
2016-01-15,IND,104,22,17,WAS,118,18,19,40,36
2016-01-15,OKC,113,28,12,MIN,93,12,28,40,40
2016-01-15,BOS,117,20,19,PHX,103,13,27,33,46
2016-01-15,BKN,104,11,28,POR,116,17,24,28,52
2016-01-15,CHI,77,23,15,DAL,83,22,18,45,33
2016-01-15,NOP,109,12,26,CHA,107,18,20,30,46
2016-01-15,MIL,108,16,25,ATL,101,23,16,39,41
2016-01-15,DEN,95,15,24,MIA,98,22,17,37,41
2016-01-15,HOU,77,21,19,CLE,91,27,10,48,29
2016-01-16,ATL,114,23,17,BKN,86,11,29,34,46
2016-01-16,CHA,92,18,21,MIL,105,17,25,35,46
2016-01-16,WAS,117,19,19,BOS,119,21,19,40,38
2016-01-16,DET,113,21,18,GSW,95,37,3,58,21
2016-01-16,PHI,114,4,37,POR,89,18,24,22,61
2016-01-16,MEM,103,22,19,NYK,95,20,21,42,40
2016-01-16,UTA,109,17,22,LAL,82,9,32,26,54
2016-01-16,LAC,103,26,13,SAC,110,16,23,42,36
2016-01-17,MIN,117,12,29,PHX,87,13,28,25,57
2016-01-17,OKC,99,29,12,MIA,74,23,17,52,29
2016-01-17,SAS,112,35,6,DAL,83,23,18,58,24
2016-01-17,DEN,129,15,25,IND,126,22,18,37,43
2016-01-17,LAL,95,9,33,HOU,112,21,20,30,53
2016-01-18,NYK,119,20,22,PHI,113,5,37,25,59
2016-01-18,CHA,124,18,22,UTA,119,18,22,36,44
2016-01-18,WAS,98,19,20,POR,108,18,25,37,45
2016-01-18,MEM,101,23,19,NOP,99,13,26,36,45
2016-01-18,DET,101,22,18,CHI,111,23,16,45,34
2016-01-18,ATL,98,24,17,ORL,81,20,19,44,36
2016-01-18,TOR,112,25,15,BKN,100,11,30,36,45
2016-01-18,CLE,98,28,10,GSW,132,37,4,65,14
2016-01-18,DAL,118,23,19,BOS,113,22,19,45,38
2016-01-18,LAC,140,26,14,HOU,132,22,20,48,34
2016-01-19,MIA,79,23,18,MIL,91,18,25,41,43
2016-01-19,NOP,114,13,27,MIN,99,13,29,26,56
2016-01-19,DEN,104,16,25,OKC,110,30,12,46,37
2016-01-19,PHX,94,13,29,IND,97,22,19,35,48
2016-01-20,ORL,87,20,20,PHI,96,5,38,25,58
2016-01-20,WAS,106,19,21,MIA,87,23,19,42,40
2016-01-20,BKN,78,11,31,CLE,91,28,11,39,42
2016-01-20,NYK,118,21,22,UTA,111,18,23,39,45
2016-01-20,TOR,115,26,15,BOS,109,22,20,48,35
2016-01-20,CHI,94,24,16,GSW,125,38,4,62,20
2016-01-20,HOU,114,22,21,DET,123,22,19,44,40
2016-01-20,OKC,109,31,12,CHA,95,19,22,50,34
2016-01-20,DAL,106,24,19,MIN,94,13,30,37,49
2016-01-20,LAL,93,9,34,SAC,112,17,23,26,57
2016-01-20,POR,98,19,25,ATL,104,25,17,44,42